,Team,Season,Player,Age,G,GS,MP,FG,FGA,FG%,3P,3PA,3P%,2P,2PA,2P%,eFG%,FT,FTA,FT%,ORB,DRB,TRB,AST,STL,BLK,TOV,PF,PTS
0,MIA,2024,Bam Adebayo,26,71,71,2416,530,1017,.521,15,42,.357,515,975,.528,.529,292,387,.755,159,578,737,278,81,66,162,159,1367
1,MIA,2024,Jaime Jaquez Jr.,22,75,20,2113,341,697,.489,65,202,.322,276,495,.558,.536,142,175,.811,82,203,285,195,77,20,110,167,889
2,MIA,2024,Jimmy Butler,34,60,60,2042,396,793,.499,60,145,.414,336,648,.519,.537,394,459,.858,105,213,318,298,79,17,102,68,1246
3,MIA,2024,Duncan Robinson,29,68,36,1905,304,675,.450,187,473,.395,117,202,.579,.589,80,90,.889,15,158,173,192,46,16,95,163,875
4,MIA,2024,Caleb Martin,28,64,23,1756,241,559,.431,81,232,.349,160,327,.489,.504,77,99,.778,74,207,281,143,47,29,77,126,640
5,MIA,2024,Tyler Herro,24,42,40,1407,324,735,.441,132,333,.396,192,402,.478,.531,95,111,.856,19,203,222,188,30,3,93,63,875
6,MIA,2024,Haywood Highsmith,27,66,26,1366,153,329,.465,76,192,.396,77,137,.562,.581,23,36,.639,65,145,210,70,53,30,34,117,405
7,MIA,2024,Josh Richardson,30,43,6,1103,154,347,.444,66,190,.347,88,157,.561,.539,51,54,.944,18,103,121,105,24,14,36,76,425
8,MIA,2024,Kyle Lowry,37,37,35,1037,103,242,.426,62,161,.385,41,81,.506,.554,35,42,.833,25,104,129,147,39,15,53,94,303
9,MIA,2024,Terry Rozier,29,31,30,975,190,449,.423,66,178,.371,124,271,.458,.497,63,69,.913,18,112,130,144,31,9,41,49,509
10,MIA,2024,Kevin Love,35,55,5,924,158,359,.440,84,244,.344,74,115,.643,.557,85,108,.787,59,279,338,115,18,10,48,97,485
11,MIA,2024,Nikola Jović,20,46,38,896,127,281,.452,65,163,.399,62,118,.525,.568,33,47,.702,25,167,192,90,25,14,42,82,352
12,MIA,2024,Thomas Bryant,26,38,4,441,86,149,.577,4,22,.182,82,127,.646,.591,41,47,.872,40,101,141,23,10,16,21,46,217
13,MIA,2024,Orlando Robinson,23,36,7,304,36,72,.500,8,15,.533,28,57,.491,.556,19,25,.760,28,56,84,34,7,8,18,35,99
14,MIA,2024,Delon Wright,31,14,1,286,26,66,.394,11,30,.367,15,36,.417,.477,13,16,.813,6,21,27,37,19,3,3,10,76
15,MIA,2024,Jamal Cain,24,26,1,259,34,79,.430,11,31,.355,23,48,.479,.500,18,23,.783,15,22,37,10,10,5,8,22,97
16,MIA,2024,Patty Mills,35,13,5,213,27,80,.338,11,53,.208,16,27,.593,.406,11,11,1.000,4,11,15,20,11,0,8,15,76
17,MIA,2024,Dru Smith,26,9,0,131,15,33,.455,7,17,.412,8,16,.500,.561,2,2,1.000,6,8,14,14,9,3,5,12,39
18,MIA,2024,Cole Swider,24,18,0,87,15,38,.395,10,30,.333,5,8,.625,.526,2,2,1.000,1,6,7,5,1,1,8,4,42
19,MIA,2024,R.J. Hampton,22,8,2,76,4,14,.286,1,8,.125,3,6,.500,.321,1,2,.500,2,4,6,8,0,0,3,8,10
20,MIA,2024,Alondes Williams,24,7,0,16,2,8,.250,0,4,.000,2,4,.500,.250,1,1,1.000,0,1,1,0,0,1,2,2,5
21,MIA,2023,Bam Adebayo,25,75,75,2598,602,1114,.540,1,12,.083,601,1102,.545,.541,324,402,.806,184,504,688,240,88,61,187,208,1529
22,MIA,2023,Tyler Herro,23,67,67,2337,487,1109,.439,203,537,.378,284,572,.497,.531,170,182,.934,27,333,360,280,51,16,158,101,1347
23,MIA,2023,Max Strus,26,80,33,2272,324,790,.410,197,563,.350,127,227,.559,.535,78,89,.876,49,209,258,171,42,12,70,166,923
24,MIA,2023,Jimmy Butler,33,64,64,2138,479,888,.539,36,103,.350,443,785,.564,.560,472,555,.850,141,234,375,340,117,21,101,80,1466
25,MIA,2023,Caleb Martin,27,71,49,2077,254,548,.464,84,236,.356,170,312,.545,.540,91,113,.805,88,256,344,117,71,31,78,145,683
26,MIA,2023,Gabe Vincent,26,68,34,1759,228,567,.402,117,350,.334,111,217,.512,.505,68,78,.872,27,118,145,167,62,5,92,154,641
27,MIA,2023,Kyle Lowry,36,55,44,1718,196,485,.404,107,310,.345,89,175,.509,.514,116,135,.859,43,182,225,281,57,21,103,143,615
28,MIA,2023,Victor Oladipo,30,42,2,1106,160,403,.397,70,212,.330,90,191,.471,.484,59,79,.747,16,112,128,146,57,12,87,99,449
29,MIA,2023,Haywood Highsmith,26,54,11,969,93,216,.431,37,109,.339,56,107,.523,.516,13,28,.464,57,131,188,43,36,17,45,82,236
30,MIA,2023,Duncan Robinson,28,42,1,691,88,237,.371,63,192,.328,25,45,.556,.504,29,32,.906,8,61,69,46,14,0,28,77,268
31,MIA,2023,Orlando Robinson,22,31,1,425,47,89,.528,0,6,.000,47,83,.566,.528,22,31,.710,48,78,126,25,12,12,16,53,116
32,MIA,2023,Kevin Love,34,21,17,419,54,139,.388,30,101,.297,24,38,.632,.496,24,28,.857,17,102,119,40,9,5,23,32,162
33,MIA,2023,Dewayne Dedmon,33,30,0,350,64,129,.496,11,37,.297,53,92,.576,.539,32,44,.727,28,81,109,16,7,14,19,61,171
34,MIA,2023,Jamal Cain,23,18,0,240,37,66,.561,7,20,.350,30,46,.652,.614,17,22,.773,15,37,52,12,11,1,6,21,98
35,MIA,2023,Cody Zeller,30,15,2,217,37,59,.627,0,2,.000,37,57,.649,.627,24,35,.686,25,39,64,10,3,4,14,33,98
36,MIA,2023,Nikola Jović,19,15,8,204,28,69,.406,8,35,.229,20,34,.588,.464,18,19,.947,9,22,31,10,7,2,10,19,82
37,MIA,2023,Omer Yurtseven,24,9,0,83,16,27,.593,3,7,.429,13,20,.650,.648,5,6,.833,8,15,23,2,2,2,4,16,40
38,MIA,2023,Udonis Haslem,42,7,1,71,10,29,.345,3,9,.333,7,20,.350,.397,4,5,.800,4,7,11,0,1,2,1,11,27
39,MIA,2023,Dru Smith,25,5,1,67,5,14,.357,1,6,.167,4,8,.500,.393,0,0,,1,8,9,5,4,3,1,10,11
40,MIA,2023,Jamaree Bouyea,23,4,0,65,6,13,.462,2,5,.400,4,8,.500,.538,1,2,.500,1,4,5,4,4,2,4,5,15
41,MIA,2022,Tyler Herro,22,66,10,2151,501,1122,.447,175,439,.399,326,683,.477,.525,190,219,.868,32,297,329,263,44,8,174,95,1367
42,MIA,2022,Kyle Lowry,35,63,63,2133,276,627,.440,144,382,.377,132,245,.539,.555,148,174,.851,33,249,282,474,67,17,168,177,844
43,MIA,2022,Duncan Robinson,27,79,68,2043,290,726,.399,232,624,.372,58,102,.569,.559,51,61,.836,24,179,203,129,42,14,60,201,863
44,MIA,2022,P.J. Tucker,36,71,70,1981,207,428,.484,80,193,.415,127,235,.540,.577,45,61,.738,100,287,387,149,58,15,66,161,539
45,MIA,2022,Jimmy Butler,32,57,57,1931,398,829,.480,27,116,.233,371,713,.520,.496,396,455,.870,102,234,336,312,94,27,121,88,1219
46,MIA,2022,Bam Adebayo,24,56,56,1825,406,729,.557,0,6,.000,406,723,.562,.557,256,340,.753,137,427,564,190,80,44,148,171,1068
47,MIA,2022,Gabe Vincent,25,68,27,1589,214,513,.417,119,323,.368,95,190,.500,.533,44,54,.815,22,104,126,210,62,12,98,158,591
48,MIA,2022,Max Strus,25,68,16,1587,249,564,.441,181,442,.410,68,122,.557,.602,42,53,.792,24,178,202,92,28,16,57,116,721
49,MIA,2022,Caleb Martin,26,60,12,1372,208,410,.507,64,155,.413,144,255,.565,.585,71,93,.763,70,160,230,64,58,30,52,104,551
50,MIA,2022,Dewayne Dedmon,32,67,15,1065,164,290,.566,19,47,.404,145,243,.597,.598,75,100,.750,105,281,386,47,24,42,70,174,422
51,MIA,2022,Omer Yurtseven,23,56,12,706,130,247,.526,1,11,.091,129,236,.547,.528,38,61,.623,85,209,294,49,17,20,41,84,299
52,MIA,2022,Markieff Morris,32,17,1,298,54,114,.474,13,39,.333,41,75,.547,.531,8,9,.889,17,28,45,23,6,1,20,33,129
53,MIA,2022,KZ Okpala,22,21,0,244,30,69,.435,9,26,.346,21,43,.488,.500,8,11,.727,11,30,41,14,4,7,5,25,77
54,MIA,2022,Kyle Guy,24,19,0,186,26,65,.400,14,40,.350,12,25,.480,.508,8,12,.667,4,13,17,17,7,1,13,12,74
55,MIA,2022,Victor Oladipo,29,8,1,173,35,73,.479,15,36,.417,20,37,.541,.582,14,19,.737,3,20,23,28,5,1,16,13,99
56,MIA,2022,Haywood Highsmith,25,19,1,163,16,46,.348,9,28,.321,7,18,.389,.446,2,5,.400,10,16,26,6,2,3,3,13,43
57,MIA,2022,Marcus Garrett,23,12,0,128,5,21,.238,1,4,.250,4,17,.235,.262,2,5,.400,9,14,23,7,5,3,2,16,13
58,MIA,2022,Chris Silva,25,9,0,88,8,15,.533,0,0,,8,15,.533,.533,10,12,.833,13,22,35,7,0,1,8,20,26
59,MIA,2022,Udonis Haslem,41,13,0,83,14,31,.452,1,4,.250,13,27,.481,.468,3,3,1.000,4,21,25,4,1,1,5,15,32
60,MIA,2022,Mychal Mulder,27,2,1,44,4,10,.400,4,8,.500,0,2,.000,.600,2,2,1.000,0,3,3,2,0,1,0,1,14
61,MIA,2022,Javonte Smart,22,4,0,40,8,17,.471,4,9,.444,4,8,.500,.588,0,0,,1,4,5,2,2,1,2,1,20
62,MIA,2022,Nik Stauskas,28,2,0,24,3,8,.375,2,4,.500,1,4,.250,.500,3,4,.750,1,2,3,1,0,0,0,1,11
63,MIA,2021,Duncan Robinson,26,72,72,2262,315,717,.439,250,613,.408,65,104,.625,.614,62,75,.827,7,243,250,127,43,20,81,181,942
64,MIA,2021,Bam Adebayo,23,64,64,2143,456,800,.570,2,8,.250,454,792,.573,.571,283,354,.799,142,431,573,346,75,66,169,145,1197
65,MIA,2021,Jimmy Butler,31,52,52,1745,366,736,.497,25,102,.245,341,634,.538,.514,359,416,.863,94,265,359,369,108,18,109,71,1116
66,MIA,2021,Kendrick Nunn,25,56,44,1650,319,658,.485,122,320,.381,197,338,.583,.578,56,60,.933,21,158,179,148,52,14,80,108,816
67,MIA,2021,Tyler Herro,21,54,15,1635,307,699,.439,107,297,.360,200,402,.498,.516,94,117,.803,25,243,268,184,35,17,101,71,815
68,MIA,2021,Andre Iguodala,37,63,5,1339,95,248,.383,60,182,.330,35,66,.530,.504,25,38,.658,38,183,221,142,57,35,67,90,275
69,MIA,2021,Goran Dragić,34,50,11,1337,240,555,.432,91,244,.373,149,311,.479,.514,101,122,.828,25,144,169,219,33,8,118,113,672
70,MIA,2021,Kelly Olynyk,29,43,38,1157,162,376,.431,77,243,.317,85,133,.639,.533,31,40,.775,44,217,261,91,40,26,55,123,432
71,MIA,2021,Trevor Ariza,35,30,27,841,99,241,.411,50,143,.350,49,98,.500,.515,34,44,.773,27,117,144,55,31,18,21,55,282
72,MIA,2021,Precious Achiuwa,21,61,4,737,124,228,.544,0,1,.000,124,227,.546,.544,56,110,.509,73,135,208,29,20,28,43,91,304
73,MIA,2021,Gabe Vincent,24,50,7,655,88,233,.378,46,149,.309,42,84,.500,.476,20,23,.870,10,46,56,67,21,2,34,79,242
74,MIA,2021,Max Strus,24,39,0,507,85,187,.455,50,148,.338,35,39,.897,.588,16,24,.667,5,36,41,24,11,2,8,43,236
75,MIA,2021,KZ Okpala,21,37,9,447,36,96,.375,12,50,.240,24,46,.522,.438,8,15,.533,21,47,68,19,10,11,15,59,92
76,MIA,2021,Avery Bradley,30,10,1,211,31,66,.470,16,38,.421,15,28,.536,.591,7,9,.778,2,16,18,14,7,1,9,26,85
77,MIA,2021,Dewayne Dedmon,31,16,0,210,46,65,.708,1,5,.200,45,60,.750,.715,20,27,.741,28,58,86,12,9,6,13,36,113
78,MIA,2021,Nemanja Bjelica,32,11,2,156,20,46,.435,10,27,.370,10,19,.526,.543,5,9,.556,5,22,27,20,7,3,5,20,55
79,MIA,2021,Maurice Harkless,27,11,3,124,5,13,.385,5,11,.455,0,2,.000,.577,0,2,.000,2,11,13,7,2,4,3,14,15
80,MIA,2021,Victor Oladipo,28,4,4,111,16,43,.372,4,17,.235,12,26,.462,.419,12,18,.667,3,11,14,14,7,2,14,13,48
81,MIA,2021,Chris Silva,24,11,0,83,9,13,.692,1,1,1.000,8,12,.667,.731,11,15,.733,7,18,25,6,1,5,9,20,30
82,MIA,2021,Meyers Leonard,28,3,2,29,3,7,.429,3,7,.429,0,0,,.643,1,2,.500,0,7,7,2,0,0,2,5,10
83,MIA,2021,Udonis Haslem,40,1,0,3,2,2,1.000,0,0,,2,2,1.000,1.000,0,0,,0,1,1,0,0,0,0,0,4
84,MIA,2020,Bam Adebayo,22,72,72,2417,440,790,.557,2,14,.143,438,776,.564,.558,264,382,.691,176,559,735,368,82,93,204,182,1146
85,MIA,2020,Duncan Robinson,25,73,68,2166,323,687,.470,270,606,.446,53,81,.654,.667,67,72,.931,10,222,232,102,35,19,70,193,983
86,MIA,2020,Kendrick Nunn,24,67,67,1962,401,914,.439,137,391,.350,264,523,.505,.514,85,100,.850,21,159,180,220,56,15,114,152,1024
87,MIA,2020,Jimmy Butler,30,58,58,1959,345,758,.455,29,119,.244,316,639,.495,.474,438,525,.834,106,280,386,350,103,32,127,81,1157
88,MIA,2020,Goran Dragić,33,59,3,1663,319,724,.441,124,338,.367,195,386,.505,.526,191,246,.776,29,158,187,301,40,10,144,124,953
89,MIA,2020,Tyler Herro,20,55,8,1508,270,631,.428,116,298,.389,154,333,.462,.520,87,100,.870,16,208,224,121,34,9,87,76,743
90,MIA,2020,Derrick Jones Jr.,22,59,16,1375,184,349,.527,37,132,.280,147,217,.677,.580,95,123,.772,66,167,233,62,58,38,30,130,500
91,MIA,2020,Kelly Olynyk,28,67,9,1300,184,398,.462,95,234,.406,89,164,.543,.582,86,100,.860,44,261,305,116,45,23,71,173,549
92,MIA,2020,Meyers Leonard,27,51,49,1034,119,234,.509,53,128,.414,66,106,.623,.622,18,28,.643,30,230,260,55,14,15,39,107,309
93,MIA,2020,Jae Crowder,29,20,8,553,79,164,.482,57,128,.445,22,36,.611,.655,22,30,.733,12,95,107,36,25,10,15,58,237
94,MIA,2020,Andre Iguodala,36,21,0,418,38,88,.432,14,47,.298,24,41,.585,.511,6,15,.400,17,61,78,51,14,21,26,35,96
95,MIA,2020,Justise Winslow,23,11,5,352,50,129,.388,6,27,.222,44,102,.431,.411,18,27,.667,16,57,73,44,7,5,24,38,124
96,MIA,2020,Chris Silva,23,44,0,346,48,78,.615,0,3,.000,48,75,.640,.615,37,55,.673,60,66,126,23,9,21,32,85,133
97,MIA,2020,James Johnson,32,18,0,281,39,87,.448,16,45,.356,23,42,.548,.540,8,14,.571,8,44,52,21,6,13,15,34,102
98,MIA,2020,Solomon Hill,28,11,1,187,14,45,.311,7,24,.292,7,21,.333,.389,14,16,.875,5,16,21,10,12,5,11,12,49
99,MIA,2020,Gabe Vincent,23,9,0,83,8,37,.216,6,27,.222,2,10,.200,.297,0,0,,0,5,5,6,5,0,1,6,22
100,MIA,2020,Udonis Haslem,39,4,1,44,4,11,.364,1,3,.333,3,8,.375,.409,3,4,.750,1,15,16,1,0,0,1,6,12
101,MIA,2020,Dion Waiters,28,3,0,42,10,26,.385,8,17,.471,2,9,.222,.538,0,1,.000,0,11,11,3,0,2,3,5,28
102,MIA,2020,KZ Okpala,20,5,0,26,3,5,.600,0,1,.000,3,4,.750,.600,1,2,.500,1,4,5,1,2,1,1,2,7
103,MIA,2020,Daryl Macon,24,4,0,14,1,3,.333,1,2,.500,0,1,.000,.500,0,0,,0,0,0,1,0,0,2,1,3
104,MIA,2020,Kyle Alexander,23,2,0,13,1,2,.500,0,0,,1,2,.500,.500,0,0,,2,1,3,0,0,0,1,1,2
105,MIA,2019,Josh Richardson,25,73,73,2539,423,1026,.412,164,460,.357,259,566,.458,.492,199,231,.861,54,209,263,298,79,34,113,200,1209
106,MIA,2019,Justise Winslow,22,66,52,1959,324,749,.433,96,256,.375,228,493,.462,.497,86,137,.628,63,292,355,282,72,19,142,177,830
107,MIA,2019,Bam Adebayo,21,82,28,1913,280,486,.576,3,15,.200,277,471,.588,.579,166,226,.735,165,432,597,184,71,65,121,203,729
108,MIA,2019,Dwyane Wade,37,72,2,1885,416,960,.433,86,261,.330,330,699,.472,.478,165,233,.708,69,216,285,301,59,38,166,118,1083
109,MIA,2019,Kelly Olynyk,27,79,36,1812,261,564,.463,113,319,.354,148,245,.604,.563,152,185,.822,72,303,375,140,53,37,114,183,787
110,MIA,2019,Hassan Whiteside,29,72,53,1674,388,680,.571,2,16,.125,386,664,.581,.572,109,243,.449,257,560,817,56,46,136,97,192,887
111,MIA,2019,Rodney McGruder,27,66,45,1550,186,461,.403,79,225,.351,107,236,.453,.489,52,72,.722,60,178,238,112,36,12,64,115,503
112,MIA,2019,James Johnson,31,55,33,1164,164,379,.433,50,149,.336,114,230,.496,.499,50,70,.714,22,154,176,135,35,27,74,114,428
113,MIA,2019,Derrick Jones Jr.,21,60,14,1153,160,324,.494,28,91,.308,132,233,.567,.537,74,122,.607,96,144,240,37,46,42,43,123,422
114,MIA,2019,Dion Waiters,27,44,28,1138,198,478,.414,109,289,.377,89,189,.471,.528,22,44,.500,7,109,116,121,29,9,64,72,527
115,MIA,2019,Tyler Johnson,26,44,10,1123,171,401,.426,72,204,.353,99,197,.503,.516,61,88,.693,19,102,121,112,40,21,63,72,475
116,MIA,2019,Goran Dragić,32,36,22,991,179,433,.413,57,164,.348,122,269,.454,.479,79,101,.782,20,91,111,174,30,5,71,81,494
117,MIA,2019,Wayne Ellington,31,25,12,533,69,184,.375,57,155,.368,12,29,.414,.530,14,16,.875,6,41,47,29,24,3,14,40,209
118,MIA,2019,Duncan Robinson,24,15,1,161,18,46,.391,10,35,.286,8,11,.727,.500,4,6,.667,2,17,19,5,5,0,4,11,50
119,MIA,2019,Udonis Haslem,38,10,1,74,11,33,.333,0,12,.000,11,21,.524,.333,3,4,.750,3,24,27,2,0,0,3,9,25
120,MIA,2019,Ryan Anderson,30,10,0,44,2,9,.222,2,6,.333,0,3,.000,.333,1,2,.500,4,5,9,2,1,0,2,2,7
121,MIA,2019,Yante Maten,22,2,0,13,1,4,.250,0,1,.000,1,3,.333,.250,0,0,,1,2,3,0,1,0,0,0,2
122,MIA,2019,Emanuel Terry,22,1,0,3,0,1,.000,0,0,,0,1,.000,.000,1,2,.500,1,0,1,1,0,0,0,0,1
123,MIA,2018,Josh Richardson,24,81,81,2689,399,885,.451,127,336,.378,272,549,.495,.523,120,142,.845,69,216,285,231,121,75,140,199,1045
124,MIA,2018,Goran Dragić,31,75,75,2378,484,1075,.450,111,300,.370,373,775,.481,.502,217,271,.801,54,252,306,359,63,12,166,180,1296
125,MIA,2018,Tyler Johnson,25,72,39,2052,309,711,.435,119,324,.367,190,387,.491,.518,106,129,.822,34,214,248,165,60,34,81,148,843
126,MIA,2018,Wayne Ellington,30,77,2,2041,285,700,.407,227,579,.392,58,121,.479,.569,67,78,.859,23,195,218,79,53,8,52,94,864
127,MIA,2018,James Johnson,30,73,41,1943,309,614,.503,57,185,.308,252,429,.587,.550,113,162,.698,61,297,358,280,70,51,141,192,788
128,MIA,2018,Kelly Olynyk,26,76,22,1779,316,636,.497,106,280,.379,210,356,.590,.580,134,174,.770,89,342,431,207,62,35,147,222,872
129,MIA,2018,Justise Winslow,21,68,25,1680,207,488,.424,49,129,.380,158,359,.440,.474,66,104,.635,64,306,370,148,54,33,77,140,529
130,MIA,2018,Bam Adebayo,20,69,19,1368,174,340,.512,0,7,.000,174,333,.523,.512,129,179,.721,118,263,381,101,32,41,66,138,477
131,MIA,2018,Hassan Whiteside,28,54,54,1364,312,578,.540,2,2,1.000,310,576,.538,.542,128,182,.703,174,444,618,54,37,94,92,131,754
132,MIA,2018,Dion Waiters,26,30,30,918,163,410,.398,52,170,.306,111,240,.463,.461,51,69,.739,8,69,77,113,23,9,70,61,429
133,MIA,2018,Dwyane Wade,36,21,0,467,101,247,.409,9,41,.220,92,206,.447,.427,41,55,.745,11,60,71,65,19,15,48,40,252
134,MIA,2018,Rodney McGruder,26,18,2,299,36,73,.493,15,35,.429,21,38,.553,.596,4,8,.500,11,22,33,17,8,3,4,21,91
135,MIA,2018,Jordan Mickey,23,23,3,284,39,82,.476,2,16,.125,37,66,.561,.488,13,19,.684,18,63,81,9,6,10,18,36,93
136,MIA,2018,Derrick Jones Jr.,20,14,8,212,19,49,.388,3,16,.188,16,33,.485,.418,11,18,.611,19,15,34,6,3,9,6,22,52
137,MIA,2018,Derrick Walton,22,16,0,147,8,25,.320,7,17,.412,1,8,.125,.460,6,6,1.000,2,14,16,16,7,3,2,7,29
138,MIA,2018,Luke Babbitt,28,13,5,145,11,47,.234,11,45,.244,0,2,.000,.351,0,0,,2,13,15,5,1,2,4,7,33
139,MIA,2018,Okaro White,25,6,4,80,7,16,.438,4,11,.364,3,5,.600,.563,2,3,.667,3,8,11,2,1,1,1,6,20
140,MIA,2018,Udonis Haslem,37,14,0,72,3,15,.200,1,8,.125,2,7,.286,.233,1,2,.500,3,7,10,5,0,2,2,3,8
141,MIA,2018,Matt Williams,24,3,0,11,2,6,.333,1,5,.200,1,1,1.000,.417,0,0,,0,1,1,0,0,0,1,1,5
142,MIA,2017,Hassan Whiteside,27,77,77,2513,542,973,.557,0,0,,542,973,.557,.557,225,358,.628,293,795,1088,57,57,161,154,226,1309
143,MIA,2017,Goran Dragić,30,73,73,2459,534,1124,.475,117,289,.405,417,835,.499,.527,298,377,.790,62,217,279,423,89,13,212,199,1483
144,MIA,2017,Tyler Johnson,24,73,0,2178,357,824,.433,93,250,.372,264,574,.460,.490,195,254,.768,50,243,293,233,84,44,90,176,1002
145,MIA,2017,James Johnson,29,76,5,2085,368,769,.479,87,256,.340,281,513,.548,.535,152,215,.707,66,310,376,276,76,86,171,197,975
146,MIA,2017,Rodney McGruder,25,78,65,1966,190,460,.413,73,220,.332,117,240,.488,.492,44,71,.620,94,162,256,124,46,18,56,140,497
147,MIA,2017,Josh Richardson,23,53,34,1614,202,513,.394,75,227,.330,127,286,.444,.467,60,77,.779,35,133,168,140,60,39,65,132,539
148,MIA,2017,Wayne Ellington,29,62,13,1500,231,555,.416,149,394,.378,82,161,.509,.550,37,43,.860,18,114,132,70,35,4,30,70,648
149,MIA,2017,Dion Waiters,25,46,43,1384,281,663,.424,85,215,.395,196,448,.438,.488,82,127,.646,18,135,153,200,42,20,103,95,729
150,MIA,2017,Luke Babbitt,27,68,55,1065,113,281,.402,87,210,.414,26,71,.366,.557,11,15,.733,12,129,141,36,20,11,25,118,324
151,MIA,2017,Willie Reed,26,71,5,1031,162,285,.568,1,4,.250,161,281,.573,.570,49,88,.557,129,203,332,26,18,47,31,137,374
152,MIA,2017,Justise Winslow,20,18,15,625,80,225,.356,7,35,.200,73,190,.384,.371,29,47,.617,23,71,94,66,26,6,33,52,196
153,MIA,2017,Okaro White,24,35,0,471,33,87,.379,12,34,.353,21,53,.396,.448,20,22,.909,25,57,82,21,10,10,18,52,98
154,MIA,2017,Josh McRoberts,29,22,14,381,44,118,.373,13,31,.419,31,87,.356,.428,6,9,.667,23,51,74,50,10,4,23,31,107
155,MIA,2017,Derrick Williams,25,25,11,377,54,137,.394,9,45,.200,45,92,.489,.427,31,50,.620,16,57,73,14,9,5,14,33,148
156,MIA,2017,Udonis Haslem,36,16,0,130,11,23,.478,0,3,.000,11,20,.550,.478,9,15,.600,8,28,36,6,6,1,8,22,31
157,MIA,2016,Luol Deng,30,74,73,2394,339,745,.455,88,256,.344,251,489,.513,.514,145,192,.755,108,335,443,140,74,29,81,122,911
158,MIA,2016,Goran Dragić,29,72,72,2363,417,875,.477,64,205,.312,353,670,.527,.513,120,165,.727,54,223,277,419,71,17,185,188,1018
159,MIA,2016,Dwyane Wade,34,74,73,2258,540,1183,.456,7,44,.159,533,1139,.468,.459,322,406,.793,82,220,302,344,79,42,203,116,1409
160,MIA,2016,Justise Winslow,19,78,8,2232,195,462,.422,32,116,.276,163,346,.471,.457,80,117,.684,81,322,403,117,68,26,95,184,502
161,MIA,2016,Hassan Whiteside,26,73,43,2125,413,682,.606,0,0,,413,682,.606,.606,214,329,.650,238,627,865,30,44,269,137,201,1040
162,MIA,2016,Chris Bosh,31,53,53,1778,358,767,.467,81,222,.365,277,545,.508,.520,213,268,.795,48,342,390,128,36,34,78,101,1010
163,MIA,2016,Gerald Green,30,69,14,1557,230,587,.392,84,260,.323,146,327,.446,.463,72,92,.783,25,138,163,56,38,19,46,123,616
164,MIA,2016,Josh Richardson,22,52,2,1107,123,272,.452,53,115,.461,70,157,.446,.550,42,63,.667,21,86,107,73,36,25,35,107,341
165,MIA,2016,Tyler Johnson,23,36,5,863,118,243,.486,27,71,.380,91,172,.529,.541,51,64,.797,28,81,109,79,24,14,47,66,314
166,MIA,2016,Joe Johnson,34,24,24,769,130,251,.518,35,84,.417,95,167,.569,.588,26,34,.765,15,53,68,86,21,2,43,46,321
167,MIA,2016,Amar'e Stoudemire,33,52,36,762,125,221,.566,0,0,,125,221,.566,.566,50,67,.746,65,157,222,27,18,41,47,92,300
168,MIA,2016,Josh McRoberts,28,42,1,595,55,148,.372,12,49,.245,43,99,.434,.412,28,40,.700,22,83,105,81,18,7,30,68,150
169,MIA,2016,Beno Udrih,33,36,5,587,66,152,.434,11,33,.333,55,119,.462,.470,15,17,.882,6,57,63,90,11,0,42,40,158
170,MIA,2016,Udonis Haslem,35,37,0,260,23,61,.377,1,9,.111,22,52,.423,.385,12,16,.750,10,65,75,14,5,2,5,25,59
171,MIA,2016,Mario Chalmers,29,6,0,120,10,32,.313,1,11,.091,9,21,.429,.328,12,13,.923,1,13,14,19,8,1,9,16,33
172,MIA,2016,Chris Andersen,37,7,1,36,4,10,.400,2,5,.400,2,5,.400,.500,3,4,.750,3,6,9,3,1,3,2,4,13
173,MIA,2016,Jarnell Stokes,22,5,0,14,3,5,.600,0,0,,3,5,.600,.600,1,2,.500,0,2,2,1,1,0,0,1,7
174,MIA,2016,James Ennis III,25,3,0,7,0,0,,0,0,,0,0,,,0,0,,0,0,0,1,0,0,0,1,0
175,MIA,2016,Briante Weber,23,1,0,3,1,1,1.000,0,0,,1,1,1.000,1.000,0,0,,0,1,1,1,0,0,0,1,2
176,MIA,2015,Luol Deng,29,72,72,2421,369,787,.469,78,220,.355,291,567,.513,.518,191,251,.761,103,273,376,139,65,22,108,109,1007
177,MIA,2015,Mario Chalmers,28,80,37,2368,267,663,.403,73,248,.294,194,415,.467,.458,206,266,.774,24,182,206,307,122,10,173,251,813
178,MIA,2015,Dwyane Wade,33,62,62,1971,509,1084,.470,29,102,.284,480,982,.489,.483,284,370,.768,58,161,219,299,73,21,209,105,1331
179,MIA,2015,Chris Bosh,30,44,44,1556,343,745,.460,63,168,.375,280,577,.485,.503,179,232,.772,46,264,310,95,41,25,95,69,928
180,MIA,2015,Norris Cole,26,47,23,1148,118,306,.386,27,102,.265,91,204,.446,.430,32,46,.696,12,96,108,165,42,8,58,75,295
181,MIA,2015,Hassan Whiteside,25,48,32,1142,243,387,.628,0,0,,243,387,.628,.628,78,156,.500,145,337,482,6,27,123,58,129,564
182,MIA,2015,Chris Andersen,36,60,20,1132,120,207,.580,4,13,.308,116,194,.598,.589,76,114,.667,76,223,299,43,26,61,40,88,320
183,MIA,2015,James Ennis III,24,62,3,1051,101,247,.409,31,95,.326,70,152,.461,.472,79,94,.840,51,125,176,48,25,17,39,89,312
184,MIA,2015,Shabazz Napier,23,51,10,1012,87,228,.382,43,118,.364,44,110,.400,.476,44,56,.786,17,96,113,130,40,4,81,76,261
185,MIA,2015,Udonis Haslem,34,62,25,995,107,239,.448,2,10,.200,105,229,.459,.452,45,64,.703,71,187,258,46,21,13,41,113,261
186,MIA,2015,Shawne Williams,28,44,22,924,102,240,.425,60,152,.395,42,88,.477,.550,28,33,.848,27,112,139,36,21,17,23,116,292
187,MIA,2015,Goran Dragić,28,26,26,905,162,323,.502,24,73,.329,138,250,.552,.539,84,104,.808,30,59,89,139,28,6,59,75,432
188,MIA,2015,Henry Walker,27,24,13,628,58,168,.345,45,132,.341,13,36,.361,.479,14,18,.778,7,75,82,29,24,9,24,76,175
189,MIA,2015,Danny Granger,31,30,6,613,65,162,.401,30,84,.357,35,78,.449,.494,28,37,.757,20,60,80,17,13,6,24,67,188
190,MIA,2015,Tyler Johnson,22,32,2,603,70,167,.419,18,48,.375,52,119,.437,.473,32,47,.681,14,67,81,42,33,9,30,42,190
191,MIA,2015,Michael Beasley,26,24,1,505,92,212,.434,8,34,.235,84,178,.472,.453,20,26,.769,12,77,89,32,15,13,37,66,212
192,MIA,2015,Josh McRoberts,27,17,4,296,28,53,.528,8,19,.421,20,34,.588,.604,8,13,.615,7,38,45,33,12,3,22,41,72
193,MIA,2015,Justin Hamilton,24,24,5,289,27,65,.415,6,19,.316,21,46,.457,.462,6,7,.857,24,24,48,12,8,5,8,33,66
194,MIA,2015,Shannon Brown,29,5,2,89,7,19,.368,3,7,.429,4,12,.333,.447,3,4,.750,0,1,1,3,4,0,4,8,20
195,MIA,2015,Zoran Dragić,25,10,1,62,9,22,.409,3,9,.333,6,13,.462,.477,1,2,.500,3,2,5,4,2,0,5,5,22
196,MIA,2015,Andre Dawkins,23,4,0,22,1,6,.167,1,6,.167,0,0,,.250,0,0,,0,2,2,1,0,0,1,3,3
197,MIA,2014,LeBron James,29,77,77,2902,767,1353,.567,116,306,.379,651,1047,.622,.610,439,585,.750,81,452,533,488,121,26,270,126,2089
198,MIA,2014,Chris Bosh,29,79,79,2531,492,953,.516,74,218,.339,418,735,.569,.555,223,272,.820,98,424,522,87,80,78,125,192,1281
199,MIA,2014,Mario Chalmers,27,73,73,2178,254,560,.454,87,226,.385,167,334,.500,.531,121,163,.742,41,173,214,357,119,16,162,210,716
200,MIA,2014,Norris Cole,25,82,6,2014,207,500,.414,60,174,.345,147,326,.451,.474,53,68,.779,17,143,160,248,77,5,127,156,527
201,MIA,2014,Ray Allen,38,73,9,1936,240,543,.442,116,309,.375,124,234,.530,.549,105,116,.905,23,182,205,143,54,8,84,115,701
202,MIA,2014,Dwyane Wade,32,54,53,1775,415,761,.545,9,32,.281,406,729,.557,.551,189,258,.733,60,181,241,252,79,29,161,106,1028
203,MIA,2014,Shane Battier,35,73,56,1468,105,275,.382,73,210,.348,32,65,.492,.515,15,23,.652,34,104,138,63,50,39,21,124,298
204,MIA,2014,Chris Andersen,35,72,0,1396,177,275,.644,3,12,.250,174,263,.662,.649,120,169,.710,129,250,379,19,32,97,53,162,477
205,MIA,2014,Rashard Lewis,34,60,6,971,98,236,.415,46,134,.343,52,102,.510,.513,26,33,.788,24,86,110,57,53,8,35,90,268
206,MIA,2014,Michael Beasley,25,55,2,831,177,355,.499,21,54,.389,156,301,.518,.528,61,79,.772,31,141,172,42,23,21,57,93,436
207,MIA,2014,Udonis Haslem,33,46,18,653,74,146,.507,0,0,,74,146,.507,.507,25,44,.568,42,133,175,13,11,15,24,79,173
208,MIA,2014,Toney Douglas,27,27,17,410,41,104,.394,12,43,.279,29,61,.475,.452,20,26,.769,14,47,61,49,13,3,18,47,114
209,MIA,2014,Roger Mason,33,25,2,260,25,67,.373,17,48,.354,8,19,.421,.500,7,7,1.000,1,21,22,19,6,1,9,26,74
210,MIA,2014,James Jones,33,20,6,236,31,68,.456,28,54,.519,3,14,.214,.662,7,11,.636,2,21,23,9,3,4,4,6,97
211,MIA,2014,Greg Oden,26,23,6,212,27,49,.551,0,0,,27,49,.551,.551,13,23,.565,23,31,54,1,7,13,12,52,67
212,MIA,2014,Justin Hamilton,23,7,0,68,9,20,.450,3,9,.333,6,11,.545,.525,5,5,1.000,4,3,7,0,4,0,3,8,26
213,MIA,2014,Joel Anthony,31,12,0,37,2,6,.333,0,0,,2,6,.333,.333,2,2,1.000,2,5,7,0,0,4,1,4,6
214,MIA,2014,DeAndre Liggins,25,1,0,1,1,1,1.000,0,0,,1,1,1.000,1.000,0,0,,1,0,1,0,0,0,0,0,2
215,MIA,2013,LeBron James,28,76,76,2877,765,1354,.565,103,254,.406,662,1100,.602,.603,403,535,.753,97,513,610,551,129,67,226,110,2036
216,MIA,2013,Chris Bosh,28,74,74,2454,485,907,.535,21,74,.284,464,833,.557,.546,241,302,.798,131,370,501,123,66,101,128,168,1232
217,MIA,2013,Dwyane Wade,31,69,69,2391,569,1093,.521,17,66,.258,552,1027,.537,.528,308,425,.725,86,258,344,352,128,56,194,140,1463
218,MIA,2013,Mario Chalmers,26,77,77,2068,227,529,.429,123,301,.409,104,228,.456,.545,89,112,.795,19,152,171,273,118,12,119,196,666
219,MIA,2013,Ray Allen,37,79,0,2035,292,651,.449,139,332,.419,153,319,.480,.555,140,158,.886,40,177,217,135,67,15,103,129,863
220,MIA,2013,Shane Battier,34,72,20,1786,152,362,.420,136,316,.430,16,46,.348,.608,32,38,.842,37,128,165,72,41,55,34,149,472
221,MIA,2013,Norris Cole,24,80,4,1590,179,425,.421,35,98,.357,144,327,.440,.462,52,80,.650,18,112,130,164,57,7,104,155,445
222,MIA,2013,Udonis Haslem,32,75,59,1414,129,251,.514,0,0,,129,251,.514,.514,32,45,.711,97,307,404,38,30,15,45,173,290
223,MIA,2013,Mike Miller,32,59,17,900,100,231,.433,73,175,.417,27,56,.482,.591,8,11,.727,18,139,157,99,21,4,35,63,281
224,MIA,2013,Rashard Lewis,33,55,9,792,103,249,.414,51,131,.389,52,118,.441,.516,28,45,.622,19,102,121,30,21,14,33,67,285
225,MIA,2013,Chris Andersen,34,42,0,624,71,123,.577,2,3,.667,69,120,.575,.585,63,93,.677,57,115,172,17,16,44,24,89,207
226,MIA,2013,Joel Anthony,30,62,3,566,35,68,.515,0,0,,35,68,.515,.515,17,28,.607,45,70,115,13,13,42,22,49,87
227,MIA,2013,James Jones,32,38,0,221,21,61,.344,16,53,.302,5,8,.625,.475,2,4,.500,0,22,22,13,2,6,3,16,60
228,MIA,2013,Juwan Howard,39,7,2,51,10,19,.526,0,0,,10,19,.526,.526,1,1,1.000,0,8,8,6,0,0,4,9,21
229,MIA,2013,Jarvis Varnado,24,8,0,40,1,3,.333,0,0,,1,3,.333,.333,0,0,,1,5,6,2,0,2,5,9,2
230,MIA,2013,Josh Harrellson,23,6,0,31,4,9,.444,1,5,.200,3,4,.750,.500,1,2,.500,3,4,7,0,1,1,3,4,10
231,MIA,2013,Terrel Harris,25,7,0,29,2,8,.250,0,1,.000,2,7,.286,.250,6,8,.750,4,5,9,2,0,0,4,3,10
232,MIA,2013,Dexter Pittman,24,4,0,12,3,5,.600,0,0,,3,5,.600,.600,0,0,,4,3,7,0,0,0,2,4,6
233,MIA,2012,LeBron James,27,62,62,2326,621,1169,.531,54,149,.362,567,1020,.556,.554,387,502,.771,94,398,492,387,115,50,213,96,1683
234,MIA,2012,Chris Bosh,27,57,57,2007,393,807,.487,10,35,.286,383,772,.496,.493,229,279,.821,94,358,452,103,51,45,117,128,1025
235,MIA,2012,Mario Chalmers,25,64,64,1825,223,498,.448,101,260,.388,122,238,.513,.549,80,101,.792,16,155,171,222,97,11,142,166,627
236,MIA,2012,Dwyane Wade,30,49,49,1625,416,837,.497,15,56,.268,401,781,.513,.506,235,297,.791,73,164,237,225,82,63,129,110,1082
237,MIA,2012,Udonis Haslem,31,64,10,1589,151,357,.423,0,0,,151,357,.423,.423,83,102,.814,117,353,470,42,35,24,60,142,385
238,MIA,2012,Shane Battier,33,65,10,1499,113,292,.387,62,183,.339,51,109,.468,.493,23,37,.622,56,100,156,82,64,33,37,105,311
239,MIA,2012,Joel Anthony,29,64,51,1349,85,152,.559,0,0,,85,152,.559,.559,49,71,.690,100,150,250,9,36,84,45,126,219
240,MIA,2012,Norris Cole,23,65,2,1260,177,450,.393,21,76,.276,156,374,.417,.417,66,85,.776,21,70,91,133,44,2,105,124,441
241,MIA,2012,Mike Miller,31,39,2,752,91,209,.435,53,117,.453,38,92,.413,.562,2,5,.400,22,106,128,42,14,6,30,58,237
242,MIA,2012,James Jones,31,51,10,666,57,150,.380,46,114,.404,11,36,.306,.533,25,30,.833,6,43,49,19,17,9,10,45,185
243,MIA,2012,Terrel Harris,24,22,1,318,29,83,.349,8,39,.205,21,44,.477,.398,14,21,.667,18,33,51,26,9,2,25,34,80
244,MIA,2012,Dexter Pittman,23,35,6,301,44,94,.468,0,0,,44,94,.468,.468,18,28,.643,27,44,71,9,8,8,17,73,106
245,MIA,2012,Ronny Turiaf,29,13,5,221,16,30,.533,0,1,.000,16,29,.552,.533,13,22,.591,19,39,58,5,8,14,8,32,45
246,MIA,2012,Juwan Howard,38,28,0,190,17,55,.309,0,0,,17,55,.309,.309,8,10,.800,18,29,47,10,4,1,20,18,42
247,MIA,2012,Eddy Curry,29,14,1,83,12,26,.462,0,0,,12,26,.462,.462,6,8,.750,4,8,12,1,0,2,10,17,30
248,MIA,2012,Mickell Gladness,25,8,0,28,1,3,.333,0,0,,1,3,.333,.333,0,0,,1,10,11,2,1,1,3,8,2
249,MIA,2011,LeBron James,26,79,79,3063,758,1485,.510,92,279,.330,666,1206,.552,.541,503,663,.759,80,510,590,554,124,50,284,163,2111
250,MIA,2011,Dwyane Wade,29,76,76,2823,692,1384,.500,63,206,.306,629,1178,.534,.523,494,652,.758,123,362,485,346,111,87,237,197,1941
251,MIA,2011,Chris Bosh,26,77,77,2795,524,1056,.496,6,25,.240,518,1031,.502,.499,384,471,.815,141,500,641,144,59,49,138,172,1438
252,MIA,2011,Mario Chalmers,24,70,28,1579,155,388,.399,83,231,.359,72,157,.459,.506,54,62,.871,12,134,146,177,76,7,91,158,447
253,MIA,2011,James Jones,30,81,8,1549,146,346,.422,123,287,.429,23,59,.390,.600,60,72,.833,23,137,160,43,29,19,21,129,475
254,MIA,2011,Joel Anthony,28,75,11,1463,53,99,.535,0,0,,53,99,.535,.535,47,73,.644,104,162,266,24,10,93,36,194,153
255,MIA,2011,Zydrunas Ilgauskas,35,72,51,1145,162,319,.508,0,1,.000,162,318,.509,.508,36,46,.783,108,179,287,26,23,58,52,185,360
256,MIA,2011,Carlos Arroyo,31,49,42,995,109,238,.458,28,64,.438,81,174,.466,.517,28,35,.800,13,67,80,100,14,1,43,60,274
257,MIA,2011,Eddie House,32,56,1,978,128,321,.399,68,175,.389,60,146,.411,.505,38,40,.950,9,83,92,62,32,3,29,68,362
258,MIA,2011,Mike Miller,30,41,2,838,81,202,.401,43,118,.364,38,84,.452,.507,23,34,.676,38,146,184,51,20,2,41,88,228
259,MIA,2011,Erick Dampier,35,51,22,815,52,89,.584,0,1,.000,52,88,.591,.584,24,44,.545,53,124,177,22,14,47,32,82,128
260,MIA,2011,Juwan Howard,37,57,0,592,55,125,.440,0,0,,55,125,.440,.440,29,35,.829,36,86,122,23,10,4,25,61,139
261,MIA,2011,Mike Bibby,32,22,12,582,55,126,.437,40,88,.455,15,38,.395,.595,10,16,.625,2,47,49,55,11,3,32,47,160
262,MIA,2011,Udonis Haslem,30,13,0,345,44,86,.512,0,0,,44,86,.512,.512,16,20,.800,29,77,106,6,7,3,14,39,104
263,MIA,2011,Jamaal Magloire,32,18,0,158,13,22,.591,0,0,,13,22,.591,.591,9,18,.500,17,44,61,3,4,2,5,26,35
264,MIA,2011,Jerry Stackhouse,36,7,1,50,3,12,.250,1,4,.250,2,8,.250,.292,5,7,.714,1,6,7,3,0,2,2,3,12
265,MIA,2011,Dexter Pittman,22,2,0,11,1,3,.333,0,0,,1,3,.333,.333,0,0,,1,2,3,0,0,0,2,2,2
266,MIA,2010,Dwyane Wade,28,77,77,2792,719,1511,.476,73,243,.300,646,1268,.509,.500,534,702,.761,107,266,373,501,142,82,252,181,2045
267,MIA,2010,Michael Beasley,21,78,78,2328,468,1040,.450,28,102,.275,440,938,.469,.463,192,240,.800,123,375,498,100,80,49,131,221,1156
268,MIA,2010,Udonis Haslem,29,78,0,2177,312,632,.494,0,0,,312,632,.494,.494,147,193,.762,167,462,629,52,30,23,75,174,771
269,MIA,2010,Quentin Richardson,29,76,75,2082,242,561,.431,142,358,.397,100,203,.493,.558,52,71,.732,64,310,374,93,70,18,62,169,678
270,MIA,2010,Jermaine O'Neal,31,70,70,1991,394,745,.529,0,2,.000,394,743,.530,.529,162,225,.720,124,362,486,92,25,95,125,212,950
271,MIA,2010,Mario Chalmers,23,73,22,1807,182,454,.401,75,236,.318,107,218,.491,.483,82,110,.745,25,110,135,246,91,12,123,175,521
272,MIA,2010,Carlos Arroyo,30,72,35,1585,178,375,.475,7,25,.280,171,350,.489,.484,76,90,.844,26,104,130,225,36,6,54,102,439
273,MIA,2010,Dorell Wright,24,72,1,1496,194,419,.463,61,157,.389,133,262,.508,.536,61,69,.884,50,185,235,91,52,32,53,94,510
274,MIA,2010,Joel Anthony,27,80,16,1322,76,159,.478,0,0,,76,159,.478,.478,66,92,.717,123,126,249,12,20,109,45,158,218
275,MIA,2010,Daequan Cook,22,45,3,691,81,253,.320,40,126,.317,41,127,.323,.399,21,25,.840,9,73,82,43,14,10,24,50,223
276,MIA,2010,Rafer Alston,33,25,25,655,60,169,.355,30,81,.370,30,88,.341,.444,15,27,.556,4,50,54,72,23,5,34,53,165
277,MIA,2010,James Jones,29,36,6,503,43,119,.361,37,90,.411,6,29,.207,.517,23,28,.821,4,41,45,17,11,4,11,45,146
278,MIA,2010,Jamaal Magloire,31,36,0,359,28,56,.500,0,0,,28,56,.500,.500,21,59,.356,41,80,121,1,9,11,17,59,77
279,MIA,2010,Shavlik Randolph,26,3,0,47,5,15,.333,0,0,,5,15,.333,.333,0,0,,7,6,13,0,1,1,2,9,10
280,MIA,2010,Yakhouba Diawara,27,6,2,44,2,10,.200,1,6,.167,1,4,.250,.250,0,0,,1,3,4,3,1,0,3,8,5
281,MIA,2009,Dwyane Wade,27,79,79,3048,854,1739,.491,88,278,.317,766,1461,.524,.516,590,771,.765,89,309,398,589,173,106,272,178,2386
282,MIA,2009,Mario Chalmers,22,82,82,2626,278,662,.420,114,311,.367,164,351,.467,.506,148,193,.767,37,191,228,403,160,8,165,240,818
283,MIA,2009,Udonis Haslem,28,75,75,2560,333,643,.518,0,0,,333,643,.518,.518,128,170,.753,169,449,618,85,43,25,82,204,794
284,MIA,2009,Michael Beasley,20,81,19,2009,452,957,.472,33,81,.407,419,876,.478,.490,186,241,.772,110,329,439,83,41,37,121,184,1123
285,MIA,2009,Daequan Cook,21,75,4,1833,242,645,.375,153,395,.387,89,250,.356,.494,49,56,.875,19,170,189,71,39,10,42,125,686
286,MIA,2009,Shawn Marion,30,42,41,1516,215,446,.482,8,40,.200,207,406,.510,.491,67,85,.788,107,258,365,77,57,45,56,92,505
287,MIA,2009,Joel Anthony,26,65,28,1048,57,118,.483,0,0,,57,118,.483,.483,30,46,.652,89,108,197,27,20,93,41,139,144
288,MIA,2009,Chris Quinn,25,66,0,962,118,289,.408,56,137,.409,62,152,.408,.505,47,58,.810,8,67,75,132,24,2,33,79,339
289,MIA,2009,Yakhouba Diawara,26,63,21,851,76,217,.350,51,163,.313,25,54,.463,.468,10,19,.526,26,56,82,27,13,6,16,75,213
290,MIA,2009,Jermaine O'Neal,30,27,27,811,145,305,.475,0,0,,145,305,.475,.475,60,80,.750,55,90,145,55,11,54,52,81,350
291,MIA,2009,Jamaal Magloire,30,55,12,709,65,131,.496,0,0,,65,131,.496,.496,29,60,.483,82,140,222,22,11,25,32,121,159
292,MIA,2009,Jamario Moon,28,26,21,689,72,157,.459,27,73,.370,45,84,.536,.545,13,15,.867,10,106,116,25,21,16,12,48,184
293,MIA,2009,James Jones,28,40,1,630,55,149,.369,33,96,.344,22,53,.415,.480,26,31,.839,12,50,62,20,12,14,12,58,169
294,MIA,2009,Mark Blount,33,20,0,207,30,78,.385,11,27,.407,19,51,.373,.455,8,13,.615,10,31,41,4,1,7,14,17,79
295,MIA,2009,Luther Head,26,10,0,176,16,43,.372,6,16,.375,10,27,.370,.442,5,8,.625,3,22,25,23,11,1,9,22,43
296,MIA,2009,Marcus Banks,27,16,0,166,15,39,.385,2,14,.143,13,25,.520,.410,10,15,.667,0,15,15,22,10,2,11,21,42
297,MIA,2009,Dorell Wright,23,6,0,73,8,20,.400,0,0,,8,20,.400,.400,2,6,.333,2,18,20,2,2,0,6,8,18
298,MIA,2009,Shaun Livingston,23,4,0,41,3,8,.375,0,0,,3,8,.375,.375,3,4,.750,0,2,2,4,2,0,3,4,9
299,MIA,2008,Ricky Davis,28,82,47,2963,420,971,.433,135,333,.405,285,638,.447,.502,155,197,.787,55,298,353,276,87,14,191,187,1130
300,MIA,2008,Dwyane Wade,26,51,49,1954,439,937,.469,22,77,.286,417,860,.485,.480,354,467,.758,45,169,214,354,87,37,224,137,1254
301,MIA,2008,Jason Williams,32,67,53,1886,211,550,.384,97,275,.353,114,275,.415,.472,69,80,.863,12,118,130,307,83,5,91,93,588
302,MIA,2008,Udonis Haslem,27,49,48,1805,237,507,.467,0,0,,237,507,.467,.467,115,142,.810,107,336,443,68,39,18,67,145,589
303,MIA,2008,Mark Blount,32,69,46,1542,238,515,.462,17,44,.386,221,471,.469,.479,88,138,.638,69,194,263,41,33,34,70,133,581
304,MIA,2008,Daequan Cook,20,59,19,1441,196,514,.381,79,238,.332,117,276,.424,.458,47,57,.825,20,157,177,75,23,9,63,157,518
305,MIA,2008,Chris Quinn,24,60,25,1340,158,373,.424,64,159,.403,94,214,.439,.509,85,98,.867,11,107,118,178,46,4,55,90,465
306,MIA,2008,Dorell Wright,22,44,34,1104,143,293,.488,4,11,.364,139,282,.493,.495,57,69,.826,48,172,220,60,29,41,29,79,347
307,MIA,2008,Shaquille O'Neal,35,33,33,945,191,329,.581,0,0,,191,329,.581,.581,88,178,.494,99,159,258,45,19,54,98,134,470
308,MIA,2008,Earl Barron,26,46,15,889,132,327,.404,1,13,.077,131,314,.417,.405,61,87,.701,67,131,198,29,19,8,48,114,326
309,MIA,2008,Shawn Marion,29,16,15,602,96,209,.459,8,31,.258,88,178,.494,.478,29,42,.690,50,129,179,40,30,15,37,33,229
310,MIA,2008,Alexander Johnson,24,43,6,549,61,125,.488,0,0,,61,125,.488,.488,57,83,.687,32,62,94,13,13,10,42,80,179
311,MIA,2008,Joel Anthony,25,24,1,498,28,60,.467,0,0,,28,60,.467,.467,29,49,.592,38,55,93,3,9,31,17,55,85
312,MIA,2008,Alonzo Mourning,37,25,0,389,52,95,.547,0,0,,52,95,.547,.547,45,76,.592,34,59,93,7,4,42,25,56,149
313,MIA,2008,Anfernee Hardaway,36,16,8,325,22,60,.367,8,19,.421,14,41,.341,.433,8,9,.889,3,32,35,35,19,1,13,24,60
314,MIA,2008,Kasib Powell,26,11,4,304,35,95,.368,8,33,.242,27,62,.435,.411,6,9,.667,8,36,44,18,9,2,5,18,84
315,MIA,2008,Stéphane Lasme,25,15,4,303,32,71,.451,0,0,,32,71,.451,.451,19,32,.594,26,27,53,3,13,22,15,35,83
316,MIA,2008,Marcus Banks,26,12,2,259,42,82,.512,15,37,.405,27,45,.600,.604,15,19,.789,1,24,25,36,6,5,21,27,114
317,MIA,2008,Luke Jackson,26,14,1,228,26,80,.325,11,30,.367,15,50,.300,.394,16,23,.696,7,26,33,17,8,0,9,22,79
318,MIA,2008,Smush Parker,26,9,0,183,17,54,.315,6,24,.250,11,30,.367,.370,3,4,.750,2,17,19,15,5,3,8,13,43
319,MIA,2008,Blake Ahearn,23,12,0,177,15,57,.263,10,34,.294,5,23,.217,.351,30,31,.968,1,18,19,19,6,0,16,20,70
320,MIA,2008,Bobby Jones,24,6,0,143,17,32,.531,6,15,.400,11,17,.647,.625,8,13,.615,8,16,24,5,2,0,7,18,48
321,MIA,2007,Udonis Haslem,26,79,79,2483,353,717,.492,0,4,.000,353,713,.495,.492,138,203,.680,188,466,654,97,49,26,110,236,844
322,MIA,2007,Dwyane Wade,25,51,50,1931,472,962,.491,21,79,.266,451,883,.511,.502,432,535,.807,51,188,239,384,107,62,216,117,1397
323,MIA,2007,James Posey,30,71,19,1919,186,432,.431,97,259,.375,89,173,.514,.543,81,98,.827,66,291,357,94,71,23,55,193,550
324,MIA,2007,Jason Williams,31,61,55,1865,235,569,.413,100,295,.339,135,274,.493,.501,94,103,.913,18,123,141,322,58,1,100,68,664
325,MIA,2007,Antoine Walker,30,78,15,1818,265,668,.397,84,305,.275,181,363,.499,.460,46,105,.438,92,247,339,130,48,17,141,173,660
326,MIA,2007,Jason Kapono,25,67,35,1767,278,563,.494,108,210,.514,170,353,.482,.590,66,74,.892,26,154,180,81,38,2,70,135,730
327,MIA,2007,Alonzo Mourning,36,77,43,1572,238,425,.560,0,0,,238,425,.560,.560,185,308,.601,126,224,350,18,13,178,129,219,661
328,MIA,2007,Gary Payton,38,68,28,1503,144,366,.393,32,123,.260,112,243,.461,.437,38,57,.667,18,114,132,201,43,3,66,117,358
329,MIA,2007,Dorell Wright,21,66,19,1292,162,364,.445,5,34,.147,157,330,.476,.452,64,86,.744,40,232,272,95,41,46,65,112,393
330,MIA,2007,Shaquille O'Neal,34,40,39,1135,283,479,.591,0,0,,283,479,.591,.591,124,294,.422,97,200,297,79,8,55,95,139,690
331,MIA,2007,Eddie Jones,35,35,27,1033,121,271,.446,56,148,.378,65,123,.528,.550,34,41,.829,17,112,129,76,46,8,24,70,332
332,MIA,2007,Michael Doleac,29,56,0,698,82,175,.469,0,1,.000,82,174,.471,.469,36,41,.878,44,111,155,22,18,15,30,96,200
333,MIA,2007,Chris Quinn,23,42,1,408,48,131,.366,20,57,.351,28,74,.378,.443,25,37,.676,6,24,30,65,15,0,21,32,141
334,MIA,2007,Earl Barron,25,28,0,203,24,83,.289,0,1,.000,24,82,.293,.289,17,18,.944,19,22,41,5,6,4,11,21,65
335,MIA,2007,Robert Hite,23,12,0,136,19,60,.317,5,23,.217,14,37,.378,.358,8,12,.667,4,12,16,8,3,2,6,8,51
336,MIA,2007,Wayne Simien,23,8,0,93,9,23,.391,0,0,,9,23,.391,.391,5,7,.714,5,6,11,4,2,0,3,13,23
337,MIA,2006,Dwyane Wade,24,75,75,2892,699,1413,.495,13,76,.171,686,1337,.513,.499,629,803,.783,107,323,430,503,146,58,268,217,2040
338,MIA,2006,Udonis Haslem,25,81,80,2491,300,591,.508,0,2,.000,300,589,.509,.508,157,199,.789,167,467,634,95,50,17,80,216,757
339,MIA,2006,Gary Payton,37,81,25,2305,230,547,.420,66,230,.287,164,317,.517,.481,100,126,.794,34,199,233,257,71,10,102,169,626
340,MIA,2006,Antoine Walker,29,82,19,2199,391,898,.435,137,383,.358,254,515,.493,.512,81,129,.628,103,318,421,166,47,30,150,187,1000
341,MIA,2006,James Posey,29,67,63,1914,159,395,.403,117,290,.403,42,105,.400,.551,48,61,.787,33,286,319,89,54,20,58,196,483
342,MIA,2006,Jason Williams,30,59,56,1874,268,606,.442,107,288,.372,161,318,.506,.531,85,98,.867,6,133,139,287,53,5,100,101,728
343,MIA,2006,Shaquille O'Neal,33,59,58,1806,480,800,.600,0,0,,480,800,.600,.600,221,471,.469,172,369,541,113,23,104,168,230,1181
344,MIA,2006,Alonzo Mourning,35,65,20,1302,188,315,.597,0,1,.000,188,314,.599,.597,133,224,.594,125,234,359,11,13,173,79,177,509
345,MIA,2006,Jason Kapono,24,51,2,665,79,177,.446,21,53,.396,58,124,.468,.506,28,33,.848,12,59,71,37,7,3,20,89,207
346,MIA,2006,Shandon Anderson,32,48,1,638,54,126,.429,5,19,.263,49,107,.458,.448,13,18,.722,18,63,81,30,17,6,24,75,126
347,MIA,2006,Derek Anderson,31,23,3,465,40,130,.308,21,67,.313,19,63,.302,.388,32,38,.842,9,51,60,48,8,2,17,49,133
348,MIA,2006,Wayne Simien,22,43,2,414,58,120,.483,0,0,,58,120,.483,.483,30,34,.882,38,50,88,7,13,1,24,70,146
349,MIA,2006,Michael Doleac,28,31,3,371,37,88,.420,0,0,,37,88,.420,.420,24,30,.800,23,62,85,8,10,7,14,45,98
350,MIA,2006,Gerald Fitch,23,18,1,239,30,89,.337,7,26,.269,23,63,.365,.376,17,23,.739,7,23,30,33,7,5,15,28,84
351,MIA,2006,Dorell Wright,20,20,2,132,20,43,.465,3,6,.500,17,37,.459,.500,15,17,.882,2,30,32,8,3,1,14,12,58
352,MIA,2006,Earl Barron,24,8,0,45,5,16,.313,0,0,,5,16,.313,.313,3,4,.750,2,8,10,0,0,0,5,10,13
353,MIA,2006,Matt Walsh,23,2,0,3,1,1,1.000,0,0,,1,1,1.000,1.000,0,2,.000,0,0,0,0,0,0,1,0,2
354,MIA,2005,Dwyane Wade,23,77,77,2974,630,1318,.478,13,45,.289,617,1273,.485,.483,581,762,.762,110,287,397,520,121,82,321,230,1854
355,MIA,2005,Eddie Jones,33,80,80,2839,351,820,.428,142,382,.372,209,438,.477,.515,174,216,.806,38,367,405,212,86,38,99,251,1018
356,MIA,2005,Udonis Haslem,24,80,80,2675,346,641,.540,0,4,.000,346,637,.543,.540,178,225,.791,239,487,726,108,63,41,113,260,870
357,MIA,2005,Damon Jones,28,82,66,2576,331,726,.456,225,521,.432,106,205,.517,.611,68,86,.791,14,217,231,350,44,5,98,121,955
358,MIA,2005,Shaquille O'Neal,32,73,73,2492,658,1095,.601,0,0,,658,1095,.601,.601,353,765,.461,253,507,760,200,36,171,203,262,1669
359,MIA,2005,Rasual Butler,25,65,15,1203,163,409,.399,57,153,.373,106,256,.414,.468,37,48,.771,15,136,151,62,18,29,37,104,420
360,MIA,2005,Keyon Dooling,24,74,0,1184,139,345,.403,19,75,.253,120,270,.444,.430,85,109,.780,11,79,90,132,39,11,65,120,382
361,MIA,2005,Michael Doleac,27,80,8,1175,148,331,.447,0,2,.000,148,329,.450,.447,25,41,.610,74,185,259,47,23,22,36,160,321
362,MIA,2005,Shandon Anderson,31,65,5,1151,98,215,.456,5,28,.179,93,187,.497,.467,54,66,.818,40,150,190,70,40,14,49,136,255
363,MIA,2005,Christian Laettner,35,49,0,739,107,184,.582,1,7,.143,106,177,.599,.584,45,59,.763,36,95,131,41,32,15,29,78,260
364,MIA,2005,Malik Allen,26,14,0,248,35,76,.461,0,0,,35,76,.461,.461,13,14,.929,24,28,52,11,4,11,11,29,83
365,MIA,2005,Alonzo Mourning,34,19,3,245,32,62,.516,0,0,,32,62,.516,.516,31,55,.564,22,49,71,4,3,33,12,32,95
366,MIA,2005,Wesley Person,33,16,3,206,25,57,.439,8,21,.381,17,36,.472,.509,4,4,1.000,1,21,22,11,6,0,7,6,62
367,MIA,2005,Steve Smith,35,13,0,114,9,30,.300,3,15,.200,6,15,.400,.350,2,3,.667,2,14,16,14,2,0,3,8,23
368,MIA,2005,Wang Zhizhi,27,20,0,92,17,36,.472,2,3,.667,15,33,.455,.500,7,12,.583,6,12,18,5,3,2,5,9,43
369,MIA,2005,Qyntel Woods,23,3,0,40,5,12,.417,0,0,,5,12,.417,.417,0,0,,2,4,6,0,4,0,2,6,10
370,MIA,2005,Dorell Wright,19,3,0,27,3,11,.273,0,4,.000,3,7,.429,.273,1,1,1.000,0,1,1,3,4,0,3,2,7
371,MIA,2004,Lamar Odom,24,80,80,3003,485,1127,.430,61,205,.298,424,922,.460,.457,340,458,.742,160,616,776,327,85,71,236,273,1371
372,MIA,2004,Eddie Jones,32,81,81,2998,473,1156,.409,177,479,.370,296,677,.437,.486,278,333,.835,38,270,308,258,92,34,129,226,1401
373,MIA,2004,Rafer Alston,27,82,28,2581,287,764,.376,161,434,.371,126,330,.382,.481,103,134,.769,26,200,226,372,114,18,128,212,838
374,MIA,2004,Brian Grant,31,76,76,2303,289,613,.471,0,1,.000,289,612,.472,.471,86,110,.782,174,350,524,69,51,35,82,254,664
375,MIA,2004,Dwyane Wade,22,61,56,2126,371,798,.465,16,53,.302,355,745,.477,.475,233,312,.747,85,162,247,275,86,34,196,140,991
376,MIA,2004,Caron Butler,23,68,56,2030,240,631,.380,10,42,.238,230,589,.390,.388,133,176,.756,92,234,326,126,75,13,91,162,623
377,MIA,2004,Udonis Haslem,23,75,24,1795,205,447,.459,0,3,.000,205,444,.462,.459,140,183,.765,189,284,473,51,33,24,74,197,550
378,MIA,2004,Rasual Butler,24,45,0,675,119,250,.476,50,108,.463,69,142,.486,.576,16,21,.762,4,57,61,23,10,13,28,72,304
379,MIA,2004,Malik Allen,25,45,6,616,83,198,.419,0,0,,83,198,.419,.419,25,33,.758,42,77,119,16,12,28,27,81,191
380,MIA,2004,Loren Woods,25,38,2,506,44,96,.458,0,0,,44,96,.458,.458,33,55,.600,65,69,134,10,11,19,26,52,121
381,MIA,2004,Samaki Walker,27,33,0,418,38,99,.384,0,2,.000,38,97,.392,.384,29,44,.659,42,70,112,6,9,11,15,54,105
382,MIA,2004,John Wallace,29,37,0,368,61,145,.421,5,13,.385,56,132,.424,.438,31,40,.775,12,47,59,14,5,8,24,38,158
383,MIA,2004,Bimbo Coles,35,22,1,170,12,34,.353,0,0,,12,34,.353,.353,4,6,.667,2,8,10,15,3,0,9,27,28
384,MIA,2004,Wang Zhizhi,26,14,0,105,17,45,.378,4,14,.286,13,31,.419,.422,5,6,.833,4,10,14,2,3,4,6,13,43
385,MIA,2004,Tyrone Hill,35,5,0,38,3,5,.600,0,0,,3,5,.600,.600,3,4,.750,5,3,8,0,0,1,2,10,9
386,MIA,2004,Kirk Penney,23,2,0,18,1,6,.167,1,3,.333,0,3,.000,.250,0,0,,0,1,1,1,1,0,3,1,3
387,MIA,2004,Jerome Beasley,23,2,0,5,1,3,.333,0,0,,1,3,.333,.333,0,0,,0,1,1,0,0,0,0,0,2
388,MIA,2003,Caron Butler,22,78,78,2858,429,1032,.416,34,107,.318,395,925,.427,.432,309,375,.824,135,262,397,213,137,31,192,230,1201
389,MIA,2003,Brian Grant,30,82,82,2641,344,676,.509,0,0,,344,676,.509,.509,158,205,.771,241,596,837,104,63,47,129,300,846
390,MIA,2003,Malik Allen,24,80,73,2318,335,790,.424,0,4,.000,335,786,.426,.424,97,121,.802,134,291,425,54,37,78,128,234,767
391,MIA,2003,Travis Best,30,72,52,1807,231,583,.396,36,109,.330,195,474,.411,.427,105,123,.854,26,121,147,255,44,7,106,174,603
392,MIA,2003,Eddie Jones,31,47,47,1789,291,688,.423,98,241,.407,193,447,.432,.494,189,230,.822,35,191,226,173,64,31,85,137,869
393,MIA,2003,Mike James,27,78,8,1722,218,585,.373,67,228,.294,151,357,.423,.430,104,142,.732,26,123,149,246,64,5,108,176,607
394,MIA,2003,Vladimir Stepania,26,79,6,1594,185,427,.433,0,0,,185,427,.433,.433,71,134,.530,211,343,554,24,45,40,69,169,441
395,MIA,2003,Rasual Butler,23,72,28,1514,207,572,.362,50,171,.292,157,401,.392,.406,76,104,.731,29,157,186,93,21,43,77,105,540
396,MIA,2003,Eddie House,24,55,7,1025,172,444,.387,36,120,.300,136,324,.420,.428,31,36,.861,17,84,101,87,44,1,46,73,411
397,MIA,2003,Anthony Carter,27,49,26,912,83,233,.356,0,8,.000,83,225,.369,.356,33,50,.660,12,71,83,203,45,5,81,70,199
398,MIA,2003,LaPhonso Ellis,32,55,3,784,100,262,.382,27,107,.252,73,155,.471,.433,50,66,.758,44,113,157,15,15,15,31,88,277
399,MIA,2003,Sean Lampley,23,35,0,487,56,129,.434,0,4,.000,56,125,.448,.434,57,82,.695,26,57,83,31,7,3,25,43,169
400,MIA,2003,Sean Marks,27,23,0,223,22,59,.373,0,1,.000,22,58,.379,.373,10,15,.667,8,27,35,3,5,6,14,37,54
401,MIA,2003,Ken Johnson,24,16,0,156,15,37,.405,0,0,,15,37,.405,.405,2,6,.333,4,28,32,0,1,12,6,20,32
402,MIA,2002,Eddie Jones,30,81,81,3156,517,1198,.432,149,382,.390,368,816,.451,.494,297,355,.837,61,317,378,262,117,77,148,258,1480
403,MIA,2002,Alonzo Mourning,31,75,74,2455,447,866,.516,1,3,.333,446,863,.517,.517,283,431,.657,182,450,632,87,27,186,182,258,1178
404,MIA,2002,Rod Strickland,35,76,64,2294,316,714,.443,8,26,.308,308,688,.448,.448,154,201,.766,49,183,232,463,82,11,159,114,794
405,MIA,2002,Brian Grant,29,72,72,2256,286,610,.469,0,2,.000,286,608,.470,.469,101,119,.849,168,407,575,137,48,31,122,236,673
406,MIA,2002,Jim Jackson,31,55,19,1825,238,538,.442,38,81,.469,200,457,.438,.478,75,87,.862,54,236,290,140,42,14,106,145,589
407,MIA,2002,LaPhonso Ellis,31,66,14,1684,189,452,.418,38,124,.306,151,328,.460,.460,53,84,.631,107,180,287,56,30,37,73,196,469
408,MIA,2002,Kendall Gill,33,65,49,1410,162,422,.384,6,44,.136,156,378,.413,.391,42,62,.677,29,155,184,100,44,8,55,140,372
409,MIA,2002,Eddie House,23,64,3,1230,209,524,.399,54,157,.344,155,367,.422,.450,42,49,.857,17,93,110,123,43,5,80,98,514
410,MIA,2002,Anthony Carter,26,46,18,1050,89,260,.342,1,19,.053,88,241,.365,.344,19,36,.528,19,98,117,214,50,3,72,85,198
411,MIA,2002,Vladimir Stepania,25,67,4,884,117,249,.470,1,2,.500,116,247,.470,.472,50,104,.481,100,170,270,16,24,44,52,103,285
412,MIA,2002,Chris Gatling,34,54,1,809,131,293,.447,1,8,.125,130,285,.456,.449,82,117,.701,71,135,206,25,17,11,58,109,345
413,MIA,2002,Sean Marks,26,21,6,319,38,88,.432,0,0,,38,88,.432,.432,20,34,.588,19,56,75,8,5,10,19,40,96
414,MIA,2002,Malik Allen,23,12,2,161,22,51,.431,0,1,.000,22,50,.440,.431,8,10,.800,15,23,38,5,3,8,2,16,52
415,MIA,2002,Sam Mack,31,12,1,159,14,49,.286,7,28,.250,7,21,.333,.357,5,7,.714,2,12,14,4,5,1,7,17,40
416,MIA,2002,Mike James,26,15,0,119,15,43,.349,8,21,.381,7,22,.318,.442,4,7,.571,2,12,14,19,6,1,13,17,42
417,MIA,2002,Tang Hamilton,23,9,2,98,10,19,.526,0,1,.000,10,18,.556,.526,0,1,.000,6,12,18,5,4,0,2,10,20
418,MIA,2002,Ernest Brown,22,3,0,21,1,6,.167,0,0,,1,6,.167,.167,1,4,.250,1,5,6,0,0,1,3,4,3
419,MIA,2001,Anthony Mason,34,80,80,3254,460,954,.482,0,0,,460,954,.482,.482,370,474,.781,169,601,770,248,80,25,179,231,1290
420,MIA,2001,Brian Grant,28,82,79,2771,484,1010,.479,0,1,.000,484,1009,.480,.479,282,354,.797,217,501,718,101,60,71,170,293,1250
421,MIA,2001,Bruce Bowen,29,82,72,2685,211,581,.363,103,307,.336,108,274,.394,.452,98,161,.609,45,200,245,132,83,53,74,269,623
422,MIA,2001,Tim Hardaway,34,77,77,2613,408,1042,.392,189,517,.366,219,525,.417,.482,145,181,.801,26,178,204,483,90,6,189,155,1150
423,MIA,2001,Eddie Jones,29,63,58,2282,388,871,.445,90,238,.378,298,633,.471,.497,228,270,.844,75,217,292,171,110,58,135,183,1094
424,MIA,2001,Anthony Carter,25,72,6,1630,195,480,.406,6,40,.150,189,440,.430,.413,65,103,.631,46,134,180,268,73,10,119,154,461
425,MIA,2001,A.C. Green,37,82,1,1411,144,324,.444,0,6,.000,144,318,.453,.444,79,111,.712,107,206,313,39,30,8,45,119,367
426,MIA,2001,Dan Majerle,35,53,19,1306,87,259,.336,57,181,.315,30,78,.385,.446,36,44,.818,20,146,166,88,53,15,35,98,267
427,MIA,2001,Eddie House,22,50,0,550,104,247,.421,19,55,.345,85,192,.443,.460,24,35,.686,5,37,42,52,13,0,35,58,251
428,MIA,2001,Cedric Ceballos,31,27,0,393,73,158,.462,11,33,.333,62,125,.496,.497,29,33,.879,27,53,80,13,10,4,23,42,186
429,MIA,2001,Duane Causwell,32,31,14,384,32,85,.376,0,0,,32,85,.376,.376,12,25,.480,23,60,83,5,8,18,23,67,76
430,MIA,2001,Alonzo Mourning,30,13,3,306,73,141,.518,0,1,.000,73,140,.521,.518,31,55,.564,35,66,101,12,4,31,28,24,177
431,MIA,2001,Todd Fuller,26,10,0,77,10,35,.286,0,0,,10,35,.286,.286,8,8,1.000,7,11,18,1,3,2,3,10,28
432,MIA,2001,Don MacLean,31,8,1,76,10,20,.500,2,2,1.000,8,18,.444,.550,9,12,.750,7,11,18,4,5,1,10,9,31
433,MIA,2001,Jamal Robinson,27,6,0,72,3,22,.136,0,2,.000,3,20,.150,.136,0,0,,3,8,11,2,6,0,3,7,6
434,MIA,2001,Ricky Davis,21,7,0,70,12,29,.414,1,1,1.000,11,28,.393,.431,7,8,.875,1,6,7,11,5,2,5,7,32
435,MIA,2000,Jamal Mashburn,27,76,76,2828,515,1158,.445,112,278,.403,403,880,.458,.493,186,239,.778,64,317,381,298,79,14,180,215,1328
436,MIA,2000,Alonzo Mourning,29,79,78,2748,652,1184,.551,0,4,.000,652,1180,.553,.551,414,582,.711,215,538,753,123,40,294,217,308,1718
437,MIA,2000,Dan Majerle,34,69,69,2308,170,422,.403,110,304,.362,60,118,.508,.533,56,69,.812,27,306,333,206,89,17,62,156,506
438,MIA,2000,P.J. Brown,30,80,80,2302,322,671,.480,0,1,.000,322,670,.481,.480,120,159,.755,216,384,600,145,65,61,100,264,764
439,MIA,2000,Anthony Carter,24,79,30,1859,201,509,.395,3,23,.130,198,486,.407,.398,93,124,.750,48,151,199,378,93,5,173,167,498
440,MIA,2000,Tim Hardaway,33,52,52,1672,246,638,.386,94,256,.367,152,382,.398,.459,110,133,.827,25,125,150,385,49,4,119,112,696
441,MIA,2000,Clarence Weatherspoon,29,78,2,1615,215,419,.513,0,0,,215,419,.513,.513,135,183,.738,128,321,449,93,51,49,100,165,565
442,MIA,2000,Voshon Lenard,26,53,13,1434,228,560,.407,89,228,.390,139,332,.419,.487,84,106,.792,37,116,153,136,41,15,80,127,629
443,MIA,2000,Otis Thorpe,37,51,1,777,125,243,.514,0,3,.000,125,240,.521,.514,29,48,.604,56,110,166,33,26,9,59,136,279
444,MIA,2000,Mark Strickland,29,58,5,663,122,224,.545,0,0,,122,224,.545,.545,40,56,.714,44,96,140,22,15,18,24,68,284
445,MIA,2000,Bruce Bowen,28,27,2,567,46,121,.380,26,56,.464,20,65,.308,.488,19,31,.613,13,47,60,18,14,10,14,81,137
446,MIA,2000,Rex Walters,29,33,0,389,38,91,.418,5,20,.250,33,71,.465,.445,12,16,.750,8,28,36,65,6,0,29,44,93
447,MIA,2000,Rodney Buford,22,34,0,386,62,151,.411,7,29,.241,55,122,.451,.434,16,22,.727,10,38,48,21,10,8,9,44,147
448,MIA,2000,Duane Causwell,31,25,2,185,20,37,.541,0,0,,20,37,.541,.541,26,38,.684,11,36,47,2,2,16,10,42,66
449,MIA,2000,Harold Jamison,23,12,0,74,7,20,.350,0,0,,7,20,.350,.350,4,18,.222,16,5,21,4,2,1,4,17,18
450,MIA,2000,Tim James,23,4,0,23,5,14,.357,0,0,,5,14,.357,.357,1,3,.333,3,1,4,2,0,3,2,1,11
451,MIA,1999,Tim Hardaway,32,48,48,1772,301,752,.400,112,311,.360,189,441,.429,.475,121,149,.812,15,137,152,352,57,6,131,102,835
452,MIA,1999,Alonzo Mourning,28,46,46,1753,324,634,.511,0,2,.000,324,632,.513,.511,276,423,.652,166,341,507,74,34,180,139,161,924
453,MIA,1999,Dan Majerle,33,48,48,1624,118,298,.396,68,203,.335,50,95,.526,.510,33,46,.717,21,187,208,150,38,7,55,100,337
454,MIA,1999,P.J. Brown,29,50,50,1611,229,477,.480,0,0,,229,477,.480,.480,113,146,.774,115,231,346,66,46,48,69,166,571
455,MIA,1999,Terry Porter,35,50,1,1365,172,370,.465,58,141,.411,114,229,.498,.543,123,148,.831,13,127,140,146,48,11,74,97,525
456,MIA,1999,Clarence Weatherspoon,28,49,3,1040,141,264,.534,0,0,,141,264,.534,.534,115,143,.804,72,171,243,34,28,17,61,107,397
457,MIA,1999,Jamal Mashburn,26,24,23,855,134,297,.451,13,30,.433,121,267,.453,.473,75,104,.721,24,122,146,75,20,3,60,58,356
458,MIA,1999,Rex Walters,28,33,13,506,35,95,.368,12,38,.316,23,57,.404,.432,19,23,.826,10,40,50,58,10,3,32,63,101
459,MIA,1999,Keith Askins,31,33,13,415,20,62,.323,8,29,.276,12,33,.364,.387,5,8,.625,10,34,44,10,17,3,13,58,53
460,MIA,1999,Mark Strickland,28,32,1,357,50,101,.495,0,1,.000,50,100,.500,.495,19,26,.731,26,52,78,9,7,8,13,28,119
461,MIA,1999,Blue Edwards,33,24,0,283,32,72,.444,4,10,.400,28,62,.452,.472,9,13,.692,7,26,33,30,17,5,21,23,77
462,MIA,1999,Voshon Lenard,25,12,2,190,31,79,.392,12,35,.343,19,44,.432,.468,8,11,.727,4,12,16,10,3,1,7,18,82
463,MIA,1999,Duane Causwell,30,19,1,137,20,35,.571,0,0,,20,35,.571,.571,4,12,.333,14,21,35,2,0,11,18,32,44
464,MIA,1999,Mark Davis,25,4,1,35,2,6,.333,0,0,,2,6,.333,.333,5,6,.833,2,5,7,1,1,0,7,12,9
465,MIA,1999,Marty Conlon,31,7,0,35,3,13,.231,0,0,,3,13,.231,.231,2,2,1.000,1,4,5,1,0,1,3,6,8
466,MIA,1999,Terry Mills,31,1,0,29,3,8,.375,2,4,.500,1,4,.250,.500,1,2,.500,3,1,4,0,1,0,3,3,9
467,MIA,1999,Jamie Watson,26,3,0,18,1,2,.500,0,0,,1,2,.500,.500,0,0,,0,1,1,1,0,0,1,1,2
468,MIA,1998,Tim Hardaway,31,81,81,3031,558,1296,.431,155,442,.351,403,854,.472,.490,257,329,.781,48,251,299,672,136,16,224,200,1528
469,MIA,1998,Voshon Lenard,24,81,81,2621,363,854,.425,153,378,.405,210,476,.441,.515,141,179,.788,72,220,292,180,58,16,99,219,1020
470,MIA,1998,P.J. Brown,28,74,74,2362,278,590,.471,0,0,,278,590,.471,.471,151,197,.766,235,400,635,103,66,98,97,264,707
471,MIA,1998,Alonzo Mourning,27,58,56,1939,403,732,.551,0,0,,403,732,.551,.551,309,465,.665,193,365,558,52,40,130,179,208,1115
472,MIA,1998,Dan Majerle,32,72,22,1928,184,439,.419,111,295,.376,73,144,.507,.546,40,51,.784,48,220,268,157,68,15,65,139,519
473,MIA,1998,Jamal Mashburn,25,48,48,1729,251,577,.435,37,122,.303,214,455,.470,.467,184,231,.797,72,164,236,132,43,14,108,137,723
474,MIA,1998,Eric Murdock,29,82,1,1395,177,419,.422,28,91,.308,149,328,.454,.456,125,156,.801,39,117,156,219,103,13,104,173,507
475,MIA,1998,Isaac Austin,28,52,25,1371,252,532,.474,0,3,.000,252,529,.476,.474,155,228,.680,119,211,330,87,43,34,117,162,659
476,MIA,1998,Mark Strickland,27,51,8,847,145,269,.539,0,1,.000,145,268,.541,.539,59,82,.720,80,133,213,26,18,34,47,87,349
477,MIA,1998,Terry Mills,30,50,0,782,81,206,.393,25,81,.309,56,125,.448,.454,25,33,.758,34,118,152,39,19,9,45,129,212
478,MIA,1998,Keith Askins,30,46,12,681,39,122,.320,21,74,.284,18,48,.375,.406,12,19,.632,28,73,101,29,27,12,26,107,111
479,MIA,1998,Duane Causwell,29,37,2,363,37,89,.416,0,0,,37,89,.416,.416,15,26,.577,29,70,99,5,7,27,18,73,89
480,MIA,1998,Brent Barry,26,17,0,259,23,62,.371,12,34,.353,11,28,.393,.468,12,12,1.000,2,26,28,21,14,4,9,30,70
481,MIA,1998,Marty Conlon,30,18,0,209,28,62,.452,0,0,,28,62,.452,.452,32,44,.727,16,30,46,12,9,5,11,27,88
482,MIA,1998,Rex Walters,27,19,0,108,13,24,.542,3,8,.375,10,16,.625,.604,9,11,.818,2,13,15,14,3,1,10,11,38
483,MIA,1998,Todd Day,28,5,0,69,11,31,.355,2,12,.167,9,19,.474,.387,6,9,.667,4,2,6,7,7,0,3,10,30
484,MIA,1998,Charles Smith,22,11,0,32,4,18,.222,1,3,.333,3,15,.200,.250,1,2,.500,5,3,8,2,2,1,6,3,10
485,MIA,1998,Antonio Lang,25,6,0,29,3,5,.600,0,0,,3,5,.600,.600,6,8,.750,2,3,5,1,2,0,4,3,12
486,MIA,1997,Tim Hardaway,30,81,81,3136,575,1384,.415,203,590,.344,372,794,.469,.489,291,364,.799,49,228,277,695,151,9,230,165,1644
487,MIA,1997,P.J. Brown,27,80,71,2592,300,656,.457,0,2,.000,300,654,.459,.457,161,220,.732,239,431,670,92,85,98,113,283,761
488,MIA,1997,Alonzo Mourning,26,66,65,2320,473,885,.534,1,9,.111,472,876,.539,.535,363,565,.642,189,467,656,104,56,189,226,272,1310
489,MIA,1997,Voshon Lenard,23,73,47,2111,314,684,.459,183,442,.414,131,242,.541,.593,86,105,.819,38,179,217,161,50,18,109,168,897
490,MIA,1997,Isaac Austin,27,82,17,1881,321,639,.502,0,3,.000,321,636,.505,.502,150,226,.664,136,342,478,101,45,43,161,244,792
491,MIA,1997,Keith Askins,29,78,30,1773,138,319,.433,69,172,.401,69,147,.469,.541,39,58,.672,86,185,271,75,53,19,59,196,384
492,MIA,1997,Sasha Danilović,26,43,33,1351,175,396,.442,63,176,.358,112,220,.509,.521,73,94,.777,21,81,102,77,39,8,94,123,486
493,MIA,1997,Dan Majerle,31,36,26,1264,141,347,.406,68,201,.338,73,146,.500,.504,40,59,.678,45,117,162,116,54,14,50,75,390
494,MIA,1997,Jamal Mashburn,24,32,30,1189,146,367,.398,48,146,.329,98,221,.443,.463,88,117,.752,41,138,179,111,43,7,57,117,428
495,MIA,1997,John Crotty,27,48,0,659,79,154,.513,20,49,.408,59,105,.562,.578,54,64,.844,15,32,47,102,18,0,42,79,232
496,MIA,1997,Kurt Thomas,24,18,9,374,39,105,.371,0,1,.000,39,104,.375,.371,35,46,.761,31,76,107,9,12,9,25,67,113
497,MIA,1997,Gary Grant,31,28,0,365,39,110,.355,14,46,.304,25,64,.391,.418,18,22,.818,8,30,38,45,16,0,27,39,110
498,MIA,1997,Willie Anderson,30,28,1,303,29,64,.453,8,19,.421,21,45,.467,.516,17,20,.850,15,27,42,34,14,4,19,36,83
499,MIA,1997,Ed Pinckney,33,27,0,273,23,43,.535,0,0,,23,43,.535,.535,20,25,.800,25,40,65,6,8,9,19,30,66
500,MIA,1997,Mark Strickland,26,31,0,153,25,60,.417,0,1,.000,25,59,.424,.417,12,21,.571,16,21,37,1,4,10,15,17,62
501,MIA,1997,James Scott,24,8,0,32,0,8,.000,0,4,.000,0,4,.000,.000,1,2,.500,1,5,6,3,2,0,2,5,1
502,MIA,1997,Martin Müürsepp,22,10,0,27,5,14,.357,1,4,.250,4,10,.400,.393,6,14,.429,2,3,5,3,0,1,3,3,17
503,MIA,1997,Matt Fish,27,1,0,1,0,0,,0,0,,0,0,,,0,0,,0,0,0,0,0,0,0,0,0
504,MIA,1997,Bruce Bowen,25,1,0,1,0,0,,0,0,,0,0,,,0,0,,0,0,0,0,0,1,0,0,0
505,MIA,1996,Alonzo Mourning,25,70,70,2671,563,1076,.523,9,30,.300,554,1046,.530,.527,488,712,.685,218,509,727,159,70,189,262,245,1623
506,MIA,1996,Keith Askins,28,75,14,1897,157,391,.402,99,237,.418,58,154,.377,.528,45,57,.789,113,211,324,121,48,61,82,271,458
507,MIA,1996,Bimbo Coles,27,52,52,1882,231,559,.413,63,172,.366,168,387,.434,.470,139,173,.803,38,163,201,296,63,12,123,175,664
508,MIA,1996,Rex Chapman,28,56,50,1865,289,679,.426,125,337,.371,164,342,.480,.518,83,113,.735,22,123,145,166,45,10,79,117,786
509,MIA,1996,Kurt Thomas,23,74,42,1655,274,547,.501,0,2,.000,274,545,.503,.501,118,178,.663,122,317,439,46,47,36,98,271,666
510,MIA,1996,Billy Owens,26,40,40,1388,239,473,.505,0,6,.000,239,467,.512,.505,112,177,.633,94,192,286,134,30,22,113,132,590
511,MIA,1996,Kevin Willis,33,47,42,1357,195,412,.473,0,5,.000,195,407,.479,.473,89,125,.712,134,286,420,34,19,25,99,158,479
512,MIA,1996,Tim Hardaway,29,28,28,1047,164,386,.425,53,147,.361,111,239,.464,.494,101,123,.821,13,85,98,280,58,6,110,70,482
513,MIA,1996,Kevin Gamble,30,44,13,1033,117,297,.394,38,91,.418,79,206,.383,.458,33,38,.868,14,72,86,82,31,5,32,119,305
514,MIA,1996,Walt Williams,25,28,28,788,124,268,.463,56,123,.455,68,145,.469,.567,33,60,.550,37,75,112,65,32,16,48,87,337
515,MIA,1996,Pete Myers,32,39,1,639,62,160,.388,11,42,.262,51,118,.432,.422,49,76,.645,21,52,73,97,14,11,56,75,184
516,MIA,1996,Chris Gatling,28,24,0,565,155,259,.598,0,0,,155,259,.598,.598,55,75,.733,51,124,175,17,17,11,35,82,365
517,MIA,1996,Sasha Danilović,25,19,18,542,83,184,.451,34,78,.436,49,106,.462,.543,55,72,.764,12,34,46,47,15,3,37,49,255
518,MIA,1996,Tony Smith,27,25,1,410,46,101,.455,13,39,.333,33,62,.532,.520,4,9,.444,6,33,39,68,16,5,26,46,109
519,MIA,1996,Danny Schayes,36,32,6,399,32,94,.340,0,0,,32,94,.340,.340,37,46,.804,29,60,89,9,11,16,23,60,101
520,MIA,1996,Terrence Rencher,22,34,1,397,32,99,.323,9,29,.310,23,70,.329,.369,30,43,.698,9,33,42,54,16,1,41,36,103
521,MIA,1996,Tyrone Corbin,33,22,0,354,38,92,.413,2,6,.333,36,86,.419,.424,23,28,.821,26,39,65,23,16,3,17,51,101
522,MIA,1996,Voshon Lenard,22,30,0,323,53,141,.376,36,101,.356,17,40,.425,.504,34,43,.791,12,40,52,31,6,1,23,31,176
523,MIA,1996,Ron Grandison,31,18,3,235,13,39,.333,4,13,.308,9,26,.346,.385,13,19,.684,14,22,36,10,8,1,11,27,43
524,MIA,1996,Stacey King,29,15,0,156,17,36,.472,0,0,,17,36,.472,.472,4,8,.500,9,14,23,2,7,2,18,39,38
525,MIA,1996,Jeff Malone,34,7,0,103,13,33,.394,0,0,,13,33,.394,.394,5,6,.833,0,8,8,7,3,0,3,6,31
526,MIA,1996,LeRon Ellis,26,12,1,74,5,22,.227,0,0,,5,22,.227,.227,3,6,.500,5,3,8,4,2,3,3,11,13
527,MIA,1995,Glen Rice,27,82,82,3014,667,1403,.475,185,451,.410,482,952,.506,.541,312,365,.855,99,279,378,192,112,14,153,203,1831
528,MIA,1995,Kevin Willis,32,65,61,2301,457,974,.469,3,14,.214,454,960,.473,.471,195,282,.691,217,479,696,83,59,33,155,208,1112
529,MIA,1995,Billy Owens,25,70,60,2296,403,820,.491,2,22,.091,401,798,.503,.493,194,313,.620,203,299,502,246,80,30,204,205,1002
530,MIA,1995,Bimbo Coles,26,68,65,2207,261,607,.430,16,76,.211,245,531,.461,.443,141,174,.810,46,145,191,416,99,13,156,185,679
531,MIA,1995,John Salley,30,75,50,1955,197,395,.499,0,0,,197,395,.499,.499,153,207,.739,110,226,336,123,47,85,97,279,547
532,MIA,1995,Matt Geiger,25,74,43,1712,260,485,.536,4,10,.400,256,475,.539,.540,93,143,.650,146,267,413,55,41,51,113,245,617
533,MIA,1995,Khalid Reeves,22,67,17,1462,206,465,.443,67,171,.392,139,294,.473,.515,140,196,.714,52,134,186,288,77,10,132,139,619
534,MIA,1995,Kevin Gamble,29,77,0,1223,220,450,.489,39,98,.398,181,352,.514,.532,87,111,.784,29,93,122,119,52,10,49,130,566
535,MIA,1995,Ledell Eackles,28,54,6,898,143,326,.439,18,41,.439,125,285,.439,.466,91,126,.722,33,62,95,72,19,2,53,88,395
536,MIA,1995,Harold Miner,23,45,16,871,123,305,.403,14,49,.286,109,256,.426,.426,69,95,.726,38,79,117,69,15,6,77,85,329
537,MIA,1995,Keith Askins,27,50,5,854,81,207,.391,21,78,.269,60,129,.465,.442,46,57,.807,86,112,198,39,35,17,25,109,229
538,MIA,1995,Brad Lohaus,30,61,1,730,97,231,.420,63,155,.406,34,76,.447,.556,10,15,.667,28,74,102,43,20,25,29,85,267
539,MIA,1995,Kevin Pritchard,27,14,0,158,13,29,.448,2,5,.400,11,24,.458,.483,15,17,.882,0,11,11,23,2,1,7,19,43
540,MIA,1995,Grant Long,28,2,2,62,5,12,.417,0,0,,5,12,.417,.417,6,10,.600,1,10,11,4,2,0,4,11,16
541,MIA,1995,Steve Smith,25,2,2,62,11,29,.379,2,12,.167,9,17,.529,.414,17,22,.773,4,2,6,7,2,1,4,9,41
542,MIA,1994,Glen Rice,26,81,81,2999,663,1421,.467,132,346,.382,531,1075,.494,.513,250,284,.880,76,358,434,184,110,32,130,186,1708
543,MIA,1994,Steve Smith,24,78,77,2776,491,1076,.456,91,262,.347,400,814,.491,.499,273,327,.835,156,196,352,394,84,35,202,217,1346
544,MIA,1994,Rony Seikaly,28,72,60,2410,392,803,.488,0,2,.000,392,801,.489,.488,304,422,.720,244,496,740,136,59,100,195,279,1088
545,MIA,1994,Grant Long,27,69,59,2201,300,672,.446,1,6,.167,299,666,.449,.447,187,238,.786,190,305,495,170,89,26,125,244,788
546,MIA,1994,Brian Shaw,27,77,52,2037,278,667,.417,73,216,.338,205,451,.455,.472,64,89,.719,104,246,350,385,71,21,173,195,693
547,MIA,1994,John Salley,29,76,45,1910,208,436,.477,2,3,.667,206,433,.476,.479,164,225,.729,132,275,407,135,56,78,94,260,582
548,MIA,1994,Bimbo Coles,25,76,4,1726,233,519,.449,20,99,.202,213,420,.507,.468,102,131,.779,50,109,159,263,75,12,107,132,588
549,MIA,1994,Harold Miner,22,63,31,1358,254,532,.477,4,6,.667,250,526,.475,.481,149,180,.828,75,81,156,95,31,13,95,132,661
550,MIA,1994,Matt Geiger,24,72,0,1199,202,352,.574,1,5,.200,201,347,.579,.575,116,149,.779,119,184,303,32,36,29,61,201,521
551,MIA,1994,Willie Burton,25,53,1,697,124,283,.438,3,15,.200,121,268,.451,.443,120,158,.759,50,86,136,39,18,20,54,96,371
552,MIA,1994,Keith Askins,26,37,0,319,36,88,.409,4,21,.190,32,67,.478,.432,9,10,.900,33,49,82,13,11,1,21,57,85
553,MIA,1994,Alec Kessler,27,15,0,66,11,25,.440,5,9,.556,6,16,.375,.540,6,8,.750,4,6,10,2,1,1,5,14,33
554,MIA,1994,Manute Bol,31,8,0,61,1,12,.083,0,3,.000,1,9,.111,.083,0,0,,1,10,11,0,0,6,5,4,2
555,MIA,1994,Morlon Wiley,27,4,0,34,3,8,.375,1,4,.250,2,4,.500,.438,0,0,,0,4,4,7,2,0,6,4,7
556,MIA,1994,Gary Alexander,24,4,0,12,1,2,.500,0,0,,1,2,.500,.500,0,2,.000,1,2,3,1,0,0,1,3,2
557,MIA,1993,Glen Rice,25,82,82,3082,582,1324,.440,148,386,.383,434,938,.463,.495,242,295,.820,92,332,424,180,92,25,157,201,1554
558,MIA,1993,Grant Long,26,76,62,2728,397,847,.469,6,26,.231,391,821,.476,.472,261,341,.765,197,371,568,182,104,31,133,264,1061
559,MIA,1993,Rony Seikaly,27,72,64,2456,417,868,.480,1,8,.125,416,860,.484,.481,397,540,.735,259,587,846,100,38,83,203,260,1232
560,MIA,1993,Bimbo Coles,24,81,37,2232,318,686,.464,42,137,.307,276,549,.503,.494,177,220,.805,58,108,166,373,80,11,108,199,855
561,MIA,1993,Steve Smith,23,48,43,1610,279,619,.451,53,132,.402,226,487,.464,.494,155,197,.787,56,141,197,267,50,16,129,148,766
562,MIA,1993,Brian Shaw,26,68,45,1603,197,501,.393,43,130,.331,154,371,.415,.436,61,78,.782,70,187,257,235,48,19,96,163,498
563,MIA,1993,John Salley,28,51,34,1422,154,307,.502,0,0,,154,307,.502,.502,115,144,.799,113,200,313,83,32,70,101,192,423
564,MIA,1993,Harold Miner,21,73,0,1383,292,615,.475,3,9,.333,289,606,.477,.477,163,214,.762,74,73,147,73,34,8,92,130,750
565,MIA,1993,Kevin Edwards,27,40,30,1134,216,462,.468,5,17,.294,211,445,.474,.473,119,141,.844,48,73,121,120,68,12,75,69,556
566,MIA,1993,Keith Askins,25,69,1,935,88,213,.413,22,65,.338,66,148,.446,.465,29,40,.725,74,124,198,31,31,29,37,141,227
567,MIA,1993,Matt Geiger,23,48,2,554,76,145,.524,0,4,.000,76,141,.539,.524,62,92,.674,46,74,120,14,15,18,36,123,214
568,MIA,1993,Willie Burton,24,26,8,451,54,141,.383,5,15,.333,49,126,.389,.401,91,127,.717,22,48,70,16,13,16,50,58,204
569,MIA,1993,Alec Kessler,26,40,2,415,57,122,.467,5,11,.455,52,111,.468,.488,36,47,.766,25,66,91,14,4,12,21,63,155
570,MIA,1992,Grant Long,25,82,82,3063,440,890,.494,6,22,.273,434,868,.500,.498,326,404,.807,259,432,691,225,139,40,185,248,1212
571,MIA,1992,Glen Rice,24,79,79,3007,672,1432,.469,155,396,.391,517,1036,.499,.523,266,318,.836,84,310,394,184,90,35,145,170,1765
572,MIA,1992,Rony Seikaly,26,79,78,2800,463,947,.489,0,3,.000,463,944,.490,.489,370,505,.733,307,627,934,109,40,121,216,278,1296
573,MIA,1992,Bimbo Coles,23,81,28,1976,295,649,.455,10,52,.192,285,597,.477,.462,216,262,.824,69,120,189,366,73,13,167,151,816
574,MIA,1992,Kevin Edwards,26,81,1,1840,325,716,.454,7,32,.219,318,684,.465,.459,162,191,.848,56,155,211,170,99,20,120,138,819
575,MIA,1992,Steve Smith,22,61,59,1806,297,654,.454,40,125,.320,257,529,.486,.485,95,127,.748,81,107,188,278,59,19,152,162,729
576,MIA,1992,Willie Burton,23,68,50,1585,280,622,.450,6,15,.400,274,607,.451,.455,196,245,.800,76,168,244,123,46,37,119,186,762
577,MIA,1992,Alec Kessler,25,77,4,1197,158,383,.413,0,0,,158,383,.413,.413,94,115,.817,114,200,314,34,17,32,58,185,410
578,MIA,1992,Brian Shaw,25,46,23,987,139,349,.398,5,16,.313,134,333,.402,.405,37,51,.725,39,96,135,161,45,12,67,86,320
579,MIA,1992,Keith Askins,24,59,4,843,84,205,.410,25,73,.342,59,132,.447,.471,26,37,.703,65,77,142,38,40,15,47,109,219
580,MIA,1992,Alan Ogg,24,43,0,367,46,84,.548,0,0,,46,84,.548,.548,16,30,.533,30,44,74,7,5,28,19,73,108
581,MIA,1992,John Morton,24,21,0,216,33,81,.407,2,15,.133,31,66,.470,.420,24,29,.828,3,16,19,27,12,1,24,20,92
582,MIA,1992,Sherman Douglas,25,5,2,98,16,31,.516,0,1,.000,16,30,.533,.516,5,7,.714,1,5,6,19,4,0,8,10,37
583,MIA,1992,Miloš Babić,23,9,0,35,6,13,.462,0,0,,6,13,.462,.462,6,8,.750,2,9,11,6,1,0,5,0,18
584,MIA,1992,Jon Sundvold,30,3,0,8,1,3,.333,1,1,1.000,0,2,.000,.500,0,0,,0,0,0,2,0,0,0,2,3
585,MIA,1992,Winston Bennett,26,2,0,2,1,2,.500,0,0,,1,2,.500,.500,0,0,,1,0,1,0,0,0,0,1,2
586,MIA,1991,Glen Rice,23,77,77,2646,550,1193,.461,71,184,.386,479,1009,.475,.491,171,209,.818,85,296,381,189,101,26,166,216,1342
587,MIA,1991,Sherman Douglas,24,73,73,2562,532,1055,.504,4,31,.129,528,1024,.516,.506,284,414,.686,78,131,209,624,121,5,270,178,1352
588,MIA,1991,Grant Long,24,80,66,2514,276,561,.492,1,6,.167,275,555,.495,.493,181,230,.787,225,343,568,176,119,43,156,295,734
589,MIA,1991,Rony Seikaly,25,64,59,2171,395,822,.481,2,6,.333,393,816,.482,.482,258,417,.619,207,502,709,95,51,86,205,213,1050
590,MIA,1991,Kevin Edwards,25,79,16,2000,380,927,.410,24,84,.286,356,843,.422,.423,171,213,.803,80,125,205,240,129,46,163,151,955
591,MIA,1991,Willie Burton,22,76,26,1928,341,773,.441,4,30,.133,337,743,.454,.444,229,293,.782,111,151,262,107,72,24,144,275,915
592,MIA,1991,Billy Thompson,27,73,46,1481,205,411,.499,0,4,.000,205,407,.504,.499,89,124,.718,120,192,312,111,32,48,117,161,499
593,MIA,1991,Bimbo Coles,22,82,9,1355,162,393,.412,6,34,.176,156,359,.435,.420,71,95,.747,56,97,153,232,65,12,98,149,401
594,MIA,1991,Alec Kessler,24,78,18,1259,199,468,.425,0,4,.000,199,464,.429,.425,88,131,.672,115,221,336,31,17,26,108,189,486
595,MIA,1991,Terry Davis,23,55,17,996,115,236,.487,1,2,.500,114,234,.487,.489,69,124,.556,107,159,266,39,18,28,36,129,300
596,MIA,1991,Keith Askins,23,39,1,266,34,81,.420,6,25,.240,28,56,.500,.457,12,25,.480,30,38,68,19,16,13,11,46,86
597,MIA,1991,Alan Ogg,23,31,1,261,24,55,.436,0,2,.000,24,53,.453,.436,6,10,.600,15,34,49,2,6,27,8,53,54
598,MIA,1991,Jon Sundvold,29,24,0,225,43,107,.402,15,35,.429,28,72,.389,.472,11,11,1.000,3,6,9,24,7,0,16,11,112
599,MIA,1991,Milt Wagner,27,13,1,116,24,57,.421,6,17,.353,18,40,.450,.474,9,11,.818,0,7,7,15,2,3,12,14,63
600,MIA,1990,Sherman Douglas,23,81,66,2470,463,938,.494,5,31,.161,458,907,.505,.496,224,326,.687,70,136,206,619,145,10,246,187,1155
601,MIA,1990,Rony Seikaly,24,74,72,2409,486,968,.502,0,1,.000,486,967,.503,.502,256,431,.594,253,513,766,78,78,124,236,258,1228
602,MIA,1990,Glen Rice,22,77,60,2311,470,1071,.439,17,69,.246,453,1002,.452,.447,91,124,.734,100,252,352,138,67,27,113,198,1048
603,MIA,1990,Kevin Edwards,24,78,54,2211,395,959,.412,9,30,.300,386,929,.416,.417,139,183,.760,77,205,282,252,125,33,180,149,938
604,MIA,1990,Billy Thompson,26,79,45,2142,375,727,.516,2,4,.500,373,723,.516,.517,115,185,.622,238,313,551,166,54,89,156,237,867
605,MIA,1990,Grant Long,23,81,31,1856,257,532,.483,0,3,.000,257,529,.486,.483,172,241,.714,156,246,402,96,91,38,139,300,686
606,MIA,1990,Tellis Frank,24,77,39,1762,278,607,.458,0,0,,278,607,.458,.458,179,234,.765,151,234,385,85,51,27,134,282,735
607,MIA,1990,Rory Sparrow,31,82,25,1756,210,510,.412,8,40,.200,202,470,.430,.420,59,77,.766,37,101,138,298,49,4,99,140,487
608,MIA,1990,Terry Davis,22,63,9,884,122,262,.466,0,1,.000,122,261,.467,.466,54,87,.621,93,136,229,25,25,28,68,171,298
609,MIA,1990,Jon Sundvold,28,63,2,867,148,363,.408,44,100,.440,104,263,.395,.468,44,52,.846,15,56,71,102,25,0,52,69,384
610,MIA,1990,Scott Haffner,23,43,6,559,88,217,.406,3,21,.143,85,196,.434,.412,17,25,.680,7,44,51,80,13,2,33,53,196
611,MIA,1990,Pat Cummings,33,37,1,391,77,159,.484,0,0,,77,159,.484,.484,21,37,.568,28,65,93,13,12,4,32,60,175
612,MIA,1990,Jim Rowinski,29,14,0,112,14,32,.438,0,0,,14,32,.438,.438,22,26,.846,17,12,29,5,1,2,10,19,50
613,MIA,1989,Rory Sparrow,30,80,79,2613,444,982,.452,18,74,.243,426,908,.469,.461,94,107,.879,55,161,216,429,103,17,204,168,1000
614,MIA,1989,Grant Long,22,82,73,2435,336,692,.486,0,5,.000,336,687,.489,.486,304,406,.749,240,306,546,149,122,48,201,337,976
615,MIA,1989,Kevin Edwards,23,79,62,2349,470,1105,.425,10,37,.270,460,1068,.431,.430,144,193,.746,85,177,262,349,139,27,246,154,1094
616,MIA,1989,Billy Thompson,25,79,58,2273,349,716,.487,0,4,.000,349,712,.490,.487,156,224,.696,241,331,572,176,56,105,189,260,854
617,MIA,1989,Rony Seikaly,23,78,62,1962,333,744,.448,1,4,.250,332,740,.449,.448,181,354,.511,204,345,549,55,46,96,200,258,848
618,MIA,1989,Jon Sundvold,27,68,8,1338,307,675,.455,48,92,.522,259,583,.444,.490,47,57,.825,18,69,87,137,27,1,87,78,709
619,MIA,1989,Sylvester Gray,21,55,15,1220,167,398,.420,1,4,.250,166,394,.421,.421,105,156,.673,117,169,286,117,36,25,102,144,440
620,MIA,1989,Scott Hastings,28,75,6,1206,143,328,.436,9,28,.321,134,300,.447,.450,91,107,.850,72,159,231,59,32,42,68,203,386
621,MIA,1989,Pat Cummings,32,53,28,1096,197,394,.500,0,2,.000,197,392,.503,.500,72,97,.742,84,197,281,47,29,18,111,160,466
622,MIA,1989,Pearl Washington,25,54,8,1065,164,387,.424,1,14,.071,163,373,.437,.425,82,104,.788,49,74,123,226,73,4,122,101,411
623,MIA,1989,John Shasky,24,65,4,944,121,248,.488,0,2,.000,121,246,.492,.488,115,167,.689,96,136,232,22,14,13,46,94,357
624,MIA,1989,Anthony Taylor,23,21,7,368,60,151,.397,0,2,.000,60,149,.403,.397,24,32,.750,11,23,34,43,22,5,20,37,144
625,MIA,1989,Craig Neal,24,32,0,341,34,88,.386,8,25,.320,26,63,.413,.432,13,21,.619,4,14,18,86,15,4,40,46,89
626,MIA,1989,Todd Mitchell,22,22,0,320,41,88,.466,0,0,,41,88,.466,.466,36,60,.600,17,30,47,20,15,2,29,49,118
627,MIA,1989,Kelvin Upshaw,26,9,0,144,26,63,.413,1,5,.200,25,58,.431,.421,4,6,.667,4,9,13,20,7,0,13,18,57
628,MIA,1989,Clinton Wheeler,29,8,0,143,24,42,.571,0,0,,24,42,.571,.571,8,10,.800,5,7,12,21,8,0,6,9,56
629,MIA,1989,Dave Popson,24,7,0,38,5,15,.333,0,0,,5,15,.333,.333,1,2,.500,7,4,11,2,0,1,4,8,11
630,WAS,2024,Jordan Poole,24,78,66,2346,490,1186,.413,184,564,.326,306,622,.492,.491,192,219,.877,32,180,212,343,86,25,188,244,1356
631,WAS,2024,Kyle Kuzma,28,70,70,2281,608,1313,.463,151,450,.336,457,863,.530,.521,186,240,.775,62,402,464,296,37,49,192,153,1553
632,WAS,2024,Deni Avdija,23,75,75,2257,406,803,.506,88,235,.374,318,568,.560,.560,202,273,.740,84,456,540,286,60,36,160,185,1102
633,WAS,2024,Corey Kispert,24,80,22,2067,386,794,.486,184,480,.383,202,314,.643,.602,114,157,.726,30,195,225,156,41,16,98,141,1070
634,WAS,2024,Tyus Jones,27,66,66,1933,326,666,.489,106,256,.414,220,410,.537,.569,32,40,.800,20,159,179,485,71,18,66,48,790
635,WAS,2024,Bilal Coulibaly,19,63,15,1715,188,432,.435,64,185,.346,124,247,.502,.509,92,131,.702,56,200,256,110,57,48,87,137,532
636,WAS,2024,Daniel Gafford,25,45,45,1192,203,294,.690,0,0,,203,294,.690,.690,84,119,.706,131,230,361,69,44,97,46,147,490
637,WAS,2024,Landry Shamet,26,46,5,726,118,274,.431,53,157,.338,65,117,.556,.527,38,46,.826,16,46,62,54,25,10,30,76,327
638,WAS,2024,Johnny Davis,21,50,6,613,62,154,.403,14,40,.350,48,114,.421,.448,14,24,.583,18,54,72,32,18,10,13,57,152
639,WAS,2024,Marvin Bagley III,24,24,15,575,132,227,.581,8,17,.471,124,210,.590,.599,46,65,.708,84,110,194,28,15,19,30,41,318
640,WAS,2024,Jared Butler,23,40,0,566,98,201,.488,24,78,.308,74,123,.602,.547,31,36,.861,9,49,58,126,29,8,50,58,251
641,WAS,2024,Patrick Baldwin Jr.,21,38,7,493,59,155,.381,31,97,.320,28,58,.483,.481,19,28,.679,17,106,123,29,18,15,19,56,168
642,WAS,2024,Anthony Gill,31,50,3,466,75,160,.469,10,41,.244,65,119,.546,.500,29,36,.806,37,57,94,34,13,11,23,48,189
643,WAS,2024,Delon Wright,31,33,0,456,48,122,.393,14,38,.368,34,84,.405,.451,24,29,.828,13,46,59,82,35,8,11,22,134
644,WAS,2024,Eugene Omoruyi,26,43,0,393,81,167,.485,13,46,.283,68,121,.562,.524,32,49,.653,35,50,85,35,27,5,21,62,207
645,WAS,2024,Danilo Gallinari,35,26,0,385,57,131,.435,20,64,.313,37,67,.552,.511,47,56,.839,12,64,76,31,6,3,12,26,181
646,WAS,2024,Mike Muscala,32,24,2,338,33,90,.367,14,51,.275,19,39,.487,.444,15,20,.750,22,53,75,22,5,7,16,31,95
647,WAS,2024,Richaun Holmes,30,17,8,318,49,88,.557,1,3,.333,48,85,.565,.563,22,26,.846,38,66,104,10,8,10,12,41,121
648,WAS,2024,Justin Champagnie,22,15,1,235,32,78,.410,13,45,.289,19,33,.576,.494,12,15,.800,19,34,53,19,10,9,10,14,89
649,WAS,2024,Tristan Vukcevic,20,10,4,153,29,67,.433,10,36,.278,19,31,.613,.507,17,22,.773,6,30,36,13,5,7,10,28,85
650,WAS,2024,Jules Bernard,24,19,0,149,29,64,.453,11,29,.379,18,35,.514,.539,5,9,.556,10,16,26,16,3,1,8,14,74
651,WAS,2024,Ryan Rollins,21,10,0,66,13,25,.520,2,3,.667,11,22,.500,.560,13,17,.765,2,9,11,11,8,3,7,7,41
652,WAS,2024,Hamidou Diallo,25,2,0,5,1,2,.500,0,0,,1,2,.500,.500,0,0,,2,0,2,1,2,0,1,1,2
653,WAS,2024,Trey Jemison,24,2,0,1,0,0,,0,0,,0,0,,,0,0,,0,1,1,0,0,0,1,0,0
654,WAS,2023,Kyle Kuzma,27,64,64,2239,512,1142,.448,160,481,.333,352,661,.533,.518,173,237,.730,55,408,463,239,36,29,190,145,1357
655,WAS,2023,Kristaps Porziņģis,27,65,65,2120,507,1018,.498,137,356,.385,370,662,.559,.565,354,416,.851,114,432,546,174,58,100,137,196,1505
656,WAS,2023,Corey Kispert,23,74,45,2093,291,585,.497,163,384,.424,128,201,.637,.637,75,88,.852,33,174,207,87,32,9,55,97,820
657,WAS,2023,Deni Avdija,22,76,40,2020,253,579,.437,69,232,.297,184,347,.530,.497,122,165,.739,74,413,487,211,65,29,123,209,697
658,WAS,2023,Monte Morris,27,62,61,1695,247,515,.480,78,204,.382,169,311,.543,.555,64,77,.831,26,184,210,326,43,13,60,75,636
659,WAS,2023,Bradley Beal,29,50,50,1673,444,878,.506,80,219,.365,364,659,.552,.551,192,228,.842,41,155,196,271,45,33,145,107,1160
660,WAS,2023,Daniel Gafford,24,78,47,1604,289,395,.732,0,0,,289,395,.732,.732,127,187,.679,163,270,433,84,33,99,85,187,705
661,WAS,2023,Delon Wright,30,50,14,1221,138,291,.474,41,119,.345,97,172,.564,.545,52,60,.867,58,122,180,194,92,17,44,59,369
662,WAS,2023,Jordan Goodwin,24,62,7,1106,158,353,.448,38,118,.322,120,235,.511,.501,53,69,.768,57,148,205,168,58,26,57,95,407
663,WAS,2023,Will Barton,32,40,0,782,110,285,.386,52,138,.377,58,147,.395,.477,35,45,.778,10,101,111,95,17,10,45,39,307
664,WAS,2023,Rui Hachimura,24,30,0,728,158,324,.488,30,89,.337,128,235,.545,.534,44,58,.759,19,109,128,35,11,12,36,39,390
665,WAS,2023,Anthony Gill,30,59,8,624,71,132,.538,4,29,.138,67,103,.650,.553,49,67,.731,37,62,99,34,7,12,15,70,195
666,WAS,2023,Taj Gibson,37,49,2,480,65,125,.520,8,24,.333,57,101,.564,.552,30,42,.714,32,61,93,34,15,12,26,84,168
667,WAS,2023,Kendrick Nunn,27,31,0,436,89,199,.447,38,97,.392,51,102,.500,.543,18,20,.900,10,44,54,56,17,4,35,31,234
668,WAS,2023,Johnny Davis,20,28,5,423,66,171,.386,17,70,.243,49,101,.485,.436,14,27,.519,10,55,65,28,10,8,17,48,163
669,WAS,2023,Quenton Jackson,24,9,0,135,19,42,.452,1,12,.083,18,30,.600,.464,17,22,.773,2,6,8,15,4,1,4,10,56
670,WAS,2023,Xavier Cooks,27,10,1,126,17,28,.607,0,1,.000,17,27,.630,.607,4,10,.400,16,22,38,6,6,4,8,13,38
671,WAS,2023,Jay Huff,24,7,0,95,15,25,.600,6,12,.500,9,13,.692,.720,15,16,.938,6,15,21,10,3,4,5,15,51
672,WAS,2023,Isaiah Todd,21,6,1,61,3,19,.158,1,10,.100,2,9,.222,.184,2,2,1.000,2,10,12,4,1,0,2,4,9
673,WAS,2023,Devon Dotson,23,6,0,53,1,10,.100,1,4,.250,0,6,.000,.150,0,0,,6,4,10,8,5,0,3,9,3
674,WAS,2023,Vernon Carey Jr.,21,11,0,28,2,8,.250,0,0,,2,8,.250,.250,2,2,1.000,3,8,11,3,2,2,2,5,6
675,WAS,2023,Jamaree Bouyea,23,1,0,6,0,1,.000,0,1,.000,0,0,,.000,0,0,,0,1,1,0,0,0,0,1,0
676,WAS,2023,Jordan Schakel,24,2,0,6,1,2,.500,1,1,1.000,0,1,.000,.750,0,0,,0,0,0,1,1,0,0,1,3
677,WAS,2022,Kentavious Caldwell-Pope,28,77,77,2329,361,829,.435,159,408,.390,202,421,.480,.531,137,154,.890,41,220,261,145,83,26,97,139,1018
678,WAS,2022,Kyle Kuzma,26,66,66,2204,423,936,.452,128,375,.341,295,561,.526,.520,156,219,.712,70,491,561,233,42,57,169,128,1130
679,WAS,2022,Deni Avdija,21,82,8,1984,250,579,.432,82,259,.317,168,320,.525,.503,103,136,.757,52,373,425,167,59,44,87,190,685
680,WAS,2022,Corey Kispert,22,77,36,1801,234,514,.455,112,320,.350,122,194,.629,.564,54,62,.871,53,156,209,85,35,22,50,93,634
681,WAS,2022,Daniel Gafford,23,72,53,1444,285,411,.693,0,1,.000,285,410,.695,.693,107,153,.699,155,252,407,68,30,99,65,170,677
682,WAS,2022,Bradley Beal,28,40,40,1439,348,771,.451,63,210,.300,285,561,.508,.492,169,203,.833,38,151,189,265,36,15,135,95,928
683,WAS,2022,Raul Neto,29,70,19,1372,204,441,.463,35,120,.292,169,321,.526,.502,83,108,.769,13,121,134,217,55,3,79,104,526
684,WAS,2022,Spencer Dinwiddie,28,44,44,1330,185,492,.376,70,226,.310,115,266,.432,.447,116,143,.811,36,171,207,256,27,7,73,107,556
685,WAS,2022,Montrezl Harrell,28,46,3,1117,247,383,.645,4,15,.267,243,368,.660,.650,149,205,.727,96,213,309,96,18,31,50,88,647
686,WAS,2022,Rui Hachimura,23,42,13,943,187,381,.491,55,123,.447,132,258,.512,.563,46,66,.697,25,135,160,48,23,9,33,53,475
687,WAS,2022,Aaron Holiday,25,41,14,663,100,214,.467,23,67,.343,77,147,.524,.521,28,35,.800,9,58,67,78,24,9,39,60,251
688,WAS,2022,Ish Smith,33,28,0,615,112,245,.457,15,42,.357,97,203,.478,.488,3,5,.600,14,69,83,146,27,13,42,44,242
689,WAS,2022,Dāvis Bertāns,29,34,0,501,60,171,.351,46,144,.319,14,27,.519,.485,28,30,.933,6,55,61,16,11,6,14,55,194
690,WAS,2022,Kristaps Porziņģis,26,17,17,479,123,259,.475,29,79,.367,94,180,.522,.531,101,116,.871,38,112,150,50,12,25,28,49,376
691,WAS,2022,Anthony Gill,29,44,0,463,62,109,.569,14,26,.538,48,83,.578,.633,42,52,.808,33,52,85,27,5,11,18,58,180
692,WAS,2022,Thomas Bryant,24,27,9,439,77,148,.520,12,42,.286,65,106,.613,.561,35,40,.875,26,82,108,23,6,21,19,43,201
693,WAS,2022,Tomáš Satoranský,30,22,10,416,40,84,.476,6,22,.273,34,62,.548,.512,21,25,.840,9,52,61,108,15,4,23,38,107
694,WAS,2022,Isaiah Todd,20,12,0,74,7,26,.269,4,16,.250,3,10,.300,.346,2,6,.333,3,9,12,4,4,2,4,4,20
695,WAS,2022,Cassius Winston,23,7,0,39,4,11,.364,2,6,.333,2,5,.400,.455,4,4,1.000,0,1,1,7,0,0,3,9,14
696,WAS,2022,Jordan Schakel,23,4,0,30,1,11,.091,1,6,.167,0,5,.000,.136,2,2,1.000,2,6,8,0,1,0,1,0,5
697,WAS,2022,Vernon Carey Jr.,20,3,0,27,4,7,.571,0,0,,4,7,.571,.571,4,10,.400,5,2,7,0,1,1,2,3,12
698,WAS,2022,Brad Wanamaker,32,1,1,27,2,5,.400,0,0,,2,5,.400,.400,3,3,1.000,0,4,4,7,2,0,0,3,7
699,WAS,2022,Joel Ayayi,21,7,0,20,1,6,.167,0,1,.000,1,5,.200,.167,0,0,,1,2,3,4,0,0,0,0,2
700,WAS,2022,Craig Sword,28,3,0,19,3,4,.750,0,1,.000,3,3,1.000,.750,0,0,,0,0,0,1,4,0,1,7,6
701,WAS,2022,Greg Monroe,31,2,0,18,4,8,.500,0,0,,4,8,.500,.500,0,0,,7,3,10,1,1,1,2,2,8
702,WAS,2022,Alize Johnson,25,3,0,18,2,6,.333,0,2,.000,2,4,.500,.333,0,1,.000,5,7,12,0,0,0,3,0,4
703,WAS,2022,Tremont Waters,24,1,0,8,1,2,.500,0,0,,1,2,.500,.500,0,0,,0,0,0,0,1,0,0,2,2
704,WAS,2022,Jordan Goodwin,23,2,0,6,0,3,.000,0,1,.000,0,2,.000,.000,0,0,,0,1,1,0,0,0,0,1,0
705,WAS,2022,Jaime Echenique,24,1,0,3,0,0,,0,0,,0,0,,,0,0,,0,0,0,0,0,0,0,0,0
706,WAS,2021,Russell Westbrook,32,65,65,2369,544,1238,.439,86,273,.315,458,965,.475,.474,271,413,.656,109,641,750,763,89,23,312,190,1445
707,WAS,2021,Bradley Beal,27,60,60,2147,670,1382,.485,130,373,.349,540,1009,.535,.532,408,459,.889,72,211,283,265,69,22,187,140,1878
708,WAS,2021,Rui Hachimura,22,57,57,1797,310,648,.478,45,137,.328,265,511,.519,.513,124,161,.770,49,263,312,82,44,7,68,120,789
709,WAS,2021,Dāvis Bertāns,28,57,7,1464,193,478,.404,169,428,.395,24,50,.480,.581,100,115,.870,18,150,168,49,33,13,33,136,655
710,WAS,2021,Raul Neto,28,64,22,1403,209,447,.468,64,164,.390,145,283,.512,.539,75,85,.882,28,128,156,146,73,6,53,109,557
711,WAS,2021,Robin Lopez,32,71,9,1354,269,425,.633,5,18,.278,264,407,.649,.639,99,137,.723,141,131,272,55,15,44,75,109,642
712,WAS,2021,Deni Avdija,20,54,32,1257,130,312,.417,53,168,.315,77,144,.535,.502,29,45,.644,22,240,262,63,32,15,33,140,342
713,WAS,2021,Garrison Mathews,24,64,24,1038,97,237,.409,76,198,.384,21,39,.538,.570,84,95,.884,16,71,87,26,29,7,10,106,354
714,WAS,2021,Ish Smith,32,44,1,924,129,297,.434,18,49,.367,111,248,.448,.465,19,33,.576,22,128,150,172,32,13,41,62,295
715,WAS,2021,Alex Len,27,57,40,903,166,268,.619,5,19,.263,161,249,.647,.629,70,110,.636,78,171,249,46,19,58,47,117,407
716,WAS,2021,Isaac Bonga,21,40,8,432,30,81,.370,13,47,.277,17,34,.500,.451,5,8,.625,18,48,66,23,11,9,22,63,78
717,WAS,2021,Daniel Gafford,22,23,0,408,94,138,.681,0,0,,94,138,.681,.681,45,67,.672,50,78,128,12,15,41,19,44,233
718,WAS,2021,Moritz Wagner,23,25,13,375,62,122,.508,13,42,.310,49,80,.613,.561,41,52,.788,13,60,73,32,22,8,21,62,178
719,WAS,2021,Jerome Robinson,23,17,6,305,28,95,.295,11,42,.262,17,53,.321,.353,16,20,.800,4,34,38,25,12,6,19,31,83
720,WAS,2021,Troy Brown Jr.,21,21,0,287,33,89,.371,14,46,.304,19,43,.442,.449,10,15,.667,11,50,61,19,3,4,16,29,90
721,WAS,2021,Chandler Hutchison,24,18,1,282,34,85,.400,7,19,.368,27,66,.409,.441,19,23,.826,5,53,58,13,11,5,15,24,94
722,WAS,2021,Thomas Bryant,23,10,10,271,59,91,.648,9,21,.429,50,70,.714,.698,16,24,.667,18,43,61,15,4,8,11,31,143
723,WAS,2021,Anthony Gill,28,26,4,218,30,60,.500,7,24,.292,23,36,.639,.558,13,16,.813,16,35,51,11,10,4,8,27,80
724,WAS,2021,Cassius Winston,22,22,0,98,14,33,.424,8,17,.471,6,16,.375,.545,5,6,.833,0,9,9,12,2,1,5,8,41
725,WAS,2021,Jordan Bell,26,5,1,67,7,20,.350,0,2,.000,7,18,.389,.350,0,0,,6,13,19,5,3,3,3,5,14
726,WAS,2021,Anžejs Pasečņiks,25,1,0,6,0,1,.000,0,1,.000,0,0,,.000,0,0,,1,0,1,1,0,0,5,2,0
727,WAS,2020,Bradley Beal,26,57,57,2053,593,1303,.455,170,481,.353,423,822,.515,.520,385,457,.842,52,190,242,347,71,23,194,126,1741
728,WAS,2020,Ish Smith,31,68,23,1787,308,689,.447,62,169,.367,246,520,.473,.492,62,86,.721,30,189,219,334,59,30,95,106,740
729,WAS,2020,Troy Brown Jr.,20,69,22,1782,273,622,.439,61,179,.341,212,443,.479,.488,109,139,.784,76,307,383,178,85,7,79,132,716
730,WAS,2020,Dāvis Bertāns,27,54,4,1583,265,610,.434,200,472,.424,65,138,.471,.598,104,122,.852,35,210,245,92,37,33,59,139,834
731,WAS,2020,Rui Hachimura,21,48,48,1444,254,545,.466,25,87,.287,229,458,.500,.489,116,140,.829,78,216,294,87,37,8,53,105,649
732,WAS,2020,Isaac Bonga,20,66,49,1250,118,234,.504,25,71,.352,93,163,.571,.558,69,85,.812,71,151,222,76,45,22,58,156,330
733,WAS,2020,Thomas Bryant,22,46,36,1147,243,418,.581,37,91,.407,206,327,.630,.626,86,116,.741,98,233,331,83,25,49,53,103,609
734,WAS,2020,Isaiah Thomas,30,40,37,925,174,426,.408,78,189,.413,96,237,.405,.500,62,76,.816,11,57,68,146,13,6,77,77,488
735,WAS,2020,Moritz Wagner,22,45,5,835,145,266,.545,25,80,.313,120,186,.645,.592,78,95,.821,56,163,219,56,28,19,66,152,393
736,WAS,2020,Ian Mahinmi,33,38,35,808,104,210,.495,5,26,.192,99,184,.538,.507,70,113,.619,78,140,218,49,31,44,45,114,283
737,WAS,2020,Jordan McRae,28,29,4,654,133,317,.420,40,106,.377,93,211,.441,.483,64,83,.771,17,87,104,82,19,15,38,61,370
738,WAS,2020,Jerome Robinson,22,21,5,503,69,174,.397,30,86,.349,39,88,.443,.483,29,38,.763,8,61,69,41,15,9,23,57,197
739,WAS,2020,Shabazz Napier,28,20,10,488,74,173,.428,29,81,.358,45,92,.489,.512,54,65,.831,9,39,48,75,29,4,52,39,231
740,WAS,2020,Anžejs Pasečņiks,24,27,0,437,61,116,.526,0,3,.000,61,113,.540,.526,34,58,.586,42,65,107,18,9,12,24,75,156
741,WAS,2020,Gary Payton II,27,29,17,432,48,116,.414,13,46,.283,35,70,.500,.470,4,8,.500,26,54,80,48,33,7,20,54,113
742,WAS,2020,Admiral Schofield,22,33,2,368,35,92,.380,19,61,.311,16,31,.516,.484,10,15,.667,7,40,47,15,8,4,7,50,99
743,WAS,2020,Garrison Mathews,23,18,0,227,24,56,.429,19,46,.413,5,10,.500,.598,31,34,.912,6,18,24,10,8,1,8,32,98
744,WAS,2020,Johnathan Williams,24,15,6,180,19,34,.559,0,2,.000,19,32,.594,.559,7,13,.538,24,40,64,8,1,8,5,16,45
745,WAS,2020,C.J. Miles,32,10,0,161,19,59,.322,11,35,.314,8,24,.333,.415,15,20,.750,4,8,12,12,10,4,4,14,64
746,WAS,2020,Chris Chiozza,24,10,0,123,10,34,.294,7,16,.438,3,18,.167,.397,0,0,,0,15,15,28,10,2,9,12,27
747,WAS,2020,Jerian Grant,27,6,0,80,10,27,.370,2,8,.250,8,19,.421,.407,5,7,.714,2,4,6,9,1,1,3,11,27
748,WAS,2020,Justin Robinson,22,9,0,49,5,12,.417,3,5,.600,2,7,.286,.542,0,0,,1,4,5,7,0,1,3,2,13
749,WAS,2020,Jarrod Uthoff,26,3,0,39,6,11,.545,3,5,.600,3,6,.500,.682,0,0,,1,4,5,0,0,0,0,1,15
750,WAS,2019,Bradley Beal,25,82,82,3028,764,1609,.475,209,596,.351,555,1013,.548,.540,362,448,.808,89,322,411,448,121,58,224,226,2099
751,WAS,2019,Tomáš Satoranský,27,80,54,2164,257,530,.485,64,162,.395,193,368,.524,.545,131,160,.819,82,197,279,399,82,13,120,172,709
752,WAS,2019,Jeff Green,32,77,44,2097,326,687,.475,111,320,.347,215,367,.586,.555,183,206,.888,57,252,309,137,43,39,101,160,946
753,WAS,2019,Thomas Bryant,21,72,53,1496,309,502,.616,33,99,.333,276,403,.685,.648,107,137,.781,113,341,454,92,25,67,60,126,758
754,WAS,2019,Trevor Ariza,33,43,43,1465,208,509,.409,95,295,.322,113,214,.528,.502,94,121,.777,34,192,226,165,53,13,67,86,605
755,WAS,2019,Otto Porter Jr.,25,41,28,1191,202,442,.457,65,176,.369,137,266,.515,.531,49,64,.766,40,191,231,80,64,22,40,79,518
756,WAS,2019,John Wall,28,32,32,1104,245,552,.444,51,169,.302,194,383,.507,.490,122,175,.697,15,101,116,279,49,29,121,71,663
757,WAS,2019,Markieff Morris,29,34,15,883,143,328,.436,48,144,.333,95,184,.516,.509,57,73,.781,41,133,174,60,25,20,47,117,391
758,WAS,2019,Bobby Portis,23,28,22,768,157,357,.440,48,119,.403,109,238,.458,.507,38,47,.809,63,179,242,43,24,12,45,84,400
759,WAS,2019,Kelly Oubre Jr.,23,29,7,755,132,305,.433,41,132,.311,91,173,.526,.500,68,85,.800,24,105,129,20,27,20,30,71,373
760,WAS,2019,Chasson Randle,25,49,2,743,91,217,.419,46,115,.400,45,102,.441,.525,43,62,.694,10,46,56,97,25,3,43,91,271
761,WAS,2019,Troy Brown Jr.,19,52,10,730,97,234,.415,22,69,.319,75,165,.455,.462,32,47,.681,35,110,145,80,21,5,30,56,248
762,WAS,2019,Austin Rivers,26,29,2,683,76,194,.392,33,106,.311,43,88,.489,.477,25,46,.543,10,61,71,58,18,10,36,72,210
763,WAS,2019,Jabari Parker,23,25,0,682,149,285,.523,24,81,.296,125,204,.613,.565,52,76,.684,38,142,180,68,23,16,67,58,374
764,WAS,2019,Sam Dekker,24,38,0,619,98,208,.471,14,49,.286,84,159,.528,.505,20,36,.556,44,71,115,37,27,7,19,34,230
765,WAS,2019,Ian Mahinmi,32,34,6,498,47,104,.452,3,16,.188,44,88,.500,.466,42,61,.689,48,80,128,25,25,16,21,84,139
766,WAS,2019,Jordan McRae,27,27,0,333,61,130,.469,10,35,.286,51,95,.537,.508,28,35,.800,6,34,40,30,13,7,15,26,160
767,WAS,2019,Dwight Howard,33,9,9,230,43,69,.623,0,0,,43,69,.623,.623,29,48,.604,24,59,83,4,7,4,16,34,115
768,WAS,2019,Wesley Johnson,31,12,0,157,10,40,.250,6,26,.231,4,14,.286,.325,7,10,.700,2,16,18,7,2,5,6,18,33
769,WAS,2019,Jason Smith,32,12,1,130,15,37,.405,4,10,.400,11,27,.407,.459,10,12,.833,11,26,37,12,1,5,7,21,44
770,WAS,2019,Devin Robinson,23,7,0,95,19,32,.594,0,2,.000,19,30,.633,.594,9,14,.643,6,14,20,6,4,6,2,11,47
771,WAS,2019,Ron Baker,25,4,0,45,0,4,.000,0,4,.000,0,0,,.000,0,0,,0,4,4,2,1,1,2,2,0
772,WAS,2019,Gary Payton II,26,3,0,16,5,8,.625,1,2,.500,4,6,.667,.688,0,0,,1,1,2,4,3,1,1,2,11
773,WAS,2019,John Jenkins,27,4,0,14,2,2,1.000,2,2,1.000,0,0,,1.500,0,0,,0,1,1,1,0,0,0,0,6
774,WAS,2019,Okaro White,26,3,0,6,0,2,.000,0,2,.000,0,0,,.000,0,0,,1,1,2,0,0,0,0,0,0
775,WAS,2018,Bradley Beal,24,82,82,2977,683,1484,.460,199,530,.375,484,954,.507,.527,292,369,.791,61,302,363,373,96,36,214,160,1857
776,WAS,2018,Otto Porter Jr.,24,77,77,2432,445,885,.503,138,313,.441,307,572,.537,.581,106,128,.828,103,389,492,157,116,41,75,151,1134
777,WAS,2018,Kelly Oubre Jr.,22,81,11,2231,318,790,.403,126,369,.341,192,421,.456,.482,191,233,.820,59,304,363,98,80,35,90,234,953
778,WAS,2018,Marcin Gortat,33,82,82,2075,290,560,.518,0,0,,290,560,.518,.518,110,163,.675,181,442,623,151,40,61,99,175,690
779,WAS,2018,Markieff Morris,28,73,73,1968,330,687,.480,76,207,.367,254,480,.529,.536,105,128,.820,75,334,409,142,56,38,127,216,841
780,WAS,2018,Tomáš Satoranský,26,73,30,1643,201,384,.523,47,101,.465,154,283,.544,.585,75,96,.781,72,161,233,286,52,15,83,131,524
781,WAS,2018,John Wall,27,41,41,1410,280,667,.420,62,167,.371,218,500,.436,.466,175,241,.726,22,128,150,393,57,45,158,80,797
782,WAS,2018,Mike Scott,29,76,1,1406,276,524,.527,66,163,.405,210,361,.582,.590,50,76,.658,50,197,247,80,23,10,79,148,668
783,WAS,2018,Ian Mahinmi,31,77,0,1145,138,248,.556,0,2,.000,138,246,.561,.556,90,128,.703,135,177,312,53,38,42,100,230,366
784,WAS,2018,Jodie Meeks,30,77,0,1119,157,393,.399,72,210,.343,85,183,.464,.491,101,117,.863,15,111,126,70,29,4,37,55,487
785,WAS,2018,Tim Frazier,27,59,11,838,68,172,.395,17,56,.304,51,116,.440,.445,23,30,.767,18,97,115,194,47,7,57,97,176
786,WAS,2018,Jason Smith,31,33,2,285,45,115,.391,4,32,.125,41,83,.494,.409,19,21,.905,18,35,53,14,3,13,16,44,113
787,WAS,2018,Ramon Sessions,31,15,0,225,25,64,.391,6,15,.400,19,49,.388,.438,32,42,.762,5,15,20,50,7,1,15,15,88
788,WAS,2018,Chris McCullough,22,19,0,90,18,42,.429,1,8,.125,17,34,.500,.440,9,14,.643,7,18,25,4,0,5,2,8,46
789,WAS,2018,Devin Robinson,22,1,0,13,1,3,.333,0,0,,1,3,.333,.333,0,0,,2,3,5,0,1,0,0,2,2
790,WAS,2017,John Wall,26,78,78,2836,647,1435,.451,89,272,.327,558,1163,.480,.482,422,527,.801,59,267,326,831,157,49,322,151,1805
791,WAS,2017,Bradley Beal,23,77,77,2684,637,1322,.482,223,552,.404,414,770,.538,.566,282,342,.825,53,187,240,267,83,21,156,169,1779
792,WAS,2017,Otto Porter Jr.,23,80,80,2605,414,803,.516,148,341,.434,266,462,.576,.608,99,119,.832,118,396,514,121,116,42,44,193,1075
793,WAS,2017,Marcin Gortat,32,82,82,2556,390,674,.579,0,2,.000,390,672,.580,.579,103,159,.648,238,611,849,121,40,61,119,213,883
794,WAS,2017,Markieff Morris,27,76,76,2374,406,889,.457,71,196,.362,335,693,.483,.497,180,215,.837,107,386,493,126,82,42,129,254,1063
795,WAS,2017,Kelly Oubre Jr.,21,79,5,1605,186,442,.421,54,188,.287,132,254,.520,.482,75,99,.758,61,200,261,47,58,17,50,195,501
796,WAS,2017,Jason Smith,30,74,3,1068,174,329,.529,37,78,.474,137,251,.546,.585,35,51,.686,64,194,258,37,21,54,58,168,420
797,WAS,2017,Tomáš Satoranský,25,57,3,719,61,147,.415,9,37,.243,52,110,.473,.446,23,33,.697,25,58,83,92,26,6,38,60,154
798,WAS,2017,Trey Burke,24,57,0,703,116,255,.455,31,70,.443,85,185,.459,.516,22,29,.759,7,40,47,100,11,5,48,54,285
799,WAS,2017,Bojan Bogdanović,27,26,0,601,107,234,.457,45,115,.391,62,119,.521,.553,71,76,.934,14,66,80,21,10,4,38,47,330
800,WAS,2017,Marcus Thornton,29,33,1,575,84,210,.400,28,80,.350,56,130,.431,.467,23,27,.852,22,54,76,41,19,3,25,48,219
801,WAS,2017,Ian Mahinmi,30,31,0,555,65,111,.586,0,0,,65,111,.586,.586,43,75,.573,47,103,150,19,33,24,34,90,173
802,WAS,2017,Brandon Jennings,27,23,2,374,29,106,.274,11,52,.212,18,54,.333,.325,12,17,.706,8,36,44,108,15,0,22,32,81
803,WAS,2017,Sheldon Mac,24,30,3,287,30,75,.400,7,30,.233,23,45,.511,.447,23,27,.852,4,30,34,15,8,2,5,17,90
804,WAS,2017,Andrew Nicholson,27,28,0,231,30,77,.390,3,16,.188,27,61,.443,.409,7,12,.583,11,23,34,7,11,6,11,37,70
805,WAS,2017,Daniel Ochefu,23,19,0,75,12,27,.444,0,0,,12,27,.444,.444,0,2,.000,5,17,22,3,2,0,3,17,24
806,WAS,2017,Chris McCullough,21,2,0,8,0,1,.000,0,1,.000,0,0,,.000,1,2,.500,0,2,2,0,1,0,1,0,1
807,WAS,2017,Danuel House Jr.,23,1,0,1,0,0,,0,0,,0,0,,,0,0,,0,1,1,0,0,0,0,0,0
808,WAS,2016,John Wall,25,77,77,2784,572,1349,.424,115,328,.351,457,1021,.448,.467,272,344,.791,42,337,379,789,145,59,318,159,1531
809,WAS,2016,Otto Porter Jr.,22,75,73,2276,339,717,.473,98,267,.367,241,450,.536,.541,95,126,.754,97,294,391,120,105,32,70,163,871
810,WAS,2016,Marcin Gortat,31,75,74,2256,433,764,.567,0,1,.000,433,763,.567,.567,146,207,.705,222,519,741,106,47,96,121,193,1012
811,WAS,2016,Jared Dudley,30,81,41,2098,233,487,.478,100,238,.420,133,249,.534,.581,72,98,.735,54,232,286,170,75,18,80,190,638
812,WAS,2016,Garrett Temple,29,80,43,1951,201,505,.398,89,258,.345,112,247,.453,.486,91,125,.728,36,176,212,140,69,18,64,195,582
813,WAS,2016,Bradley Beal,22,55,35,1708,359,799,.449,105,271,.387,254,528,.481,.515,135,176,.767,41,147,188,162,54,11,112,117,958
814,WAS,2016,Ramon Sessions,29,82,5,1667,280,592,.473,36,111,.324,244,481,.507,.503,214,283,.756,25,178,203,239,46,5,115,102,810
815,WAS,2016,Nenê,33,57,11,1094,209,384,.544,0,3,.000,209,381,.549,.544,107,185,.578,52,207,259,97,54,26,76,156,525
816,WAS,2016,Gary Neal,31,40,2,807,151,325,.465,41,100,.410,110,225,.489,.528,47,55,.855,11,72,83,47,20,1,29,55,390
817,WAS,2016,Markieff Morris,26,27,21,712,134,287,.467,25,79,.316,109,208,.524,.510,42,55,.764,30,128,158,37,25,17,45,80,335
818,WAS,2016,Kelly Oubre Jr.,20,63,9,671,90,211,.427,25,79,.316,65,132,.492,.486,31,49,.633,25,108,133,13,22,7,34,100,236
819,WAS,2016,Kris Humphries,30,28,14,466,64,158,.405,23,67,.343,41,91,.451,.478,29,31,.935,26,89,115,16,3,14,20,42,180
820,WAS,2016,Drew Gooden,34,30,0,305,33,103,.320,7,41,.171,26,62,.419,.354,9,14,.643,28,57,85,13,8,11,13,40,82
821,WAS,2016,Marcus Thornton,28,14,2,224,42,107,.393,18,54,.333,24,53,.453,.477,16,21,.762,7,28,35,19,13,1,11,17,118
822,WAS,2016,DeJuan Blair,26,29,0,218,28,68,.412,0,1,.000,28,67,.418,.412,5,13,.385,20,37,57,11,8,2,15,53,61
823,WAS,2016,Alan Anderson,33,13,0,192,21,59,.356,12,37,.324,9,22,.409,.458,11,15,.733,1,26,27,14,4,1,2,25,65
824,WAS,2016,Jarell Eddie,24,26,0,147,20,65,.308,15,47,.319,5,18,.278,.423,8,8,1.000,2,21,23,5,5,1,1,5,63
825,WAS,2016,J.J. Hickson,27,15,0,131,25,46,.543,0,1,.000,25,45,.556,.543,19,44,.432,17,28,45,7,5,2,9,12,69
826,WAS,2016,Ryan Hollins,31,5,3,48,4,7,.571,0,0,,4,7,.571,.571,0,0,,7,4,11,0,0,1,3,4,8
827,WAS,2015,John Wall,24,79,79,2837,519,1166,.445,65,217,.300,454,949,.478,.473,284,362,.785,36,330,366,792,138,45,304,180,1387
828,WAS,2015,Marcin Gortat,30,82,82,2453,439,775,.566,0,3,.000,439,772,.569,.566,123,175,.703,180,537,717,97,49,110,100,191,1001
829,WAS,2015,Bradley Beal,21,63,59,2107,363,851,.427,106,259,.409,257,592,.434,.489,130,166,.783,57,184,241,194,76,18,123,136,962
830,WAS,2015,Paul Pierce,37,73,73,1914,293,656,.447,118,303,.389,175,353,.496,.537,164,210,.781,45,249,294,144,46,24,92,160,868
831,WAS,2015,Nenê,32,67,58,1693,307,601,.511,1,5,.200,306,596,.513,.512,122,202,.604,84,261,345,123,66,22,124,180,737
832,WAS,2015,Rasual Butler,35,75,1,1505,218,517,.422,91,235,.387,127,282,.450,.510,53,67,.791,27,170,197,63,29,22,48,98,580
833,WAS,2015,Otto Porter Jr.,21,74,13,1432,176,391,.450,35,104,.337,141,287,.491,.495,58,79,.734,70,151,221,65,44,30,52,97,445
834,WAS,2015,Kris Humphries,29,64,17,1345,211,446,.473,0,7,.000,211,439,.481,.473,87,117,.744,118,298,416,57,34,25,46,130,509
835,WAS,2015,Kevin Séraphin,25,79,0,1235,231,450,.513,0,2,.000,231,448,.516,.513,58,82,.707,87,201,288,59,10,59,98,197,520
836,WAS,2015,Drew Gooden,33,51,7,864,110,276,.399,23,59,.390,87,217,.401,.440,34,44,.773,72,151,223,49,21,9,28,91,277
837,WAS,2015,Garrett Temple,28,52,18,735,68,170,.400,33,88,.375,35,82,.427,.497,35,48,.729,24,66,90,56,42,9,34,76,204
838,WAS,2015,Andre Miller,38,51,0,631,77,142,.542,1,8,.125,76,134,.567,.546,28,39,.718,21,56,77,143,14,2,46,56,183
839,WAS,2015,Ramon Sessions,28,28,3,546,62,151,.411,13,32,.406,49,119,.412,.454,69,85,.812,10,65,75,86,16,0,35,28,206
840,WAS,2015,Martell Webster,28,32,0,352,24,91,.264,10,43,.233,14,48,.292,.319,48,64,.750,10,36,46,17,7,1,22,24,106
841,WAS,2015,DeJuan Blair,25,29,0,180,26,57,.456,0,0,,26,57,.456,.456,4,6,.667,16,40,56,3,7,1,13,41,56
842,WAS,2015,Will Bynum,32,7,0,67,10,31,.323,0,9,.000,10,22,.455,.323,2,4,.500,2,4,6,18,1,1,8,9,22
843,WAS,2015,Glen Rice Jr.,24,5,0,43,3,15,.200,1,7,.143,2,8,.250,.233,4,6,.667,2,2,4,2,0,0,2,11,11
844,WAS,2015,Toure' Murry,25,4,0,17,2,4,.500,0,0,,2,4,.500,.500,2,2,1.000,1,0,1,1,1,0,4,2,6
845,WAS,2014,John Wall,23,82,82,2980,579,1337,.433,108,308,.351,471,1029,.458,.473,317,394,.805,38,295,333,721,149,40,295,219,1583
846,WAS,2014,Trevor Ariza,28,77,77,2723,389,853,.456,180,442,.407,209,411,.509,.562,149,193,.772,99,376,475,191,126,20,132,179,1107
847,WAS,2014,Marcin Gortat,29,81,80,2655,455,840,.542,1,1,1.000,454,839,.541,.542,157,229,.686,202,565,767,138,41,121,126,201,1068
848,WAS,2014,Bradley Beal,20,73,73,2530,481,1149,.419,138,343,.402,343,806,.426,.479,149,189,.788,54,219,273,243,71,18,128,153,1249
849,WAS,2014,Martell Webster,27,78,13,2157,254,587,.433,146,372,.392,108,215,.502,.557,105,125,.840,38,184,222,97,41,15,58,150,759
850,WAS,2014,Nenê,31,53,37,1560,299,594,.503,1,5,.200,298,589,.506,.504,155,266,.583,65,229,294,153,64,47,117,164,754
851,WAS,2014,Trevor Booker,26,72,45,1553,222,403,.551,0,2,.000,222,401,.554,.551,47,76,.618,149,230,379,64,41,45,58,131,491
852,WAS,2014,Garrett Temple,27,75,0,638,51,141,.362,6,29,.207,45,112,.402,.383,30,43,.698,21,47,68,72,35,11,42,72,138
853,WAS,2014,Kevin Séraphin,24,53,1,578,111,220,.505,0,0,,111,220,.505,.505,27,31,.871,53,75,128,17,3,26,41,103,249
854,WAS,2014,Al Harrington,33,34,0,511,82,207,.396,34,100,.340,48,107,.449,.478,27,35,.771,15,65,80,28,14,0,34,72,225
855,WAS,2014,Jan Veselý,23,33,1,470,48,92,.522,0,0,,48,92,.522,.522,8,30,.267,53,60,113,10,26,19,22,64,104
856,WAS,2014,Andre Miller,37,28,0,412,40,87,.460,2,3,.667,38,84,.452,.471,25,30,.833,12,45,57,97,19,2,28,43,107
857,WAS,2014,Drew Gooden,32,22,0,395,76,143,.531,7,17,.412,69,126,.548,.556,24,27,.889,37,77,114,15,10,7,17,53,183
858,WAS,2014,Otto Porter Jr.,20,37,0,319,33,91,.363,4,21,.190,29,70,.414,.385,8,12,.667,21,36,57,10,8,1,14,26,78
859,WAS,2014,Chris Singleton,24,25,0,250,25,67,.373,7,19,.368,18,48,.375,.425,18,25,.720,18,37,55,6,9,3,17,25,75
860,WAS,2014,Eric Maynor,26,23,0,215,21,72,.292,8,25,.320,13,47,.277,.347,2,3,.667,7,17,24,40,5,1,17,13,52
861,WAS,2014,Glen Rice Jr.,23,11,1,109,11,37,.297,5,17,.294,6,20,.300,.365,5,7,.714,4,16,20,7,6,1,9,7,32
862,WAS,2013,Martell Webster,26,76,62,2200,281,636,.442,139,329,.422,142,307,.463,.551,168,198,.848,53,241,294,143,49,17,90,166,869
863,WAS,2013,Emeka Okafor,30,79,77,2052,328,687,.477,0,0,,328,687,.477,.477,109,191,.571,199,493,692,93,45,77,107,145,765
864,WAS,2013,Bradley Beal,19,56,46,1745,282,687,.410,91,236,.386,191,451,.424,.477,125,159,.786,43,168,211,137,50,29,90,113,780
865,WAS,2013,Kevin Séraphin,23,79,8,1721,330,716,.461,0,0,,330,716,.461,.461,61,88,.693,107,239,346,57,24,59,130,211,721
866,WAS,2013,Nenê,30,61,49,1659,285,594,.480,0,1,.000,285,593,.481,.480,196,269,.729,101,306,407,177,55,37,139,171,766
867,WAS,2013,John Wall,22,49,42,1602,324,735,.441,12,45,.267,312,690,.452,.449,246,306,.804,35,161,196,373,65,37,157,117,906
868,WAS,2013,Trevor Ariza,27,56,15,1471,188,451,.417,76,209,.364,112,242,.463,.501,78,95,.821,44,222,266,113,72,20,84,72,530
869,WAS,2013,A.J. Price,26,57,22,1278,161,413,.390,70,200,.350,91,213,.427,.475,49,62,.790,20,94,114,205,33,3,64,73,441
870,WAS,2013,Garrett Temple,26,51,36,1156,105,258,.407,26,80,.325,79,178,.444,.457,26,37,.703,29,94,123,115,50,17,61,94,262
871,WAS,2013,Jordan Crawford,24,43,12,1127,211,508,.415,59,171,.345,152,337,.451,.473,87,106,.821,31,104,135,157,27,5,97,61,568
872,WAS,2013,Chris Singleton,23,57,11,924,92,241,.382,7,36,.194,85,205,.415,.396,40,70,.571,51,133,184,37,38,24,45,124,231
873,WAS,2013,Trevor Booker,25,48,14,887,108,220,.491,0,5,.000,108,215,.502,.491,40,72,.556,98,141,239,40,32,16,31,95,256
874,WAS,2013,Cartier Martin,28,41,3,694,96,252,.381,58,146,.397,38,106,.358,.496,20,28,.714,11,89,100,20,19,6,32,58,270
875,WAS,2013,Jan Veselý,22,51,4,601,57,114,.500,0,1,.000,57,113,.504,.500,12,39,.308,43,79,122,28,15,17,27,107,126
876,WAS,2013,Shaun Livingston,27,17,4,320,24,66,.364,0,3,.000,24,63,.381,.364,15,15,1.000,2,35,37,38,11,2,17,22,63
877,WAS,2013,Shelvin Mack,22,7,2,141,16,40,.400,4,13,.308,12,27,.444,.450,1,2,.500,3,13,16,23,6,0,8,10,37
878,WAS,2013,Earl Barron,31,11,1,122,13,37,.351,0,0,,13,37,.351,.351,2,5,.400,16,27,43,3,5,5,10,23,28
879,WAS,2013,Jannero Pargo,33,7,0,102,8,32,.250,3,20,.150,5,12,.417,.297,2,2,1.000,0,6,6,14,0,1,8,8,21
880,WAS,2013,Jason Collins,34,6,2,54,1,6,.167,0,0,,1,6,.167,.167,2,2,1.000,1,7,8,2,2,4,2,11,4
881,WAS,2012,John Wall,21,66,66,2386,378,894,.423,3,42,.071,375,852,.440,.424,317,402,.789,48,252,300,530,95,57,255,137,1076
882,WAS,2012,Jordan Crawford,23,64,32,1753,349,872,.400,79,273,.289,270,599,.451,.446,161,203,.793,44,124,168,190,59,5,141,111,938
883,WAS,2012,Chris Singleton,22,66,51,1431,116,312,.372,44,127,.346,72,185,.389,.442,30,44,.682,43,190,233,49,70,30,38,176,306
884,WAS,2012,Trevor Booker,24,50,32,1261,181,341,.531,1,2,.500,180,339,.531,.532,56,93,.602,119,206,325,40,48,43,58,138,419
885,WAS,2012,Nick Young,26,40,32,1211,240,591,.406,73,197,.371,167,394,.424,.468,112,130,.862,20,77,97,46,30,11,59,90,665
886,WAS,2012,Kevin Séraphin,22,57,21,1176,203,382,.531,0,1,.000,203,381,.533,.531,47,70,.671,103,177,280,33,19,76,66,133,453
887,WAS,2012,JaVale McGee,24,41,40,1124,214,400,.535,0,0,,214,400,.535,.535,58,116,.500,127,235,362,25,25,101,68,118,486
888,WAS,2012,Jan Veselý,21,57,20,1078,117,218,.537,0,1,.000,117,217,.539,.537,33,62,.532,101,148,249,47,39,32,60,156,267
889,WAS,2012,Shelvin Mack,21,64,0,779,88,220,.400,12,42,.286,76,178,.427,.427,42,59,.712,12,80,92,131,28,2,48,50,230
890,WAS,2012,Rashard Lewis,32,28,15,729,85,221,.385,16,67,.239,69,154,.448,.421,31,37,.838,34,75,109,27,23,10,32,49,217
891,WAS,2012,Roger Mason,31,52,0,697,103,258,.399,59,154,.383,44,104,.423,.514,21,27,.778,7,62,69,47,13,5,32,33,286
892,WAS,2012,Andray Blatche,25,26,13,626,93,245,.380,2,7,.286,91,238,.382,.384,33,49,.673,42,108,150,28,20,17,37,54,221
893,WAS,2012,Cartier Martin,27,17,2,391,59,134,.440,29,75,.387,30,59,.508,.549,11,19,.579,12,46,58,10,11,2,13,35,158
894,WAS,2012,Maurice Evans,33,24,0,343,45,112,.402,17,45,.378,28,67,.418,.478,10,13,.769,8,16,24,9,14,0,10,36,117
895,WAS,2012,Nenê,29,11,6,284,68,112,.607,0,2,.000,68,110,.618,.607,23,35,.657,20,63,83,19,6,13,19,26,159
896,WAS,2012,James Singleton,30,12,0,262,41,75,.547,2,9,.222,39,66,.591,.560,14,15,.933,25,56,81,15,9,8,10,27,98
897,WAS,2012,Brian Cook,31,16,0,155,20,49,.408,5,23,.217,15,26,.577,.459,5,6,.833,6,34,40,8,4,1,7,22,50
898,WAS,2012,Morris Almond,26,4,0,67,6,17,.353,1,3,.333,5,14,.357,.382,1,3,.333,1,7,8,2,7,0,1,6,14
899,WAS,2012,Ronny Turiaf,29,4,0,58,3,3,1.000,0,0,,3,3,1.000,1.000,0,0,,1,11,12,5,6,3,6,7,6
900,WAS,2012,Edwin Ubiles,25,4,0,52,5,18,.278,1,5,.200,4,13,.308,.306,3,3,1.000,2,8,10,1,1,1,1,1,14
901,WAS,2012,Hamady N'Diaye,25,3,0,3,0,1,.000,0,0,,0,1,.000,.000,0,0,,0,0,0,0,0,0,0,0,0
902,WAS,2011,John Wall,20,69,64,2606,398,972,.409,34,115,.296,364,857,.425,.427,301,393,.766,35,282,317,574,121,35,261,175,1131
903,WAS,2011,JaVale McGee,23,79,75,2193,332,604,.550,0,3,.000,332,601,.552,.550,134,230,.583,223,411,634,38,41,193,102,232,798
904,WAS,2011,Andray Blatche,24,64,63,2172,426,957,.445,4,18,.222,422,939,.449,.447,220,283,.777,183,343,526,144,98,51,172,182,1076
905,WAS,2011,Nick Young,25,64,40,2034,412,935,.441,105,271,.387,307,664,.462,.497,186,228,.816,26,148,174,75,45,17,90,144,1115
906,WAS,2011,Kirk Hinrich,30,48,29,1471,198,438,.452,43,112,.384,155,326,.475,.501,92,105,.876,14,115,129,210,56,10,84,119,531
907,WAS,2011,Yi Jianlian,23,63,11,1112,145,347,.418,3,13,.231,142,334,.425,.422,62,91,.681,79,169,248,25,27,32,51,115,355
908,WAS,2011,Al Thornton,27,49,23,1069,154,327,.471,4,25,.160,150,302,.497,.477,81,107,.757,46,110,156,51,28,9,44,103,393
909,WAS,2011,Trevor Booker,23,65,14,1063,139,253,.549,0,1,.000,139,252,.552,.549,68,101,.673,98,153,251,35,29,42,38,115,346
910,WAS,2011,Rashard Lewis,31,32,27,1014,139,312,.446,43,124,.347,96,188,.511,.514,43,51,.843,48,136,184,63,30,20,52,96,364
911,WAS,2011,Jordan Crawford,22,26,18,867,165,423,.390,24,101,.238,141,322,.438,.418,69,78,.885,22,55,77,102,36,3,68,50,423
912,WAS,2011,Gilbert Arenas,29,21,14,726,130,330,.394,47,145,.324,83,185,.449,.465,56,67,.836,6,64,70,117,30,12,71,76,363
913,WAS,2011,Maurice Evans,32,26,12,712,98,223,.439,27,78,.346,71,145,.490,.500,28,30,.933,29,43,72,15,18,9,18,55,251
914,WAS,2011,Kevin Séraphin,21,58,1,635,66,147,.449,0,0,,66,147,.449,.449,22,31,.710,80,72,152,10,17,28,42,126,154
915,WAS,2011,Cartier Martin,26,52,1,542,71,182,.390,39,99,.394,32,83,.386,.497,28,40,.700,20,54,74,18,18,6,16,52,209
916,WAS,2011,Hilton Armstrong,26,41,2,412,31,64,.484,1,3,.333,30,61,.492,.492,14,23,.609,39,75,114,10,15,16,25,75,77
917,WAS,2011,Josh Howard,30,18,10,409,58,162,.358,7,29,.241,51,133,.383,.380,29,47,.617,18,56,74,24,13,5,20,34,152
918,WAS,2011,Othyus Jeffers,25,16,1,314,30,62,.484,1,4,.250,29,58,.500,.492,30,46,.652,25,40,65,19,17,0,13,31,91
919,WAS,2011,Mustafa Shakur,26,22,0,159,21,59,.356,1,10,.100,20,49,.408,.364,8,15,.533,7,15,22,25,5,3,18,15,51
920,WAS,2011,Alonzo Gee,23,11,5,127,12,27,.444,0,2,.000,12,25,.480,.444,8,12,.667,11,11,22,5,7,0,8,10,32
921,WAS,2011,Larry Owens,28,5,0,112,12,26,.462,5,10,.500,7,16,.438,.558,2,5,.400,1,10,11,7,7,5,5,14,31
922,WAS,2011,Hamady N'Diaye,24,16,0,80,4,5,.800,0,0,,4,5,.800,.800,6,12,.500,2,5,7,0,2,5,3,18,14
923,WAS,2011,Lester Hudson,26,11,0,73,6,24,.250,4,15,.267,2,9,.222,.333,2,4,.500,1,4,5,17,4,1,7,10,18
924,WAS,2011,Mike Bibby,32,2,0,29,1,9,.111,0,4,.000,1,5,.200,.111,0,0,,0,3,3,8,1,0,1,3,2
925,WAS,2010,Andray Blatche,23,81,36,2256,478,999,.478,13,44,.295,465,955,.487,.485,174,234,.744,158,351,509,170,85,71,182,218,1143
926,WAS,2010,Caron Butler,29,47,47,1853,293,694,.422,25,95,.263,268,599,.447,.440,185,211,.877,68,248,316,107,68,15,113,126,796
927,WAS,2010,Mike Miller,29,54,50,1805,217,433,.501,82,171,.480,135,262,.515,.596,70,85,.824,55,281,336,212,39,12,115,131,586
928,WAS,2010,Randy Foye,26,70,38,1667,256,619,.414,63,182,.346,193,437,.442,.464,129,145,.890,16,114,130,228,33,10,94,123,704
929,WAS,2010,Brendan Haywood,30,49,48,1614,188,335,.561,0,0,,188,335,.561,.561,102,158,.646,200,307,507,18,18,101,67,145,478
930,WAS,2010,Antawn Jamison,33,41,41,1595,315,700,.450,58,168,.345,257,532,.483,.491,152,217,.700,99,263,362,52,43,9,61,112,840
931,WAS,2010,Nick Young,24,74,23,1421,233,558,.418,69,170,.406,164,388,.423,.479,104,130,.800,20,82,102,48,28,8,56,147,639
932,WAS,2010,Gilbert Arenas,28,32,32,1169,253,616,.411,63,181,.348,190,435,.437,.462,153,207,.739,17,116,133,230,41,9,117,95,722
933,WAS,2010,Earl Boykins,33,67,1,1117,172,403,.427,19,60,.317,153,343,.446,.450,77,89,.865,17,58,75,171,24,3,69,48,440
934,WAS,2010,JaVale McGee,22,60,19,968,156,307,.508,0,1,.000,156,306,.510,.508,74,116,.638,88,155,243,14,16,101,51,122,386
935,WAS,2010,James Singleton,28,32,3,766,73,190,.384,2,15,.133,71,175,.406,.389,47,56,.839,91,130,221,22,17,36,37,82,195
936,WAS,2010,Al Thornton,26,24,16,674,100,216,.463,6,17,.353,94,199,.472,.477,50,72,.694,31,71,102,29,20,13,36,62,256
937,WAS,2010,Shaun Livingston,24,26,18,666,99,185,.535,0,4,.000,99,181,.547,.535,42,48,.875,12,46,58,116,12,9,50,52,240
938,WAS,2010,Fabricio Oberto,34,57,20,650,35,56,.625,0,0,,35,56,.625,.625,13,17,.765,34,71,105,51,11,9,36,121,83
939,WAS,2010,DeShawn Stevenson,28,40,13,616,29,103,.282,11,62,.177,18,41,.439,.335,18,25,.720,7,58,65,44,11,5,24,51,87
940,WAS,2010,Quinton Ross,28,25,0,261,17,55,.309,1,8,.125,16,47,.340,.318,3,6,.500,6,16,22,5,6,2,8,35,38
941,WAS,2010,Dominic McGuire,24,41,0,240,15,40,.375,0,0,,15,40,.375,.375,0,5,.000,17,44,61,8,4,3,10,32,30
942,WAS,2010,Alonzo Gee,22,11,2,182,28,59,.475,7,9,.778,21,50,.420,.534,18,29,.621,15,18,33,7,7,1,10,13,81
943,WAS,2010,Cartier Martin,25,8,0,114,18,48,.375,7,18,.389,11,30,.367,.448,8,9,.889,8,13,21,7,3,1,6,12,51
944,WAS,2010,Josh Howard,29,4,3,91,20,46,.435,3,11,.273,17,35,.486,.467,15,20,.750,4,9,13,4,3,2,3,13,58
945,WAS,2010,Mike James,34,4,0,46,6,20,.300,2,6,.333,4,14,.286,.350,4,8,.500,1,2,3,5,3,0,5,3,18
946,WAS,2010,Cedric Jackson,23,4,0,39,4,11,.364,1,3,.333,3,8,.375,.409,3,4,.750,1,2,3,6,0,0,8,5,12
947,WAS,2010,Mike Harris,26,5,0,14,1,3,.333,0,0,,1,3,.333,.333,2,2,1.000,1,3,4,0,1,0,0,4,4
948,WAS,2010,Paul Davis,25,2,0,8,2,4,.500,0,0,,2,4,.500,.500,1,2,.500,0,0,0,3,0,1,0,0,5
949,WAS,2009,Antawn Jamison,32,81,81,3096,674,1441,.468,112,319,.351,562,1122,.501,.507,341,452,.754,196,525,721,153,95,25,125,218,1801
950,WAS,2009,Caron Butler,28,67,67,2585,491,1085,.453,65,210,.310,426,875,.487,.482,345,402,.858,118,296,414,290,106,20,210,165,1392
951,WAS,2009,Dominic McGuire,23,79,57,2072,140,324,.432,2,4,.500,138,320,.431,.435,74,102,.725,113,315,428,198,62,74,92,153,356
952,WAS,2009,Nick Young,23,82,5,1837,336,756,.444,56,164,.341,280,592,.473,.481,164,193,.850,31,119,150,95,39,20,92,140,892
953,WAS,2009,Andray Blatche,22,71,36,1703,297,630,.471,5,21,.238,292,609,.479,.475,114,162,.704,126,252,378,118,53,74,117,211,713
954,WAS,2009,Mike James,33,53,50,1575,189,489,.387,66,180,.367,123,309,.398,.454,67,80,.838,24,102,126,193,42,6,91,101,511
955,WAS,2009,Darius Songaila,30,77,29,1521,243,457,.532,0,1,.000,243,456,.533,.532,80,90,.889,75,152,227,94,64,20,74,200,566
956,WAS,2009,JaVale McGee,21,75,14,1143,191,387,.494,0,0,,191,387,.494,.494,107,162,.660,120,174,294,23,33,75,61,155,489
957,WAS,2009,Javaris Crittenton,21,56,10,1130,124,270,.459,2,14,.143,122,256,.477,.463,48,81,.593,53,107,160,145,39,6,79,96,298
958,WAS,2009,DeShawn Stevenson,27,32,25,886,72,231,.312,35,129,.271,37,102,.363,.387,32,60,.533,11,65,76,98,21,2,32,43,211
959,WAS,2009,Juan Dixon,30,50,6,816,101,256,.395,25,75,.333,76,181,.420,.443,34,39,.872,8,59,67,118,35,6,70,74,261
960,WAS,2009,Etan Thomas,30,26,7,306,32,66,.485,0,0,,32,66,.485,.485,16,23,.696,25,41,66,6,3,18,18,35,80
961,WAS,2009,Antonio Daniels,33,13,5,288,18,45,.400,5,11,.455,13,34,.382,.456,25,33,.758,0,22,22,47,7,0,13,14,66
962,WAS,2009,Oleksiy Pecherov,23,32,0,277,39,101,.386,14,43,.326,25,58,.431,.455,24,29,.828,35,41,76,2,6,3,10,34,116
963,WAS,2009,Dee Brown,24,17,11,233,17,44,.386,6,20,.300,11,24,.458,.455,1,3,.333,7,21,28,33,10,0,14,22,41
964,WAS,2009,Brendan Haywood,29,6,5,175,24,50,.480,0,0,,24,50,.480,.480,10,21,.476,13,31,44,8,4,15,9,14,58
965,WAS,2009,Gilbert Arenas,27,2,2,63,6,23,.261,2,7,.286,4,16,.250,.304,12,16,.750,1,8,9,20,0,1,1,4,26
966,MIA,2024,Bam Adebayo,26,71,71,2416,530,1017,.521,15,42,.357,515,975,.528,.529,292,387,.755,159,578,737,278,81,66,162,159,1367
967,MIA,2024,Jaime Jaquez Jr.,22,75,20,2113,341,697,.489,65,202,.322,276,495,.558,.536,142,175,.811,82,203,285,195,77,20,110,167,889
968,MIA,2024,Jimmy Butler,34,60,60,2042,396,793,.499,60,145,.414,336,648,.519,.537,394,459,.858,105,213,318,298,79,17,102,68,1246
969,MIA,2024,Duncan Robinson,29,68,36,1905,304,675,.450,187,473,.395,117,202,.579,.589,80,90,.889,15,158,173,192,46,16,95,163,875
970,MIA,2024,Caleb Martin,28,64,23,1756,241,559,.431,81,232,.349,160,327,.489,.504,77,99,.778,74,207,281,143,47,29,77,126,640
971,MIA,2024,Tyler Herro,24,42,40,1407,324,735,.441,132,333,.396,192,402,.478,.531,95,111,.856,19,203,222,188,30,3,93,63,875
972,MIA,2024,Haywood Highsmith,27,66,26,1366,153,329,.465,76,192,.396,77,137,.562,.581,23,36,.639,65,145,210,70,53,30,34,117,405
973,MIA,2024,Josh Richardson,30,43,6,1103,154,347,.444,66,190,.347,88,157,.561,.539,51,54,.944,18,103,121,105,24,14,36,76,425
974,MIA,2024,Kyle Lowry,37,37,35,1037,103,242,.426,62,161,.385,41,81,.506,.554,35,42,.833,25,104,129,147,39,15,53,94,303
975,MIA,2024,Terry Rozier,29,31,30,975,190,449,.423,66,178,.371,124,271,.458,.497,63,69,.913,18,112,130,144,31,9,41,49,509
976,MIA,2024,Kevin Love,35,55,5,924,158,359,.440,84,244,.344,74,115,.643,.557,85,108,.787,59,279,338,115,18,10,48,97,485
977,MIA,2024,Nikola Jović,20,46,38,896,127,281,.452,65,163,.399,62,118,.525,.568,33,47,.702,25,167,192,90,25,14,42,82,352
978,MIA,2024,Thomas Bryant,26,38,4,441,86,149,.577,4,22,.182,82,127,.646,.591,41,47,.872,40,101,141,23,10,16,21,46,217
979,MIA,2024,Orlando Robinson,23,36,7,304,36,72,.500,8,15,.533,28,57,.491,.556,19,25,.760,28,56,84,34,7,8,18,35,99
980,MIA,2024,Delon Wright,31,14,1,286,26,66,.394,11,30,.367,15,36,.417,.477,13,16,.813,6,21,27,37,19,3,3,10,76
981,MIA,2024,Jamal Cain,24,26,1,259,34,79,.430,11,31,.355,23,48,.479,.500,18,23,.783,15,22,37,10,10,5,8,22,97
982,MIA,2024,Patty Mills,35,13,5,213,27,80,.338,11,53,.208,16,27,.593,.406,11,11,1.000,4,11,15,20,11,0,8,15,76
983,MIA,2024,Dru Smith,26,9,0,131,15,33,.455,7,17,.412,8,16,.500,.561,2,2,1.000,6,8,14,14,9,3,5,12,39
984,MIA,2024,Cole Swider,24,18,0,87,15,38,.395,10,30,.333,5,8,.625,.526,2,2,1.000,1,6,7,5,1,1,8,4,42
985,MIA,2024,R.J. Hampton,22,8,2,76,4,14,.286,1,8,.125,3,6,.500,.321,1,2,.500,2,4,6,8,0,0,3,8,10
986,MIA,2024,Alondes Williams,24,7,0,16,2,8,.250,0,4,.000,2,4,.500,.250,1,1,1.000,0,1,1,0,0,1,2,2,5
987,MIA,2023,Bam Adebayo,25,75,75,2598,602,1114,.540,1,12,.083,601,1102,.545,.541,324,402,.806,184,504,688,240,88,61,187,208,1529
988,MIA,2023,Tyler Herro,23,67,67,2337,487,1109,.439,203,537,.378,284,572,.497,.531,170,182,.934,27,333,360,280,51,16,158,101,1347
989,MIA,2023,Max Strus,26,80,33,2272,324,790,.410,197,563,.350,127,227,.559,.535,78,89,.876,49,209,258,171,42,12,70,166,923
990,MIA,2023,Jimmy Butler,33,64,64,2138,479,888,.539,36,103,.350,443,785,.564,.560,472,555,.850,141,234,375,340,117,21,101,80,1466
991,MIA,2023,Caleb Martin,27,71,49,2077,254,548,.464,84,236,.356,170,312,.545,.540,91,113,.805,88,256,344,117,71,31,78,145,683
992,MIA,2023,Gabe Vincent,26,68,34,1759,228,567,.402,117,350,.334,111,217,.512,.505,68,78,.872,27,118,145,167,62,5,92,154,641
993,MIA,2023,Kyle Lowry,36,55,44,1718,196,485,.404,107,310,.345,89,175,.509,.514,116,135,.859,43,182,225,281,57,21,103,143,615
994,MIA,2023,Victor Oladipo,30,42,2,1106,160,403,.397,70,212,.330,90,191,.471,.484,59,79,.747,16,112,128,146,57,12,87,99,449
995,MIA,2023,Haywood Highsmith,26,54,11,969,93,216,.431,37,109,.339,56,107,.523,.516,13,28,.464,57,131,188,43,36,17,45,82,236
996,MIA,2023,Duncan Robinson,28,42,1,691,88,237,.371,63,192,.328,25,45,.556,.504,29,32,.906,8,61,69,46,14,0,28,77,268
997,MIA,2023,Orlando Robinson,22,31,1,425,47,89,.528,0,6,.000,47,83,.566,.528,22,31,.710,48,78,126,25,12,12,16,53,116
998,MIA,2023,Kevin Love,34,21,17,419,54,139,.388,30,101,.297,24,38,.632,.496,24,28,.857,17,102,119,40,9,5,23,32,162
999,MIA,2023,Dewayne Dedmon,33,30,0,350,64,129,.496,11,37,.297,53,92,.576,.539,32,44,.727,28,81,109,16,7,14,19,61,171
1000,MIA,2023,Jamal Cain,23,18,0,240,37,66,.561,7,20,.350,30,46,.652,.614,17,22,.773,15,37,52,12,11,1,6,21,98
1001,MIA,2023,Cody Zeller,30,15,2,217,37,59,.627,0,2,.000,37,57,.649,.627,24,35,.686,25,39,64,10,3,4,14,33,98
1002,MIA,2023,Nikola Jović,19,15,8,204,28,69,.406,8,35,.229,20,34,.588,.464,18,19,.947,9,22,31,10,7,2,10,19,82
1003,MIA,2023,Omer Yurtseven,24,9,0,83,16,27,.593,3,7,.429,13,20,.650,.648,5,6,.833,8,15,23,2,2,2,4,16,40
1004,MIA,2023,Udonis Haslem,42,7,1,71,10,29,.345,3,9,.333,7,20,.350,.397,4,5,.800,4,7,11,0,1,2,1,11,27
1005,MIA,2023,Dru Smith,25,5,1,67,5,14,.357,1,6,.167,4,8,.500,.393,0,0,,1,8,9,5,4,3,1,10,11
1006,MIA,2023,Jamaree Bouyea,23,4,0,65,6,13,.462,2,5,.400,4,8,.500,.538,1,2,.500,1,4,5,4,4,2,4,5,15
1007,MIA,2022,Tyler Herro,22,66,10,2151,501,1122,.447,175,439,.399,326,683,.477,.525,190,219,.868,32,297,329,263,44,8,174,95,1367
1008,MIA,2022,Kyle Lowry,35,63,63,2133,276,627,.440,144,382,.377,132,245,.539,.555,148,174,.851,33,249,282,474,67,17,168,177,844
1009,MIA,2022,Duncan Robinson,27,79,68,2043,290,726,.399,232,624,.372,58,102,.569,.559,51,61,.836,24,179,203,129,42,14,60,201,863
1010,MIA,2022,P.J. Tucker,36,71,70,1981,207,428,.484,80,193,.415,127,235,.540,.577,45,61,.738,100,287,387,149,58,15,66,161,539
1011,MIA,2022,Jimmy Butler,32,57,57,1931,398,829,.480,27,116,.233,371,713,.520,.496,396,455,.870,102,234,336,312,94,27,121,88,1219
1012,MIA,2022,Bam Adebayo,24,56,56,1825,406,729,.557,0,6,.000,406,723,.562,.557,256,340,.753,137,427,564,190,80,44,148,171,1068
1013,MIA,2022,Gabe Vincent,25,68,27,1589,214,513,.417,119,323,.368,95,190,.500,.533,44,54,.815,22,104,126,210,62,12,98,158,591
1014,MIA,2022,Max Strus,25,68,16,1587,249,564,.441,181,442,.410,68,122,.557,.602,42,53,.792,24,178,202,92,28,16,57,116,721
1015,MIA,2022,Caleb Martin,26,60,12,1372,208,410,.507,64,155,.413,144,255,.565,.585,71,93,.763,70,160,230,64,58,30,52,104,551
1016,MIA,2022,Dewayne Dedmon,32,67,15,1065,164,290,.566,19,47,.404,145,243,.597,.598,75,100,.750,105,281,386,47,24,42,70,174,422
1017,MIA,2022,Omer Yurtseven,23,56,12,706,130,247,.526,1,11,.091,129,236,.547,.528,38,61,.623,85,209,294,49,17,20,41,84,299
1018,MIA,2022,Markieff Morris,32,17,1,298,54,114,.474,13,39,.333,41,75,.547,.531,8,9,.889,17,28,45,23,6,1,20,33,129
1019,MIA,2022,KZ Okpala,22,21,0,244,30,69,.435,9,26,.346,21,43,.488,.500,8,11,.727,11,30,41,14,4,7,5,25,77
1020,MIA,2022,Kyle Guy,24,19,0,186,26,65,.400,14,40,.350,12,25,.480,.508,8,12,.667,4,13,17,17,7,1,13,12,74
1021,MIA,2022,Victor Oladipo,29,8,1,173,35,73,.479,15,36,.417,20,37,.541,.582,14,19,.737,3,20,23,28,5,1,16,13,99
1022,MIA,2022,Haywood Highsmith,25,19,1,163,16,46,.348,9,28,.321,7,18,.389,.446,2,5,.400,10,16,26,6,2,3,3,13,43
1023,MIA,2022,Marcus Garrett,23,12,0,128,5,21,.238,1,4,.250,4,17,.235,.262,2,5,.400,9,14,23,7,5,3,2,16,13
1024,MIA,2022,Chris Silva,25,9,0,88,8,15,.533,0,0,,8,15,.533,.533,10,12,.833,13,22,35,7,0,1,8,20,26
1025,MIA,2022,Udonis Haslem,41,13,0,83,14,31,.452,1,4,.250,13,27,.481,.468,3,3,1.000,4,21,25,4,1,1,5,15,32
1026,MIA,2022,Mychal Mulder,27,2,1,44,4,10,.400,4,8,.500,0,2,.000,.600,2,2,1.000,0,3,3,2,0,1,0,1,14
1027,MIA,2022,Javonte Smart,22,4,0,40,8,17,.471,4,9,.444,4,8,.500,.588,0,0,,1,4,5,2,2,1,2,1,20
1028,MIA,2022,Nik Stauskas,28,2,0,24,3,8,.375,2,4,.500,1,4,.250,.500,3,4,.750,1,2,3,1,0,0,0,1,11
1029,MIA,2021,Duncan Robinson,26,72,72,2262,315,717,.439,250,613,.408,65,104,.625,.614,62,75,.827,7,243,250,127,43,20,81,181,942
1030,MIA,2021,Bam Adebayo,23,64,64,2143,456,800,.570,2,8,.250,454,792,.573,.571,283,354,.799,142,431,573,346,75,66,169,145,1197
1031,MIA,2021,Jimmy Butler,31,52,52,1745,366,736,.497,25,102,.245,341,634,.538,.514,359,416,.863,94,265,359,369,108,18,109,71,1116
1032,MIA,2021,Kendrick Nunn,25,56,44,1650,319,658,.485,122,320,.381,197,338,.583,.578,56,60,.933,21,158,179,148,52,14,80,108,816
1033,MIA,2021,Tyler Herro,21,54,15,1635,307,699,.439,107,297,.360,200,402,.498,.516,94,117,.803,25,243,268,184,35,17,101,71,815
1034,MIA,2021,Andre Iguodala,37,63,5,1339,95,248,.383,60,182,.330,35,66,.530,.504,25,38,.658,38,183,221,142,57,35,67,90,275
1035,MIA,2021,Goran Dragić,34,50,11,1337,240,555,.432,91,244,.373,149,311,.479,.514,101,122,.828,25,144,169,219,33,8,118,113,672
1036,MIA,2021,Kelly Olynyk,29,43,38,1157,162,376,.431,77,243,.317,85,133,.639,.533,31,40,.775,44,217,261,91,40,26,55,123,432
1037,MIA,2021,Trevor Ariza,35,30,27,841,99,241,.411,50,143,.350,49,98,.500,.515,34,44,.773,27,117,144,55,31,18,21,55,282
1038,MIA,2021,Precious Achiuwa,21,61,4,737,124,228,.544,0,1,.000,124,227,.546,.544,56,110,.509,73,135,208,29,20,28,43,91,304
1039,MIA,2021,Gabe Vincent,24,50,7,655,88,233,.378,46,149,.309,42,84,.500,.476,20,23,.870,10,46,56,67,21,2,34,79,242
1040,MIA,2021,Max Strus,24,39,0,507,85,187,.455,50,148,.338,35,39,.897,.588,16,24,.667,5,36,41,24,11,2,8,43,236
1041,MIA,2021,KZ Okpala,21,37,9,447,36,96,.375,12,50,.240,24,46,.522,.438,8,15,.533,21,47,68,19,10,11,15,59,92
1042,MIA,2021,Avery Bradley,30,10,1,211,31,66,.470,16,38,.421,15,28,.536,.591,7,9,.778,2,16,18,14,7,1,9,26,85
1043,MIA,2021,Dewayne Dedmon,31,16,0,210,46,65,.708,1,5,.200,45,60,.750,.715,20,27,.741,28,58,86,12,9,6,13,36,113
1044,MIA,2021,Nemanja Bjelica,32,11,2,156,20,46,.435,10,27,.370,10,19,.526,.543,5,9,.556,5,22,27,20,7,3,5,20,55
1045,MIA,2021,Maurice Harkless,27,11,3,124,5,13,.385,5,11,.455,0,2,.000,.577,0,2,.000,2,11,13,7,2,4,3,14,15
1046,MIA,2021,Victor Oladipo,28,4,4,111,16,43,.372,4,17,.235,12,26,.462,.419,12,18,.667,3,11,14,14,7,2,14,13,48
1047,MIA,2021,Chris Silva,24,11,0,83,9,13,.692,1,1,1.000,8,12,.667,.731,11,15,.733,7,18,25,6,1,5,9,20,30
1048,MIA,2021,Meyers Leonard,28,3,2,29,3,7,.429,3,7,.429,0,0,,.643,1,2,.500,0,7,7,2,0,0,2,5,10
1049,MIA,2021,Udonis Haslem,40,1,0,3,2,2,1.000,0,0,,2,2,1.000,1.000,0,0,,0,1,1,0,0,0,0,0,4
1050,MIA,2020,Bam Adebayo,22,72,72,2417,440,790,.557,2,14,.143,438,776,.564,.558,264,382,.691,176,559,735,368,82,93,204,182,1146
1051,MIA,2020,Duncan Robinson,25,73,68,2166,323,687,.470,270,606,.446,53,81,.654,.667,67,72,.931,10,222,232,102,35,19,70,193,983
1052,MIA,2020,Kendrick Nunn,24,67,67,1962,401,914,.439,137,391,.350,264,523,.505,.514,85,100,.850,21,159,180,220,56,15,114,152,1024
1053,MIA,2020,Jimmy Butler,30,58,58,1959,345,758,.455,29,119,.244,316,639,.495,.474,438,525,.834,106,280,386,350,103,32,127,81,1157
1054,MIA,2020,Goran Dragić,33,59,3,1663,319,724,.441,124,338,.367,195,386,.505,.526,191,246,.776,29,158,187,301,40,10,144,124,953
1055,MIA,2020,Tyler Herro,20,55,8,1508,270,631,.428,116,298,.389,154,333,.462,.520,87,100,.870,16,208,224,121,34,9,87,76,743
1056,MIA,2020,Derrick Jones Jr.,22,59,16,1375,184,349,.527,37,132,.280,147,217,.677,.580,95,123,.772,66,167,233,62,58,38,30,130,500
1057,MIA,2020,Kelly Olynyk,28,67,9,1300,184,398,.462,95,234,.406,89,164,.543,.582,86,100,.860,44,261,305,116,45,23,71,173,549
1058,MIA,2020,Meyers Leonard,27,51,49,1034,119,234,.509,53,128,.414,66,106,.623,.622,18,28,.643,30,230,260,55,14,15,39,107,309
1059,MIA,2020,Jae Crowder,29,20,8,553,79,164,.482,57,128,.445,22,36,.611,.655,22,30,.733,12,95,107,36,25,10,15,58,237
1060,MIA,2020,Andre Iguodala,36,21,0,418,38,88,.432,14,47,.298,24,41,.585,.511,6,15,.400,17,61,78,51,14,21,26,35,96
1061,MIA,2020,Justise Winslow,23,11,5,352,50,129,.388,6,27,.222,44,102,.431,.411,18,27,.667,16,57,73,44,7,5,24,38,124
1062,MIA,2020,Chris Silva,23,44,0,346,48,78,.615,0,3,.000,48,75,.640,.615,37,55,.673,60,66,126,23,9,21,32,85,133
1063,MIA,2020,James Johnson,32,18,0,281,39,87,.448,16,45,.356,23,42,.548,.540,8,14,.571,8,44,52,21,6,13,15,34,102
1064,MIA,2020,Solomon Hill,28,11,1,187,14,45,.311,7,24,.292,7,21,.333,.389,14,16,.875,5,16,21,10,12,5,11,12,49
1065,MIA,2020,Gabe Vincent,23,9,0,83,8,37,.216,6,27,.222,2,10,.200,.297,0,0,,0,5,5,6,5,0,1,6,22
1066,MIA,2020,Udonis Haslem,39,4,1,44,4,11,.364,1,3,.333,3,8,.375,.409,3,4,.750,1,15,16,1,0,0,1,6,12
1067,MIA,2020,Dion Waiters,28,3,0,42,10,26,.385,8,17,.471,2,9,.222,.538,0,1,.000,0,11,11,3,0,2,3,5,28
1068,MIA,2020,KZ Okpala,20,5,0,26,3,5,.600,0,1,.000,3,4,.750,.600,1,2,.500,1,4,5,1,2,1,1,2,7
1069,MIA,2020,Daryl Macon,24,4,0,14,1,3,.333,1,2,.500,0,1,.000,.500,0,0,,0,0,0,1,0,0,2,1,3
1070,MIA,2020,Kyle Alexander,23,2,0,13,1,2,.500,0,0,,1,2,.500,.500,0,0,,2,1,3,0,0,0,1,1,2
1071,MIA,2019,Josh Richardson,25,73,73,2539,423,1026,.412,164,460,.357,259,566,.458,.492,199,231,.861,54,209,263,298,79,34,113,200,1209
1072,MIA,2019,Justise Winslow,22,66,52,1959,324,749,.433,96,256,.375,228,493,.462,.497,86,137,.628,63,292,355,282,72,19,142,177,830
1073,MIA,2019,Bam Adebayo,21,82,28,1913,280,486,.576,3,15,.200,277,471,.588,.579,166,226,.735,165,432,597,184,71,65,121,203,729
1074,MIA,2019,Dwyane Wade,37,72,2,1885,416,960,.433,86,261,.330,330,699,.472,.478,165,233,.708,69,216,285,301,59,38,166,118,1083
1075,MIA,2019,Kelly Olynyk,27,79,36,1812,261,564,.463,113,319,.354,148,245,.604,.563,152,185,.822,72,303,375,140,53,37,114,183,787
1076,MIA,2019,Hassan Whiteside,29,72,53,1674,388,680,.571,2,16,.125,386,664,.581,.572,109,243,.449,257,560,817,56,46,136,97,192,887
1077,MIA,2019,Rodney McGruder,27,66,45,1550,186,461,.403,79,225,.351,107,236,.453,.489,52,72,.722,60,178,238,112,36,12,64,115,503
1078,MIA,2019,James Johnson,31,55,33,1164,164,379,.433,50,149,.336,114,230,.496,.499,50,70,.714,22,154,176,135,35,27,74,114,428
1079,MIA,2019,Derrick Jones Jr.,21,60,14,1153,160,324,.494,28,91,.308,132,233,.567,.537,74,122,.607,96,144,240,37,46,42,43,123,422
1080,MIA,2019,Dion Waiters,27,44,28,1138,198,478,.414,109,289,.377,89,189,.471,.528,22,44,.500,7,109,116,121,29,9,64,72,527
1081,MIA,2019,Tyler Johnson,26,44,10,1123,171,401,.426,72,204,.353,99,197,.503,.516,61,88,.693,19,102,121,112,40,21,63,72,475
1082,MIA,2019,Goran Dragić,32,36,22,991,179,433,.413,57,164,.348,122,269,.454,.479,79,101,.782,20,91,111,174,30,5,71,81,494
1083,MIA,2019,Wayne Ellington,31,25,12,533,69,184,.375,57,155,.368,12,29,.414,.530,14,16,.875,6,41,47,29,24,3,14,40,209
1084,MIA,2019,Duncan Robinson,24,15,1,161,18,46,.391,10,35,.286,8,11,.727,.500,4,6,.667,2,17,19,5,5,0,4,11,50
1085,MIA,2019,Udonis Haslem,38,10,1,74,11,33,.333,0,12,.000,11,21,.524,.333,3,4,.750,3,24,27,2,0,0,3,9,25
1086,MIA,2019,Ryan Anderson,30,10,0,44,2,9,.222,2,6,.333,0,3,.000,.333,1,2,.500,4,5,9,2,1,0,2,2,7
1087,MIA,2019,Yante Maten,22,2,0,13,1,4,.250,0,1,.000,1,3,.333,.250,0,0,,1,2,3,0,1,0,0,0,2
1088,MIA,2019,Emanuel Terry,22,1,0,3,0,1,.000,0,0,,0,1,.000,.000,1,2,.500,1,0,1,1,0,0,0,0,1
1089,MIA,2018,Josh Richardson,24,81,81,2689,399,885,.451,127,336,.378,272,549,.495,.523,120,142,.845,69,216,285,231,121,75,140,199,1045
1090,MIA,2018,Goran Dragić,31,75,75,2378,484,1075,.450,111,300,.370,373,775,.481,.502,217,271,.801,54,252,306,359,63,12,166,180,1296
1091,MIA,2018,Tyler Johnson,25,72,39,2052,309,711,.435,119,324,.367,190,387,.491,.518,106,129,.822,34,214,248,165,60,34,81,148,843
1092,MIA,2018,Wayne Ellington,30,77,2,2041,285,700,.407,227,579,.392,58,121,.479,.569,67,78,.859,23,195,218,79,53,8,52,94,864
1093,MIA,2018,James Johnson,30,73,41,1943,309,614,.503,57,185,.308,252,429,.587,.550,113,162,.698,61,297,358,280,70,51,141,192,788
1094,MIA,2018,Kelly Olynyk,26,76,22,1779,316,636,.497,106,280,.379,210,356,.590,.580,134,174,.770,89,342,431,207,62,35,147,222,872
1095,MIA,2018,Justise Winslow,21,68,25,1680,207,488,.424,49,129,.380,158,359,.440,.474,66,104,.635,64,306,370,148,54,33,77,140,529
1096,MIA,2018,Bam Adebayo,20,69,19,1368,174,340,.512,0,7,.000,174,333,.523,.512,129,179,.721,118,263,381,101,32,41,66,138,477
1097,MIA,2018,Hassan Whiteside,28,54,54,1364,312,578,.540,2,2,1.000,310,576,.538,.542,128,182,.703,174,444,618,54,37,94,92,131,754
1098,MIA,2018,Dion Waiters,26,30,30,918,163,410,.398,52,170,.306,111,240,.463,.461,51,69,.739,8,69,77,113,23,9,70,61,429
1099,MIA,2018,Dwyane Wade,36,21,0,467,101,247,.409,9,41,.220,92,206,.447,.427,41,55,.745,11,60,71,65,19,15,48,40,252
1100,MIA,2018,Rodney McGruder,26,18,2,299,36,73,.493,15,35,.429,21,38,.553,.596,4,8,.500,11,22,33,17,8,3,4,21,91
1101,MIA,2018,Jordan Mickey,23,23,3,284,39,82,.476,2,16,.125,37,66,.561,.488,13,19,.684,18,63,81,9,6,10,18,36,93
1102,MIA,2018,Derrick Jones Jr.,20,14,8,212,19,49,.388,3,16,.188,16,33,.485,.418,11,18,.611,19,15,34,6,3,9,6,22,52
1103,MIA,2018,Derrick Walton,22,16,0,147,8,25,.320,7,17,.412,1,8,.125,.460,6,6,1.000,2,14,16,16,7,3,2,7,29
1104,MIA,2018,Luke Babbitt,28,13,5,145,11,47,.234,11,45,.244,0,2,.000,.351,0,0,,2,13,15,5,1,2,4,7,33
1105,MIA,2018,Okaro White,25,6,4,80,7,16,.438,4,11,.364,3,5,.600,.563,2,3,.667,3,8,11,2,1,1,1,6,20
1106,MIA,2018,Udonis Haslem,37,14,0,72,3,15,.200,1,8,.125,2,7,.286,.233,1,2,.500,3,7,10,5,0,2,2,3,8
1107,MIA,2018,Matt Williams,24,3,0,11,2,6,.333,1,5,.200,1,1,1.000,.417,0,0,,0,1,1,0,0,0,1,1,5
1108,MIA,2017,Hassan Whiteside,27,77,77,2513,542,973,.557,0,0,,542,973,.557,.557,225,358,.628,293,795,1088,57,57,161,154,226,1309
1109,MIA,2017,Goran Dragić,30,73,73,2459,534,1124,.475,117,289,.405,417,835,.499,.527,298,377,.790,62,217,279,423,89,13,212,199,1483
1110,MIA,2017,Tyler Johnson,24,73,0,2178,357,824,.433,93,250,.372,264,574,.460,.490,195,254,.768,50,243,293,233,84,44,90,176,1002
1111,MIA,2017,James Johnson,29,76,5,2085,368,769,.479,87,256,.340,281,513,.548,.535,152,215,.707,66,310,376,276,76,86,171,197,975
1112,MIA,2017,Rodney McGruder,25,78,65,1966,190,460,.413,73,220,.332,117,240,.488,.492,44,71,.620,94,162,256,124,46,18,56,140,497
1113,MIA,2017,Josh Richardson,23,53,34,1614,202,513,.394,75,227,.330,127,286,.444,.467,60,77,.779,35,133,168,140,60,39,65,132,539
1114,MIA,2017,Wayne Ellington,29,62,13,1500,231,555,.416,149,394,.378,82,161,.509,.550,37,43,.860,18,114,132,70,35,4,30,70,648
1115,MIA,2017,Dion Waiters,25,46,43,1384,281,663,.424,85,215,.395,196,448,.438,.488,82,127,.646,18,135,153,200,42,20,103,95,729
1116,MIA,2017,Luke Babbitt,27,68,55,1065,113,281,.402,87,210,.414,26,71,.366,.557,11,15,.733,12,129,141,36,20,11,25,118,324
1117,MIA,2017,Willie Reed,26,71,5,1031,162,285,.568,1,4,.250,161,281,.573,.570,49,88,.557,129,203,332,26,18,47,31,137,374
1118,MIA,2017,Justise Winslow,20,18,15,625,80,225,.356,7,35,.200,73,190,.384,.371,29,47,.617,23,71,94,66,26,6,33,52,196
1119,MIA,2017,Okaro White,24,35,0,471,33,87,.379,12,34,.353,21,53,.396,.448,20,22,.909,25,57,82,21,10,10,18,52,98
1120,MIA,2017,Josh McRoberts,29,22,14,381,44,118,.373,13,31,.419,31,87,.356,.428,6,9,.667,23,51,74,50,10,4,23,31,107
1121,MIA,2017,Derrick Williams,25,25,11,377,54,137,.394,9,45,.200,45,92,.489,.427,31,50,.620,16,57,73,14,9,5,14,33,148
1122,MIA,2017,Udonis Haslem,36,16,0,130,11,23,.478,0,3,.000,11,20,.550,.478,9,15,.600,8,28,36,6,6,1,8,22,31
1123,MIA,2016,Luol Deng,30,74,73,2394,339,745,.455,88,256,.344,251,489,.513,.514,145,192,.755,108,335,443,140,74,29,81,122,911
1124,MIA,2016,Goran Dragić,29,72,72,2363,417,875,.477,64,205,.312,353,670,.527,.513,120,165,.727,54,223,277,419,71,17,185,188,1018
1125,MIA,2016,Dwyane Wade,34,74,73,2258,540,1183,.456,7,44,.159,533,1139,.468,.459,322,406,.793,82,220,302,344,79,42,203,116,1409
1126,MIA,2016,Justise Winslow,19,78,8,2232,195,462,.422,32,116,.276,163,346,.471,.457,80,117,.684,81,322,403,117,68,26,95,184,502
1127,MIA,2016,Hassan Whiteside,26,73,43,2125,413,682,.606,0,0,,413,682,.606,.606,214,329,.650,238,627,865,30,44,269,137,201,1040
1128,MIA,2016,Chris Bosh,31,53,53,1778,358,767,.467,81,222,.365,277,545,.508,.520,213,268,.795,48,342,390,128,36,34,78,101,1010
1129,MIA,2016,Gerald Green,30,69,14,1557,230,587,.392,84,260,.323,146,327,.446,.463,72,92,.783,25,138,163,56,38,19,46,123,616
1130,MIA,2016,Josh Richardson,22,52,2,1107,123,272,.452,53,115,.461,70,157,.446,.550,42,63,.667,21,86,107,73,36,25,35,107,341
1131,MIA,2016,Tyler Johnson,23,36,5,863,118,243,.486,27,71,.380,91,172,.529,.541,51,64,.797,28,81,109,79,24,14,47,66,314
1132,MIA,2016,Joe Johnson,34,24,24,769,130,251,.518,35,84,.417,95,167,.569,.588,26,34,.765,15,53,68,86,21,2,43,46,321
1133,MIA,2016,Amar'e Stoudemire,33,52,36,762,125,221,.566,0,0,,125,221,.566,.566,50,67,.746,65,157,222,27,18,41,47,92,300
1134,MIA,2016,Josh McRoberts,28,42,1,595,55,148,.372,12,49,.245,43,99,.434,.412,28,40,.700,22,83,105,81,18,7,30,68,150
1135,MIA,2016,Beno Udrih,33,36,5,587,66,152,.434,11,33,.333,55,119,.462,.470,15,17,.882,6,57,63,90,11,0,42,40,158
1136,MIA,2016,Udonis Haslem,35,37,0,260,23,61,.377,1,9,.111,22,52,.423,.385,12,16,.750,10,65,75,14,5,2,5,25,59
1137,MIA,2016,Mario Chalmers,29,6,0,120,10,32,.313,1,11,.091,9,21,.429,.328,12,13,.923,1,13,14,19,8,1,9,16,33
1138,MIA,2016,Chris Andersen,37,7,1,36,4,10,.400,2,5,.400,2,5,.400,.500,3,4,.750,3,6,9,3,1,3,2,4,13
1139,MIA,2016,Jarnell Stokes,22,5,0,14,3,5,.600,0,0,,3,5,.600,.600,1,2,.500,0,2,2,1,1,0,0,1,7
1140,MIA,2016,James Ennis III,25,3,0,7,0,0,,0,0,,0,0,,,0,0,,0,0,0,1,0,0,0,1,0
1141,MIA,2016,Briante Weber,23,1,0,3,1,1,1.000,0,0,,1,1,1.000,1.000,0,0,,0,1,1,1,0,0,0,1,2
1142,MIA,2015,Luol Deng,29,72,72,2421,369,787,.469,78,220,.355,291,567,.513,.518,191,251,.761,103,273,376,139,65,22,108,109,1007
1143,MIA,2015,Mario Chalmers,28,80,37,2368,267,663,.403,73,248,.294,194,415,.467,.458,206,266,.774,24,182,206,307,122,10,173,251,813
1144,MIA,2015,Dwyane Wade,33,62,62,1971,509,1084,.470,29,102,.284,480,982,.489,.483,284,370,.768,58,161,219,299,73,21,209,105,1331
1145,MIA,2015,Chris Bosh,30,44,44,1556,343,745,.460,63,168,.375,280,577,.485,.503,179,232,.772,46,264,310,95,41,25,95,69,928
1146,MIA,2015,Norris Cole,26,47,23,1148,118,306,.386,27,102,.265,91,204,.446,.430,32,46,.696,12,96,108,165,42,8,58,75,295
1147,MIA,2015,Hassan Whiteside,25,48,32,1142,243,387,.628,0,0,,243,387,.628,.628,78,156,.500,145,337,482,6,27,123,58,129,564
1148,MIA,2015,Chris Andersen,36,60,20,1132,120,207,.580,4,13,.308,116,194,.598,.589,76,114,.667,76,223,299,43,26,61,40,88,320
1149,MIA,2015,James Ennis III,24,62,3,1051,101,247,.409,31,95,.326,70,152,.461,.472,79,94,.840,51,125,176,48,25,17,39,89,312
1150,MIA,2015,Shabazz Napier,23,51,10,1012,87,228,.382,43,118,.364,44,110,.400,.476,44,56,.786,17,96,113,130,40,4,81,76,261
1151,MIA,2015,Udonis Haslem,34,62,25,995,107,239,.448,2,10,.200,105,229,.459,.452,45,64,.703,71,187,258,46,21,13,41,113,261
1152,MIA,2015,Shawne Williams,28,44,22,924,102,240,.425,60,152,.395,42,88,.477,.550,28,33,.848,27,112,139,36,21,17,23,116,292
1153,MIA,2015,Goran Dragić,28,26,26,905,162,323,.502,24,73,.329,138,250,.552,.539,84,104,.808,30,59,89,139,28,6,59,75,432
1154,MIA,2015,Henry Walker,27,24,13,628,58,168,.345,45,132,.341,13,36,.361,.479,14,18,.778,7,75,82,29,24,9,24,76,175
1155,MIA,2015,Danny Granger,31,30,6,613,65,162,.401,30,84,.357,35,78,.449,.494,28,37,.757,20,60,80,17,13,6,24,67,188
1156,MIA,2015,Tyler Johnson,22,32,2,603,70,167,.419,18,48,.375,52,119,.437,.473,32,47,.681,14,67,81,42,33,9,30,42,190
1157,MIA,2015,Michael Beasley,26,24,1,505,92,212,.434,8,34,.235,84,178,.472,.453,20,26,.769,12,77,89,32,15,13,37,66,212
1158,MIA,2015,Josh McRoberts,27,17,4,296,28,53,.528,8,19,.421,20,34,.588,.604,8,13,.615,7,38,45,33,12,3,22,41,72
1159,MIA,2015,Justin Hamilton,24,24,5,289,27,65,.415,6,19,.316,21,46,.457,.462,6,7,.857,24,24,48,12,8,5,8,33,66
1160,MIA,2015,Shannon Brown,29,5,2,89,7,19,.368,3,7,.429,4,12,.333,.447,3,4,.750,0,1,1,3,4,0,4,8,20
1161,MIA,2015,Zoran Dragić,25,10,1,62,9,22,.409,3,9,.333,6,13,.462,.477,1,2,.500,3,2,5,4,2,0,5,5,22
1162,MIA,2015,Andre Dawkins,23,4,0,22,1,6,.167,1,6,.167,0,0,,.250,0,0,,0,2,2,1,0,0,1,3,3
1163,MIA,2014,LeBron James,29,77,77,2902,767,1353,.567,116,306,.379,651,1047,.622,.610,439,585,.750,81,452,533,488,121,26,270,126,2089
1164,MIA,2014,Chris Bosh,29,79,79,2531,492,953,.516,74,218,.339,418,735,.569,.555,223,272,.820,98,424,522,87,80,78,125,192,1281
1165,MIA,2014,Mario Chalmers,27,73,73,2178,254,560,.454,87,226,.385,167,334,.500,.531,121,163,.742,41,173,214,357,119,16,162,210,716
1166,MIA,2014,Norris Cole,25,82,6,2014,207,500,.414,60,174,.345,147,326,.451,.474,53,68,.779,17,143,160,248,77,5,127,156,527
1167,MIA,2014,Ray Allen,38,73,9,1936,240,543,.442,116,309,.375,124,234,.530,.549,105,116,.905,23,182,205,143,54,8,84,115,701
1168,MIA,2014,Dwyane Wade,32,54,53,1775,415,761,.545,9,32,.281,406,729,.557,.551,189,258,.733,60,181,241,252,79,29,161,106,1028
1169,MIA,2014,Shane Battier,35,73,56,1468,105,275,.382,73,210,.348,32,65,.492,.515,15,23,.652,34,104,138,63,50,39,21,124,298
1170,MIA,2014,Chris Andersen,35,72,0,1396,177,275,.644,3,12,.250,174,263,.662,.649,120,169,.710,129,250,379,19,32,97,53,162,477
1171,MIA,2014,Rashard Lewis,34,60,6,971,98,236,.415,46,134,.343,52,102,.510,.513,26,33,.788,24,86,110,57,53,8,35,90,268
1172,MIA,2014,Michael Beasley,25,55,2,831,177,355,.499,21,54,.389,156,301,.518,.528,61,79,.772,31,141,172,42,23,21,57,93,436
1173,MIA,2014,Udonis Haslem,33,46,18,653,74,146,.507,0,0,,74,146,.507,.507,25,44,.568,42,133,175,13,11,15,24,79,173
1174,MIA,2014,Toney Douglas,27,27,17,410,41,104,.394,12,43,.279,29,61,.475,.452,20,26,.769,14,47,61,49,13,3,18,47,114
1175,MIA,2014,Roger Mason,33,25,2,260,25,67,.373,17,48,.354,8,19,.421,.500,7,7,1.000,1,21,22,19,6,1,9,26,74
1176,MIA,2014,James Jones,33,20,6,236,31,68,.456,28,54,.519,3,14,.214,.662,7,11,.636,2,21,23,9,3,4,4,6,97
1177,MIA,2014,Greg Oden,26,23,6,212,27,49,.551,0,0,,27,49,.551,.551,13,23,.565,23,31,54,1,7,13,12,52,67
1178,MIA,2014,Justin Hamilton,23,7,0,68,9,20,.450,3,9,.333,6,11,.545,.525,5,5,1.000,4,3,7,0,4,0,3,8,26
1179,MIA,2014,Joel Anthony,31,12,0,37,2,6,.333,0,0,,2,6,.333,.333,2,2,1.000,2,5,7,0,0,4,1,4,6
1180,MIA,2014,DeAndre Liggins,25,1,0,1,1,1,1.000,0,0,,1,1,1.000,1.000,0,0,,1,0,1,0,0,0,0,0,2
1181,MIA,2013,LeBron James,28,76,76,2877,765,1354,.565,103,254,.406,662,1100,.602,.603,403,535,.753,97,513,610,551,129,67,226,110,2036
1182,MIA,2013,Chris Bosh,28,74,74,2454,485,907,.535,21,74,.284,464,833,.557,.546,241,302,.798,131,370,501,123,66,101,128,168,1232
1183,MIA,2013,Dwyane Wade,31,69,69,2391,569,1093,.521,17,66,.258,552,1027,.537,.528,308,425,.725,86,258,344,352,128,56,194,140,1463
1184,MIA,2013,Mario Chalmers,26,77,77,2068,227,529,.429,123,301,.409,104,228,.456,.545,89,112,.795,19,152,171,273,118,12,119,196,666
1185,MIA,2013,Ray Allen,37,79,0,2035,292,651,.449,139,332,.419,153,319,.480,.555,140,158,.886,40,177,217,135,67,15,103,129,863
1186,MIA,2013,Shane Battier,34,72,20,1786,152,362,.420,136,316,.430,16,46,.348,.608,32,38,.842,37,128,165,72,41,55,34,149,472
1187,MIA,2013,Norris Cole,24,80,4,1590,179,425,.421,35,98,.357,144,327,.440,.462,52,80,.650,18,112,130,164,57,7,104,155,445
1188,MIA,2013,Udonis Haslem,32,75,59,1414,129,251,.514,0,0,,129,251,.514,.514,32,45,.711,97,307,404,38,30,15,45,173,290
1189,MIA,2013,Mike Miller,32,59,17,900,100,231,.433,73,175,.417,27,56,.482,.591,8,11,.727,18,139,157,99,21,4,35,63,281
1190,MIA,2013,Rashard Lewis,33,55,9,792,103,249,.414,51,131,.389,52,118,.441,.516,28,45,.622,19,102,121,30,21,14,33,67,285
1191,MIA,2013,Chris Andersen,34,42,0,624,71,123,.577,2,3,.667,69,120,.575,.585,63,93,.677,57,115,172,17,16,44,24,89,207
1192,MIA,2013,Joel Anthony,30,62,3,566,35,68,.515,0,0,,35,68,.515,.515,17,28,.607,45,70,115,13,13,42,22,49,87
1193,MIA,2013,James Jones,32,38,0,221,21,61,.344,16,53,.302,5,8,.625,.475,2,4,.500,0,22,22,13,2,6,3,16,60
1194,MIA,2013,Juwan Howard,39,7,2,51,10,19,.526,0,0,,10,19,.526,.526,1,1,1.000,0,8,8,6,0,0,4,9,21
1195,MIA,2013,Jarvis Varnado,24,8,0,40,1,3,.333,0,0,,1,3,.333,.333,0,0,,1,5,6,2,0,2,5,9,2
1196,MIA,2013,Josh Harrellson,23,6,0,31,4,9,.444,1,5,.200,3,4,.750,.500,1,2,.500,3,4,7,0,1,1,3,4,10
1197,MIA,2013,Terrel Harris,25,7,0,29,2,8,.250,0,1,.000,2,7,.286,.250,6,8,.750,4,5,9,2,0,0,4,3,10
1198,MIA,2013,Dexter Pittman,24,4,0,12,3,5,.600,0,0,,3,5,.600,.600,0,0,,4,3,7,0,0,0,2,4,6
1199,MIA,2012,LeBron James,27,62,62,2326,621,1169,.531,54,149,.362,567,1020,.556,.554,387,502,.771,94,398,492,387,115,50,213,96,1683
1200,MIA,2012,Chris Bosh,27,57,57,2007,393,807,.487,10,35,.286,383,772,.496,.493,229,279,.821,94,358,452,103,51,45,117,128,1025
1201,MIA,2012,Mario Chalmers,25,64,64,1825,223,498,.448,101,260,.388,122,238,.513,.549,80,101,.792,16,155,171,222,97,11,142,166,627
1202,MIA,2012,Dwyane Wade,30,49,49,1625,416,837,.497,15,56,.268,401,781,.513,.506,235,297,.791,73,164,237,225,82,63,129,110,1082
1203,MIA,2012,Udonis Haslem,31,64,10,1589,151,357,.423,0,0,,151,357,.423,.423,83,102,.814,117,353,470,42,35,24,60,142,385
1204,MIA,2012,Shane Battier,33,65,10,1499,113,292,.387,62,183,.339,51,109,.468,.493,23,37,.622,56,100,156,82,64,33,37,105,311
1205,MIA,2012,Joel Anthony,29,64,51,1349,85,152,.559,0,0,,85,152,.559,.559,49,71,.690,100,150,250,9,36,84,45,126,219
1206,MIA,2012,Norris Cole,23,65,2,1260,177,450,.393,21,76,.276,156,374,.417,.417,66,85,.776,21,70,91,133,44,2,105,124,441
1207,MIA,2012,Mike Miller,31,39,2,752,91,209,.435,53,117,.453,38,92,.413,.562,2,5,.400,22,106,128,42,14,6,30,58,237
1208,MIA,2012,James Jones,31,51,10,666,57,150,.380,46,114,.404,11,36,.306,.533,25,30,.833,6,43,49,19,17,9,10,45,185
1209,MIA,2012,Terrel Harris,24,22,1,318,29,83,.349,8,39,.205,21,44,.477,.398,14,21,.667,18,33,51,26,9,2,25,34,80
1210,MIA,2012,Dexter Pittman,23,35,6,301,44,94,.468,0,0,,44,94,.468,.468,18,28,.643,27,44,71,9,8,8,17,73,106
1211,MIA,2012,Ronny Turiaf,29,13,5,221,16,30,.533,0,1,.000,16,29,.552,.533,13,22,.591,19,39,58,5,8,14,8,32,45
1212,MIA,2012,Juwan Howard,38,28,0,190,17,55,.309,0,0,,17,55,.309,.309,8,10,.800,18,29,47,10,4,1,20,18,42
1213,MIA,2012,Eddy Curry,29,14,1,83,12,26,.462,0,0,,12,26,.462,.462,6,8,.750,4,8,12,1,0,2,10,17,30
1214,MIA,2012,Mickell Gladness,25,8,0,28,1,3,.333,0,0,,1,3,.333,.333,0,0,,1,10,11,2,1,1,3,8,2
1215,MIA,2011,LeBron James,26,79,79,3063,758,1485,.510,92,279,.330,666,1206,.552,.541,503,663,.759,80,510,590,554,124,50,284,163,2111
1216,MIA,2011,Dwyane Wade,29,76,76,2823,692,1384,.500,63,206,.306,629,1178,.534,.523,494,652,.758,123,362,485,346,111,87,237,197,1941
1217,MIA,2011,Chris Bosh,26,77,77,2795,524,1056,.496,6,25,.240,518,1031,.502,.499,384,471,.815,141,500,641,144,59,49,138,172,1438
1218,MIA,2011,Mario Chalmers,24,70,28,1579,155,388,.399,83,231,.359,72,157,.459,.506,54,62,.871,12,134,146,177,76,7,91,158,447
1219,MIA,2011,James Jones,30,81,8,1549,146,346,.422,123,287,.429,23,59,.390,.600,60,72,.833,23,137,160,43,29,19,21,129,475
1220,MIA,2011,Joel Anthony,28,75,11,1463,53,99,.535,0,0,,53,99,.535,.535,47,73,.644,104,162,266,24,10,93,36,194,153
1221,MIA,2011,Zydrunas Ilgauskas,35,72,51,1145,162,319,.508,0,1,.000,162,318,.509,.508,36,46,.783,108,179,287,26,23,58,52,185,360
1222,MIA,2011,Carlos Arroyo,31,49,42,995,109,238,.458,28,64,.438,81,174,.466,.517,28,35,.800,13,67,80,100,14,1,43,60,274
1223,MIA,2011,Eddie House,32,56,1,978,128,321,.399,68,175,.389,60,146,.411,.505,38,40,.950,9,83,92,62,32,3,29,68,362
1224,MIA,2011,Mike Miller,30,41,2,838,81,202,.401,43,118,.364,38,84,.452,.507,23,34,.676,38,146,184,51,20,2,41,88,228
1225,MIA,2011,Erick Dampier,35,51,22,815,52,89,.584,0,1,.000,52,88,.591,.584,24,44,.545,53,124,177,22,14,47,32,82,128
1226,MIA,2011,Juwan Howard,37,57,0,592,55,125,.440,0,0,,55,125,.440,.440,29,35,.829,36,86,122,23,10,4,25,61,139
1227,MIA,2011,Mike Bibby,32,22,12,582,55,126,.437,40,88,.455,15,38,.395,.595,10,16,.625,2,47,49,55,11,3,32,47,160
1228,MIA,2011,Udonis Haslem,30,13,0,345,44,86,.512,0,0,,44,86,.512,.512,16,20,.800,29,77,106,6,7,3,14,39,104
1229,MIA,2011,Jamaal Magloire,32,18,0,158,13,22,.591,0,0,,13,22,.591,.591,9,18,.500,17,44,61,3,4,2,5,26,35
1230,MIA,2011,Jerry Stackhouse,36,7,1,50,3,12,.250,1,4,.250,2,8,.250,.292,5,7,.714,1,6,7,3,0,2,2,3,12
1231,MIA,2011,Dexter Pittman,22,2,0,11,1,3,.333,0,0,,1,3,.333,.333,0,0,,1,2,3,0,0,0,2,2,2
1232,MIA,2010,Dwyane Wade,28,77,77,2792,719,1511,.476,73,243,.300,646,1268,.509,.500,534,702,.761,107,266,373,501,142,82,252,181,2045
1233,MIA,2010,Michael Beasley,21,78,78,2328,468,1040,.450,28,102,.275,440,938,.469,.463,192,240,.800,123,375,498,100,80,49,131,221,1156
1234,MIA,2010,Udonis Haslem,29,78,0,2177,312,632,.494,0,0,,312,632,.494,.494,147,193,.762,167,462,629,52,30,23,75,174,771
1235,MIA,2010,Quentin Richardson,29,76,75,2082,242,561,.431,142,358,.397,100,203,.493,.558,52,71,.732,64,310,374,93,70,18,62,169,678
1236,MIA,2010,Jermaine O'Neal,31,70,70,1991,394,745,.529,0,2,.000,394,743,.530,.529,162,225,.720,124,362,486,92,25,95,125,212,950
1237,MIA,2010,Mario Chalmers,23,73,22,1807,182,454,.401,75,236,.318,107,218,.491,.483,82,110,.745,25,110,135,246,91,12,123,175,521
1238,MIA,2010,Carlos Arroyo,30,72,35,1585,178,375,.475,7,25,.280,171,350,.489,.484,76,90,.844,26,104,130,225,36,6,54,102,439
1239,MIA,2010,Dorell Wright,24,72,1,1496,194,419,.463,61,157,.389,133,262,.508,.536,61,69,.884,50,185,235,91,52,32,53,94,510
1240,MIA,2010,Joel Anthony,27,80,16,1322,76,159,.478,0,0,,76,159,.478,.478,66,92,.717,123,126,249,12,20,109,45,158,218
1241,MIA,2010,Daequan Cook,22,45,3,691,81,253,.320,40,126,.317,41,127,.323,.399,21,25,.840,9,73,82,43,14,10,24,50,223
1242,MIA,2010,Rafer Alston,33,25,25,655,60,169,.355,30,81,.370,30,88,.341,.444,15,27,.556,4,50,54,72,23,5,34,53,165
1243,MIA,2010,James Jones,29,36,6,503,43,119,.361,37,90,.411,6,29,.207,.517,23,28,.821,4,41,45,17,11,4,11,45,146
1244,MIA,2010,Jamaal Magloire,31,36,0,359,28,56,.500,0,0,,28,56,.500,.500,21,59,.356,41,80,121,1,9,11,17,59,77
1245,MIA,2010,Shavlik Randolph,26,3,0,47,5,15,.333,0,0,,5,15,.333,.333,0,0,,7,6,13,0,1,1,2,9,10
1246,MIA,2010,Yakhouba Diawara,27,6,2,44,2,10,.200,1,6,.167,1,4,.250,.250,0,0,,1,3,4,3,1,0,3,8,5
1247,MIA,2009,Dwyane Wade,27,79,79,3048,854,1739,.491,88,278,.317,766,1461,.524,.516,590,771,.765,89,309,398,589,173,106,272,178,2386
1248,MIA,2009,Mario Chalmers,22,82,82,2626,278,662,.420,114,311,.367,164,351,.467,.506,148,193,.767,37,191,228,403,160,8,165,240,818
1249,MIA,2009,Udonis Haslem,28,75,75,2560,333,643,.518,0,0,,333,643,.518,.518,128,170,.753,169,449,618,85,43,25,82,204,794
1250,MIA,2009,Michael Beasley,20,81,19,2009,452,957,.472,33,81,.407,419,876,.478,.490,186,241,.772,110,329,439,83,41,37,121,184,1123
1251,MIA,2009,Daequan Cook,21,75,4,1833,242,645,.375,153,395,.387,89,250,.356,.494,49,56,.875,19,170,189,71,39,10,42,125,686
1252,MIA,2009,Shawn Marion,30,42,41,1516,215,446,.482,8,40,.200,207,406,.510,.491,67,85,.788,107,258,365,77,57,45,56,92,505
1253,MIA,2009,Joel Anthony,26,65,28,1048,57,118,.483,0,0,,57,118,.483,.483,30,46,.652,89,108,197,27,20,93,41,139,144
1254,MIA,2009,Chris Quinn,25,66,0,962,118,289,.408,56,137,.409,62,152,.408,.505,47,58,.810,8,67,75,132,24,2,33,79,339
1255,MIA,2009,Yakhouba Diawara,26,63,21,851,76,217,.350,51,163,.313,25,54,.463,.468,10,19,.526,26,56,82,27,13,6,16,75,213
1256,MIA,2009,Jermaine O'Neal,30,27,27,811,145,305,.475,0,0,,145,305,.475,.475,60,80,.750,55,90,145,55,11,54,52,81,350
1257,MIA,2009,Jamaal Magloire,30,55,12,709,65,131,.496,0,0,,65,131,.496,.496,29,60,.483,82,140,222,22,11,25,32,121,159
1258,MIA,2009,Jamario Moon,28,26,21,689,72,157,.459,27,73,.370,45,84,.536,.545,13,15,.867,10,106,116,25,21,16,12,48,184
1259,MIA,2009,James Jones,28,40,1,630,55,149,.369,33,96,.344,22,53,.415,.480,26,31,.839,12,50,62,20,12,14,12,58,169
1260,MIA,2009,Mark Blount,33,20,0,207,30,78,.385,11,27,.407,19,51,.373,.455,8,13,.615,10,31,41,4,1,7,14,17,79
1261,MIA,2009,Luther Head,26,10,0,176,16,43,.372,6,16,.375,10,27,.370,.442,5,8,.625,3,22,25,23,11,1,9,22,43
1262,MIA,2009,Marcus Banks,27,16,0,166,15,39,.385,2,14,.143,13,25,.520,.410,10,15,.667,0,15,15,22,10,2,11,21,42
1263,MIA,2009,Dorell Wright,23,6,0,73,8,20,.400,0,0,,8,20,.400,.400,2,6,.333,2,18,20,2,2,0,6,8,18
1264,MIA,2009,Shaun Livingston,23,4,0,41,3,8,.375,0,0,,3,8,.375,.375,3,4,.750,0,2,2,4,2,0,3,4,9
1265,MIA,2008,Ricky Davis,28,82,47,2963,420,971,.433,135,333,.405,285,638,.447,.502,155,197,.787,55,298,353,276,87,14,191,187,1130
1266,MIA,2008,Dwyane Wade,26,51,49,1954,439,937,.469,22,77,.286,417,860,.485,.480,354,467,.758,45,169,214,354,87,37,224,137,1254
1267,MIA,2008,Jason Williams,32,67,53,1886,211,550,.384,97,275,.353,114,275,.415,.472,69,80,.863,12,118,130,307,83,5,91,93,588
1268,MIA,2008,Udonis Haslem,27,49,48,1805,237,507,.467,0,0,,237,507,.467,.467,115,142,.810,107,336,443,68,39,18,67,145,589
1269,MIA,2008,Mark Blount,32,69,46,1542,238,515,.462,17,44,.386,221,471,.469,.479,88,138,.638,69,194,263,41,33,34,70,133,581
1270,MIA,2008,Daequan Cook,20,59,19,1441,196,514,.381,79,238,.332,117,276,.424,.458,47,57,.825,20,157,177,75,23,9,63,157,518
1271,MIA,2008,Chris Quinn,24,60,25,1340,158,373,.424,64,159,.403,94,214,.439,.509,85,98,.867,11,107,118,178,46,4,55,90,465
1272,MIA,2008,Dorell Wright,22,44,34,1104,143,293,.488,4,11,.364,139,282,.493,.495,57,69,.826,48,172,220,60,29,41,29,79,347
1273,MIA,2008,Shaquille O'Neal,35,33,33,945,191,329,.581,0,0,,191,329,.581,.581,88,178,.494,99,159,258,45,19,54,98,134,470
1274,MIA,2008,Earl Barron,26,46,15,889,132,327,.404,1,13,.077,131,314,.417,.405,61,87,.701,67,131,198,29,19,8,48,114,326
1275,MIA,2008,Shawn Marion,29,16,15,602,96,209,.459,8,31,.258,88,178,.494,.478,29,42,.690,50,129,179,40,30,15,37,33,229
1276,MIA,2008,Alexander Johnson,24,43,6,549,61,125,.488,0,0,,61,125,.488,.488,57,83,.687,32,62,94,13,13,10,42,80,179
1277,MIA,2008,Joel Anthony,25,24,1,498,28,60,.467,0,0,,28,60,.467,.467,29,49,.592,38,55,93,3,9,31,17,55,85
1278,MIA,2008,Alonzo Mourning,37,25,0,389,52,95,.547,0,0,,52,95,.547,.547,45,76,.592,34,59,93,7,4,42,25,56,149
1279,MIA,2008,Anfernee Hardaway,36,16,8,325,22,60,.367,8,19,.421,14,41,.341,.433,8,9,.889,3,32,35,35,19,1,13,24,60
1280,MIA,2008,Kasib Powell,26,11,4,304,35,95,.368,8,33,.242,27,62,.435,.411,6,9,.667,8,36,44,18,9,2,5,18,84
1281,MIA,2008,Stéphane Lasme,25,15,4,303,32,71,.451,0,0,,32,71,.451,.451,19,32,.594,26,27,53,3,13,22,15,35,83
1282,MIA,2008,Marcus Banks,26,12,2,259,42,82,.512,15,37,.405,27,45,.600,.604,15,19,.789,1,24,25,36,6,5,21,27,114
1283,MIA,2008,Luke Jackson,26,14,1,228,26,80,.325,11,30,.367,15,50,.300,.394,16,23,.696,7,26,33,17,8,0,9,22,79
1284,MIA,2008,Smush Parker,26,9,0,183,17,54,.315,6,24,.250,11,30,.367,.370,3,4,.750,2,17,19,15,5,3,8,13,43
1285,MIA,2008,Blake Ahearn,23,12,0,177,15,57,.263,10,34,.294,5,23,.217,.351,30,31,.968,1,18,19,19,6,0,16,20,70
1286,MIA,2008,Bobby Jones,24,6,0,143,17,32,.531,6,15,.400,11,17,.647,.625,8,13,.615,8,16,24,5,2,0,7,18,48
1287,MIA,2007,Udonis Haslem,26,79,79,2483,353,717,.492,0,4,.000,353,713,.495,.492,138,203,.680,188,466,654,97,49,26,110,236,844
1288,MIA,2007,Dwyane Wade,25,51,50,1931,472,962,.491,21,79,.266,451,883,.511,.502,432,535,.807,51,188,239,384,107,62,216,117,1397
1289,MIA,2007,James Posey,30,71,19,1919,186,432,.431,97,259,.375,89,173,.514,.543,81,98,.827,66,291,357,94,71,23,55,193,550
1290,MIA,2007,Jason Williams,31,61,55,1865,235,569,.413,100,295,.339,135,274,.493,.501,94,103,.913,18,123,141,322,58,1,100,68,664
1291,MIA,2007,Antoine Walker,30,78,15,1818,265,668,.397,84,305,.275,181,363,.499,.460,46,105,.438,92,247,339,130,48,17,141,173,660
1292,MIA,2007,Jason Kapono,25,67,35,1767,278,563,.494,108,210,.514,170,353,.482,.590,66,74,.892,26,154,180,81,38,2,70,135,730
1293,MIA,2007,Alonzo Mourning,36,77,43,1572,238,425,.560,0,0,,238,425,.560,.560,185,308,.601,126,224,350,18,13,178,129,219,661
1294,MIA,2007,Gary Payton,38,68,28,1503,144,366,.393,32,123,.260,112,243,.461,.437,38,57,.667,18,114,132,201,43,3,66,117,358
1295,MIA,2007,Dorell Wright,21,66,19,1292,162,364,.445,5,34,.147,157,330,.476,.452,64,86,.744,40,232,272,95,41,46,65,112,393
1296,MIA,2007,Shaquille O'Neal,34,40,39,1135,283,479,.591,0,0,,283,479,.591,.591,124,294,.422,97,200,297,79,8,55,95,139,690
1297,MIA,2007,Eddie Jones,35,35,27,1033,121,271,.446,56,148,.378,65,123,.528,.550,34,41,.829,17,112,129,76,46,8,24,70,332
1298,MIA,2007,Michael Doleac,29,56,0,698,82,175,.469,0,1,.000,82,174,.471,.469,36,41,.878,44,111,155,22,18,15,30,96,200
1299,MIA,2007,Chris Quinn,23,42,1,408,48,131,.366,20,57,.351,28,74,.378,.443,25,37,.676,6,24,30,65,15,0,21,32,141
1300,MIA,2007,Earl Barron,25,28,0,203,24,83,.289,0,1,.000,24,82,.293,.289,17,18,.944,19,22,41,5,6,4,11,21,65
1301,MIA,2007,Robert Hite,23,12,0,136,19,60,.317,5,23,.217,14,37,.378,.358,8,12,.667,4,12,16,8,3,2,6,8,51
1302,MIA,2007,Wayne Simien,23,8,0,93,9,23,.391,0,0,,9,23,.391,.391,5,7,.714,5,6,11,4,2,0,3,13,23
1303,MIA,2006,Dwyane Wade,24,75,75,2892,699,1413,.495,13,76,.171,686,1337,.513,.499,629,803,.783,107,323,430,503,146,58,268,217,2040
1304,MIA,2006,Udonis Haslem,25,81,80,2491,300,591,.508,0,2,.000,300,589,.509,.508,157,199,.789,167,467,634,95,50,17,80,216,757
1305,MIA,2006,Gary Payton,37,81,25,2305,230,547,.420,66,230,.287,164,317,.517,.481,100,126,.794,34,199,233,257,71,10,102,169,626
1306,MIA,2006,Antoine Walker,29,82,19,2199,391,898,.435,137,383,.358,254,515,.493,.512,81,129,.628,103,318,421,166,47,30,150,187,1000
1307,MIA,2006,James Posey,29,67,63,1914,159,395,.403,117,290,.403,42,105,.400,.551,48,61,.787,33,286,319,89,54,20,58,196,483
1308,MIA,2006,Jason Williams,30,59,56,1874,268,606,.442,107,288,.372,161,318,.506,.531,85,98,.867,6,133,139,287,53,5,100,101,728
1309,MIA,2006,Shaquille O'Neal,33,59,58,1806,480,800,.600,0,0,,480,800,.600,.600,221,471,.469,172,369,541,113,23,104,168,230,1181
1310,MIA,2006,Alonzo Mourning,35,65,20,1302,188,315,.597,0,1,.000,188,314,.599,.597,133,224,.594,125,234,359,11,13,173,79,177,509
1311,MIA,2006,Jason Kapono,24,51,2,665,79,177,.446,21,53,.396,58,124,.468,.506,28,33,.848,12,59,71,37,7,3,20,89,207
1312,MIA,2006,Shandon Anderson,32,48,1,638,54,126,.429,5,19,.263,49,107,.458,.448,13,18,.722,18,63,81,30,17,6,24,75,126
1313,MIA,2006,Derek Anderson,31,23,3,465,40,130,.308,21,67,.313,19,63,.302,.388,32,38,.842,9,51,60,48,8,2,17,49,133
1314,MIA,2006,Wayne Simien,22,43,2,414,58,120,.483,0,0,,58,120,.483,.483,30,34,.882,38,50,88,7,13,1,24,70,146
1315,MIA,2006,Michael Doleac,28,31,3,371,37,88,.420,0,0,,37,88,.420,.420,24,30,.800,23,62,85,8,10,7,14,45,98
1316,MIA,2006,Gerald Fitch,23,18,1,239,30,89,.337,7,26,.269,23,63,.365,.376,17,23,.739,7,23,30,33,7,5,15,28,84
1317,MIA,2006,Dorell Wright,20,20,2,132,20,43,.465,3,6,.500,17,37,.459,.500,15,17,.882,2,30,32,8,3,1,14,12,58
1318,MIA,2006,Earl Barron,24,8,0,45,5,16,.313,0,0,,5,16,.313,.313,3,4,.750,2,8,10,0,0,0,5,10,13
1319,MIA,2006,Matt Walsh,23,2,0,3,1,1,1.000,0,0,,1,1,1.000,1.000,0,2,.000,0,0,0,0,0,0,1,0,2
1320,MIA,2005,Dwyane Wade,23,77,77,2974,630,1318,.478,13,45,.289,617,1273,.485,.483,581,762,.762,110,287,397,520,121,82,321,230,1854
1321,MIA,2005,Eddie Jones,33,80,80,2839,351,820,.428,142,382,.372,209,438,.477,.515,174,216,.806,38,367,405,212,86,38,99,251,1018
1322,MIA,2005,Udonis Haslem,24,80,80,2675,346,641,.540,0,4,.000,346,637,.543,.540,178,225,.791,239,487,726,108,63,41,113,260,870
1323,MIA,2005,Damon Jones,28,82,66,2576,331,726,.456,225,521,.432,106,205,.517,.611,68,86,.791,14,217,231,350,44,5,98,121,955
1324,MIA,2005,Shaquille O'Neal,32,73,73,2492,658,1095,.601,0,0,,658,1095,.601,.601,353,765,.461,253,507,760,200,36,171,203,262,1669
1325,MIA,2005,Rasual Butler,25,65,15,1203,163,409,.399,57,153,.373,106,256,.414,.468,37,48,.771,15,136,151,62,18,29,37,104,420
1326,MIA,2005,Keyon Dooling,24,74,0,1184,139,345,.403,19,75,.253,120,270,.444,.430,85,109,.780,11,79,90,132,39,11,65,120,382
1327,MIA,2005,Michael Doleac,27,80,8,1175,148,331,.447,0,2,.000,148,329,.450,.447,25,41,.610,74,185,259,47,23,22,36,160,321
1328,MIA,2005,Shandon Anderson,31,65,5,1151,98,215,.456,5,28,.179,93,187,.497,.467,54,66,.818,40,150,190,70,40,14,49,136,255
1329,MIA,2005,Christian Laettner,35,49,0,739,107,184,.582,1,7,.143,106,177,.599,.584,45,59,.763,36,95,131,41,32,15,29,78,260
1330,MIA,2005,Malik Allen,26,14,0,248,35,76,.461,0,0,,35,76,.461,.461,13,14,.929,24,28,52,11,4,11,11,29,83
1331,MIA,2005,Alonzo Mourning,34,19,3,245,32,62,.516,0,0,,32,62,.516,.516,31,55,.564,22,49,71,4,3,33,12,32,95
1332,MIA,2005,Wesley Person,33,16,3,206,25,57,.439,8,21,.381,17,36,.472,.509,4,4,1.000,1,21,22,11,6,0,7,6,62
1333,MIA,2005,Steve Smith,35,13,0,114,9,30,.300,3,15,.200,6,15,.400,.350,2,3,.667,2,14,16,14,2,0,3,8,23
1334,MIA,2005,Wang Zhizhi,27,20,0,92,17,36,.472,2,3,.667,15,33,.455,.500,7,12,.583,6,12,18,5,3,2,5,9,43
1335,MIA,2005,Qyntel Woods,23,3,0,40,5,12,.417,0,0,,5,12,.417,.417,0,0,,2,4,6,0,4,0,2,6,10
1336,MIA,2005,Dorell Wright,19,3,0,27,3,11,.273,0,4,.000,3,7,.429,.273,1,1,1.000,0,1,1,3,4,0,3,2,7
1337,MIA,2004,Lamar Odom,24,80,80,3003,485,1127,.430,61,205,.298,424,922,.460,.457,340,458,.742,160,616,776,327,85,71,236,273,1371
1338,MIA,2004,Eddie Jones,32,81,81,2998,473,1156,.409,177,479,.370,296,677,.437,.486,278,333,.835,38,270,308,258,92,34,129,226,1401
1339,MIA,2004,Rafer Alston,27,82,28,2581,287,764,.376,161,434,.371,126,330,.382,.481,103,134,.769,26,200,226,372,114,18,128,212,838
1340,MIA,2004,Brian Grant,31,76,76,2303,289,613,.471,0,1,.000,289,612,.472,.471,86,110,.782,174,350,524,69,51,35,82,254,664
1341,MIA,2004,Dwyane Wade,22,61,56,2126,371,798,.465,16,53,.302,355,745,.477,.475,233,312,.747,85,162,247,275,86,34,196,140,991
1342,MIA,2004,Caron Butler,23,68,56,2030,240,631,.380,10,42,.238,230,589,.390,.388,133,176,.756,92,234,326,126,75,13,91,162,623
1343,MIA,2004,Udonis Haslem,23,75,24,1795,205,447,.459,0,3,.000,205,444,.462,.459,140,183,.765,189,284,473,51,33,24,74,197,550
1344,MIA,2004,Rasual Butler,24,45,0,675,119,250,.476,50,108,.463,69,142,.486,.576,16,21,.762,4,57,61,23,10,13,28,72,304
1345,MIA,2004,Malik Allen,25,45,6,616,83,198,.419,0,0,,83,198,.419,.419,25,33,.758,42,77,119,16,12,28,27,81,191
1346,MIA,2004,Loren Woods,25,38,2,506,44,96,.458,0,0,,44,96,.458,.458,33,55,.600,65,69,134,10,11,19,26,52,121
1347,MIA,2004,Samaki Walker,27,33,0,418,38,99,.384,0,2,.000,38,97,.392,.384,29,44,.659,42,70,112,6,9,11,15,54,105
1348,MIA,2004,John Wallace,29,37,0,368,61,145,.421,5,13,.385,56,132,.424,.438,31,40,.775,12,47,59,14,5,8,24,38,158
1349,MIA,2004,Bimbo Coles,35,22,1,170,12,34,.353,0,0,,12,34,.353,.353,4,6,.667,2,8,10,15,3,0,9,27,28
1350,MIA,2004,Wang Zhizhi,26,14,0,105,17,45,.378,4,14,.286,13,31,.419,.422,5,6,.833,4,10,14,2,3,4,6,13,43
1351,MIA,2004,Tyrone Hill,35,5,0,38,3,5,.600,0,0,,3,5,.600,.600,3,4,.750,5,3,8,0,0,1,2,10,9
1352,MIA,2004,Kirk Penney,23,2,0,18,1,6,.167,1,3,.333,0,3,.000,.250,0,0,,0,1,1,1,1,0,3,1,3
1353,MIA,2004,Jerome Beasley,23,2,0,5,1,3,.333,0,0,,1,3,.333,.333,0,0,,0,1,1,0,0,0,0,0,2
1354,MIA,2003,Caron Butler,22,78,78,2858,429,1032,.416,34,107,.318,395,925,.427,.432,309,375,.824,135,262,397,213,137,31,192,230,1201
1355,MIA,2003,Brian Grant,30,82,82,2641,344,676,.509,0,0,,344,676,.509,.509,158,205,.771,241,596,837,104,63,47,129,300,846
1356,MIA,2003,Malik Allen,24,80,73,2318,335,790,.424,0,4,.000,335,786,.426,.424,97,121,.802,134,291,425,54,37,78,128,234,767
1357,MIA,2003,Travis Best,30,72,52,1807,231,583,.396,36,109,.330,195,474,.411,.427,105,123,.854,26,121,147,255,44,7,106,174,603
1358,MIA,2003,Eddie Jones,31,47,47,1789,291,688,.423,98,241,.407,193,447,.432,.494,189,230,.822,35,191,226,173,64,31,85,137,869
1359,MIA,2003,Mike James,27,78,8,1722,218,585,.373,67,228,.294,151,357,.423,.430,104,142,.732,26,123,149,246,64,5,108,176,607
1360,MIA,2003,Vladimir Stepania,26,79,6,1594,185,427,.433,0,0,,185,427,.433,.433,71,134,.530,211,343,554,24,45,40,69,169,441
1361,MIA,2003,Rasual Butler,23,72,28,1514,207,572,.362,50,171,.292,157,401,.392,.406,76,104,.731,29,157,186,93,21,43,77,105,540
1362,MIA,2003,Eddie House,24,55,7,1025,172,444,.387,36,120,.300,136,324,.420,.428,31,36,.861,17,84,101,87,44,1,46,73,411
1363,MIA,2003,Anthony Carter,27,49,26,912,83,233,.356,0,8,.000,83,225,.369,.356,33,50,.660,12,71,83,203,45,5,81,70,199
1364,MIA,2003,LaPhonso Ellis,32,55,3,784,100,262,.382,27,107,.252,73,155,.471,.433,50,66,.758,44,113,157,15,15,15,31,88,277
1365,MIA,2003,Sean Lampley,23,35,0,487,56,129,.434,0,4,.000,56,125,.448,.434,57,82,.695,26,57,83,31,7,3,25,43,169
1366,MIA,2003,Sean Marks,27,23,0,223,22,59,.373,0,1,.000,22,58,.379,.373,10,15,.667,8,27,35,3,5,6,14,37,54
1367,MIA,2003,Ken Johnson,24,16,0,156,15,37,.405,0,0,,15,37,.405,.405,2,6,.333,4,28,32,0,1,12,6,20,32
1368,MIA,2002,Eddie Jones,30,81,81,3156,517,1198,.432,149,382,.390,368,816,.451,.494,297,355,.837,61,317,378,262,117,77,148,258,1480
1369,MIA,2002,Alonzo Mourning,31,75,74,2455,447,866,.516,1,3,.333,446,863,.517,.517,283,431,.657,182,450,632,87,27,186,182,258,1178
1370,MIA,2002,Rod Strickland,35,76,64,2294,316,714,.443,8,26,.308,308,688,.448,.448,154,201,.766,49,183,232,463,82,11,159,114,794
1371,MIA,2002,Brian Grant,29,72,72,2256,286,610,.469,0,2,.000,286,608,.470,.469,101,119,.849,168,407,575,137,48,31,122,236,673
1372,MIA,2002,Jim Jackson,31,55,19,1825,238,538,.442,38,81,.469,200,457,.438,.478,75,87,.862,54,236,290,140,42,14,106,145,589
1373,MIA,2002,LaPhonso Ellis,31,66,14,1684,189,452,.418,38,124,.306,151,328,.460,.460,53,84,.631,107,180,287,56,30,37,73,196,469
1374,MIA,2002,Kendall Gill,33,65,49,1410,162,422,.384,6,44,.136,156,378,.413,.391,42,62,.677,29,155,184,100,44,8,55,140,372
1375,MIA,2002,Eddie House,23,64,3,1230,209,524,.399,54,157,.344,155,367,.422,.450,42,49,.857,17,93,110,123,43,5,80,98,514
1376,MIA,2002,Anthony Carter,26,46,18,1050,89,260,.342,1,19,.053,88,241,.365,.344,19,36,.528,19,98,117,214,50,3,72,85,198
1377,MIA,2002,Vladimir Stepania,25,67,4,884,117,249,.470,1,2,.500,116,247,.470,.472,50,104,.481,100,170,270,16,24,44,52,103,285
1378,MIA,2002,Chris Gatling,34,54,1,809,131,293,.447,1,8,.125,130,285,.456,.449,82,117,.701,71,135,206,25,17,11,58,109,345
1379,MIA,2002,Sean Marks,26,21,6,319,38,88,.432,0,0,,38,88,.432,.432,20,34,.588,19,56,75,8,5,10,19,40,96
1380,MIA,2002,Malik Allen,23,12,2,161,22,51,.431,0,1,.000,22,50,.440,.431,8,10,.800,15,23,38,5,3,8,2,16,52
1381,MIA,2002,Sam Mack,31,12,1,159,14,49,.286,7,28,.250,7,21,.333,.357,5,7,.714,2,12,14,4,5,1,7,17,40
1382,MIA,2002,Mike James,26,15,0,119,15,43,.349,8,21,.381,7,22,.318,.442,4,7,.571,2,12,14,19,6,1,13,17,42
1383,MIA,2002,Tang Hamilton,23,9,2,98,10,19,.526,0,1,.000,10,18,.556,.526,0,1,.000,6,12,18,5,4,0,2,10,20
1384,MIA,2002,Ernest Brown,22,3,0,21,1,6,.167,0,0,,1,6,.167,.167,1,4,.250,1,5,6,0,0,1,3,4,3
1385,MIA,2001,Anthony Mason,34,80,80,3254,460,954,.482,0,0,,460,954,.482,.482,370,474,.781,169,601,770,248,80,25,179,231,1290
1386,MIA,2001,Brian Grant,28,82,79,2771,484,1010,.479,0,1,.000,484,1009,.480,.479,282,354,.797,217,501,718,101,60,71,170,293,1250
1387,MIA,2001,Bruce Bowen,29,82,72,2685,211,581,.363,103,307,.336,108,274,.394,.452,98,161,.609,45,200,245,132,83,53,74,269,623
1388,MIA,2001,Tim Hardaway,34,77,77,2613,408,1042,.392,189,517,.366,219,525,.417,.482,145,181,.801,26,178,204,483,90,6,189,155,1150
1389,MIA,2001,Eddie Jones,29,63,58,2282,388,871,.445,90,238,.378,298,633,.471,.497,228,270,.844,75,217,292,171,110,58,135,183,1094
1390,MIA,2001,Anthony Carter,25,72,6,1630,195,480,.406,6,40,.150,189,440,.430,.413,65,103,.631,46,134,180,268,73,10,119,154,461
1391,MIA,2001,A.C. Green,37,82,1,1411,144,324,.444,0,6,.000,144,318,.453,.444,79,111,.712,107,206,313,39,30,8,45,119,367
1392,MIA,2001,Dan Majerle,35,53,19,1306,87,259,.336,57,181,.315,30,78,.385,.446,36,44,.818,20,146,166,88,53,15,35,98,267
1393,MIA,2001,Eddie House,22,50,0,550,104,247,.421,19,55,.345,85,192,.443,.460,24,35,.686,5,37,42,52,13,0,35,58,251
1394,MIA,2001,Cedric Ceballos,31,27,0,393,73,158,.462,11,33,.333,62,125,.496,.497,29,33,.879,27,53,80,13,10,4,23,42,186
1395,MIA,2001,Duane Causwell,32,31,14,384,32,85,.376,0,0,,32,85,.376,.376,12,25,.480,23,60,83,5,8,18,23,67,76
1396,MIA,2001,Alonzo Mourning,30,13,3,306,73,141,.518,0,1,.000,73,140,.521,.518,31,55,.564,35,66,101,12,4,31,28,24,177
1397,MIA,2001,Todd Fuller,26,10,0,77,10,35,.286,0,0,,10,35,.286,.286,8,8,1.000,7,11,18,1,3,2,3,10,28
1398,MIA,2001,Don MacLean,31,8,1,76,10,20,.500,2,2,1.000,8,18,.444,.550,9,12,.750,7,11,18,4,5,1,10,9,31
1399,MIA,2001,Jamal Robinson,27,6,0,72,3,22,.136,0,2,.000,3,20,.150,.136,0,0,,3,8,11,2,6,0,3,7,6
1400,MIA,2001,Ricky Davis,21,7,0,70,12,29,.414,1,1,1.000,11,28,.393,.431,7,8,.875,1,6,7,11,5,2,5,7,32
1401,MIA,2000,Jamal Mashburn,27,76,76,2828,515,1158,.445,112,278,.403,403,880,.458,.493,186,239,.778,64,317,381,298,79,14,180,215,1328
1402,MIA,2000,Alonzo Mourning,29,79,78,2748,652,1184,.551,0,4,.000,652,1180,.553,.551,414,582,.711,215,538,753,123,40,294,217,308,1718
1403,MIA,2000,Dan Majerle,34,69,69,2308,170,422,.403,110,304,.362,60,118,.508,.533,56,69,.812,27,306,333,206,89,17,62,156,506
1404,MIA,2000,P.J. Brown,30,80,80,2302,322,671,.480,0,1,.000,322,670,.481,.480,120,159,.755,216,384,600,145,65,61,100,264,764
1405,MIA,2000,Anthony Carter,24,79,30,1859,201,509,.395,3,23,.130,198,486,.407,.398,93,124,.750,48,151,199,378,93,5,173,167,498
1406,MIA,2000,Tim Hardaway,33,52,52,1672,246,638,.386,94,256,.367,152,382,.398,.459,110,133,.827,25,125,150,385,49,4,119,112,696
1407,MIA,2000,Clarence Weatherspoon,29,78,2,1615,215,419,.513,0,0,,215,419,.513,.513,135,183,.738,128,321,449,93,51,49,100,165,565
1408,MIA,2000,Voshon Lenard,26,53,13,1434,228,560,.407,89,228,.390,139,332,.419,.487,84,106,.792,37,116,153,136,41,15,80,127,629
1409,MIA,2000,Otis Thorpe,37,51,1,777,125,243,.514,0,3,.000,125,240,.521,.514,29,48,.604,56,110,166,33,26,9,59,136,279
1410,MIA,2000,Mark Strickland,29,58,5,663,122,224,.545,0,0,,122,224,.545,.545,40,56,.714,44,96,140,22,15,18,24,68,284
1411,MIA,2000,Bruce Bowen,28,27,2,567,46,121,.380,26,56,.464,20,65,.308,.488,19,31,.613,13,47,60,18,14,10,14,81,137
1412,MIA,2000,Rex Walters,29,33,0,389,38,91,.418,5,20,.250,33,71,.465,.445,12,16,.750,8,28,36,65,6,0,29,44,93
1413,MIA,2000,Rodney Buford,22,34,0,386,62,151,.411,7,29,.241,55,122,.451,.434,16,22,.727,10,38,48,21,10,8,9,44,147
1414,MIA,2000,Duane Causwell,31,25,2,185,20,37,.541,0,0,,20,37,.541,.541,26,38,.684,11,36,47,2,2,16,10,42,66
1415,MIA,2000,Harold Jamison,23,12,0,74,7,20,.350,0,0,,7,20,.350,.350,4,18,.222,16,5,21,4,2,1,4,17,18
1416,MIA,2000,Tim James,23,4,0,23,5,14,.357,0,0,,5,14,.357,.357,1,3,.333,3,1,4,2,0,3,2,1,11
1417,MIA,1999,Tim Hardaway,32,48,48,1772,301,752,.400,112,311,.360,189,441,.429,.475,121,149,.812,15,137,152,352,57,6,131,102,835
1418,MIA,1999,Alonzo Mourning,28,46,46,1753,324,634,.511,0,2,.000,324,632,.513,.511,276,423,.652,166,341,507,74,34,180,139,161,924
1419,MIA,1999,Dan Majerle,33,48,48,1624,118,298,.396,68,203,.335,50,95,.526,.510,33,46,.717,21,187,208,150,38,7,55,100,337
1420,MIA,1999,P.J. Brown,29,50,50,1611,229,477,.480,0,0,,229,477,.480,.480,113,146,.774,115,231,346,66,46,48,69,166,571
1421,MIA,1999,Terry Porter,35,50,1,1365,172,370,.465,58,141,.411,114,229,.498,.543,123,148,.831,13,127,140,146,48,11,74,97,525
1422,MIA,1999,Clarence Weatherspoon,28,49,3,1040,141,264,.534,0,0,,141,264,.534,.534,115,143,.804,72,171,243,34,28,17,61,107,397
1423,MIA,1999,Jamal Mashburn,26,24,23,855,134,297,.451,13,30,.433,121,267,.453,.473,75,104,.721,24,122,146,75,20,3,60,58,356
1424,MIA,1999,Rex Walters,28,33,13,506,35,95,.368,12,38,.316,23,57,.404,.432,19,23,.826,10,40,50,58,10,3,32,63,101
1425,MIA,1999,Keith Askins,31,33,13,415,20,62,.323,8,29,.276,12,33,.364,.387,5,8,.625,10,34,44,10,17,3,13,58,53
1426,MIA,1999,Mark Strickland,28,32,1,357,50,101,.495,0,1,.000,50,100,.500,.495,19,26,.731,26,52,78,9,7,8,13,28,119
1427,MIA,1999,Blue Edwards,33,24,0,283,32,72,.444,4,10,.400,28,62,.452,.472,9,13,.692,7,26,33,30,17,5,21,23,77
1428,MIA,1999,Voshon Lenard,25,12,2,190,31,79,.392,12,35,.343,19,44,.432,.468,8,11,.727,4,12,16,10,3,1,7,18,82
1429,MIA,1999,Duane Causwell,30,19,1,137,20,35,.571,0,0,,20,35,.571,.571,4,12,.333,14,21,35,2,0,11,18,32,44
1430,MIA,1999,Mark Davis,25,4,1,35,2,6,.333,0,0,,2,6,.333,.333,5,6,.833,2,5,7,1,1,0,7,12,9
1431,MIA,1999,Marty Conlon,31,7,0,35,3,13,.231,0,0,,3,13,.231,.231,2,2,1.000,1,4,5,1,0,1,3,6,8
1432,MIA,1999,Terry Mills,31,1,0,29,3,8,.375,2,4,.500,1,4,.250,.500,1,2,.500,3,1,4,0,1,0,3,3,9
1433,MIA,1999,Jamie Watson,26,3,0,18,1,2,.500,0,0,,1,2,.500,.500,0,0,,0,1,1,1,0,0,1,1,2
1434,MIA,1998,Tim Hardaway,31,81,81,3031,558,1296,.431,155,442,.351,403,854,.472,.490,257,329,.781,48,251,299,672,136,16,224,200,1528
1435,MIA,1998,Voshon Lenard,24,81,81,2621,363,854,.425,153,378,.405,210,476,.441,.515,141,179,.788,72,220,292,180,58,16,99,219,1020
1436,MIA,1998,P.J. Brown,28,74,74,2362,278,590,.471,0,0,,278,590,.471,.471,151,197,.766,235,400,635,103,66,98,97,264,707
1437,MIA,1998,Alonzo Mourning,27,58,56,1939,403,732,.551,0,0,,403,732,.551,.551,309,465,.665,193,365,558,52,40,130,179,208,1115
1438,MIA,1998,Dan Majerle,32,72,22,1928,184,439,.419,111,295,.376,73,144,.507,.546,40,51,.784,48,220,268,157,68,15,65,139,519
1439,MIA,1998,Jamal Mashburn,25,48,48,1729,251,577,.435,37,122,.303,214,455,.470,.467,184,231,.797,72,164,236,132,43,14,108,137,723
1440,MIA,1998,Eric Murdock,29,82,1,1395,177,419,.422,28,91,.308,149,328,.454,.456,125,156,.801,39,117,156,219,103,13,104,173,507
1441,MIA,1998,Isaac Austin,28,52,25,1371,252,532,.474,0,3,.000,252,529,.476,.474,155,228,.680,119,211,330,87,43,34,117,162,659
1442,MIA,1998,Mark Strickland,27,51,8,847,145,269,.539,0,1,.000,145,268,.541,.539,59,82,.720,80,133,213,26,18,34,47,87,349
1443,MIA,1998,Terry Mills,30,50,0,782,81,206,.393,25,81,.309,56,125,.448,.454,25,33,.758,34,118,152,39,19,9,45,129,212
1444,MIA,1998,Keith Askins,30,46,12,681,39,122,.320,21,74,.284,18,48,.375,.406,12,19,.632,28,73,101,29,27,12,26,107,111
1445,MIA,1998,Duane Causwell,29,37,2,363,37,89,.416,0,0,,37,89,.416,.416,15,26,.577,29,70,99,5,7,27,18,73,89
1446,MIA,1998,Brent Barry,26,17,0,259,23,62,.371,12,34,.353,11,28,.393,.468,12,12,1.000,2,26,28,21,14,4,9,30,70
1447,MIA,1998,Marty Conlon,30,18,0,209,28,62,.452,0,0,,28,62,.452,.452,32,44,.727,16,30,46,12,9,5,11,27,88
1448,MIA,1998,Rex Walters,27,19,0,108,13,24,.542,3,8,.375,10,16,.625,.604,9,11,.818,2,13,15,14,3,1,10,11,38
1449,MIA,1998,Todd Day,28,5,0,69,11,31,.355,2,12,.167,9,19,.474,.387,6,9,.667,4,2,6,7,7,0,3,10,30
1450,MIA,1998,Charles Smith,22,11,0,32,4,18,.222,1,3,.333,3,15,.200,.250,1,2,.500,5,3,8,2,2,1,6,3,10
1451,MIA,1998,Antonio Lang,25,6,0,29,3,5,.600,0,0,,3,5,.600,.600,6,8,.750,2,3,5,1,2,0,4,3,12
1452,MIA,1997,Tim Hardaway,30,81,81,3136,575,1384,.415,203,590,.344,372,794,.469,.489,291,364,.799,49,228,277,695,151,9,230,165,1644
1453,MIA,1997,P.J. Brown,27,80,71,2592,300,656,.457,0,2,.000,300,654,.459,.457,161,220,.732,239,431,670,92,85,98,113,283,761
1454,MIA,1997,Alonzo Mourning,26,66,65,2320,473,885,.534,1,9,.111,472,876,.539,.535,363,565,.642,189,467,656,104,56,189,226,272,1310
1455,MIA,1997,Voshon Lenard,23,73,47,2111,314,684,.459,183,442,.414,131,242,.541,.593,86,105,.819,38,179,217,161,50,18,109,168,897
1456,MIA,1997,Isaac Austin,27,82,17,1881,321,639,.502,0,3,.000,321,636,.505,.502,150,226,.664,136,342,478,101,45,43,161,244,792
1457,MIA,1997,Keith Askins,29,78,30,1773,138,319,.433,69,172,.401,69,147,.469,.541,39,58,.672,86,185,271,75,53,19,59,196,384
1458,MIA,1997,Sasha Danilović,26,43,33,1351,175,396,.442,63,176,.358,112,220,.509,.521,73,94,.777,21,81,102,77,39,8,94,123,486
1459,MIA,1997,Dan Majerle,31,36,26,1264,141,347,.406,68,201,.338,73,146,.500,.504,40,59,.678,45,117,162,116,54,14,50,75,390
1460,MIA,1997,Jamal Mashburn,24,32,30,1189,146,367,.398,48,146,.329,98,221,.443,.463,88,117,.752,41,138,179,111,43,7,57,117,428
1461,MIA,1997,John Crotty,27,48,0,659,79,154,.513,20,49,.408,59,105,.562,.578,54,64,.844,15,32,47,102,18,0,42,79,232
1462,MIA,1997,Kurt Thomas,24,18,9,374,39,105,.371,0,1,.000,39,104,.375,.371,35,46,.761,31,76,107,9,12,9,25,67,113
1463,MIA,1997,Gary Grant,31,28,0,365,39,110,.355,14,46,.304,25,64,.391,.418,18,22,.818,8,30,38,45,16,0,27,39,110
1464,MIA,1997,Willie Anderson,30,28,1,303,29,64,.453,8,19,.421,21,45,.467,.516,17,20,.850,15,27,42,34,14,4,19,36,83
1465,MIA,1997,Ed Pinckney,33,27,0,273,23,43,.535,0,0,,23,43,.535,.535,20,25,.800,25,40,65,6,8,9,19,30,66
1466,MIA,1997,Mark Strickland,26,31,0,153,25,60,.417,0,1,.000,25,59,.424,.417,12,21,.571,16,21,37,1,4,10,15,17,62
1467,MIA,1997,James Scott,24,8,0,32,0,8,.000,0,4,.000,0,4,.000,.000,1,2,.500,1,5,6,3,2,0,2,5,1
1468,MIA,1997,Martin Müürsepp,22,10,0,27,5,14,.357,1,4,.250,4,10,.400,.393,6,14,.429,2,3,5,3,0,1,3,3,17
1469,MIA,1997,Matt Fish,27,1,0,1,0,0,,0,0,,0,0,,,0,0,,0,0,0,0,0,0,0,0,0
1470,MIA,1997,Bruce Bowen,25,1,0,1,0,0,,0,0,,0,0,,,0,0,,0,0,0,0,0,1,0,0,0
1471,MIA,1996,Alonzo Mourning,25,70,70,2671,563,1076,.523,9,30,.300,554,1046,.530,.527,488,712,.685,218,509,727,159,70,189,262,245,1623
1472,MIA,1996,Keith Askins,28,75,14,1897,157,391,.402,99,237,.418,58,154,.377,.528,45,57,.789,113,211,324,121,48,61,82,271,458
1473,MIA,1996,Bimbo Coles,27,52,52,1882,231,559,.413,63,172,.366,168,387,.434,.470,139,173,.803,38,163,201,296,63,12,123,175,664
1474,MIA,1996,Rex Chapman,28,56,50,1865,289,679,.426,125,337,.371,164,342,.480,.518,83,113,.735,22,123,145,166,45,10,79,117,786
1475,MIA,1996,Kurt Thomas,23,74,42,1655,274,547,.501,0,2,.000,274,545,.503,.501,118,178,.663,122,317,439,46,47,36,98,271,666
1476,MIA,1996,Billy Owens,26,40,40,1388,239,473,.505,0,6,.000,239,467,.512,.505,112,177,.633,94,192,286,134,30,22,113,132,590
1477,MIA,1996,Kevin Willis,33,47,42,1357,195,412,.473,0,5,.000,195,407,.479,.473,89,125,.712,134,286,420,34,19,25,99,158,479
1478,MIA,1996,Tim Hardaway,29,28,28,1047,164,386,.425,53,147,.361,111,239,.464,.494,101,123,.821,13,85,98,280,58,6,110,70,482
1479,MIA,1996,Kevin Gamble,30,44,13,1033,117,297,.394,38,91,.418,79,206,.383,.458,33,38,.868,14,72,86,82,31,5,32,119,305
1480,MIA,1996,Walt Williams,25,28,28,788,124,268,.463,56,123,.455,68,145,.469,.567,33,60,.550,37,75,112,65,32,16,48,87,337
1481,MIA,1996,Pete Myers,32,39,1,639,62,160,.388,11,42,.262,51,118,.432,.422,49,76,.645,21,52,73,97,14,11,56,75,184
1482,MIA,1996,Chris Gatling,28,24,0,565,155,259,.598,0,0,,155,259,.598,.598,55,75,.733,51,124,175,17,17,11,35,82,365
1483,MIA,1996,Sasha Danilović,25,19,18,542,83,184,.451,34,78,.436,49,106,.462,.543,55,72,.764,12,34,46,47,15,3,37,49,255
1484,MIA,1996,Tony Smith,27,25,1,410,46,101,.455,13,39,.333,33,62,.532,.520,4,9,.444,6,33,39,68,16,5,26,46,109
1485,MIA,1996,Danny Schayes,36,32,6,399,32,94,.340,0,0,,32,94,.340,.340,37,46,.804,29,60,89,9,11,16,23,60,101
1486,MIA,1996,Terrence Rencher,22,34,1,397,32,99,.323,9,29,.310,23,70,.329,.369,30,43,.698,9,33,42,54,16,1,41,36,103
1487,MIA,1996,Tyrone Corbin,33,22,0,354,38,92,.413,2,6,.333,36,86,.419,.424,23,28,.821,26,39,65,23,16,3,17,51,101
1488,MIA,1996,Voshon Lenard,22,30,0,323,53,141,.376,36,101,.356,17,40,.425,.504,34,43,.791,12,40,52,31,6,1,23,31,176
1489,MIA,1996,Ron Grandison,31,18,3,235,13,39,.333,4,13,.308,9,26,.346,.385,13,19,.684,14,22,36,10,8,1,11,27,43
1490,MIA,1996,Stacey King,29,15,0,156,17,36,.472,0,0,,17,36,.472,.472,4,8,.500,9,14,23,2,7,2,18,39,38
1491,MIA,1996,Jeff Malone,34,7,0,103,13,33,.394,0,0,,13,33,.394,.394,5,6,.833,0,8,8,7,3,0,3,6,31
1492,MIA,1996,LeRon Ellis,26,12,1,74,5,22,.227,0,0,,5,22,.227,.227,3,6,.500,5,3,8,4,2,3,3,11,13
1493,MIA,1995,Glen Rice,27,82,82,3014,667,1403,.475,185,451,.410,482,952,.506,.541,312,365,.855,99,279,378,192,112,14,153,203,1831
1494,MIA,1995,Kevin Willis,32,65,61,2301,457,974,.469,3,14,.214,454,960,.473,.471,195,282,.691,217,479,696,83,59,33,155,208,1112
1495,MIA,1995,Billy Owens,25,70,60,2296,403,820,.491,2,22,.091,401,798,.503,.493,194,313,.620,203,299,502,246,80,30,204,205,1002
1496,MIA,1995,Bimbo Coles,26,68,65,2207,261,607,.430,16,76,.211,245,531,.461,.443,141,174,.810,46,145,191,416,99,13,156,185,679
1497,MIA,1995,John Salley,30,75,50,1955,197,395,.499,0,0,,197,395,.499,.499,153,207,.739,110,226,336,123,47,85,97,279,547
1498,MIA,1995,Matt Geiger,25,74,43,1712,260,485,.536,4,10,.400,256,475,.539,.540,93,143,.650,146,267,413,55,41,51,113,245,617
1499,MIA,1995,Khalid Reeves,22,67,17,1462,206,465,.443,67,171,.392,139,294,.473,.515,140,196,.714,52,134,186,288,77,10,132,139,619
1500,MIA,1995,Kevin Gamble,29,77,0,1223,220,450,.489,39,98,.398,181,352,.514,.532,87,111,.784,29,93,122,119,52,10,49,130,566
1501,MIA,1995,Ledell Eackles,28,54,6,898,143,326,.439,18,41,.439,125,285,.439,.466,91,126,.722,33,62,95,72,19,2,53,88,395
1502,MIA,1995,Harold Miner,23,45,16,871,123,305,.403,14,49,.286,109,256,.426,.426,69,95,.726,38,79,117,69,15,6,77,85,329
1503,MIA,1995,Keith Askins,27,50,5,854,81,207,.391,21,78,.269,60,129,.465,.442,46,57,.807,86,112,198,39,35,17,25,109,229
1504,MIA,1995,Brad Lohaus,30,61,1,730,97,231,.420,63,155,.406,34,76,.447,.556,10,15,.667,28,74,102,43,20,25,29,85,267
1505,MIA,1995,Kevin Pritchard,27,14,0,158,13,29,.448,2,5,.400,11,24,.458,.483,15,17,.882,0,11,11,23,2,1,7,19,43
1506,MIA,1995,Grant Long,28,2,2,62,5,12,.417,0,0,,5,12,.417,.417,6,10,.600,1,10,11,4,2,0,4,11,16
1507,MIA,1995,Steve Smith,25,2,2,62,11,29,.379,2,12,.167,9,17,.529,.414,17,22,.773,4,2,6,7,2,1,4,9,41
1508,MIA,1994,Glen Rice,26,81,81,2999,663,1421,.467,132,346,.382,531,1075,.494,.513,250,284,.880,76,358,434,184,110,32,130,186,1708
1509,MIA,1994,Steve Smith,24,78,77,2776,491,1076,.456,91,262,.347,400,814,.491,.499,273,327,.835,156,196,352,394,84,35,202,217,1346
1510,MIA,1994,Rony Seikaly,28,72,60,2410,392,803,.488,0,2,.000,392,801,.489,.488,304,422,.720,244,496,740,136,59,100,195,279,1088
1511,MIA,1994,Grant Long,27,69,59,2201,300,672,.446,1,6,.167,299,666,.449,.447,187,238,.786,190,305,495,170,89,26,125,244,788
1512,MIA,1994,Brian Shaw,27,77,52,2037,278,667,.417,73,216,.338,205,451,.455,.472,64,89,.719,104,246,350,385,71,21,173,195,693
1513,MIA,1994,John Salley,29,76,45,1910,208,436,.477,2,3,.667,206,433,.476,.479,164,225,.729,132,275,407,135,56,78,94,260,582
1514,MIA,1994,Bimbo Coles,25,76,4,1726,233,519,.449,20,99,.202,213,420,.507,.468,102,131,.779,50,109,159,263,75,12,107,132,588
1515,MIA,1994,Harold Miner,22,63,31,1358,254,532,.477,4,6,.667,250,526,.475,.481,149,180,.828,75,81,156,95,31,13,95,132,661
1516,MIA,1994,Matt Geiger,24,72,0,1199,202,352,.574,1,5,.200,201,347,.579,.575,116,149,.779,119,184,303,32,36,29,61,201,521
1517,MIA,1994,Willie Burton,25,53,1,697,124,283,.438,3,15,.200,121,268,.451,.443,120,158,.759,50,86,136,39,18,20,54,96,371
1518,MIA,1994,Keith Askins,26,37,0,319,36,88,.409,4,21,.190,32,67,.478,.432,9,10,.900,33,49,82,13,11,1,21,57,85
1519,MIA,1994,Alec Kessler,27,15,0,66,11,25,.440,5,9,.556,6,16,.375,.540,6,8,.750,4,6,10,2,1,1,5,14,33
1520,MIA,1994,Manute Bol,31,8,0,61,1,12,.083,0,3,.000,1,9,.111,.083,0,0,,1,10,11,0,0,6,5,4,2
1521,MIA,1994,Morlon Wiley,27,4,0,34,3,8,.375,1,4,.250,2,4,.500,.438,0,0,,0,4,4,7,2,0,6,4,7
1522,MIA,1994,Gary Alexander,24,4,0,12,1,2,.500,0,0,,1,2,.500,.500,0,2,.000,1,2,3,1,0,0,1,3,2
1523,MIA,1993,Glen Rice,25,82,82,3082,582,1324,.440,148,386,.383,434,938,.463,.495,242,295,.820,92,332,424,180,92,25,157,201,1554
1524,MIA,1993,Grant Long,26,76,62,2728,397,847,.469,6,26,.231,391,821,.476,.472,261,341,.765,197,371,568,182,104,31,133,264,1061
1525,MIA,1993,Rony Seikaly,27,72,64,2456,417,868,.480,1,8,.125,416,860,.484,.481,397,540,.735,259,587,846,100,38,83,203,260,1232
1526,MIA,1993,Bimbo Coles,24,81,37,2232,318,686,.464,42,137,.307,276,549,.503,.494,177,220,.805,58,108,166,373,80,11,108,199,855
1527,MIA,1993,Steve Smith,23,48,43,1610,279,619,.451,53,132,.402,226,487,.464,.494,155,197,.787,56,141,197,267,50,16,129,148,766
1528,MIA,1993,Brian Shaw,26,68,45,1603,197,501,.393,43,130,.331,154,371,.415,.436,61,78,.782,70,187,257,235,48,19,96,163,498
1529,MIA,1993,John Salley,28,51,34,1422,154,307,.502,0,0,,154,307,.502,.502,115,144,.799,113,200,313,83,32,70,101,192,423
1530,MIA,1993,Harold Miner,21,73,0,1383,292,615,.475,3,9,.333,289,606,.477,.477,163,214,.762,74,73,147,73,34,8,92,130,750
1531,MIA,1993,Kevin Edwards,27,40,30,1134,216,462,.468,5,17,.294,211,445,.474,.473,119,141,.844,48,73,121,120,68,12,75,69,556
1532,MIA,1993,Keith Askins,25,69,1,935,88,213,.413,22,65,.338,66,148,.446,.465,29,40,.725,74,124,198,31,31,29,37,141,227
1533,MIA,1993,Matt Geiger,23,48,2,554,76,145,.524,0,4,.000,76,141,.539,.524,62,92,.674,46,74,120,14,15,18,36,123,214
1534,MIA,1993,Willie Burton,24,26,8,451,54,141,.383,5,15,.333,49,126,.389,.401,91,127,.717,22,48,70,16,13,16,50,58,204
1535,MIA,1993,Alec Kessler,26,40,2,415,57,122,.467,5,11,.455,52,111,.468,.488,36,47,.766,25,66,91,14,4,12,21,63,155
1536,MIA,1992,Grant Long,25,82,82,3063,440,890,.494,6,22,.273,434,868,.500,.498,326,404,.807,259,432,691,225,139,40,185,248,1212
1537,MIA,1992,Glen Rice,24,79,79,3007,672,1432,.469,155,396,.391,517,1036,.499,.523,266,318,.836,84,310,394,184,90,35,145,170,1765
1538,MIA,1992,Rony Seikaly,26,79,78,2800,463,947,.489,0,3,.000,463,944,.490,.489,370,505,.733,307,627,934,109,40,121,216,278,1296
1539,MIA,1992,Bimbo Coles,23,81,28,1976,295,649,.455,10,52,.192,285,597,.477,.462,216,262,.824,69,120,189,366,73,13,167,151,816
1540,MIA,1992,Kevin Edwards,26,81,1,1840,325,716,.454,7,32,.219,318,684,.465,.459,162,191,.848,56,155,211,170,99,20,120,138,819
1541,MIA,1992,Steve Smith,22,61,59,1806,297,654,.454,40,125,.320,257,529,.486,.485,95,127,.748,81,107,188,278,59,19,152,162,729
1542,MIA,1992,Willie Burton,23,68,50,1585,280,622,.450,6,15,.400,274,607,.451,.455,196,245,.800,76,168,244,123,46,37,119,186,762
1543,MIA,1992,Alec Kessler,25,77,4,1197,158,383,.413,0,0,,158,383,.413,.413,94,115,.817,114,200,314,34,17,32,58,185,410
1544,MIA,1992,Brian Shaw,25,46,23,987,139,349,.398,5,16,.313,134,333,.402,.405,37,51,.725,39,96,135,161,45,12,67,86,320
1545,MIA,1992,Keith Askins,24,59,4,843,84,205,.410,25,73,.342,59,132,.447,.471,26,37,.703,65,77,142,38,40,15,47,109,219
1546,MIA,1992,Alan Ogg,24,43,0,367,46,84,.548,0,0,,46,84,.548,.548,16,30,.533,30,44,74,7,5,28,19,73,108
1547,MIA,1992,John Morton,24,21,0,216,33,81,.407,2,15,.133,31,66,.470,.420,24,29,.828,3,16,19,27,12,1,24,20,92
1548,MIA,1992,Sherman Douglas,25,5,2,98,16,31,.516,0,1,.000,16,30,.533,.516,5,7,.714,1,5,6,19,4,0,8,10,37
1549,MIA,1992,Miloš Babić,23,9,0,35,6,13,.462,0,0,,6,13,.462,.462,6,8,.750,2,9,11,6,1,0,5,0,18
1550,MIA,1992,Jon Sundvold,30,3,0,8,1,3,.333,1,1,1.000,0,2,.000,.500,0,0,,0,0,0,2,0,0,0,2,3
1551,MIA,1992,Winston Bennett,26,2,0,2,1,2,.500,0,0,,1,2,.500,.500,0,0,,1,0,1,0,0,0,0,1,2
1552,MIA,1991,Glen Rice,23,77,77,2646,550,1193,.461,71,184,.386,479,1009,.475,.491,171,209,.818,85,296,381,189,101,26,166,216,1342
1553,MIA,1991,Sherman Douglas,24,73,73,2562,532,1055,.504,4,31,.129,528,1024,.516,.506,284,414,.686,78,131,209,624,121,5,270,178,1352
1554,MIA,1991,Grant Long,24,80,66,2514,276,561,.492,1,6,.167,275,555,.495,.493,181,230,.787,225,343,568,176,119,43,156,295,734
1555,MIA,1991,Rony Seikaly,25,64,59,2171,395,822,.481,2,6,.333,393,816,.482,.482,258,417,.619,207,502,709,95,51,86,205,213,1050
1556,MIA,1991,Kevin Edwards,25,79,16,2000,380,927,.410,24,84,.286,356,843,.422,.423,171,213,.803,80,125,205,240,129,46,163,151,955
1557,MIA,1991,Willie Burton,22,76,26,1928,341,773,.441,4,30,.133,337,743,.454,.444,229,293,.782,111,151,262,107,72,24,144,275,915
1558,MIA,1991,Billy Thompson,27,73,46,1481,205,411,.499,0,4,.000,205,407,.504,.499,89,124,.718,120,192,312,111,32,48,117,161,499
1559,MIA,1991,Bimbo Coles,22,82,9,1355,162,393,.412,6,34,.176,156,359,.435,.420,71,95,.747,56,97,153,232,65,12,98,149,401
1560,MIA,1991,Alec Kessler,24,78,18,1259,199,468,.425,0,4,.000,199,464,.429,.425,88,131,.672,115,221,336,31,17,26,108,189,486
1561,MIA,1991,Terry Davis,23,55,17,996,115,236,.487,1,2,.500,114,234,.487,.489,69,124,.556,107,159,266,39,18,28,36,129,300
1562,MIA,1991,Keith Askins,23,39,1,266,34,81,.420,6,25,.240,28,56,.500,.457,12,25,.480,30,38,68,19,16,13,11,46,86
1563,MIA,1991,Alan Ogg,23,31,1,261,24,55,.436,0,2,.000,24,53,.453,.436,6,10,.600,15,34,49,2,6,27,8,53,54
1564,MIA,1991,Jon Sundvold,29,24,0,225,43,107,.402,15,35,.429,28,72,.389,.472,11,11,1.000,3,6,9,24,7,0,16,11,112
1565,MIA,1991,Milt Wagner,27,13,1,116,24,57,.421,6,17,.353,18,40,.450,.474,9,11,.818,0,7,7,15,2,3,12,14,63
1566,MIA,1990,Sherman Douglas,23,81,66,2470,463,938,.494,5,31,.161,458,907,.505,.496,224,326,.687,70,136,206,619,145,10,246,187,1155
1567,MIA,1990,Rony Seikaly,24,74,72,2409,486,968,.502,0,1,.000,486,967,.503,.502,256,431,.594,253,513,766,78,78,124,236,258,1228
1568,MIA,1990,Glen Rice,22,77,60,2311,470,1071,.439,17,69,.246,453,1002,.452,.447,91,124,.734,100,252,352,138,67,27,113,198,1048
1569,MIA,1990,Kevin Edwards,24,78,54,2211,395,959,.412,9,30,.300,386,929,.416,.417,139,183,.760,77,205,282,252,125,33,180,149,938
1570,MIA,1990,Billy Thompson,26,79,45,2142,375,727,.516,2,4,.500,373,723,.516,.517,115,185,.622,238,313,551,166,54,89,156,237,867
1571,MIA,1990,Grant Long,23,81,31,1856,257,532,.483,0,3,.000,257,529,.486,.483,172,241,.714,156,246,402,96,91,38,139,300,686
1572,MIA,1990,Tellis Frank,24,77,39,1762,278,607,.458,0,0,,278,607,.458,.458,179,234,.765,151,234,385,85,51,27,134,282,735
1573,MIA,1990,Rory Sparrow,31,82,25,1756,210,510,.412,8,40,.200,202,470,.430,.420,59,77,.766,37,101,138,298,49,4,99,140,487
1574,MIA,1990,Terry Davis,22,63,9,884,122,262,.466,0,1,.000,122,261,.467,.466,54,87,.621,93,136,229,25,25,28,68,171,298
1575,MIA,1990,Jon Sundvold,28,63,2,867,148,363,.408,44,100,.440,104,263,.395,.468,44,52,.846,15,56,71,102,25,0,52,69,384
1576,MIA,1990,Scott Haffner,23,43,6,559,88,217,.406,3,21,.143,85,196,.434,.412,17,25,.680,7,44,51,80,13,2,33,53,196
1577,MIA,1990,Pat Cummings,33,37,1,391,77,159,.484,0,0,,77,159,.484,.484,21,37,.568,28,65,93,13,12,4,32,60,175
1578,MIA,1990,Jim Rowinski,29,14,0,112,14,32,.438,0,0,,14,32,.438,.438,22,26,.846,17,12,29,5,1,2,10,19,50
1579,MIA,1989,Rory Sparrow,30,80,79,2613,444,982,.452,18,74,.243,426,908,.469,.461,94,107,.879,55,161,216,429,103,17,204,168,1000
1580,MIA,1989,Grant Long,22,82,73,2435,336,692,.486,0,5,.000,336,687,.489,.486,304,406,.749,240,306,546,149,122,48,201,337,976
1581,MIA,1989,Kevin Edwards,23,79,62,2349,470,1105,.425,10,37,.270,460,1068,.431,.430,144,193,.746,85,177,262,349,139,27,246,154,1094
1582,MIA,1989,Billy Thompson,25,79,58,2273,349,716,.487,0,4,.000,349,712,.490,.487,156,224,.696,241,331,572,176,56,105,189,260,854
1583,MIA,1989,Rony Seikaly,23,78,62,1962,333,744,.448,1,4,.250,332,740,.449,.448,181,354,.511,204,345,549,55,46,96,200,258,848
1584,MIA,1989,Jon Sundvold,27,68,8,1338,307,675,.455,48,92,.522,259,583,.444,.490,47,57,.825,18,69,87,137,27,1,87,78,709
1585,MIA,1989,Sylvester Gray,21,55,15,1220,167,398,.420,1,4,.250,166,394,.421,.421,105,156,.673,117,169,286,117,36,25,102,144,440
1586,MIA,1989,Scott Hastings,28,75,6,1206,143,328,.436,9,28,.321,134,300,.447,.450,91,107,.850,72,159,231,59,32,42,68,203,386
1587,MIA,1989,Pat Cummings,32,53,28,1096,197,394,.500,0,2,.000,197,392,.503,.500,72,97,.742,84,197,281,47,29,18,111,160,466
1588,MIA,1989,Pearl Washington,25,54,8,1065,164,387,.424,1,14,.071,163,373,.437,.425,82,104,.788,49,74,123,226,73,4,122,101,411
1589,MIA,1989,John Shasky,24,65,4,944,121,248,.488,0,2,.000,121,246,.492,.488,115,167,.689,96,136,232,22,14,13,46,94,357
1590,MIA,1989,Anthony Taylor,23,21,7,368,60,151,.397,0,2,.000,60,149,.403,.397,24,32,.750,11,23,34,43,22,5,20,37,144
1591,MIA,1989,Craig Neal,24,32,0,341,34,88,.386,8,25,.320,26,63,.413,.432,13,21,.619,4,14,18,86,15,4,40,46,89
1592,MIA,1989,Todd Mitchell,22,22,0,320,41,88,.466,0,0,,41,88,.466,.466,36,60,.600,17,30,47,20,15,2,29,49,118
1593,MIA,1989,Kelvin Upshaw,26,9,0,144,26,63,.413,1,5,.200,25,58,.431,.421,4,6,.667,4,9,13,20,7,0,13,18,57
1594,MIA,1989,Clinton Wheeler,29,8,0,143,24,42,.571,0,0,,24,42,.571,.571,8,10,.800,5,7,12,21,8,0,6,9,56
1595,MIA,1989,Dave Popson,24,7,0,38,5,15,.333,0,0,,5,15,.333,.333,1,2,.500,7,4,11,2,0,1,4,8,11
1596,WAS,2024,Jordan Poole,24,78,66,2346,490,1186,.413,184,564,.326,306,622,.492,.491,192,219,.877,32,180,212,343,86,25,188,244,1356
1597,WAS,2024,Kyle Kuzma,28,70,70,2281,608,1313,.463,151,450,.336,457,863,.530,.521,186,240,.775,62,402,464,296,37,49,192,153,1553
1598,WAS,2024,Deni Avdija,23,75,75,2257,406,803,.506,88,235,.374,318,568,.560,.560,202,273,.740,84,456,540,286,60,36,160,185,1102
1599,WAS,2024,Corey Kispert,24,80,22,2067,386,794,.486,184,480,.383,202,314,.643,.602,114,157,.726,30,195,225,156,41,16,98,141,1070
1600,WAS,2024,Tyus Jones,27,66,66,1933,326,666,.489,106,256,.414,220,410,.537,.569,32,40,.800,20,159,179,485,71,18,66,48,790
1601,WAS,2024,Bilal Coulibaly,19,63,15,1715,188,432,.435,64,185,.346,124,247,.502,.509,92,131,.702,56,200,256,110,57,48,87,137,532
1602,WAS,2024,Daniel Gafford,25,45,45,1192,203,294,.690,0,0,,203,294,.690,.690,84,119,.706,131,230,361,69,44,97,46,147,490
1603,WAS,2024,Landry Shamet,26,46,5,726,118,274,.431,53,157,.338,65,117,.556,.527,38,46,.826,16,46,62,54,25,10,30,76,327
1604,WAS,2024,Johnny Davis,21,50,6,613,62,154,.403,14,40,.350,48,114,.421,.448,14,24,.583,18,54,72,32,18,10,13,57,152
1605,WAS,2024,Marvin Bagley III,24,24,15,575,132,227,.581,8,17,.471,124,210,.590,.599,46,65,.708,84,110,194,28,15,19,30,41,318
1606,WAS,2024,Jared Butler,23,40,0,566,98,201,.488,24,78,.308,74,123,.602,.547,31,36,.861,9,49,58,126,29,8,50,58,251
1607,WAS,2024,Patrick Baldwin Jr.,21,38,7,493,59,155,.381,31,97,.320,28,58,.483,.481,19,28,.679,17,106,123,29,18,15,19,56,168
1608,WAS,2024,Anthony Gill,31,50,3,466,75,160,.469,10,41,.244,65,119,.546,.500,29,36,.806,37,57,94,34,13,11,23,48,189
1609,WAS,2024,Delon Wright,31,33,0,456,48,122,.393,14,38,.368,34,84,.405,.451,24,29,.828,13,46,59,82,35,8,11,22,134
1610,WAS,2024,Eugene Omoruyi,26,43,0,393,81,167,.485,13,46,.283,68,121,.562,.524,32,49,.653,35,50,85,35,27,5,21,62,207
1611,WAS,2024,Danilo Gallinari,35,26,0,385,57,131,.435,20,64,.313,37,67,.552,.511,47,56,.839,12,64,76,31,6,3,12,26,181
1612,WAS,2024,Mike Muscala,32,24,2,338,33,90,.367,14,51,.275,19,39,.487,.444,15,20,.750,22,53,75,22,5,7,16,31,95
1613,WAS,2024,Richaun Holmes,30,17,8,318,49,88,.557,1,3,.333,48,85,.565,.563,22,26,.846,38,66,104,10,8,10,12,41,121
1614,WAS,2024,Justin Champagnie,22,15,1,235,32,78,.410,13,45,.289,19,33,.576,.494,12,15,.800,19,34,53,19,10,9,10,14,89
1615,WAS,2024,Tristan Vukcevic,20,10,4,153,29,67,.433,10,36,.278,19,31,.613,.507,17,22,.773,6,30,36,13,5,7,10,28,85
1616,WAS,2024,Jules Bernard,24,19,0,149,29,64,.453,11,29,.379,18,35,.514,.539,5,9,.556,10,16,26,16,3,1,8,14,74
1617,WAS,2024,Ryan Rollins,21,10,0,66,13,25,.520,2,3,.667,11,22,.500,.560,13,17,.765,2,9,11,11,8,3,7,7,41
1618,WAS,2024,Hamidou Diallo,25,2,0,5,1,2,.500,0,0,,1,2,.500,.500,0,0,,2,0,2,1,2,0,1,1,2
1619,WAS,2024,Trey Jemison,24,2,0,1,0,0,,0,0,,0,0,,,0,0,,0,1,1,0,0,0,1,0,0
1620,WAS,2023,Kyle Kuzma,27,64,64,2239,512,1142,.448,160,481,.333,352,661,.533,.518,173,237,.730,55,408,463,239,36,29,190,145,1357
1621,WAS,2023,Kristaps Porziņģis,27,65,65,2120,507,1018,.498,137,356,.385,370,662,.559,.565,354,416,.851,114,432,546,174,58,100,137,196,1505
1622,WAS,2023,Corey Kispert,23,74,45,2093,291,585,.497,163,384,.424,128,201,.637,.637,75,88,.852,33,174,207,87,32,9,55,97,820
1623,WAS,2023,Deni Avdija,22,76,40,2020,253,579,.437,69,232,.297,184,347,.530,.497,122,165,.739,74,413,487,211,65,29,123,209,697
1624,WAS,2023,Monte Morris,27,62,61,1695,247,515,.480,78,204,.382,169,311,.543,.555,64,77,.831,26,184,210,326,43,13,60,75,636
1625,WAS,2023,Bradley Beal,29,50,50,1673,444,878,.506,80,219,.365,364,659,.552,.551,192,228,.842,41,155,196,271,45,33,145,107,1160
1626,WAS,2023,Daniel Gafford,24,78,47,1604,289,395,.732,0,0,,289,395,.732,.732,127,187,.679,163,270,433,84,33,99,85,187,705
1627,WAS,2023,Delon Wright,30,50,14,1221,138,291,.474,41,119,.345,97,172,.564,.545,52,60,.867,58,122,180,194,92,17,44,59,369
1628,WAS,2023,Jordan Goodwin,24,62,7,1106,158,353,.448,38,118,.322,120,235,.511,.501,53,69,.768,57,148,205,168,58,26,57,95,407
1629,WAS,2023,Will Barton,32,40,0,782,110,285,.386,52,138,.377,58,147,.395,.477,35,45,.778,10,101,111,95,17,10,45,39,307
1630,WAS,2023,Rui Hachimura,24,30,0,728,158,324,.488,30,89,.337,128,235,.545,.534,44,58,.759,19,109,128,35,11,12,36,39,390
1631,WAS,2023,Anthony Gill,30,59,8,624,71,132,.538,4,29,.138,67,103,.650,.553,49,67,.731,37,62,99,34,7,12,15,70,195
1632,WAS,2023,Taj Gibson,37,49,2,480,65,125,.520,8,24,.333,57,101,.564,.552,30,42,.714,32,61,93,34,15,12,26,84,168
1633,WAS,2023,Kendrick Nunn,27,31,0,436,89,199,.447,38,97,.392,51,102,.500,.543,18,20,.900,10,44,54,56,17,4,35,31,234
1634,WAS,2023,Johnny Davis,20,28,5,423,66,171,.386,17,70,.243,49,101,.485,.436,14,27,.519,10,55,65,28,10,8,17,48,163
1635,WAS,2023,Quenton Jackson,24,9,0,135,19,42,.452,1,12,.083,18,30,.600,.464,17,22,.773,2,6,8,15,4,1,4,10,56
1636,WAS,2023,Xavier Cooks,27,10,1,126,17,28,.607,0,1,.000,17,27,.630,.607,4,10,.400,16,22,38,6,6,4,8,13,38
1637,WAS,2023,Jay Huff,24,7,0,95,15,25,.600,6,12,.500,9,13,.692,.720,15,16,.938,6,15,21,10,3,4,5,15,51
1638,WAS,2023,Isaiah Todd,21,6,1,61,3,19,.158,1,10,.100,2,9,.222,.184,2,2,1.000,2,10,12,4,1,0,2,4,9
1639,WAS,2023,Devon Dotson,23,6,0,53,1,10,.100,1,4,.250,0,6,.000,.150,0,0,,6,4,10,8,5,0,3,9,3
1640,WAS,2023,Vernon Carey Jr.,21,11,0,28,2,8,.250,0,0,,2,8,.250,.250,2,2,1.000,3,8,11,3,2,2,2,5,6
1641,WAS,2023,Jamaree Bouyea,23,1,0,6,0,1,.000,0,1,.000,0,0,,.000,0,0,,0,1,1,0,0,0,0,1,0
1642,WAS,2023,Jordan Schakel,24,2,0,6,1,2,.500,1,1,1.000,0,1,.000,.750,0,0,,0,0,0,1,1,0,0,1,3
1643,WAS,2022,Kentavious Caldwell-Pope,28,77,77,2329,361,829,.435,159,408,.390,202,421,.480,.531,137,154,.890,41,220,261,145,83,26,97,139,1018
1644,WAS,2022,Kyle Kuzma,26,66,66,2204,423,936,.452,128,375,.341,295,561,.526,.520,156,219,.712,70,491,561,233,42,57,169,128,1130
1645,WAS,2022,Deni Avdija,21,82,8,1984,250,579,.432,82,259,.317,168,320,.525,.503,103,136,.757,52,373,425,167,59,44,87,190,685
1646,WAS,2022,Corey Kispert,22,77,36,1801,234,514,.455,112,320,.350,122,194,.629,.564,54,62,.871,53,156,209,85,35,22,50,93,634
1647,WAS,2022,Daniel Gafford,23,72,53,1444,285,411,.693,0,1,.000,285,410,.695,.693,107,153,.699,155,252,407,68,30,99,65,170,677
1648,WAS,2022,Bradley Beal,28,40,40,1439,348,771,.451,63,210,.300,285,561,.508,.492,169,203,.833,38,151,189,265,36,15,135,95,928
1649,WAS,2022,Raul Neto,29,70,19,1372,204,441,.463,35,120,.292,169,321,.526,.502,83,108,.769,13,121,134,217,55,3,79,104,526
1650,WAS,2022,Spencer Dinwiddie,28,44,44,1330,185,492,.376,70,226,.310,115,266,.432,.447,116,143,.811,36,171,207,256,27,7,73,107,556
1651,WAS,2022,Montrezl Harrell,28,46,3,1117,247,383,.645,4,15,.267,243,368,.660,.650,149,205,.727,96,213,309,96,18,31,50,88,647
1652,WAS,2022,Rui Hachimura,23,42,13,943,187,381,.491,55,123,.447,132,258,.512,.563,46,66,.697,25,135,160,48,23,9,33,53,475
1653,WAS,2022,Aaron Holiday,25,41,14,663,100,214,.467,23,67,.343,77,147,.524,.521,28,35,.800,9,58,67,78,24,9,39,60,251
1654,WAS,2022,Ish Smith,33,28,0,615,112,245,.457,15,42,.357,97,203,.478,.488,3,5,.600,14,69,83,146,27,13,42,44,242
1655,WAS,2022,Dāvis Bertāns,29,34,0,501,60,171,.351,46,144,.319,14,27,.519,.485,28,30,.933,6,55,61,16,11,6,14,55,194
1656,WAS,2022,Kristaps Porziņģis,26,17,17,479,123,259,.475,29,79,.367,94,180,.522,.531,101,116,.871,38,112,150,50,12,25,28,49,376
1657,WAS,2022,Anthony Gill,29,44,0,463,62,109,.569,14,26,.538,48,83,.578,.633,42,52,.808,33,52,85,27,5,11,18,58,180
1658,WAS,2022,Thomas Bryant,24,27,9,439,77,148,.520,12,42,.286,65,106,.613,.561,35,40,.875,26,82,108,23,6,21,19,43,201
1659,WAS,2022,Tomáš Satoranský,30,22,10,416,40,84,.476,6,22,.273,34,62,.548,.512,21,25,.840,9,52,61,108,15,4,23,38,107
1660,WAS,2022,Isaiah Todd,20,12,0,74,7,26,.269,4,16,.250,3,10,.300,.346,2,6,.333,3,9,12,4,4,2,4,4,20
1661,WAS,2022,Cassius Winston,23,7,0,39,4,11,.364,2,6,.333,2,5,.400,.455,4,4,1.000,0,1,1,7,0,0,3,9,14
1662,WAS,2022,Jordan Schakel,23,4,0,30,1,11,.091,1,6,.167,0,5,.000,.136,2,2,1.000,2,6,8,0,1,0,1,0,5
1663,WAS,2022,Vernon Carey Jr.,20,3,0,27,4,7,.571,0,0,,4,7,.571,.571,4,10,.400,5,2,7,0,1,1,2,3,12
1664,WAS,2022,Brad Wanamaker,32,1,1,27,2,5,.400,0,0,,2,5,.400,.400,3,3,1.000,0,4,4,7,2,0,0,3,7
1665,WAS,2022,Joel Ayayi,21,7,0,20,1,6,.167,0,1,.000,1,5,.200,.167,0,0,,1,2,3,4,0,0,0,0,2
1666,WAS,2022,Craig Sword,28,3,0,19,3,4,.750,0,1,.000,3,3,1.000,.750,0,0,,0,0,0,1,4,0,1,7,6
1667,WAS,2022,Greg Monroe,31,2,0,18,4,8,.500,0,0,,4,8,.500,.500,0,0,,7,3,10,1,1,1,2,2,8
1668,WAS,2022,Alize Johnson,25,3,0,18,2,6,.333,0,2,.000,2,4,.500,.333,0,1,.000,5,7,12,0,0,0,3,0,4
1669,WAS,2022,Tremont Waters,24,1,0,8,1,2,.500,0,0,,1,2,.500,.500,0,0,,0,0,0,0,1,0,0,2,2
1670,WAS,2022,Jordan Goodwin,23,2,0,6,0,3,.000,0,1,.000,0,2,.000,.000,0,0,,0,1,1,0,0,0,0,1,0
1671,WAS,2022,Jaime Echenique,24,1,0,3,0,0,,0,0,,0,0,,,0,0,,0,0,0,0,0,0,0,0,0
1672,WAS,2021,Russell Westbrook,32,65,65,2369,544,1238,.439,86,273,.315,458,965,.475,.474,271,413,.656,109,641,750,763,89,23,312,190,1445
1673,WAS,2021,Bradley Beal,27,60,60,2147,670,1382,.485,130,373,.349,540,1009,.535,.532,408,459,.889,72,211,283,265,69,22,187,140,1878
1674,WAS,2021,Rui Hachimura,22,57,57,1797,310,648,.478,45,137,.328,265,511,.519,.513,124,161,.770,49,263,312,82,44,7,68,120,789
1675,WAS,2021,Dāvis Bertāns,28,57,7,1464,193,478,.404,169,428,.395,24,50,.480,.581,100,115,.870,18,150,168,49,33,13,33,136,655
1676,WAS,2021,Raul Neto,28,64,22,1403,209,447,.468,64,164,.390,145,283,.512,.539,75,85,.882,28,128,156,146,73,6,53,109,557
1677,WAS,2021,Robin Lopez,32,71,9,1354,269,425,.633,5,18,.278,264,407,.649,.639,99,137,.723,141,131,272,55,15,44,75,109,642
1678,WAS,2021,Deni Avdija,20,54,32,1257,130,312,.417,53,168,.315,77,144,.535,.502,29,45,.644,22,240,262,63,32,15,33,140,342
1679,WAS,2021,Garrison Mathews,24,64,24,1038,97,237,.409,76,198,.384,21,39,.538,.570,84,95,.884,16,71,87,26,29,7,10,106,354
1680,WAS,2021,Ish Smith,32,44,1,924,129,297,.434,18,49,.367,111,248,.448,.465,19,33,.576,22,128,150,172,32,13,41,62,295
1681,WAS,2021,Alex Len,27,57,40,903,166,268,.619,5,19,.263,161,249,.647,.629,70,110,.636,78,171,249,46,19,58,47,117,407
1682,WAS,2021,Isaac Bonga,21,40,8,432,30,81,.370,13,47,.277,17,34,.500,.451,5,8,.625,18,48,66,23,11,9,22,63,78
1683,WAS,2021,Daniel Gafford,22,23,0,408,94,138,.681,0,0,,94,138,.681,.681,45,67,.672,50,78,128,12,15,41,19,44,233
1684,WAS,2021,Moritz Wagner,23,25,13,375,62,122,.508,13,42,.310,49,80,.613,.561,41,52,.788,13,60,73,32,22,8,21,62,178
1685,WAS,2021,Jerome Robinson,23,17,6,305,28,95,.295,11,42,.262,17,53,.321,.353,16,20,.800,4,34,38,25,12,6,19,31,83
1686,WAS,2021,Troy Brown Jr.,21,21,0,287,33,89,.371,14,46,.304,19,43,.442,.449,10,15,.667,11,50,61,19,3,4,16,29,90
1687,WAS,2021,Chandler Hutchison,24,18,1,282,34,85,.400,7,19,.368,27,66,.409,.441,19,23,.826,5,53,58,13,11,5,15,24,94
1688,WAS,2021,Thomas Bryant,23,10,10,271,59,91,.648,9,21,.429,50,70,.714,.698,16,24,.667,18,43,61,15,4,8,11,31,143
1689,WAS,2021,Anthony Gill,28,26,4,218,30,60,.500,7,24,.292,23,36,.639,.558,13,16,.813,16,35,51,11,10,4,8,27,80
1690,WAS,2021,Cassius Winston,22,22,0,98,14,33,.424,8,17,.471,6,16,.375,.545,5,6,.833,0,9,9,12,2,1,5,8,41
1691,WAS,2021,Jordan Bell,26,5,1,67,7,20,.350,0,2,.000,7,18,.389,.350,0,0,,6,13,19,5,3,3,3,5,14
1692,WAS,2021,Anžejs Pasečņiks,25,1,0,6,0,1,.000,0,1,.000,0,0,,.000,0,0,,1,0,1,1,0,0,5,2,0
1693,WAS,2020,Bradley Beal,26,57,57,2053,593,1303,.455,170,481,.353,423,822,.515,.520,385,457,.842,52,190,242,347,71,23,194,126,1741
1694,WAS,2020,Ish Smith,31,68,23,1787,308,689,.447,62,169,.367,246,520,.473,.492,62,86,.721,30,189,219,334,59,30,95,106,740
1695,WAS,2020,Troy Brown Jr.,20,69,22,1782,273,622,.439,61,179,.341,212,443,.479,.488,109,139,.784,76,307,383,178,85,7,79,132,716
1696,WAS,2020,Dāvis Bertāns,27,54,4,1583,265,610,.434,200,472,.424,65,138,.471,.598,104,122,.852,35,210,245,92,37,33,59,139,834
1697,WAS,2020,Rui Hachimura,21,48,48,1444,254,545,.466,25,87,.287,229,458,.500,.489,116,140,.829,78,216,294,87,37,8,53,105,649
1698,WAS,2020,Isaac Bonga,20,66,49,1250,118,234,.504,25,71,.352,93,163,.571,.558,69,85,.812,71,151,222,76,45,22,58,156,330
1699,WAS,2020,Thomas Bryant,22,46,36,1147,243,418,.581,37,91,.407,206,327,.630,.626,86,116,.741,98,233,331,83,25,49,53,103,609
1700,WAS,2020,Isaiah Thomas,30,40,37,925,174,426,.408,78,189,.413,96,237,.405,.500,62,76,.816,11,57,68,146,13,6,77,77,488
1701,WAS,2020,Moritz Wagner,22,45,5,835,145,266,.545,25,80,.313,120,186,.645,.592,78,95,.821,56,163,219,56,28,19,66,152,393
1702,WAS,2020,Ian Mahinmi,33,38,35,808,104,210,.495,5,26,.192,99,184,.538,.507,70,113,.619,78,140,218,49,31,44,45,114,283
1703,WAS,2020,Jordan McRae,28,29,4,654,133,317,.420,40,106,.377,93,211,.441,.483,64,83,.771,17,87,104,82,19,15,38,61,370
1704,WAS,2020,Jerome Robinson,22,21,5,503,69,174,.397,30,86,.349,39,88,.443,.483,29,38,.763,8,61,69,41,15,9,23,57,197
1705,WAS,2020,Shabazz Napier,28,20,10,488,74,173,.428,29,81,.358,45,92,.489,.512,54,65,.831,9,39,48,75,29,4,52,39,231
1706,WAS,2020,Anžejs Pasečņiks,24,27,0,437,61,116,.526,0,3,.000,61,113,.540,.526,34,58,.586,42,65,107,18,9,12,24,75,156
1707,WAS,2020,Gary Payton II,27,29,17,432,48,116,.414,13,46,.283,35,70,.500,.470,4,8,.500,26,54,80,48,33,7,20,54,113
1708,WAS,2020,Admiral Schofield,22,33,2,368,35,92,.380,19,61,.311,16,31,.516,.484,10,15,.667,7,40,47,15,8,4,7,50,99
1709,WAS,2020,Garrison Mathews,23,18,0,227,24,56,.429,19,46,.413,5,10,.500,.598,31,34,.912,6,18,24,10,8,1,8,32,98
1710,WAS,2020,Johnathan Williams,24,15,6,180,19,34,.559,0,2,.000,19,32,.594,.559,7,13,.538,24,40,64,8,1,8,5,16,45
1711,WAS,2020,C.J. Miles,32,10,0,161,19,59,.322,11,35,.314,8,24,.333,.415,15,20,.750,4,8,12,12,10,4,4,14,64
1712,WAS,2020,Chris Chiozza,24,10,0,123,10,34,.294,7,16,.438,3,18,.167,.397,0,0,,0,15,15,28,10,2,9,12,27
1713,WAS,2020,Jerian Grant,27,6,0,80,10,27,.370,2,8,.250,8,19,.421,.407,5,7,.714,2,4,6,9,1,1,3,11,27
1714,WAS,2020,Justin Robinson,22,9,0,49,5,12,.417,3,5,.600,2,7,.286,.542,0,0,,1,4,5,7,0,1,3,2,13
1715,WAS,2020,Jarrod Uthoff,26,3,0,39,6,11,.545,3,5,.600,3,6,.500,.682,0,0,,1,4,5,0,0,0,0,1,15
1716,WAS,2019,Bradley Beal,25,82,82,3028,764,1609,.475,209,596,.351,555,1013,.548,.540,362,448,.808,89,322,411,448,121,58,224,226,2099
1717,WAS,2019,Tomáš Satoranský,27,80,54,2164,257,530,.485,64,162,.395,193,368,.524,.545,131,160,.819,82,197,279,399,82,13,120,172,709
1718,WAS,2019,Jeff Green,32,77,44,2097,326,687,.475,111,320,.347,215,367,.586,.555,183,206,.888,57,252,309,137,43,39,101,160,946
1719,WAS,2019,Thomas Bryant,21,72,53,1496,309,502,.616,33,99,.333,276,403,.685,.648,107,137,.781,113,341,454,92,25,67,60,126,758
1720,WAS,2019,Trevor Ariza,33,43,43,1465,208,509,.409,95,295,.322,113,214,.528,.502,94,121,.777,34,192,226,165,53,13,67,86,605
1721,WAS,2019,Otto Porter Jr.,25,41,28,1191,202,442,.457,65,176,.369,137,266,.515,.531,49,64,.766,40,191,231,80,64,22,40,79,518
1722,WAS,2019,John Wall,28,32,32,1104,245,552,.444,51,169,.302,194,383,.507,.490,122,175,.697,15,101,116,279,49,29,121,71,663
1723,WAS,2019,Markieff Morris,29,34,15,883,143,328,.436,48,144,.333,95,184,.516,.509,57,73,.781,41,133,174,60,25,20,47,117,391
1724,WAS,2019,Bobby Portis,23,28,22,768,157,357,.440,48,119,.403,109,238,.458,.507,38,47,.809,63,179,242,43,24,12,45,84,400
1725,WAS,2019,Kelly Oubre Jr.,23,29,7,755,132,305,.433,41,132,.311,91,173,.526,.500,68,85,.800,24,105,129,20,27,20,30,71,373
1726,WAS,2019,Chasson Randle,25,49,2,743,91,217,.419,46,115,.400,45,102,.441,.525,43,62,.694,10,46,56,97,25,3,43,91,271
1727,WAS,2019,Troy Brown Jr.,19,52,10,730,97,234,.415,22,69,.319,75,165,.455,.462,32,47,.681,35,110,145,80,21,5,30,56,248
1728,WAS,2019,Austin Rivers,26,29,2,683,76,194,.392,33,106,.311,43,88,.489,.477,25,46,.543,10,61,71,58,18,10,36,72,210
1729,WAS,2019,Jabari Parker,23,25,0,682,149,285,.523,24,81,.296,125,204,.613,.565,52,76,.684,38,142,180,68,23,16,67,58,374
1730,WAS,2019,Sam Dekker,24,38,0,619,98,208,.471,14,49,.286,84,159,.528,.505,20,36,.556,44,71,115,37,27,7,19,34,230
1731,WAS,2019,Ian Mahinmi,32,34,6,498,47,104,.452,3,16,.188,44,88,.500,.466,42,61,.689,48,80,128,25,25,16,21,84,139
1732,WAS,2019,Jordan McRae,27,27,0,333,61,130,.469,10,35,.286,51,95,.537,.508,28,35,.800,6,34,40,30,13,7,15,26,160
1733,WAS,2019,Dwight Howard,33,9,9,230,43,69,.623,0,0,,43,69,.623,.623,29,48,.604,24,59,83,4,7,4,16,34,115
1734,WAS,2019,Wesley Johnson,31,12,0,157,10,40,.250,6,26,.231,4,14,.286,.325,7,10,.700,2,16,18,7,2,5,6,18,33
1735,WAS,2019,Jason Smith,32,12,1,130,15,37,.405,4,10,.400,11,27,.407,.459,10,12,.833,11,26,37,12,1,5,7,21,44
1736,WAS,2019,Devin Robinson,23,7,0,95,19,32,.594,0,2,.000,19,30,.633,.594,9,14,.643,6,14,20,6,4,6,2,11,47
1737,WAS,2019,Ron Baker,25,4,0,45,0,4,.000,0,4,.000,0,0,,.000,0,0,,0,4,4,2,1,1,2,2,0
1738,WAS,2019,Gary Payton II,26,3,0,16,5,8,.625,1,2,.500,4,6,.667,.688,0,0,,1,1,2,4,3,1,1,2,11
1739,WAS,2019,John Jenkins,27,4,0,14,2,2,1.000,2,2,1.000,0,0,,1.500,0,0,,0,1,1,1,0,0,0,0,6
1740,WAS,2019,Okaro White,26,3,0,6,0,2,.000,0,2,.000,0,0,,.000,0,0,,1,1,2,0,0,0,0,0,0
1741,WAS,2018,Bradley Beal,24,82,82,2977,683,1484,.460,199,530,.375,484,954,.507,.527,292,369,.791,61,302,363,373,96,36,214,160,1857
1742,WAS,2018,Otto Porter Jr.,24,77,77,2432,445,885,.503,138,313,.441,307,572,.537,.581,106,128,.828,103,389,492,157,116,41,75,151,1134
1743,WAS,2018,Kelly Oubre Jr.,22,81,11,2231,318,790,.403,126,369,.341,192,421,.456,.482,191,233,.820,59,304,363,98,80,35,90,234,953
1744,WAS,2018,Marcin Gortat,33,82,82,2075,290,560,.518,0,0,,290,560,.518,.518,110,163,.675,181,442,623,151,40,61,99,175,690
1745,WAS,2018,Markieff Morris,28,73,73,1968,330,687,.480,76,207,.367,254,480,.529,.536,105,128,.820,75,334,409,142,56,38,127,216,841
1746,WAS,2018,Tomáš Satoranský,26,73,30,1643,201,384,.523,47,101,.465,154,283,.544,.585,75,96,.781,72,161,233,286,52,15,83,131,524
1747,WAS,2018,John Wall,27,41,41,1410,280,667,.420,62,167,.371,218,500,.436,.466,175,241,.726,22,128,150,393,57,45,158,80,797
1748,WAS,2018,Mike Scott,29,76,1,1406,276,524,.527,66,163,.405,210,361,.582,.590,50,76,.658,50,197,247,80,23,10,79,148,668
1749,WAS,2018,Ian Mahinmi,31,77,0,1145,138,248,.556,0,2,.000,138,246,.561,.556,90,128,.703,135,177,312,53,38,42,100,230,366
1750,WAS,2018,Jodie Meeks,30,77,0,1119,157,393,.399,72,210,.343,85,183,.464,.491,101,117,.863,15,111,126,70,29,4,37,55,487
1751,WAS,2018,Tim Frazier,27,59,11,838,68,172,.395,17,56,.304,51,116,.440,.445,23,30,.767,18,97,115,194,47,7,57,97,176
1752,WAS,2018,Jason Smith,31,33,2,285,45,115,.391,4,32,.125,41,83,.494,.409,19,21,.905,18,35,53,14,3,13,16,44,113
1753,WAS,2018,Ramon Sessions,31,15,0,225,25,64,.391,6,15,.400,19,49,.388,.438,32,42,.762,5,15,20,50,7,1,15,15,88
1754,WAS,2018,Chris McCullough,22,19,0,90,18,42,.429,1,8,.125,17,34,.500,.440,9,14,.643,7,18,25,4,0,5,2,8,46
1755,WAS,2018,Devin Robinson,22,1,0,13,1,3,.333,0,0,,1,3,.333,.333,0,0,,2,3,5,0,1,0,0,2,2
1756,WAS,2017,John Wall,26,78,78,2836,647,1435,.451,89,272,.327,558,1163,.480,.482,422,527,.801,59,267,326,831,157,49,322,151,1805
1757,WAS,2017,Bradley Beal,23,77,77,2684,637,1322,.482,223,552,.404,414,770,.538,.566,282,342,.825,53,187,240,267,83,21,156,169,1779
1758,WAS,2017,Otto Porter Jr.,23,80,80,2605,414,803,.516,148,341,.434,266,462,.576,.608,99,119,.832,118,396,514,121,116,42,44,193,1075
1759,WAS,2017,Marcin Gortat,32,82,82,2556,390,674,.579,0,2,.000,390,672,.580,.579,103,159,.648,238,611,849,121,40,61,119,213,883
1760,WAS,2017,Markieff Morris,27,76,76,2374,406,889,.457,71,196,.362,335,693,.483,.497,180,215,.837,107,386,493,126,82,42,129,254,1063
1761,WAS,2017,Kelly Oubre Jr.,21,79,5,1605,186,442,.421,54,188,.287,132,254,.520,.482,75,99,.758,61,200,261,47,58,17,50,195,501
1762,WAS,2017,Jason Smith,30,74,3,1068,174,329,.529,37,78,.474,137,251,.546,.585,35,51,.686,64,194,258,37,21,54,58,168,420
1763,WAS,2017,Tomáš Satoranský,25,57,3,719,61,147,.415,9,37,.243,52,110,.473,.446,23,33,.697,25,58,83,92,26,6,38,60,154
1764,WAS,2017,Trey Burke,24,57,0,703,116,255,.455,31,70,.443,85,185,.459,.516,22,29,.759,7,40,47,100,11,5,48,54,285
1765,WAS,2017,Bojan Bogdanović,27,26,0,601,107,234,.457,45,115,.391,62,119,.521,.553,71,76,.934,14,66,80,21,10,4,38,47,330
1766,WAS,2017,Marcus Thornton,29,33,1,575,84,210,.400,28,80,.350,56,130,.431,.467,23,27,.852,22,54,76,41,19,3,25,48,219
1767,WAS,2017,Ian Mahinmi,30,31,0,555,65,111,.586,0,0,,65,111,.586,.586,43,75,.573,47,103,150,19,33,24,34,90,173
1768,WAS,2017,Brandon Jennings,27,23,2,374,29,106,.274,11,52,.212,18,54,.333,.325,12,17,.706,8,36,44,108,15,0,22,32,81
1769,WAS,2017,Sheldon Mac,24,30,3,287,30,75,.400,7,30,.233,23,45,.511,.447,23,27,.852,4,30,34,15,8,2,5,17,90
1770,WAS,2017,Andrew Nicholson,27,28,0,231,30,77,.390,3,16,.188,27,61,.443,.409,7,12,.583,11,23,34,7,11,6,11,37,70
1771,WAS,2017,Daniel Ochefu,23,19,0,75,12,27,.444,0,0,,12,27,.444,.444,0,2,.000,5,17,22,3,2,0,3,17,24
1772,WAS,2017,Chris McCullough,21,2,0,8,0,1,.000,0,1,.000,0,0,,.000,1,2,.500,0,2,2,0,1,0,1,0,1
1773,WAS,2017,Danuel House Jr.,23,1,0,1,0,0,,0,0,,0,0,,,0,0,,0,1,1,0,0,0,0,0,0
1774,WAS,2016,John Wall,25,77,77,2784,572,1349,.424,115,328,.351,457,1021,.448,.467,272,344,.791,42,337,379,789,145,59,318,159,1531
1775,WAS,2016,Otto Porter Jr.,22,75,73,2276,339,717,.473,98,267,.367,241,450,.536,.541,95,126,.754,97,294,391,120,105,32,70,163,871
1776,WAS,2016,Marcin Gortat,31,75,74,2256,433,764,.567,0,1,.000,433,763,.567,.567,146,207,.705,222,519,741,106,47,96,121,193,1012
1777,WAS,2016,Jared Dudley,30,81,41,2098,233,487,.478,100,238,.420,133,249,.534,.581,72,98,.735,54,232,286,170,75,18,80,190,638
1778,WAS,2016,Garrett Temple,29,80,43,1951,201,505,.398,89,258,.345,112,247,.453,.486,91,125,.728,36,176,212,140,69,18,64,195,582
1779,WAS,2016,Bradley Beal,22,55,35,1708,359,799,.449,105,271,.387,254,528,.481,.515,135,176,.767,41,147,188,162,54,11,112,117,958
1780,WAS,2016,Ramon Sessions,29,82,5,1667,280,592,.473,36,111,.324,244,481,.507,.503,214,283,.756,25,178,203,239,46,5,115,102,810
1781,WAS,2016,Nenê,33,57,11,1094,209,384,.544,0,3,.000,209,381,.549,.544,107,185,.578,52,207,259,97,54,26,76,156,525
1782,WAS,2016,Gary Neal,31,40,2,807,151,325,.465,41,100,.410,110,225,.489,.528,47,55,.855,11,72,83,47,20,1,29,55,390
1783,WAS,2016,Markieff Morris,26,27,21,712,134,287,.467,25,79,.316,109,208,.524,.510,42,55,.764,30,128,158,37,25,17,45,80,335
1784,WAS,2016,Kelly Oubre Jr.,20,63,9,671,90,211,.427,25,79,.316,65,132,.492,.486,31,49,.633,25,108,133,13,22,7,34,100,236
1785,WAS,2016,Kris Humphries,30,28,14,466,64,158,.405,23,67,.343,41,91,.451,.478,29,31,.935,26,89,115,16,3,14,20,42,180
1786,WAS,2016,Drew Gooden,34,30,0,305,33,103,.320,7,41,.171,26,62,.419,.354,9,14,.643,28,57,85,13,8,11,13,40,82
1787,WAS,2016,Marcus Thornton,28,14,2,224,42,107,.393,18,54,.333,24,53,.453,.477,16,21,.762,7,28,35,19,13,1,11,17,118
1788,WAS,2016,DeJuan Blair,26,29,0,218,28,68,.412,0,1,.000,28,67,.418,.412,5,13,.385,20,37,57,11,8,2,15,53,61
1789,WAS,2016,Alan Anderson,33,13,0,192,21,59,.356,12,37,.324,9,22,.409,.458,11,15,.733,1,26,27,14,4,1,2,25,65
1790,WAS,2016,Jarell Eddie,24,26,0,147,20,65,.308,15,47,.319,5,18,.278,.423,8,8,1.000,2,21,23,5,5,1,1,5,63
1791,WAS,2016,J.J. Hickson,27,15,0,131,25,46,.543,0,1,.000,25,45,.556,.543,19,44,.432,17,28,45,7,5,2,9,12,69
1792,WAS,2016,Ryan Hollins,31,5,3,48,4,7,.571,0,0,,4,7,.571,.571,0,0,,7,4,11,0,0,1,3,4,8
1793,WAS,2015,John Wall,24,79,79,2837,519,1166,.445,65,217,.300,454,949,.478,.473,284,362,.785,36,330,366,792,138,45,304,180,1387
1794,WAS,2015,Marcin Gortat,30,82,82,2453,439,775,.566,0,3,.000,439,772,.569,.566,123,175,.703,180,537,717,97,49,110,100,191,1001
1795,WAS,2015,Bradley Beal,21,63,59,2107,363,851,.427,106,259,.409,257,592,.434,.489,130,166,.783,57,184,241,194,76,18,123,136,962
1796,WAS,2015,Paul Pierce,37,73,73,1914,293,656,.447,118,303,.389,175,353,.496,.537,164,210,.781,45,249,294,144,46,24,92,160,868
1797,WAS,2015,Nenê,32,67,58,1693,307,601,.511,1,5,.200,306,596,.513,.512,122,202,.604,84,261,345,123,66,22,124,180,737
1798,WAS,2015,Rasual Butler,35,75,1,1505,218,517,.422,91,235,.387,127,282,.450,.510,53,67,.791,27,170,197,63,29,22,48,98,580
1799,WAS,2015,Otto Porter Jr.,21,74,13,1432,176,391,.450,35,104,.337,141,287,.491,.495,58,79,.734,70,151,221,65,44,30,52,97,445
1800,WAS,2015,Kris Humphries,29,64,17,1345,211,446,.473,0,7,.000,211,439,.481,.473,87,117,.744,118,298,416,57,34,25,46,130,509
1801,WAS,2015,Kevin Séraphin,25,79,0,1235,231,450,.513,0,2,.000,231,448,.516,.513,58,82,.707,87,201,288,59,10,59,98,197,520
1802,WAS,2015,Drew Gooden,33,51,7,864,110,276,.399,23,59,.390,87,217,.401,.440,34,44,.773,72,151,223,49,21,9,28,91,277
1803,WAS,2015,Garrett Temple,28,52,18,735,68,170,.400,33,88,.375,35,82,.427,.497,35,48,.729,24,66,90,56,42,9,34,76,204
1804,WAS,2015,Andre Miller,38,51,0,631,77,142,.542,1,8,.125,76,134,.567,.546,28,39,.718,21,56,77,143,14,2,46,56,183
1805,WAS,2015,Ramon Sessions,28,28,3,546,62,151,.411,13,32,.406,49,119,.412,.454,69,85,.812,10,65,75,86,16,0,35,28,206
1806,WAS,2015,Martell Webster,28,32,0,352,24,91,.264,10,43,.233,14,48,.292,.319,48,64,.750,10,36,46,17,7,1,22,24,106
1807,WAS,2015,DeJuan Blair,25,29,0,180,26,57,.456,0,0,,26,57,.456,.456,4,6,.667,16,40,56,3,7,1,13,41,56
1808,WAS,2015,Will Bynum,32,7,0,67,10,31,.323,0,9,.000,10,22,.455,.323,2,4,.500,2,4,6,18,1,1,8,9,22
1809,WAS,2015,Glen Rice Jr.,24,5,0,43,3,15,.200,1,7,.143,2,8,.250,.233,4,6,.667,2,2,4,2,0,0,2,11,11
1810,WAS,2015,Toure' Murry,25,4,0,17,2,4,.500,0,0,,2,4,.500,.500,2,2,1.000,1,0,1,1,1,0,4,2,6
1811,WAS,2014,John Wall,23,82,82,2980,579,1337,.433,108,308,.351,471,1029,.458,.473,317,394,.805,38,295,333,721,149,40,295,219,1583
1812,WAS,2014,Trevor Ariza,28,77,77,2723,389,853,.456,180,442,.407,209,411,.509,.562,149,193,.772,99,376,475,191,126,20,132,179,1107
1813,WAS,2014,Marcin Gortat,29,81,80,2655,455,840,.542,1,1,1.000,454,839,.541,.542,157,229,.686,202,565,767,138,41,121,126,201,1068
1814,WAS,2014,Bradley Beal,20,73,73,2530,481,1149,.419,138,343,.402,343,806,.426,.479,149,189,.788,54,219,273,243,71,18,128,153,1249
1815,WAS,2014,Martell Webster,27,78,13,2157,254,587,.433,146,372,.392,108,215,.502,.557,105,125,.840,38,184,222,97,41,15,58,150,759
1816,WAS,2014,Nenê,31,53,37,1560,299,594,.503,1,5,.200,298,589,.506,.504,155,266,.583,65,229,294,153,64,47,117,164,754
1817,WAS,2014,Trevor Booker,26,72,45,1553,222,403,.551,0,2,.000,222,401,.554,.551,47,76,.618,149,230,379,64,41,45,58,131,491
1818,WAS,2014,Garrett Temple,27,75,0,638,51,141,.362,6,29,.207,45,112,.402,.383,30,43,.698,21,47,68,72,35,11,42,72,138
1819,WAS,2014,Kevin Séraphin,24,53,1,578,111,220,.505,0,0,,111,220,.505,.505,27,31,.871,53,75,128,17,3,26,41,103,249
1820,WAS,2014,Al Harrington,33,34,0,511,82,207,.396,34,100,.340,48,107,.449,.478,27,35,.771,15,65,80,28,14,0,34,72,225
1821,WAS,2014,Jan Veselý,23,33,1,470,48,92,.522,0,0,,48,92,.522,.522,8,30,.267,53,60,113,10,26,19,22,64,104
1822,WAS,2014,Andre Miller,37,28,0,412,40,87,.460,2,3,.667,38,84,.452,.471,25,30,.833,12,45,57,97,19,2,28,43,107
1823,WAS,2014,Drew Gooden,32,22,0,395,76,143,.531,7,17,.412,69,126,.548,.556,24,27,.889,37,77,114,15,10,7,17,53,183
1824,WAS,2014,Otto Porter Jr.,20,37,0,319,33,91,.363,4,21,.190,29,70,.414,.385,8,12,.667,21,36,57,10,8,1,14,26,78
1825,WAS,2014,Chris Singleton,24,25,0,250,25,67,.373,7,19,.368,18,48,.375,.425,18,25,.720,18,37,55,6,9,3,17,25,75
1826,WAS,2014,Eric Maynor,26,23,0,215,21,72,.292,8,25,.320,13,47,.277,.347,2,3,.667,7,17,24,40,5,1,17,13,52
1827,WAS,2014,Glen Rice Jr.,23,11,1,109,11,37,.297,5,17,.294,6,20,.300,.365,5,7,.714,4,16,20,7,6,1,9,7,32
1828,WAS,2013,Martell Webster,26,76,62,2200,281,636,.442,139,329,.422,142,307,.463,.551,168,198,.848,53,241,294,143,49,17,90,166,869
1829,WAS,2013,Emeka Okafor,30,79,77,2052,328,687,.477,0,0,,328,687,.477,.477,109,191,.571,199,493,692,93,45,77,107,145,765
1830,WAS,2013,Bradley Beal,19,56,46,1745,282,687,.410,91,236,.386,191,451,.424,.477,125,159,.786,43,168,211,137,50,29,90,113,780
1831,WAS,2013,Kevin Séraphin,23,79,8,1721,330,716,.461,0,0,,330,716,.461,.461,61,88,.693,107,239,346,57,24,59,130,211,721
1832,WAS,2013,Nenê,30,61,49,1659,285,594,.480,0,1,.000,285,593,.481,.480,196,269,.729,101,306,407,177,55,37,139,171,766
1833,WAS,2013,John Wall,22,49,42,1602,324,735,.441,12,45,.267,312,690,.452,.449,246,306,.804,35,161,196,373,65,37,157,117,906
1834,WAS,2013,Trevor Ariza,27,56,15,1471,188,451,.417,76,209,.364,112,242,.463,.501,78,95,.821,44,222,266,113,72,20,84,72,530
1835,WAS,2013,A.J. Price,26,57,22,1278,161,413,.390,70,200,.350,91,213,.427,.475,49,62,.790,20,94,114,205,33,3,64,73,441
1836,WAS,2013,Garrett Temple,26,51,36,1156,105,258,.407,26,80,.325,79,178,.444,.457,26,37,.703,29,94,123,115,50,17,61,94,262
1837,WAS,2013,Jordan Crawford,24,43,12,1127,211,508,.415,59,171,.345,152,337,.451,.473,87,106,.821,31,104,135,157,27,5,97,61,568
1838,WAS,2013,Chris Singleton,23,57,11,924,92,241,.382,7,36,.194,85,205,.415,.396,40,70,.571,51,133,184,37,38,24,45,124,231
1839,WAS,2013,Trevor Booker,25,48,14,887,108,220,.491,0,5,.000,108,215,.502,.491,40,72,.556,98,141,239,40,32,16,31,95,256
1840,WAS,2013,Cartier Martin,28,41,3,694,96,252,.381,58,146,.397,38,106,.358,.496,20,28,.714,11,89,100,20,19,6,32,58,270
1841,WAS,2013,Jan Veselý,22,51,4,601,57,114,.500,0,1,.000,57,113,.504,.500,12,39,.308,43,79,122,28,15,17,27,107,126
1842,WAS,2013,Shaun Livingston,27,17,4,320,24,66,.364,0,3,.000,24,63,.381,.364,15,15,1.000,2,35,37,38,11,2,17,22,63
1843,WAS,2013,Shelvin Mack,22,7,2,141,16,40,.400,4,13,.308,12,27,.444,.450,1,2,.500,3,13,16,23,6,0,8,10,37
1844,WAS,2013,Earl Barron,31,11,1,122,13,37,.351,0,0,,13,37,.351,.351,2,5,.400,16,27,43,3,5,5,10,23,28
1845,WAS,2013,Jannero Pargo,33,7,0,102,8,32,.250,3,20,.150,5,12,.417,.297,2,2,1.000,0,6,6,14,0,1,8,8,21
1846,WAS,2013,Jason Collins,34,6,2,54,1,6,.167,0,0,,1,6,.167,.167,2,2,1.000,1,7,8,2,2,4,2,11,4
1847,WAS,2012,John Wall,21,66,66,2386,378,894,.423,3,42,.071,375,852,.440,.424,317,402,.789,48,252,300,530,95,57,255,137,1076
1848,WAS,2012,Jordan Crawford,23,64,32,1753,349,872,.400,79,273,.289,270,599,.451,.446,161,203,.793,44,124,168,190,59,5,141,111,938
1849,WAS,2012,Chris Singleton,22,66,51,1431,116,312,.372,44,127,.346,72,185,.389,.442,30,44,.682,43,190,233,49,70,30,38,176,306
1850,WAS,2012,Trevor Booker,24,50,32,1261,181,341,.531,1,2,.500,180,339,.531,.532,56,93,.602,119,206,325,40,48,43,58,138,419
1851,WAS,2012,Nick Young,26,40,32,1211,240,591,.406,73,197,.371,167,394,.424,.468,112,130,.862,20,77,97,46,30,11,59,90,665
1852,WAS,2012,Kevin Séraphin,22,57,21,1176,203,382,.531,0,1,.000,203,381,.533,.531,47,70,.671,103,177,280,33,19,76,66,133,453
1853,WAS,2012,JaVale McGee,24,41,40,1124,214,400,.535,0,0,,214,400,.535,.535,58,116,.500,127,235,362,25,25,101,68,118,486
1854,WAS,2012,Jan Veselý,21,57,20,1078,117,218,.537,0,1,.000,117,217,.539,.537,33,62,.532,101,148,249,47,39,32,60,156,267
1855,WAS,2012,Shelvin Mack,21,64,0,779,88,220,.400,12,42,.286,76,178,.427,.427,42,59,.712,12,80,92,131,28,2,48,50,230
1856,WAS,2012,Rashard Lewis,32,28,15,729,85,221,.385,16,67,.239,69,154,.448,.421,31,37,.838,34,75,109,27,23,10,32,49,217
1857,WAS,2012,Roger Mason,31,52,0,697,103,258,.399,59,154,.383,44,104,.423,.514,21,27,.778,7,62,69,47,13,5,32,33,286
1858,WAS,2012,Andray Blatche,25,26,13,626,93,245,.380,2,7,.286,91,238,.382,.384,33,49,.673,42,108,150,28,20,17,37,54,221
1859,WAS,2012,Cartier Martin,27,17,2,391,59,134,.440,29,75,.387,30,59,.508,.549,11,19,.579,12,46,58,10,11,2,13,35,158
1860,WAS,2012,Maurice Evans,33,24,0,343,45,112,.402,17,45,.378,28,67,.418,.478,10,13,.769,8,16,24,9,14,0,10,36,117
1861,WAS,2012,Nenê,29,11,6,284,68,112,.607,0,2,.000,68,110,.618,.607,23,35,.657,20,63,83,19,6,13,19,26,159
1862,WAS,2012,James Singleton,30,12,0,262,41,75,.547,2,9,.222,39,66,.591,.560,14,15,.933,25,56,81,15,9,8,10,27,98
1863,WAS,2012,Brian Cook,31,16,0,155,20,49,.408,5,23,.217,15,26,.577,.459,5,6,.833,6,34,40,8,4,1,7,22,50
1864,WAS,2012,Morris Almond,26,4,0,67,6,17,.353,1,3,.333,5,14,.357,.382,1,3,.333,1,7,8,2,7,0,1,6,14
1865,WAS,2012,Ronny Turiaf,29,4,0,58,3,3,1.000,0,0,,3,3,1.000,1.000,0,0,,1,11,12,5,6,3,6,7,6
1866,WAS,2012,Edwin Ubiles,25,4,0,52,5,18,.278,1,5,.200,4,13,.308,.306,3,3,1.000,2,8,10,1,1,1,1,1,14
1867,WAS,2012,Hamady N'Diaye,25,3,0,3,0,1,.000,0,0,,0,1,.000,.000,0,0,,0,0,0,0,0,0,0,0,0
1868,WAS,2011,John Wall,20,69,64,2606,398,972,.409,34,115,.296,364,857,.425,.427,301,393,.766,35,282,317,574,121,35,261,175,1131
1869,WAS,2011,JaVale McGee,23,79,75,2193,332,604,.550,0,3,.000,332,601,.552,.550,134,230,.583,223,411,634,38,41,193,102,232,798
1870,WAS,2011,Andray Blatche,24,64,63,2172,426,957,.445,4,18,.222,422,939,.449,.447,220,283,.777,183,343,526,144,98,51,172,182,1076
1871,WAS,2011,Nick Young,25,64,40,2034,412,935,.441,105,271,.387,307,664,.462,.497,186,228,.816,26,148,174,75,45,17,90,144,1115
1872,WAS,2011,Kirk Hinrich,30,48,29,1471,198,438,.452,43,112,.384,155,326,.475,.501,92,105,.876,14,115,129,210,56,10,84,119,531
1873,WAS,2011,Yi Jianlian,23,63,11,1112,145,347,.418,3,13,.231,142,334,.425,.422,62,91,.681,79,169,248,25,27,32,51,115,355
1874,WAS,2011,Al Thornton,27,49,23,1069,154,327,.471,4,25,.160,150,302,.497,.477,81,107,.757,46,110,156,51,28,9,44,103,393
1875,WAS,2011,Trevor Booker,23,65,14,1063,139,253,.549,0,1,.000,139,252,.552,.549,68,101,.673,98,153,251,35,29,42,38,115,346
1876,WAS,2011,Rashard Lewis,31,32,27,1014,139,312,.446,43,124,.347,96,188,.511,.514,43,51,.843,48,136,184,63,30,20,52,96,364
1877,WAS,2011,Jordan Crawford,22,26,18,867,165,423,.390,24,101,.238,141,322,.438,.418,69,78,.885,22,55,77,102,36,3,68,50,423
1878,WAS,2011,Gilbert Arenas,29,21,14,726,130,330,.394,47,145,.324,83,185,.449,.465,56,67,.836,6,64,70,117,30,12,71,76,363
1879,WAS,2011,Maurice Evans,32,26,12,712,98,223,.439,27,78,.346,71,145,.490,.500,28,30,.933,29,43,72,15,18,9,18,55,251
1880,WAS,2011,Kevin Séraphin,21,58,1,635,66,147,.449,0,0,,66,147,.449,.449,22,31,.710,80,72,152,10,17,28,42,126,154
1881,WAS,2011,Cartier Martin,26,52,1,542,71,182,.390,39,99,.394,32,83,.386,.497,28,40,.700,20,54,74,18,18,6,16,52,209
1882,WAS,2011,Hilton Armstrong,26,41,2,412,31,64,.484,1,3,.333,30,61,.492,.492,14,23,.609,39,75,114,10,15,16,25,75,77
1883,WAS,2011,Josh Howard,30,18,10,409,58,162,.358,7,29,.241,51,133,.383,.380,29,47,.617,18,56,74,24,13,5,20,34,152
1884,WAS,2011,Othyus Jeffers,25,16,1,314,30,62,.484,1,4,.250,29,58,.500,.492,30,46,.652,25,40,65,19,17,0,13,31,91
1885,WAS,2011,Mustafa Shakur,26,22,0,159,21,59,.356,1,10,.100,20,49,.408,.364,8,15,.533,7,15,22,25,5,3,18,15,51
1886,WAS,2011,Alonzo Gee,23,11,5,127,12,27,.444,0,2,.000,12,25,.480,.444,8,12,.667,11,11,22,5,7,0,8,10,32
1887,WAS,2011,Larry Owens,28,5,0,112,12,26,.462,5,10,.500,7,16,.438,.558,2,5,.400,1,10,11,7,7,5,5,14,31
1888,WAS,2011,Hamady N'Diaye,24,16,0,80,4,5,.800,0,0,,4,5,.800,.800,6,12,.500,2,5,7,0,2,5,3,18,14
1889,WAS,2011,Lester Hudson,26,11,0,73,6,24,.250,4,15,.267,2,9,.222,.333,2,4,.500,1,4,5,17,4,1,7,10,18
1890,WAS,2011,Mike Bibby,32,2,0,29,1,9,.111,0,4,.000,1,5,.200,.111,0,0,,0,3,3,8,1,0,1,3,2
1891,WAS,2010,Andray Blatche,23,81,36,2256,478,999,.478,13,44,.295,465,955,.487,.485,174,234,.744,158,351,509,170,85,71,182,218,1143
1892,WAS,2010,Caron Butler,29,47,47,1853,293,694,.422,25,95,.263,268,599,.447,.440,185,211,.877,68,248,316,107,68,15,113,126,796
1893,WAS,2010,Mike Miller,29,54,50,1805,217,433,.501,82,171,.480,135,262,.515,.596,70,85,.824,55,281,336,212,39,12,115,131,586
1894,WAS,2010,Randy Foye,26,70,38,1667,256,619,.414,63,182,.346,193,437,.442,.464,129,145,.890,16,114,130,228,33,10,94,123,704
1895,WAS,2010,Brendan Haywood,30,49,48,1614,188,335,.561,0,0,,188,335,.561,.561,102,158,.646,200,307,507,18,18,101,67,145,478
1896,WAS,2010,Antawn Jamison,33,41,41,1595,315,700,.450,58,168,.345,257,532,.483,.491,152,217,.700,99,263,362,52,43,9,61,112,840
1897,WAS,2010,Nick Young,24,74,23,1421,233,558,.418,69,170,.406,164,388,.423,.479,104,130,.800,20,82,102,48,28,8,56,147,639
1898,WAS,2010,Gilbert Arenas,28,32,32,1169,253,616,.411,63,181,.348,190,435,.437,.462,153,207,.739,17,116,133,230,41,9,117,95,722
1899,WAS,2010,Earl Boykins,33,67,1,1117,172,403,.427,19,60,.317,153,343,.446,.450,77,89,.865,17,58,75,171,24,3,69,48,440
1900,WAS,2010,JaVale McGee,22,60,19,968,156,307,.508,0,1,.000,156,306,.510,.508,74,116,.638,88,155,243,14,16,101,51,122,386
1901,WAS,2010,James Singleton,28,32,3,766,73,190,.384,2,15,.133,71,175,.406,.389,47,56,.839,91,130,221,22,17,36,37,82,195
1902,WAS,2010,Al Thornton,26,24,16,674,100,216,.463,6,17,.353,94,199,.472,.477,50,72,.694,31,71,102,29,20,13,36,62,256
1903,WAS,2010,Shaun Livingston,24,26,18,666,99,185,.535,0,4,.000,99,181,.547,.535,42,48,.875,12,46,58,116,12,9,50,52,240
1904,WAS,2010,Fabricio Oberto,34,57,20,650,35,56,.625,0,0,,35,56,.625,.625,13,17,.765,34,71,105,51,11,9,36,121,83
1905,WAS,2010,DeShawn Stevenson,28,40,13,616,29,103,.282,11,62,.177,18,41,.439,.335,18,25,.720,7,58,65,44,11,5,24,51,87
1906,WAS,2010,Quinton Ross,28,25,0,261,17,55,.309,1,8,.125,16,47,.340,.318,3,6,.500,6,16,22,5,6,2,8,35,38
1907,WAS,2010,Dominic McGuire,24,41,0,240,15,40,.375,0,0,,15,40,.375,.375,0,5,.000,17,44,61,8,4,3,10,32,30
1908,WAS,2010,Alonzo Gee,22,11,2,182,28,59,.475,7,9,.778,21,50,.420,.534,18,29,.621,15,18,33,7,7,1,10,13,81
1909,WAS,2010,Cartier Martin,25,8,0,114,18,48,.375,7,18,.389,11,30,.367,.448,8,9,.889,8,13,21,7,3,1,6,12,51
1910,WAS,2010,Josh Howard,29,4,3,91,20,46,.435,3,11,.273,17,35,.486,.467,15,20,.750,4,9,13,4,3,2,3,13,58
1911,WAS,2010,Mike James,34,4,0,46,6,20,.300,2,6,.333,4,14,.286,.350,4,8,.500,1,2,3,5,3,0,5,3,18
1912,WAS,2010,Cedric Jackson,23,4,0,39,4,11,.364,1,3,.333,3,8,.375,.409,3,4,.750,1,2,3,6,0,0,8,5,12
1913,WAS,2010,Mike Harris,26,5,0,14,1,3,.333,0,0,,1,3,.333,.333,2,2,1.000,1,3,4,0,1,0,0,4,4
1914,WAS,2010,Paul Davis,25,2,0,8,2,4,.500,0,0,,2,4,.500,.500,1,2,.500,0,0,0,3,0,1,0,0,5
1915,WAS,2009,Antawn Jamison,32,81,81,3096,674,1441,.468,112,319,.351,562,1122,.501,.507,341,452,.754,196,525,721,153,95,25,125,218,1801
1916,WAS,2009,Caron Butler,28,67,67,2585,491,1085,.453,65,210,.310,426,875,.487,.482,345,402,.858,118,296,414,290,106,20,210,165,1392
1917,WAS,2009,Dominic McGuire,23,79,57,2072,140,324,.432,2,4,.500,138,320,.431,.435,74,102,.725,113,315,428,198,62,74,92,153,356
1918,WAS,2009,Nick Young,23,82,5,1837,336,756,.444,56,164,.341,280,592,.473,.481,164,193,.850,31,119,150,95,39,20,92,140,892
1919,WAS,2009,Andray Blatche,22,71,36,1703,297,630,.471,5,21,.238,292,609,.479,.475,114,162,.704,126,252,378,118,53,74,117,211,713
1920,WAS,2009,Mike James,33,53,50,1575,189,489,.387,66,180,.367,123,309,.398,.454,67,80,.838,24,102,126,193,42,6,91,101,511
1921,WAS,2009,Darius Songaila,30,77,29,1521,243,457,.532,0,1,.000,243,456,.533,.532,80,90,.889,75,152,227,94,64,20,74,200,566
1922,WAS,2009,JaVale McGee,21,75,14,1143,191,387,.494,0,0,,191,387,.494,.494,107,162,.660,120,174,294,23,33,75,61,155,489
1923,WAS,2009,Javaris Crittenton,21,56,10,1130,124,270,.459,2,14,.143,122,256,.477,.463,48,81,.593,53,107,160,145,39,6,79,96,298
1924,WAS,2009,DeShawn Stevenson,27,32,25,886,72,231,.312,35,129,.271,37,102,.363,.387,32,60,.533,11,65,76,98,21,2,32,43,211
1925,WAS,2009,Juan Dixon,30,50,6,816,101,256,.395,25,75,.333,76,181,.420,.443,34,39,.872,8,59,67,118,35,6,70,74,261
1926,WAS,2009,Etan Thomas,30,26,7,306,32,66,.485,0,0,,32,66,.485,.485,16,23,.696,25,41,66,6,3,18,18,35,80
1927,WAS,2009,Antonio Daniels,33,13,5,288,18,45,.400,5,11,.455,13,34,.382,.456,25,33,.758,0,22,22,47,7,0,13,14,66
1928,WAS,2009,Oleksiy Pecherov,23,32,0,277,39,101,.386,14,43,.326,25,58,.431,.455,24,29,.828,35,41,76,2,6,3,10,34,116
1929,WAS,2009,Dee Brown,24,17,11,233,17,44,.386,6,20,.300,11,24,.458,.455,1,3,.333,7,21,28,33,10,0,14,22,41
1930,WAS,2009,Brendan Haywood,29,6,5,175,24,50,.480,0,0,,24,50,.480,.480,10,21,.476,13,31,44,8,4,15,9,14,58
1931,WAS,2009,Gilbert Arenas,27,2,2,63,6,23,.261,2,7,.286,4,16,.250,.304,12,16,.750,1,8,9,20,0,1,1,4,26
1932,WAS,2008,Antawn Jamison,31,79,79,3061,618,1417,.436,120,354,.339,498,1063,.468,.478,333,438,.760,215,591,806,120,106,34,113,195,1689
1933,WAS,2008,DeShawn Stevenson,26,82,82,2564,301,780,.386,158,413,.383,143,367,.390,.487,157,197,.797,37,198,235,252,65,15,102,110,917
1934,WAS,2008,Caron Butler,27,58,58,2314,439,943,.466,66,185,.357,373,758,.492,.501,236,262,.901,93,295,388,284,128,20,150,160,1180
1935,WAS,2008,Brendan Haywood,28,80,80,2228,316,599,.528,0,0,,316,599,.528,.528,216,294,.735,273,303,576,71,31,133,108,216,848
1936,WAS,2008,Antonio Daniels,32,71,63,2161,205,447,.459,17,74,.230,188,373,.504,.478,170,219,.776,23,180,203,340,69,2,91,78,597
1937,WAS,2008,Roger Mason,27,80,9,1708,266,600,.443,130,327,.398,136,273,.498,.552,62,71,.873,17,113,130,134,40,18,69,140,724
1938,WAS,2008,Andray Blatche,21,82,15,1675,254,536,.474,3,13,.231,251,523,.480,.477,107,154,.695,164,261,425,92,53,114,112,258,618
1939,WAS,2008,Darius Songaila,29,80,13,1554,214,467,.458,0,2,.000,214,465,.460,.458,67,73,.918,81,190,271,135,53,16,86,181,495
1940,WAS,2008,Nick Young,22,75,2,1158,210,478,.439,40,100,.400,170,378,.450,.481,101,124,.815,23,92,115,63,35,7,94,130,561
1941,WAS,2008,Dominic McGuire,22,70,1,695,39,103,.379,1,6,.167,38,97,.392,.383,14,32,.438,53,86,139,40,20,26,40,76,93
1942,WAS,2008,Gilbert Arenas,26,13,8,425,78,196,.398,22,78,.282,56,118,.475,.454,74,96,.771,6,45,51,66,23,1,49,30,252
1943,WAS,2008,Oleksiy Pecherov,22,35,0,320,44,125,.352,17,60,.283,27,65,.415,.420,20,31,.645,21,45,66,7,6,5,17,30,125
1944,WAS,2008,Mike Wilks,28,4,0,44,2,4,.500,1,2,.500,1,2,.500,.625,0,0,,1,5,6,3,3,0,1,2,5
1945,WAS,2007,Gilbert Arenas,25,74,73,2942,647,1548,.418,205,584,.351,442,964,.459,.484,606,718,.844,61,277,338,443,139,13,236,249,2105
1946,WAS,2007,Antawn Jamison,30,70,70,2662,512,1139,.450,138,379,.364,374,760,.492,.510,226,307,.736,134,428,562,136,80,36,104,194,1388
1947,WAS,2007,Caron Butler,26,63,63,2474,451,975,.463,18,72,.250,433,903,.480,.472,283,328,.863,147,320,467,233,134,17,181,188,1203
1948,WAS,2007,DeShawn Stevenson,25,82,82,2419,347,753,.461,74,183,.404,273,570,.479,.510,152,216,.704,55,161,216,218,65,19,119,155,920
1949,WAS,2007,Antonio Daniels,31,80,8,1761,172,389,.442,19,63,.302,153,326,.469,.467,208,250,.832,18,133,151,290,39,9,69,79,571
1950,WAS,2007,Brendan Haywood,27,77,49,1740,198,355,.558,0,0,,198,355,.558,.558,115,210,.548,195,282,477,47,34,88,90,208,511
1951,WAS,2007,Jarvis Hayes,25,81,17,1626,224,546,.410,66,183,.361,158,363,.435,.471,71,84,.845,42,168,210,80,48,13,56,160,585
1952,WAS,2007,Etan Thomas,28,65,32,1246,159,277,.574,0,0,,159,277,.574,.574,77,138,.558,136,241,377,29,22,89,71,162,395
1953,WAS,2007,Darius Songaila,28,37,1,700,118,225,.524,0,2,.000,118,223,.529,.524,46,54,.852,44,90,134,38,17,10,43,105,282
1954,WAS,2007,Andray Blatche,20,56,13,682,86,197,.437,4,27,.148,82,170,.482,.447,30,49,.612,77,114,191,39,17,32,49,94,206
1955,WAS,2007,Roger Mason,26,62,0,492,59,179,.330,33,102,.324,26,77,.338,.422,14,16,.875,7,38,45,35,13,6,19,66,165
1956,WAS,2007,Calvin Booth,30,44,1,380,31,66,.470,1,2,.500,30,64,.469,.477,6,10,.600,27,54,81,18,4,29,9,71,69
1957,WAS,2007,Donell Taylor,24,47,1,369,56,140,.400,3,17,.176,53,123,.431,.411,11,21,.524,14,39,53,45,17,3,25,34,126
1958,WAS,2007,Michael Ruffin,30,30,0,271,5,18,.278,0,0,,5,18,.278,.278,7,19,.368,35,27,62,6,6,8,12,43,17
1959,WAS,2007,James Lang,23,11,0,55,4,9,.444,0,0,,4,9,.444,.444,3,5,.600,5,6,11,2,0,3,2,14,11
1960,WAS,2007,Mike Hall,22,2,0,13,1,4,.250,0,0,,1,4,.250,.250,0,0,,1,1,2,1,0,0,0,1,2
1961,WAS,2006,Gilbert Arenas,24,80,80,3384,746,1668,.447,199,540,.369,547,1128,.485,.507,655,799,.820,59,221,280,484,161,25,297,286,2346
1962,WAS,2006,Antawn Jamison,29,82,80,3288,660,1494,.442,147,373,.394,513,1121,.458,.491,217,297,.731,167,598,765,158,90,12,137,189,1684
1963,WAS,2006,Caron Butler,25,75,54,2708,494,1086,.455,41,120,.342,453,966,.469,.474,289,332,.870,114,352,466,186,127,18,175,238,1318
1964,WAS,2006,Antonio Daniels,30,80,17,2283,230,550,.418,23,101,.228,207,449,.461,.439,284,336,.845,19,153,172,284,52,8,89,96,767
1965,WAS,2006,Jared Jeffries,24,77,77,1951,187,415,.451,16,50,.320,171,365,.468,.470,99,168,.589,164,215,379,148,58,50,99,223,489
1966,WAS,2006,Brendan Haywood,26,79,70,1879,222,432,.514,0,0,,222,432,.514,.514,131,224,.585,200,267,467,46,30,104,97,232,575
1967,WAS,2006,Etan Thomas,27,71,9,1121,131,246,.533,0,0,,131,246,.533,.533,75,125,.600,99,180,279,14,20,68,51,148,337
1968,WAS,2006,Michael Ruffin,29,76,4,1010,34,77,.442,0,2,.000,34,75,.453,.442,37,74,.500,122,149,271,27,33,31,38,179,105
1969,WAS,2006,Chucky Atkins,31,28,2,552,66,174,.379,33,92,.359,33,82,.402,.474,22,31,.710,12,33,45,69,14,0,30,58,187
1970,WAS,2006,Jarvis Hayes,24,21,13,516,77,183,.421,17,47,.362,60,136,.441,.467,25,30,.833,19,57,76,27,16,1,22,38,196
1971,WAS,2006,Donell Taylor,23,51,1,465,53,136,.390,4,17,.235,49,119,.412,.404,30,43,.698,16,37,53,45,30,4,34,47,140
1972,WAS,2006,Calvin Booth,29,33,2,250,20,47,.426,1,2,.500,19,45,.422,.436,5,9,.556,19,33,52,12,9,9,8,44,46
1973,WAS,2006,Andray Blatche,19,29,0,175,26,67,.388,3,13,.231,23,54,.426,.410,10,12,.833,12,26,38,10,5,7,12,36,65
1974,WAS,2006,Billy Thomas,30,17,0,131,13,40,.325,10,30,.333,3,10,.300,.450,2,2,1.000,5,9,14,9,10,1,6,19,38
1975,WAS,2006,Awvee Storey,28,25,1,116,16,41,.390,3,7,.429,13,34,.382,.427,8,14,.571,8,14,22,4,3,1,5,22,43
1976,WAS,2005,Gilbert Arenas,23,80,80,3274,656,1523,.431,205,562,.365,451,961,.469,.498,521,640,.814,83,295,378,411,139,23,242,245,2038
1977,WAS,2005,Antawn Jamison,28,68,68,2605,519,1189,.437,71,208,.341,448,981,.457,.466,225,296,.760,160,359,519,154,55,16,118,151,1334
1978,WAS,2005,Larry Hughes,26,61,61,2358,467,1086,.430,59,209,.282,408,877,.465,.457,352,453,.777,74,308,382,285,176,18,153,168,1345
1979,WAS,2005,Jared Jeffries,23,77,71,2007,203,434,.468,16,51,.314,187,383,.488,.486,101,173,.584,152,222,374,151,66,35,114,206,523
1980,WAS,2005,Brendan Haywood,25,68,68,1865,239,427,.560,0,0,,239,427,.560,.560,159,261,.609,202,262,464,57,52,114,96,218,637
1981,WAS,2005,Jarvis Hayes,23,54,22,1560,206,530,.389,42,123,.341,164,407,.403,.428,99,118,.839,41,186,227,90,49,9,62,107,553
1982,WAS,2005,Michael Ruffin,28,79,7,1262,41,99,.414,0,1,.000,41,98,.418,.414,29,67,.433,157,175,332,64,43,41,44,193,111
1983,WAS,2005,Juan Dixon,26,63,4,1054,186,447,.416,48,147,.327,138,300,.460,.470,87,97,.897,32,87,119,111,43,4,68,98,507
1984,WAS,2005,Etan Thomas,26,47,10,976,128,255,.502,0,0,,128,255,.502,.502,76,144,.528,85,159,244,20,17,51,50,133,332
1985,WAS,2005,Kwame Brown,22,42,14,908,109,237,.460,0,0,,109,237,.460,.460,74,129,.574,72,134,206,39,25,15,67,112,292
1986,WAS,2005,Steve Blake,24,44,1,648,61,186,.328,36,93,.387,25,93,.269,.425,33,41,.805,18,53,71,69,13,0,39,47,191
1987,WAS,2005,Anthony Peeler,35,40,0,529,56,150,.373,25,65,.385,31,85,.365,.457,16,18,.889,14,51,65,57,18,2,28,39,153
1988,WAS,2005,Laron Profit,27,42,4,428,56,128,.438,8,28,.286,48,100,.480,.469,16,25,.640,24,52,76,37,16,5,27,44,136
1989,WAS,2005,Damone Brown,25,14,0,152,23,62,.371,4,11,.364,19,51,.373,.403,4,9,.444,10,18,28,14,1,6,15,17,54
1990,WAS,2005,Samaki Walker,28,14,0,134,11,31,.355,0,0,,11,31,.355,.355,2,3,.667,8,10,18,4,3,7,8,25,24
1991,WAS,2005,Peter John Ramos,19,6,0,20,5,10,.500,0,0,,5,10,.500,.500,1,2,.500,1,3,4,0,0,1,3,4,11
1992,WAS,2004,Kwame Brown,21,74,57,2239,288,589,.489,1,2,.500,287,587,.489,.490,228,334,.683,178,372,550,112,66,52,140,144,805
1993,WAS,2004,Gilbert Arenas,22,55,52,2066,358,914,.392,125,333,.375,233,581,.401,.460,237,317,.748,55,199,254,275,103,12,226,176,1078
1994,WAS,2004,Larry Hughes,25,61,61,2061,401,1009,.397,79,232,.341,322,777,.414,.437,267,335,.797,96,230,326,148,95,26,152,147,1148
1995,WAS,2004,Jarvis Hayes,22,70,42,2044,278,695,.400,40,131,.305,238,564,.422,.429,77,98,.786,71,193,264,106,71,11,110,157,673
1996,WAS,2004,Jared Jeffries,22,82,38,1913,177,469,.377,5,30,.167,172,439,.392,.383,105,171,.614,180,244,424,93,48,28,107,212,464
1997,WAS,2004,Etan Thomas,25,79,15,1901,257,526,.489,0,0,,257,526,.489,.489,191,295,.647,183,345,528,68,36,123,113,219,705
1998,WAS,2004,Brendan Haywood,24,77,59,1484,200,388,.515,0,1,.000,200,387,.517,.515,137,234,.585,186,201,387,43,32,100,80,154,537
1999,WAS,2004,Juan Dixon,25,71,16,1478,247,637,.388,59,198,.298,188,439,.428,.434,111,139,.799,30,118,148,137,82,4,104,111,664
2000,WAS,2004,Steve Blake,23,75,14,1392,157,407,.386,75,202,.371,82,205,.400,.478,55,67,.821,18,99,117,209,57,7,128,100,444
2001,WAS,2004,Christian Laettner,34,48,18,984,119,256,.465,6,21,.286,113,235,.481,.477,40,50,.800,50,182,232,89,37,28,42,102,284
2002,WAS,2004,Jerry Stackhouse,29,26,17,774,128,321,.399,23,65,.354,105,256,.410,.435,83,103,.806,16,78,94,103,24,3,88,49,362
2003,WAS,2004,Brevin Knight,28,32,12,598,58,138,.420,1,5,.200,57,133,.429,.424,19,27,.704,11,50,61,102,52,0,44,50,136
2004,WAS,2004,Mitchell Butler,33,41,4,552,54,124,.435,11,30,.367,43,94,.457,.480,15,24,.625,24,47,71,32,22,4,24,54,134
2005,WAS,2004,Chris Whitney,32,16,5,186,17,45,.378,8,18,.444,9,27,.333,.467,5,5,1.000,3,12,15,14,6,2,6,6,47
2006,WAS,2004,Lonny Baxter,25,12,0,132,16,32,.500,0,1,.000,16,31,.516,.500,9,12,.750,11,20,31,5,2,5,5,23,41
2007,WAS,2004,Torraye Braggs,27,4,0,22,3,5,.600,0,0,,3,5,.600,.600,0,0,,3,2,5,1,0,0,1,8,6
2008,WAS,2004,Jahidi White,27,1,0,4,0,1,.000,0,0,,0,1,.000,.000,0,0,,0,0,0,0,0,1,1,0,0
2009,WAS,2003,Michael Jordan,39,82,67,3031,679,1527,.445,16,55,.291,663,1472,.450,.450,266,324,.821,71,426,497,311,123,39,173,171,1640
2010,WAS,2003,Jerry Stackhouse,28,70,70,2747,491,1201,.409,71,245,.290,420,956,.439,.438,455,518,.878,61,197,258,316,65,28,193,130,1508
2011,WAS,2003,Christian Laettner,33,76,66,2215,255,516,.494,2,16,.125,253,500,.506,.496,120,144,.833,114,388,502,235,82,40,87,206,632
2012,WAS,2003,Larry Hughes,24,67,56,2137,346,741,.467,29,79,.367,317,662,.479,.487,136,186,.731,67,241,308,205,86,24,136,149,857
2013,WAS,2003,Tyronn Lue,25,75,24,1986,248,573,.433,60,176,.341,188,397,.474,.485,91,104,.875,22,127,149,263,47,1,77,151,647
2014,WAS,2003,Brendan Haywood,23,81,69,1930,173,339,.510,0,0,,173,339,.510,.510,155,245,.633,192,212,404,29,32,119,65,225,501
2015,WAS,2003,Kwame Brown,20,80,20,1773,224,502,.446,0,3,.000,224,499,.449,.446,145,217,.668,128,298,426,58,50,80,110,159,593
2016,WAS,2003,Bryon Russell,32,70,23,1388,108,306,.353,46,140,.329,62,166,.373,.428,53,69,.768,43,165,208,72,70,7,55,130,315
2017,WAS,2003,Juan Dixon,24,42,3,647,104,271,.384,25,84,.298,79,187,.422,.430,37,46,.804,13,59,72,40,26,3,42,54,270
2018,WAS,2003,Charles Oakley,39,42,1,514,23,55,.418,0,0,,23,55,.418,.418,28,34,.824,37,70,107,40,13,6,21,90,74
2019,WAS,2003,Etan Thomas,24,38,0,513,61,124,.492,0,0,,61,124,.492,.492,60,94,.638,70,95,165,3,8,23,33,66,182
2020,WAS,2003,Bobby Simmons,22,36,2,378,44,112,.393,0,5,.000,44,107,.411,.393,32,35,.914,33,44,77,20,10,3,8,51,120
2021,WAS,2003,Jared Jeffries,21,20,1,292,30,63,.476,3,6,.500,27,57,.474,.500,16,29,.552,26,32,58,16,8,5,21,28,79
2022,WAS,2003,Jahidi White,26,16,8,230,25,53,.472,0,0,,25,53,.472,.472,17,25,.680,37,36,73,2,1,12,9,33,67
2023,WAS,2003,Anthony Goldwire,31,5,0,34,4,7,.571,1,1,1.000,3,6,.500,.643,4,5,.800,0,3,3,1,0,0,4,1,13
2024,WAS,2003,Brian Cardinal,25,5,0,15,1,4,.250,0,1,.000,1,3,.333,.250,2,2,1.000,3,2,5,1,0,0,1,0,4
2025,WAS,2002,Richard Hamilton,23,63,57,2203,472,1084,.435,16,42,.381,456,1042,.438,.443,300,337,.890,73,143,216,171,38,14,132,136,1260
2026,WAS,2002,Chris Whitney,30,82,81,2171,274,656,.418,131,323,.406,143,333,.429,.518,154,175,.880,11,141,152,314,72,6,85,182,833
2027,WAS,2002,Michael Jordan,38,60,53,2093,551,1324,.416,10,53,.189,541,1271,.426,.420,263,333,.790,50,289,339,310,85,26,162,119,1375
2028,WAS,2002,Popeye Jones,31,79,40,1920,222,508,.437,4,11,.364,218,497,.439,.441,106,130,.815,233,345,578,127,50,19,88,209,554
2029,WAS,2002,Tyrone Nesby,26,70,9,1498,183,421,.435,13,47,.277,170,374,.455,.450,64,93,.688,105,213,318,91,61,22,49,164,443
2030,WAS,2002,Tyronn Lue,24,71,0,1458,222,520,.427,63,141,.447,159,379,.420,.488,48,63,.762,14,108,122,246,49,0,96,120,555
2031,WAS,2002,Christian Laettner,32,57,48,1441,168,362,.464,2,10,.200,166,352,.472,.467,66,76,.868,74,227,301,151,60,25,85,129,404
2032,WAS,2002,Jahidi White,25,71,69,1346,150,279,.538,0,0,,150,279,.538,.538,83,154,.539,159,285,444,17,25,75,65,163,383
2033,WAS,2002,Courtney Alexander,24,56,28,1325,223,474,.470,5,18,.278,218,456,.478,.476,98,121,.810,43,105,148,86,35,7,60,113,549
2034,WAS,2002,Brendan Haywood,22,62,2,1266,109,221,.493,0,0,,109,221,.493,.493,97,160,.606,143,179,322,29,21,91,50,158,315
2035,WAS,2002,Hubert Davis,31,51,17,1231,146,326,.448,57,126,.452,89,200,.445,.535,16,21,.762,7,70,77,107,28,3,44,58,365
2036,WAS,2002,Kwame Brown,19,57,3,817,94,243,.387,0,1,.000,94,242,.388,.387,70,99,.707,63,135,198,43,16,26,43,105,258
2037,WAS,2002,Etan Thomas,23,47,0,618,81,151,.536,0,0,,81,151,.536,.536,41,74,.554,55,126,181,6,17,35,26,76,203
2038,WAS,2002,Bobby Simmons,21,30,3,343,43,95,.453,4,14,.286,39,81,.481,.474,22,30,.733,25,27,52,17,13,5,14,31,112
2039,WAS,2001,Richard Hamilton,22,78,42,2519,547,1249,.438,40,146,.274,507,1103,.460,.454,277,319,.868,75,163,238,224,75,10,201,203,1411
2040,WAS,2001,Juwan Howard,27,54,54,1981,392,827,.474,0,0,,392,827,.474,.474,197,256,.770,121,258,379,154,46,21,169,186,981
2041,WAS,2001,Michael Smith,28,79,29,1610,106,218,.486,0,1,.000,106,217,.488,.486,89,154,.578,172,390,562,101,57,37,62,156,301
2042,WAS,2001,Jahidi White,24,68,56,1609,203,408,.498,0,1,.000,203,407,.499,.498,177,312,.567,178,343,521,20,32,111,136,211,583
2043,WAS,2001,Chris Whitney,29,59,31,1532,182,470,.387,93,248,.375,89,222,.401,.486,101,113,.894,12,94,106,248,55,3,103,150,558
2044,WAS,2001,Tyrone Nesby,25,48,22,1223,149,407,.366,39,134,.291,110,273,.403,.414,67,83,.807,35,96,131,65,41,16,55,127,404
2045,WAS,2001,Mitch Richmond,35,37,30,1216,205,504,.407,45,133,.338,160,371,.431,.451,143,160,.894,15,94,109,111,43,7,84,86,598
2046,WAS,2001,Felipe López,26,47,38,1108,142,326,.436,6,29,.207,136,297,.458,.445,90,123,.732,30,130,160,73,41,18,56,110,380
2047,WAS,2001,Rod Strickland,34,33,28,1020,141,331,.426,4,16,.250,137,315,.435,.432,115,147,.782,25,80,105,231,43,4,83,55,401
2048,WAS,2001,Courtney Alexander,23,27,18,910,177,395,.448,14,36,.389,163,359,.454,.466,90,105,.857,22,58,80,41,29,2,54,63,458
2049,WAS,2001,Christian Laettner,31,25,13,733,112,228,.491,3,10,.300,109,218,.500,.498,103,122,.844,43,110,153,57,31,19,67,83,330
2050,WAS,2001,Gerard King,28,45,3,706,90,176,.511,0,0,,90,176,.511,.511,36,45,.800,39,90,129,31,14,11,47,94,216
2051,WAS,2001,Calvin Booth,24,40,22,640,74,168,.440,0,0,,74,168,.440,.440,33,45,.733,53,121,174,23,17,81,36,91,181
2052,WAS,2001,Popeye Jones,30,45,1,638,60,153,.392,1,6,.167,59,147,.401,.395,41,55,.745,83,137,220,31,19,8,21,95,162
2053,WAS,2001,Laron Profit,23,35,12,605,56,142,.394,7,26,.269,49,116,.422,.419,33,45,.733,18,46,64,89,36,11,46,43,152
2054,WAS,2001,Hubert Davis,30,15,11,431,57,119,.479,20,38,.526,37,81,.457,.563,19,21,.905,10,20,30,49,6,0,25,29,153
2055,WAS,2001,David Vanterpool,27,22,0,411,46,110,.418,0,6,.000,46,104,.442,.418,30,50,.600,15,22,37,66,23,3,37,44,122
2056,WAS,2001,Obinna Ekezie,25,29,0,273,32,77,.416,0,0,,32,77,.416,.416,37,53,.698,31,45,76,9,5,5,14,46,101
2057,WAS,2001,Mike Smith,24,17,0,180,19,59,.322,3,18,.167,16,41,.390,.347,10,16,.625,10,12,22,10,5,3,7,8,51
2058,WAS,2001,Cherokee Parks,28,13,0,178,18,38,.474,0,0,,18,38,.474,.474,12,17,.706,13,27,40,7,6,11,10,20,48
2059,WAS,2001,Loy Vaught,32,14,0,157,25,48,.521,0,0,,25,48,.521,.521,4,4,1.000,16,34,50,7,6,2,8,13,54
2060,WAS,2000,Juwan Howard,26,82,82,2909,509,1108,.459,0,7,.000,509,1101,.462,.459,202,275,.735,132,338,470,247,67,21,225,299,1220
2061,WAS,2000,Mitch Richmond,34,74,69,2397,447,1049,.426,93,241,.386,354,808,.438,.470,298,340,.876,37,176,213,185,110,13,154,191,1285
2062,WAS,2000,Rod Strickland,33,69,67,2188,327,762,.429,1,21,.048,326,741,.440,.430,214,305,.702,73,186,259,519,94,18,187,147,869
2063,WAS,2000,Tracy Murray,28,80,8,1831,290,670,.433,113,263,.430,177,407,.435,.517,120,141,.851,63,208,271,72,45,24,84,185,813
2064,WAS,2000,Chris Whitney,28,82,15,1627,217,521,.417,96,255,.376,121,266,.455,.509,112,132,.848,20,114,134,313,55,5,107,166,642
2065,WAS,2000,Aaron Williams,28,81,0,1545,235,450,.522,0,3,.000,235,447,.526,.522,146,201,.726,159,250,409,58,41,92,80,234,616
2066,WAS,2000,Jahidi White,23,80,59,1537,228,450,.507,0,0,,228,450,.507,.507,113,211,.536,202,351,553,15,31,83,94,234,569
2067,WAS,2000,Richard Hamilton,21,71,12,1373,254,605,.420,28,77,.364,226,528,.428,.443,103,133,.774,38,91,129,108,28,6,84,142,639
2068,WAS,2000,Isaac Austin,30,59,23,1173,151,352,.429,1,4,.250,150,348,.431,.430,94,137,.686,64,218,282,74,17,38,107,128,397
2069,WAS,2000,Michael Smith,27,46,46,1145,108,192,.563,0,1,.000,108,191,.565,.563,73,101,.723,121,210,331,56,27,23,45,127,289
2070,WAS,2000,Gerard King,27,62,28,1060,139,277,.502,0,0,,139,277,.502,.502,49,66,.742,84,166,250,49,34,15,41,132,327
2071,WAS,2000,Don Reid,26,17,0,333,44,78,.564,0,0,,44,78,.564,.564,21,28,.750,26,51,77,10,19,19,12,73,109
2072,WAS,2000,Reggie Jordan,32,36,0,243,17,53,.321,0,1,.000,17,52,.327,.321,7,13,.538,16,25,41,32,12,2,19,29,41
2073,WAS,2000,Laron Profit,22,33,1,225,21,59,.356,3,17,.176,18,42,.429,.381,4,10,.400,2,24,26,25,7,4,19,26,49
2074,WAS,2000,Calvin Booth,23,11,0,143,16,46,.348,0,0,,16,46,.348,.348,10,14,.714,15,17,32,7,3,14,6,23,42
2075,WAS,2000,Lorenzo Williams,30,8,0,76,7,9,.778,0,0,,7,9,.778,.778,0,0,,12,13,25,1,3,6,3,13,14
2076,WAS,1999,Mitch Richmond,33,50,50,1912,331,803,.412,70,221,.317,261,582,.448,.456,251,293,.857,30,142,172,122,64,10,136,121,983
2077,WAS,1999,Rod Strickland,32,44,43,1632,251,603,.416,12,42,.286,239,561,.426,.426,176,236,.746,56,156,212,434,76,5,142,91,690
2078,WAS,1999,Otis Thorpe,36,49,38,1539,240,440,.545,0,2,.000,240,438,.548,.545,74,106,.698,96,238,334,101,42,19,88,196,554
2079,WAS,1999,Juwan Howard,25,36,36,1430,286,604,.474,0,3,.000,286,601,.476,.474,110,146,.753,90,203,293,107,42,14,95,130,682
2080,WAS,1999,Calbert Cheaney,27,50,18,1266,172,415,.414,8,37,.216,164,378,.434,.424,33,67,.493,33,108,141,73,39,16,42,146,385
2081,WAS,1999,Ben Wallace,24,46,16,1231,115,199,.578,0,0,,115,199,.578,.578,47,132,.356,137,247,384,18,50,90,36,111,277
2082,WAS,1999,Tracy Murray,27,36,0,653,83,237,.350,33,103,.320,50,134,.373,.420,34,42,.810,18,63,81,27,21,6,29,65,233
2083,WAS,1999,Terry Davis,31,37,34,578,49,92,.533,0,0,,49,92,.533,.533,28,38,.737,50,89,139,10,11,3,16,79,126
2084,WAS,1999,Chris Whitney,27,39,1,441,64,156,.410,32,95,.337,32,61,.525,.513,27,31,.871,8,39,47,69,18,2,36,49,187
2085,WAS,1999,Jeff McInnis,24,35,6,427,50,134,.373,9,35,.257,41,99,.414,.407,21,28,.750,9,12,21,73,19,1,30,36,130
2086,WAS,1999,Tim Legler,32,30,0,377,51,115,.443,14,35,.400,37,80,.463,.504,3,6,.500,8,32,40,21,4,3,14,42,119
2087,WAS,1999,Randell Jackson,23,27,8,271,46,108,.426,1,7,.143,45,101,.446,.431,21,32,.656,30,24,54,8,3,11,26,29,114
2088,WAS,1999,Jahidi White,22,20,0,191,17,32,.531,0,0,,17,32,.531,.531,15,35,.429,23,35,58,1,3,11,16,39,49
2089,WAS,1999,John Coker,27,14,0,98,13,31,.419,0,0,,13,31,.419,.419,5,6,.833,7,15,22,0,1,2,2,17,31
2090,WAS,1999,Etdrick Bohannon,25,2,0,4,0,0,,0,0,,0,0,,,0,0,,0,0,0,0,0,0,0,0,0
2091,WAS,1998,Rod Strickland,31,76,76,3020,490,1130,.434,12,48,.250,478,1082,.442,.439,357,492,.726,112,293,405,801,126,25,266,182,1349
2092,WAS,1998,Calbert Cheaney,26,82,82,2841,448,981,.457,15,53,.283,433,928,.467,.464,139,215,.647,82,242,324,173,96,36,104,264,1050
2093,WAS,1998,Chris Webber,24,71,71,2809,647,1341,.482,65,205,.317,582,1136,.512,.507,196,333,.589,176,498,674,273,111,124,185,269,1555
2094,WAS,1998,Juwan Howard,24,64,64,2559,463,991,.467,0,2,.000,463,989,.468,.467,258,358,.721,161,288,449,208,82,23,185,225,1184
2095,WAS,1998,Tracy Murray,26,82,12,2227,449,1007,.446,158,403,.392,291,604,.482,.524,182,209,.871,75,202,277,84,67,25,102,167,1238
2096,WAS,1998,Terry Davis,30,74,66,1705,127,256,.496,0,1,.000,127,255,.498,.496,69,119,.580,209,271,480,30,41,24,56,193,323
2097,WAS,1998,Ben Wallace,23,67,16,1124,85,164,.518,0,0,,85,164,.518,.518,35,98,.357,112,212,324,18,61,72,28,116,205
2098,WAS,1998,Chris Whitney,26,82,6,1073,126,355,.355,52,169,.308,74,186,.398,.428,118,129,.915,16,99,115,196,34,6,65,106,422
2099,WAS,1998,Harvey Grant,32,65,8,895,75,196,.383,1,6,.167,74,190,.389,.385,19,30,.633,60,108,168,39,23,15,26,94,170
2100,WAS,1998,Darvin Ham,24,71,3,635,55,104,.529,0,0,,55,104,.529,.529,35,74,.473,72,59,131,16,21,25,37,118,145
2101,WAS,1998,Ledell Eackles,31,42,0,547,75,175,.429,16,46,.348,59,129,.457,.474,52,59,.881,25,50,75,16,17,0,29,43,218
2102,WAS,1998,God Shammgod,21,20,0,146,19,58,.328,0,2,.000,19,56,.339,.328,23,30,.767,2,5,7,36,7,1,21,27,61
2103,WAS,1998,Lorenzo Williams,28,14,6,111,13,17,.765,0,0,,13,17,.765,.765,0,2,.000,16,10,26,3,2,3,2,17,26
2104,WAS,1998,Tim Legler,31,8,0,76,3,19,.158,0,6,.000,3,13,.231,.158,3,4,.750,2,2,4,3,1,0,4,11,9
2105,WAS,1998,Lawrence Moten,25,8,0,27,3,13,.231,0,1,.000,3,12,.250,.231,3,4,.750,1,0,1,3,0,0,1,6,9
2106,WAS,1998,Jimmy Oliver,28,1,0,10,2,4,.500,1,2,.500,1,2,.500,.625,0,0,,0,2,2,1,0,0,0,1,5
2107,WSB,1997,Juwan Howard,23,82,82,3324,638,1313,.486,0,2,.000,638,1311,.487,.486,294,389,.756,202,450,652,311,93,23,246,259,1570
2108,WSB,1997,Rod Strickland,30,82,81,2997,515,1105,.466,13,77,.169,502,1028,.488,.472,367,497,.738,95,240,335,727,143,14,270,166,1410
2109,WSB,1997,Chris Webber,23,72,72,2806,604,1167,.518,60,151,.397,544,1016,.535,.543,177,313,.565,238,505,743,331,122,137,230,258,1445
2110,WSB,1997,Calbert Cheaney,25,79,79,2411,369,730,.505,4,30,.133,365,700,.521,.508,95,137,.693,70,198,268,114,77,18,94,226,837
2111,WSB,1997,Gheorghe Mureșan,25,73,69,1849,327,541,.604,0,0,,327,541,.604,.604,123,199,.618,141,340,481,29,43,96,117,230,777
2112,WSB,1997,Tracy Murray,25,82,1,1814,288,678,.425,106,300,.353,182,378,.481,.503,135,161,.839,84,169,253,78,69,19,86,150,817
2113,WSB,1997,Harvey Grant,31,78,25,1604,129,314,.411,28,89,.315,101,225,.449,.455,30,39,.769,63,193,256,68,46,48,30,167,316
2114,WSB,1997,Jaren Jackson,29,75,0,1133,134,329,.407,53,158,.335,81,171,.474,.488,53,69,.768,31,101,132,65,45,16,60,131,374
2115,WSB,1997,Chris Whitney,25,82,1,1117,139,330,.421,58,163,.356,81,167,.485,.509,94,113,.832,13,91,104,182,49,4,68,100,430
2116,WSB,1997,Lorenzo Williams,27,19,0,264,20,31,.645,0,0,,20,31,.645,.645,5,7,.714,28,41,69,4,6,8,18,49,45
2117,WSB,1997,Ben Wallace,22,34,0,197,16,46,.348,0,0,,16,46,.348,.348,6,20,.300,25,33,58,2,8,11,18,27,38
2118,WSB,1997,Tim Legler,30,15,0,182,15,48,.313,8,29,.276,7,19,.368,.396,6,7,.857,0,21,21,7,3,5,9,21,44
2119,WSB,1997,Ashraf Amaya,25,31,0,144,12,40,.300,1,1,1.000,11,39,.282,.313,15,28,.536,19,33,52,3,7,3,10,29,40
2120,WSB,1997,Matt Fish,27,5,0,7,1,3,.333,0,0,,1,3,.333,.333,0,0,,1,4,5,0,0,0,2,2,2
2121,WSB,1997,Gaylon Nickerson,27,1,0,6,1,3,.333,0,1,.000,1,2,.500,.333,0,0,,0,1,1,0,1,0,1,0,2
2122,WSB,1996,Juwan Howard,22,81,81,3294,733,1500,.489,4,13,.308,729,1487,.490,.490,319,426,.749,188,472,660,360,67,39,303,269,1789
2123,WSB,1996,Calbert Cheaney,24,70,70,2324,426,905,.471,52,154,.338,374,751,.498,.499,151,214,.706,67,172,239,154,67,18,129,205,1055
2124,WSB,1996,Gheorghe Mureșan,24,76,76,2242,466,798,.584,0,1,.000,466,797,.585,.584,172,278,.619,248,480,728,56,52,172,143,297,1104
2125,WSB,1996,Brent Price,27,81,50,2042,252,534,.472,139,301,.462,113,233,.485,.602,167,191,.874,38,190,228,416,78,4,153,184,810
2126,WSB,1996,Rasheed Wallace,21,65,51,1788,275,565,.487,27,82,.329,248,483,.513,.511,78,120,.650,93,210,303,85,42,54,103,206,655
2127,WSB,1996,Tim Legler,29,77,0,1775,233,460,.507,128,245,.522,105,215,.488,.646,132,153,.863,29,111,140,136,45,12,45,141,726
2128,WSB,1996,Ledell Eackles,29,55,26,1238,161,377,.427,54,128,.422,107,249,.430,.499,98,118,.831,44,104,148,86,28,3,57,84,474
2129,WSB,1996,Jim McIlvaine,23,80,6,1195,62,145,.428,0,0,,62,145,.428,.428,58,105,.552,66,164,230,11,21,166,36,171,182
2130,WSB,1996,Robert Pack,26,31,31,1084,190,444,.428,26,98,.265,164,346,.474,.457,154,182,.846,29,103,132,242,62,1,114,68,560
2131,WSB,1996,Mitchell Butler,25,61,3,858,88,229,.384,13,60,.217,75,169,.444,.413,48,83,.578,29,89,118,67,41,12,67,104,237
2132,WSB,1996,Bob McCann,31,62,0,653,76,153,.497,1,2,.500,75,151,.497,.500,35,74,.473,46,97,143,24,21,15,42,116,188
2133,WSB,1996,Chris Webber,22,15,15,558,150,276,.543,15,34,.441,135,242,.558,.571,41,69,.594,37,77,114,75,27,9,49,51,356
2134,WSB,1996,Chris Whitney,24,21,0,335,45,99,.455,19,44,.432,26,55,.473,.551,41,44,.932,2,31,33,51,18,1,23,46,150
2135,WSB,1996,Greg Grant,29,10,0,138,11,28,.393,2,10,.200,9,18,.500,.429,0,0,,1,5,6,23,8,0,10,8,24
2136,WSB,1996,Mark Price,31,7,1,127,18,60,.300,10,30,.333,8,30,.267,.383,10,10,1.000,1,6,7,18,6,0,10,7,56
2137,WSB,1996,Jeff Webster,24,11,0,58,8,23,.348,2,6,.333,6,17,.353,.391,0,0,,2,5,7,3,4,0,3,7,18
2138,WSB,1996,Michael Curry,27,5,0,34,3,10,.300,0,3,.000,3,7,.429,.300,4,4,1.000,2,3,5,1,1,0,1,3,10
2139,WSB,1996,Bob Thornton,33,7,0,31,1,6,.167,0,0,,1,6,.167,.167,1,2,.500,6,6,12,0,1,0,1,7,3
2140,WSB,1996,Kevin Pritchard,28,2,0,22,2,3,.667,1,1,1.000,1,2,.500,.833,2,3,.667,0,2,2,7,2,0,0,3,7
2141,WSB,1996,Mike Peplowski,25,2,0,5,0,0,,0,0,,0,0,,,0,0,,0,0,0,0,0,0,0,4,0
2142,WSB,1996,Cedric Lewis,26,3,0,4,2,3,.667,0,0,,2,3,.667,.667,0,0,,2,0,2,0,1,0,0,0,4
2143,WSB,1995,Calbert Cheaney,23,78,71,2651,512,1129,.453,96,283,.339,416,846,.492,.496,173,213,.812,105,216,321,177,80,21,151,215,1293
2144,WSB,1995,Juwan Howard,21,65,52,2348,455,931,.489,0,7,.000,455,924,.492,.489,194,292,.664,184,361,545,165,52,15,166,236,1104
2145,WSB,1995,Scott Skiles,30,62,62,2077,265,583,.455,96,228,.421,169,355,.476,.537,179,202,.886,26,133,159,452,70,6,172,135,805
2146,WSB,1995,Chris Webber,21,54,52,2067,464,938,.495,40,145,.276,424,793,.535,.516,117,233,.502,200,318,518,256,83,85,167,186,1085
2147,WSB,1995,Gheorghe Mureșan,23,73,58,1720,303,541,.560,0,0,,303,541,.560,.560,124,175,.709,179,309,488,38,48,127,115,259,730
2148,WSB,1995,Doug Overton,25,82,20,1704,207,498,.416,53,125,.424,154,373,.413,.469,109,125,.872,26,117,143,246,53,2,104,126,576
2149,WSB,1995,Mitchell Butler,24,76,5,1554,214,508,.421,46,141,.326,168,367,.458,.467,123,185,.665,43,127,170,91,61,10,106,155,597
2150,WSB,1995,Rex Chapman,27,45,29,1468,254,639,.397,86,274,.314,168,365,.460,.465,137,159,.862,23,90,113,128,67,15,62,85,731
2151,WSB,1995,Don MacLean,25,39,20,1052,158,361,.438,10,40,.250,148,321,.461,.452,104,136,.765,46,119,165,51,15,3,44,97,430
2152,WSB,1995,Anthony Tucker,25,62,13,982,96,210,.457,0,1,.000,96,209,.459,.457,51,83,.614,44,126,170,68,46,11,56,129,243
2153,WSB,1995,Kevin Duckworth,30,40,22,818,118,267,.442,2,10,.200,116,257,.451,.446,45,70,.643,65,130,195,20,21,24,59,110,283
2154,WSB,1995,Jim McIlvaine,22,55,0,534,34,71,.479,0,0,,34,71,.479,.479,28,41,.683,40,65,105,10,10,60,19,95,96
2155,WSB,1995,Larry Stewart,26,40,0,346,41,89,.461,0,2,.000,41,87,.471,.461,20,30,.667,28,39,67,18,16,9,16,52,102
2156,WSB,1995,Kenny Walker,30,24,0,266,18,42,.429,0,0,,18,42,.429,.429,21,28,.750,19,28,47,7,5,5,15,42,57
2157,WSB,1995,Tom Gugliotta,25,6,6,226,33,83,.398,4,8,.500,29,75,.387,.422,26,33,.788,16,37,53,18,21,11,15,19,96
2158,WSB,1995,Brian Oliver,26,6,0,42,4,9,.444,0,0,,4,9,.444,.444,6,8,.750,0,4,4,4,0,0,3,8,14
2159,WSB,1994,Tom Gugliotta,24,78,78,2795,540,1159,.466,40,148,.270,500,1011,.495,.483,213,311,.685,189,539,728,276,172,51,247,174,1333
2160,WSB,1994,Don MacLean,24,75,69,2487,517,1030,.502,3,21,.143,514,1009,.509,.503,328,398,.824,140,327,467,160,47,22,152,169,1365
2161,WSB,1994,Michael Adams,31,70,67,2337,285,698,.408,55,191,.288,230,507,.454,.448,224,270,.830,37,146,183,480,96,6,167,140,849
2162,WSB,1994,Rex Chapman,26,60,59,2025,431,865,.498,64,165,.388,367,700,.524,.535,168,206,.816,57,89,146,185,59,8,117,83,1094
2163,WSB,1994,Calbert Cheaney,22,65,21,1604,327,696,.470,1,23,.043,326,673,.484,.471,124,161,.770,88,102,190,126,63,10,108,148,779
2164,WSB,1994,Kevin Duckworth,29,69,52,1485,184,441,.417,0,0,,184,441,.417,.417,88,132,.667,103,222,325,56,37,35,101,223,456
2165,WSB,1994,Kenny Walker,29,73,4,1397,132,274,.482,0,3,.000,132,271,.487,.482,87,125,.696,118,171,289,33,26,59,44,156,351
2166,WSB,1994,Mitchell Butler,23,75,19,1321,207,418,.495,0,5,.000,207,413,.501,.495,104,180,.578,106,119,225,77,54,20,87,131,518
2167,WSB,1994,Pervis Ellison,26,47,24,1178,137,292,.469,0,3,.000,137,289,.474,.469,70,97,.722,77,165,242,70,25,50,73,140,344
2168,WSB,1994,Brent Price,25,65,13,1035,141,326,.433,50,150,.333,91,176,.517,.509,68,87,.782,31,59,90,213,55,2,119,114,400
2169,WSB,1994,Doug Overton,24,61,1,749,87,216,.403,1,11,.091,86,205,.420,.405,43,52,.827,19,50,69,92,21,1,54,48,218
2170,WSB,1994,Gheorghe Mureșan,22,54,2,650,128,235,.545,0,0,,128,235,.545,.545,48,71,.676,66,126,192,18,28,48,54,120,304
2171,WSB,1994,Marty Conlon,26,14,1,201,29,56,.518,0,1,.000,29,55,.527,.518,12,15,.800,19,31,50,6,4,1,10,33,70
2172,WSB,1994,Ron Anderson,35,10,0,180,20,43,.465,3,14,.214,17,29,.586,.500,9,11,.818,8,19,27,11,3,1,9,7,52
2173,WSB,1994,Gerald Paddio,28,8,0,74,11,32,.344,0,1,.000,11,31,.355,.344,8,14,.571,5,6,11,7,3,0,2,4,30
2174,WSB,1994,Andrew Gaze,28,7,0,70,8,17,.471,4,8,.500,4,9,.444,.588,2,2,1.000,1,6,7,5,2,1,3,9,22
2175,WSB,1994,LaBradford Smith,24,7,0,48,8,18,.444,0,0,,8,18,.444,.444,15,20,.750,5,3,8,5,3,1,1,8,31
2176,WSB,1994,Larry Stewart,25,3,0,35,3,8,.375,0,0,,3,8,.375,.375,7,10,.700,1,6,7,2,2,1,2,4,13
2177,WSB,1994,Tito Horford,28,3,0,28,0,2,.000,0,0,,0,2,.000,.000,0,0,,1,2,3,0,1,3,1,3,0
2178,WSB,1994,Manute Bol,31,2,0,6,0,0,,0,0,,0,0,,,0,0,,0,1,1,1,0,1,0,1,0
2179,WSB,1993,Tom Gugliotta,23,81,81,2795,484,1135,.426,38,135,.281,446,1000,.446,.443,181,281,.644,219,562,781,306,134,35,230,195,1187
2180,WSB,1993,Harvey Grant,27,72,72,2667,560,1149,.487,1,10,.100,559,1139,.491,.488,218,300,.727,133,279,412,205,72,44,90,168,1339
2181,WSB,1993,Michael Adams,30,70,70,2499,365,831,.439,68,212,.321,297,619,.480,.480,237,277,.856,52,188,240,526,100,4,175,146,1035
2182,WSB,1993,Larry Stewart,24,81,8,1823,306,564,.543,0,2,.000,306,562,.544,.543,184,253,.727,154,229,383,146,47,29,153,191,796
2183,WSB,1993,Pervis Ellison,25,49,48,1701,341,655,.521,0,4,.000,341,651,.524,.521,170,242,.702,138,295,433,117,45,108,110,154,852
2184,WSB,1993,LaBradford Smith,23,69,33,1546,261,570,.458,8,23,.348,253,547,.463,.465,109,127,.858,26,80,106,186,58,9,103,178,639
2185,WSB,1993,Rex Chapman,25,60,23,1300,287,602,.477,43,116,.371,244,486,.502,.512,132,163,.810,19,69,88,116,38,10,79,119,749
2186,WSB,1993,Buck Johnson,29,73,19,1287,193,403,.479,0,3,.000,193,400,.483,.479,92,126,.730,78,117,195,89,36,18,70,187,478
2187,WSB,1993,Charles Jones,35,67,21,1206,33,63,.524,0,1,.000,33,62,.532,.524,22,38,.579,87,190,277,42,38,77,38,144,88
2188,WSB,1993,Doug Overton,23,45,13,990,152,323,.471,3,13,.231,149,310,.481,.475,59,81,.728,25,81,106,157,31,6,72,81,366
2189,WSB,1993,Brent Price,24,68,9,859,100,279,.358,8,48,.167,92,231,.398,.373,54,68,.794,28,75,103,154,56,3,85,90,262
2190,WSB,1993,Don MacLean,23,62,4,674,157,361,.435,3,6,.500,154,355,.434,.439,90,111,.811,33,89,122,39,11,4,42,82,407
2191,WSB,1993,Mark Acres,30,12,7,246,24,40,.600,0,0,,24,40,.600,.600,10,14,.714,24,37,61,5,3,6,11,32,58
2192,WSB,1993,Greg Foster,24,10,0,93,11,25,.440,0,0,,11,25,.440,.440,2,3,.667,8,19,27,11,0,5,9,17,24
2193,WSB,1993,Byron Irvin,26,4,2,45,9,18,.500,1,1,1.000,8,17,.471,.528,3,6,.500,2,2,4,2,1,0,4,5,22
2194,WSB,1993,Steve Burtt,30,4,0,35,10,26,.385,1,3,.333,9,23,.391,.404,8,10,.800,2,1,3,6,2,0,4,5,29
2195,WSB,1993,Larry Robinson,25,4,0,33,6,16,.375,0,1,.000,6,15,.400,.375,3,5,.600,1,2,3,3,1,1,1,0,15
2196,WSB,1993,Chris Corchiani,24,1,0,3,1,1,1.000,0,0,,1,1,1.000,1.000,0,0,,0,0,0,0,0,0,0,1,2
2197,WSB,1993,Alan Ogg,25,3,0,3,2,4,.500,0,0,,2,4,.500,.500,1,2,.500,2,2,4,0,0,0,0,0,5
2198,WSB,1992,Michael Adams,29,78,78,2795,485,1233,.393,125,386,.324,360,847,.425,.444,313,360,.869,58,252,310,594,145,9,212,162,1408
2199,WSB,1992,Pervis Ellison,24,66,64,2511,547,1014,.539,1,3,.333,546,1011,.540,.540,227,312,.728,217,523,740,190,62,177,196,222,1322
2200,WSB,1992,Harvey Grant,26,64,60,2388,489,1022,.478,1,8,.125,488,1014,.481,.479,176,220,.800,157,275,432,170,74,27,109,178,1155
2201,WSB,1992,Larry Stewart,23,76,43,2229,303,590,.514,0,3,.000,303,587,.516,.514,188,233,.807,186,263,449,120,51,44,112,225,794
2202,WSB,1992,David Wingate,28,81,72,2127,266,572,.465,1,18,.056,265,554,.478,.466,105,146,.719,80,189,269,247,123,21,124,162,638
2203,WSB,1992,A.J. English,24,81,6,1665,366,846,.433,6,34,.176,360,812,.443,.436,148,176,.841,74,94,168,143,32,9,89,160,886
2204,WSB,1992,Ledell Eackles,25,65,25,1463,355,759,.468,7,35,.200,348,724,.481,.472,139,187,.743,39,139,178,125,47,7,75,145,856
2205,WSB,1992,Charles Jones,34,75,32,1365,33,90,.367,0,0,,33,90,.367,.367,20,40,.500,105,212,317,62,43,92,39,214,86
2206,WSB,1992,Tom Hammonds,24,37,19,984,195,400,.488,0,1,.000,195,399,.489,.488,50,82,.610,49,136,185,36,22,13,58,118,440
2207,WSB,1992,Andre Turner,27,70,3,871,111,261,.425,1,16,.063,110,245,.449,.427,61,77,.792,17,73,90,177,57,2,84,59,284
2208,WSB,1992,LaBradford Smith,22,48,5,708,100,246,.407,2,21,.095,98,225,.436,.411,45,56,.804,30,51,81,99,44,1,63,98,247
2209,WSB,1992,Greg Foster,23,49,3,548,89,193,.461,0,1,.000,89,192,.464,.461,35,49,.714,43,102,145,35,6,12,36,83,213
2210,WSB,1992,Ralph Sampson,31,10,0,108,9,29,.310,0,2,.000,9,27,.333,.310,4,6,.667,11,19,30,4,3,8,10,14,22
2211,WSB,1992,Albert King,32,6,0,59,11,30,.367,2,7,.286,9,23,.391,.400,7,8,.875,1,10,11,5,3,0,2,7,31
2212,WSB,1992,Rex Chapman,24,1,0,22,5,12,.417,0,2,.000,5,10,.500,.417,0,0,,1,3,4,3,1,0,3,4,10
2213,WSB,1992,Derek Strong,23,1,0,12,0,4,.000,0,0,,0,4,.000,.000,3,4,.750,1,4,5,1,0,0,1,1,3
2214,WSB,1991,Harvey Grant,25,77,76,2842,609,1224,.498,2,15,.133,607,1209,.502,.498,185,249,.743,179,378,557,204,91,61,125,232,1405
2215,WSB,1991,Bernard King,34,64,64,2401,713,1511,.472,8,37,.216,705,1474,.478,.475,383,485,.790,114,205,319,292,56,16,255,187,1817
2216,WSB,1991,Darrell Walker,29,71,65,2305,230,535,.430,0,9,.000,230,526,.437,.430,93,154,.604,140,358,498,459,78,33,154,199,553
2217,WSB,1991,Haywoode Workman,25,73,56,2034,234,515,.454,12,50,.240,222,465,.477,.466,101,133,.759,51,191,242,353,87,7,135,162,581
2218,WSB,1991,Pervis Ellison,23,76,30,1942,326,636,.513,0,6,.000,326,630,.517,.513,139,214,.650,224,361,585,102,49,157,146,268,791
2219,WSB,1991,Ledell Eackles,24,67,17,1616,345,762,.453,14,59,.237,331,703,.471,.462,164,222,.739,47,81,128,136,47,10,115,121,868
2220,WSB,1991,Charles Jones,33,62,54,1499,67,124,.540,0,0,,67,124,.540,.540,29,50,.580,119,240,359,48,51,124,46,199,163
2221,WSB,1991,A.J. English,23,70,12,1443,251,572,.439,3,31,.097,248,541,.458,.441,111,157,.707,66,81,147,177,25,15,114,127,616
2222,WSB,1991,Tom Hammonds,23,70,7,1023,155,336,.461,0,4,.000,155,332,.467,.461,57,79,.722,58,148,206,43,15,7,54,108,367
2223,WSB,1991,John Williams,24,33,11,941,164,393,.417,10,41,.244,154,352,.438,.430,73,97,.753,42,135,177,133,39,6,68,63,411
2224,WSB,1991,Greg Foster,22,54,3,606,97,211,.460,0,5,.000,97,206,.471,.460,42,61,.689,52,99,151,37,12,22,45,112,236
2225,WSB,1991,Mark Alarie,27,42,1,587,99,225,.440,5,21,.238,94,204,.461,.451,41,48,.854,41,76,117,45,15,8,40,88,244
2226,WSB,1991,Byron Irvin,24,33,4,316,60,129,.465,1,5,.200,59,124,.476,.469,50,61,.820,24,21,45,24,15,2,16,32,171
2227,WSB,1991,Larry Robinson,23,12,10,255,38,91,.418,0,1,.000,38,90,.422,.418,7,12,.583,14,14,28,24,7,0,11,26,83
2228,WSB,1991,Clinton Smith,27,5,0,45,2,4,.500,0,0,,2,4,.500,.500,3,6,.500,2,2,4,4,1,0,1,3,7
2229,WSB,1990,Darrell Walker,28,81,81,2883,316,696,.454,2,21,.095,314,675,.465,.455,138,201,.687,173,541,714,652,139,30,173,220,772
2230,WSB,1990,Bernard King,33,82,82,2687,711,1459,.487,3,23,.130,708,1436,.493,.488,412,513,.803,129,275,404,376,51,7,248,230,1837
2231,WSB,1990,Jeff Malone,28,75,74,2567,781,1592,.491,1,6,.167,780,1586,.492,.491,257,293,.877,54,152,206,243,48,6,125,116,1820
2232,WSB,1990,Charles Jones,32,81,81,2240,94,185,.508,0,0,,94,185,.508,.508,68,105,.648,145,359,504,139,50,197,76,296,256
2233,WSB,1990,Mark Alarie,26,82,10,1893,371,785,.473,10,49,.204,361,736,.490,.479,108,133,.812,151,223,374,142,60,39,101,219,860
2234,WSB,1990,Harvey Grant,24,81,25,1846,284,601,.473,0,8,.000,284,593,.479,.473,96,137,.701,138,204,342,131,52,43,85,194,664
2235,WSB,1990,Ledell Eackles,23,78,8,1696,413,940,.439,19,59,.322,394,881,.447,.449,210,280,.750,74,101,175,182,50,4,143,157,1055
2236,WSB,1990,Steve Colter,27,73,1,977,142,297,.478,0,5,.000,142,292,.486,.478,77,95,.811,55,121,176,148,47,10,38,98,361
2237,WSB,1990,Melvin Turpin,29,59,12,818,110,209,.526,0,2,.000,110,207,.531,.526,56,71,.789,88,133,221,27,15,47,45,135,276
2238,WSB,1990,Tom Hammonds,22,61,8,805,129,295,.437,0,1,.000,129,294,.439,.437,63,98,.643,61,107,168,51,11,14,46,98,321
2239,WSB,1990,John Williams,23,18,18,632,130,274,.474,2,18,.111,128,256,.500,.478,65,84,.774,27,109,136,84,21,9,43,33,327
2240,WSB,1990,Doug Roth,22,42,0,412,37,86,.430,0,1,.000,37,85,.435,.430,7,14,.500,44,76,120,20,8,13,16,70,81
2241,WSB,1990,Ed Horton,22,45,10,374,80,162,.494,0,4,.000,80,158,.506,.494,42,69,.609,59,49,108,19,9,5,39,63,202
2242,WSB,1989,Darrell Walker,27,79,78,2565,286,681,.420,0,9,.000,286,672,.426,.420,142,184,.772,135,372,507,496,155,23,184,215,714
2243,WSB,1989,Bernard King,32,81,81,2559,654,1371,.477,5,30,.167,649,1341,.484,.479,361,441,.819,133,251,384,294,64,13,227,219,1674
2244,WSB,1989,Jeff Malone,27,76,75,2418,677,1410,.480,1,19,.053,676,1391,.486,.480,296,340,.871,55,124,179,219,39,14,165,155,1651
2245,WSB,1989,John Williams,22,82,1,2413,438,940,.466,19,71,.268,419,869,.482,.476,225,290,.776,158,415,573,356,142,70,157,213,1120
2246,WSB,1989,Terry Catledge,25,79,77,2077,334,681,.490,1,5,.200,333,676,.493,.491,153,254,.602,230,342,572,75,46,25,120,250,822
2247,WSB,1989,Ledell Eackles,22,80,6,1459,318,732,.434,9,40,.225,309,692,.447,.441,272,346,.786,100,80,180,123,41,5,128,156,917
2248,WSB,1989,Steve Colter,26,80,5,1425,203,457,.444,3,25,.120,200,432,.463,.447,125,167,.749,62,120,182,225,69,14,64,158,534
2249,WSB,1989,Harvey Grant,23,71,1,1193,181,390,.464,0,1,.000,181,389,.465,.464,34,57,.596,75,88,163,79,35,29,28,147,396
2250,WSB,1989,Charles Jones,31,53,45,1154,60,125,.480,0,1,.000,60,124,.484,.480,16,25,.640,77,180,257,42,39,76,39,187,136
2251,WSB,1989,Mark Alarie,25,74,5,1141,206,431,.478,13,38,.342,193,393,.491,.493,73,87,.839,103,152,255,63,25,22,62,160,498
2252,WSB,1989,Dave Feitl,26,57,36,828,116,266,.436,0,1,.000,116,265,.438,.436,54,65,.831,69,133,202,36,17,18,65,136,286
2253,WSB,1989,Charles Jones,27,43,0,516,38,82,.463,1,3,.333,37,79,.468,.470,33,53,.623,54,86,140,18,18,16,22,49,110
2254,WSB,1989,Dominic Pressley,24,10,0,107,8,25,.320,0,0,,8,25,.320,.320,5,9,.556,3,11,14,22,4,0,11,9,21
2255,WSB,1988,Moses Malone,32,79,78,2692,531,1090,.487,2,7,.286,529,1083,.488,.488,543,689,.788,372,512,884,112,59,72,249,160,1607
2256,WSB,1988,Jeff Malone,26,80,80,2655,648,1360,.476,10,24,.417,638,1336,.478,.480,335,380,.882,44,162,206,237,51,13,172,198,1641
2257,WSB,1988,John Williams,21,82,37,2428,427,910,.469,5,38,.132,422,872,.484,.472,188,256,.734,127,317,444,232,117,34,145,217,1047
2258,WSB,1988,Bernard King,31,69,38,2044,470,938,.501,1,6,.167,469,932,.503,.502,247,324,.762,86,194,280,192,49,10,211,202,1188
2259,WSB,1988,Muggsy Bogues,23,79,14,1628,166,426,.390,3,16,.188,163,410,.398,.393,58,74,.784,35,101,136,404,127,3,101,138,393
2260,WSB,1988,Terry Catledge,24,70,40,1610,296,585,.506,0,2,.000,296,583,.508,.506,154,235,.655,180,217,397,63,33,9,101,172,746
2261,WSB,1988,Steve Colter,25,56,53,1361,188,401,.469,3,10,.300,185,391,.473,.473,68,86,.791,51,104,155,235,56,14,77,112,447
2262,WSB,1988,Charles Jones,30,69,49,1313,72,177,.407,0,1,.000,72,176,.409,.407,53,75,.707,106,219,325,59,53,113,57,226,197
2263,WSB,1988,Frank Johnson,29,75,17,1258,216,498,.434,1,9,.111,215,489,.440,.435,121,149,.812,39,82,121,188,70,4,99,120,554
2264,WSB,1988,Manute Bol,25,77,4,1136,75,165,.455,0,1,.000,75,164,.457,.455,26,49,.531,72,203,275,13,11,208,35,160,176
2265,WSB,1988,Darrell Walker,26,52,0,940,114,291,.392,0,6,.000,114,285,.400,.392,82,105,.781,43,84,127,100,62,10,69,105,310
2266,WSB,1988,Mark Alarie,24,63,0,769,144,300,.480,4,18,.222,140,282,.496,.487,35,49,.714,70,90,160,39,10,12,50,107,327
2267,WSB,1988,Jay Murphy,25,9,0,46,8,23,.348,0,0,,8,23,.348,.348,4,5,.800,4,12,16,1,0,0,5,5,20
2268,WSB,1987,Jeff Malone,25,80,79,2763,689,1509,.457,4,26,.154,685,1483,.462,.458,376,425,.885,50,168,218,298,75,13,182,154,1758
2269,WSB,1987,Moses Malone,31,73,70,2488,595,1311,.454,0,11,.000,595,1300,.458,.454,570,692,.824,340,484,824,120,59,92,202,139,1760
2270,WSB,1987,Terry Catledge,23,78,77,2149,413,835,.495,0,4,.000,413,831,.497,.495,199,335,.594,248,312,560,56,43,14,145,195,1025
2271,WSB,1987,Ennis Whatley,24,73,72,1816,246,515,.478,0,2,.000,246,513,.480,.478,126,165,.764,58,136,194,392,92,10,138,172,618
2272,WSB,1987,John Williams,20,78,6,1773,283,624,.454,8,36,.222,275,588,.468,.460,144,223,.646,130,236,366,191,129,30,122,173,718
2273,WSB,1987,Charles Jones,29,79,64,1609,118,249,.474,0,1,.000,118,248,.476,.474,48,76,.632,144,212,356,80,67,165,77,252,284
2274,WSB,1987,Manute Bol,24,82,12,1552,103,231,.446,0,1,.000,103,230,.448,.446,45,67,.672,84,278,362,11,20,302,61,189,251
2275,WSB,1987,Darwin Cook,28,82,2,1420,265,622,.426,2,23,.087,263,599,.439,.428,82,103,.796,46,99,145,151,98,17,96,136,614
2276,WSB,1987,Jay Vincent,27,51,17,1386,274,613,.447,0,3,.000,274,610,.449,.447,130,169,.769,69,141,210,85,40,17,77,127,678
2277,WSB,1987,Michael Adams,24,63,0,1303,160,393,.407,28,102,.275,132,291,.454,.443,105,124,.847,38,85,123,244,85,6,81,88,453
2278,WSB,1987,Dan Roundfield,33,36,0,669,90,220,.409,1,5,.200,89,215,.414,.411,57,72,.792,64,106,170,39,11,16,49,77,238
2279,WSB,1987,Frank Johnson,28,18,10,399,59,128,.461,0,1,.000,59,127,.465,.461,35,49,.714,10,20,30,58,21,0,31,31,153
2280,WSB,1987,Jay Murphy,24,21,0,141,31,72,.431,0,0,,31,72,.431,.431,9,16,.563,17,22,39,5,3,2,6,21,71
2281,WSB,1987,Mike O'Koren,28,15,0,123,16,42,.381,0,2,.000,16,40,.400,.381,0,2,.000,6,8,14,13,2,0,6,10,32
2282,WSB,1987,Anthony Jones,24,16,1,114,14,33,.424,0,1,.000,14,32,.438,.424,9,13,.692,1,8,9,7,10,1,11,11,37
2283,WSB,1986,Jeff Malone,24,80,80,2992,735,1522,.483,3,17,.176,732,1505,.486,.484,322,371,.868,66,222,288,191,70,12,168,180,1795
2284,WSB,1986,Cliff Robinson,25,78,78,2563,595,1255,.474,1,4,.250,594,1251,.475,.475,269,353,.762,180,500,680,186,98,44,206,217,1460
2285,WSB,1986,Dan Roundfield,32,79,21,2321,322,660,.488,0,6,.000,322,654,.492,.488,273,362,.754,210,432,642,167,36,51,187,194,917
2286,WSB,1986,Gus Williams,32,77,67,2284,434,1013,.428,30,116,.259,404,897,.450,.443,138,188,.734,52,114,166,453,96,15,160,113,1036
2287,WSB,1986,Manute Bol,23,80,60,2090,128,278,.460,0,1,.000,128,277,.462,.460,42,86,.488,123,354,477,23,28,397,65,255,298
2288,WSB,1986,Charles Jones,28,81,58,1609,129,254,.508,0,1,.000,129,253,.510,.508,54,86,.628,122,199,321,76,57,133,71,235,312
2289,WSB,1986,Jeff Ruland,27,30,24,1114,212,383,.554,0,4,.000,212,379,.559,.554,145,200,.725,107,213,320,159,23,25,121,100,569
2290,WSB,1986,Darren Daye,25,64,4,1075,198,399,.496,1,3,.333,197,396,.497,.497,159,237,.671,71,112,183,109,46,11,98,121,556
2291,WSB,1986,Tom McMillen,33,56,1,863,131,285,.460,0,3,.000,131,282,.465,.460,64,79,.810,44,69,113,35,9,10,34,85,326
2292,WSB,1986,Dudley Bradley,28,70,7,842,73,209,.349,17,68,.250,56,141,.397,.390,32,56,.571,24,71,95,107,85,3,44,101,195
2293,WSB,1986,Leon Wood,23,39,0,743,127,330,.385,28,85,.329,99,245,.404,.427,96,121,.793,16,47,63,107,20,0,67,46,378
2294,WSB,1986,Kevin McKenna,27,30,1,430,61,166,.367,27,75,.360,34,91,.374,.449,25,30,.833,9,27,36,23,29,2,18,54,174
2295,WSB,1986,Frank Johnson,27,14,9,402,69,154,.448,0,3,.000,69,151,.457,.448,38,54,.704,7,21,28,76,11,1,29,30,176
2296,WSB,1986,Kenny Green,21,20,0,221,44,101,.436,0,1,.000,44,100,.440,.436,21,26,.808,17,21,38,3,4,7,17,26,109
2297,WSB,1986,Perry Moss,27,12,0,160,21,53,.396,2,7,.286,19,46,.413,.415,11,15,.733,9,16,25,19,6,3,18,26,55
2298,WSB,1986,Freeman Williams,29,9,0,110,25,67,.373,7,14,.500,18,53,.340,.425,12,17,.706,4,8,12,7,7,1,13,10,69
2299,WSB,1986,Ennis Whatley,23,4,0,27,5,14,.357,0,0,,5,14,.357,.357,1,3,.333,2,5,7,7,0,1,0,1,11
2300,WSB,1986,George Johnson,29,2,0,7,1,3,.333,0,0,,1,3,.333,.333,2,2,1.000,1,1,2,0,0,0,1,1,4
2301,WSB,1986,Claude Gregory,27,2,0,2,1,2,.500,0,0,,1,2,.500,.500,0,0,,2,0,2,0,1,0,2,1,2
2302,WSB,1985,Gus Williams,31,79,78,2960,638,1483,.430,51,176,.290,587,1307,.449,.447,251,346,.725,72,123,195,608,178,32,213,159,1578
2303,WSB,1985,Greg Ballard,30,82,77,2664,469,978,.480,14,46,.304,455,932,.488,.487,120,151,.795,150,381,531,208,100,33,106,221,1072
2304,WSB,1985,Jeff Malone,23,76,61,2613,605,1213,.499,15,72,.208,590,1141,.517,.505,211,250,.844,60,146,206,184,52,9,107,176,1436
2305,WSB,1985,Rick Mahorn,26,77,63,2072,206,413,.499,0,0,,206,413,.499,.499,71,104,.683,150,458,608,121,59,104,133,308,483
2306,WSB,1985,Cliff Robinson,24,60,37,1870,422,896,.471,1,3,.333,421,893,.471,.472,158,213,.742,141,405,546,149,51,47,161,187,1003
2307,WSB,1985,Darren Daye,24,80,8,1573,258,504,.512,1,7,.143,257,497,.517,.513,178,249,.715,93,179,272,240,53,19,134,164,695
2308,WSB,1985,Tom McMillen,32,69,21,1547,252,534,.472,0,5,.000,252,529,.476,.472,112,135,.830,64,146,210,52,8,17,44,163,616
2309,WSB,1985,Jeff Ruland,26,37,36,1436,250,439,.569,0,2,.000,250,437,.572,.569,200,292,.685,127,283,410,162,31,27,179,128,700
2310,WSB,1985,Dudley Bradley,27,73,24,1232,142,299,.475,20,64,.313,122,235,.519,.508,54,79,.684,34,100,134,173,96,21,84,152,358
2311,WSB,1985,Frank Johnson,26,46,1,925,175,358,.489,6,17,.353,169,341,.496,.497,72,96,.750,23,40,63,143,43,3,59,72,428
2312,WSB,1985,Charles Jones,27,28,4,638,65,123,.528,0,0,,65,123,.528,.528,36,52,.692,69,109,178,25,22,74,21,101,166
2313,WSB,1985,Guy Williams,24,21,0,119,29,63,.460,1,4,.250,28,59,.475,.468,2,5,.400,15,12,27,9,5,2,8,17,61
2314,WSB,1985,Don Collins,26,11,0,91,12,34,.353,0,0,,12,34,.353,.353,8,9,.889,10,9,19,7,7,4,8,5,32
2315,WSB,1985,Tom Sewell,22,21,0,87,9,36,.250,0,2,.000,9,34,.265,.250,2,4,.500,2,2,4,6,3,1,7,13,20
2316,WSB,1985,Charles Davis,26,4,0,28,2,10,.200,0,0,,2,10,.200,.200,3,4,.750,2,2,4,1,1,0,2,3,7
2317,WSB,1984,Jeff Ruland,25,75,75,3082,599,1035,.579,1,7,.143,598,1028,.582,.579,466,636,.733,265,657,922,296,68,72,342,285,1665
2318,WSB,1984,Greg Ballard,29,82,82,2701,510,1061,.481,2,15,.133,508,1046,.486,.482,166,208,.798,140,348,488,290,94,35,142,214,1188
2319,WSB,1984,Rick Mahorn,25,82,82,2701,307,605,.507,0,0,,307,605,.507,.507,125,192,.651,169,569,738,131,62,123,142,358,739
2320,WSB,1984,Frank Johnson,25,82,81,2686,392,840,.467,11,43,.256,381,797,.478,.473,187,252,.742,58,126,184,567,96,6,191,174,982
2321,WSB,1984,Ricky Sobers,31,81,81,2624,508,1115,.456,29,111,.261,479,1004,.477,.469,221,264,.837,51,128,179,377,117,17,222,278,1266
2322,WSB,1984,Jeff Malone,22,81,2,1976,408,918,.444,24,74,.324,384,844,.455,.458,142,172,.826,57,98,155,151,23,13,110,162,982
2323,WSB,1984,Tom McMillen,31,62,5,1294,222,447,.497,1,6,.167,221,441,.501,.498,127,156,.814,64,135,199,73,14,17,70,162,572
2324,WSB,1984,Darren Daye,23,75,0,1174,180,408,.441,0,6,.000,180,402,.448,.441,95,133,.714,90,98,188,176,38,12,96,154,455
2325,WSB,1984,Joe Kopicki,23,59,2,678,64,132,.485,1,7,.143,63,125,.504,.489,91,112,.813,64,102,166,46,15,5,39,71,220
2326,WSB,1984,Charles Davis,25,46,0,467,103,218,.472,1,9,.111,102,209,.488,.475,24,39,.615,34,69,103,30,14,10,36,58,231
2327,WSB,1984,Bryan Warrick,24,32,0,254,27,66,.409,1,3,.333,26,63,.413,.417,8,16,.500,5,17,22,43,9,3,20,37,63
2328,WSB,1984,Mike Gibson,23,32,0,229,21,55,.382,0,0,,21,55,.382,.382,11,17,.647,29,37,66,9,5,7,14,30,53
2329,WSB,1984,Michael Wilson,24,6,0,26,0,2,.000,0,1,.000,0,1,.000,.000,1,2,.500,1,0,1,3,0,0,3,5,1
2330,WSB,1984,DeWayne Scales,25,2,0,13,3,5,.600,0,0,,3,5,.600,.600,0,2,.000,0,3,3,0,1,0,2,1,6
2331,WSB,1983,Rick Mahorn,24,82,82,3023,376,768,.490,0,3,.000,376,765,.492,.490,146,254,.575,171,608,779,115,86,148,170,335,898
2332,WSB,1983,Jeff Ruland,24,79,47,2862,580,1051,.552,1,3,.333,579,1048,.552,.552,375,544,.689,293,578,871,234,74,77,297,312,1536
2333,WSB,1983,Greg Ballard,28,78,78,2840,603,1274,.473,13,37,.351,590,1237,.477,.478,182,233,.781,123,385,508,262,135,25,157,176,1401
2334,WSB,1983,Frank Johnson,24,68,65,2324,321,786,.408,14,61,.230,307,725,.423,.417,196,261,.751,46,132,178,549,110,6,238,170,852
2335,WSB,1983,Don Collins,24,65,21,1575,332,635,.523,0,6,.000,332,629,.528,.523,101,136,.743,116,94,210,132,87,30,146,166,765
2336,WSB,1983,Ricky Sobers,30,41,39,1438,234,534,.438,23,55,.418,211,479,.441,.460,154,185,.832,35,67,102,218,61,14,147,158,645
2337,WSB,1983,Charles Davis,24,74,10,1161,251,534,.470,2,10,.200,249,524,.475,.472,56,89,.629,83,130,213,73,32,22,91,122,560
2338,WSB,1983,Spencer Haywood,33,38,25,775,125,312,.401,0,1,.000,125,311,.402,.401,63,87,.724,77,106,183,30,12,27,67,94,313
2339,WSB,1983,Kevin Grevey,29,41,11,756,114,294,.388,15,38,.395,99,256,.387,.413,54,69,.783,18,31,49,49,18,7,27,61,297
2340,WSB,1983,Bryan Warrick,23,43,20,727,65,171,.380,0,5,.000,65,166,.392,.380,42,57,.737,15,54,69,126,21,8,71,103,172
2341,WSB,1983,Dave Batton,26,54,5,558,85,191,.445,0,3,.000,85,188,.452,.445,8,17,.471,45,74,119,29,15,13,28,56,178
2342,WSB,1983,Carlos Terry,26,55,3,514,39,106,.368,0,2,.000,39,104,.375,.368,10,15,.667,27,72,99,46,24,13,20,79,88
2343,WSB,1983,John Lucas,29,35,0,386,62,131,.473,0,5,.000,62,126,.492,.473,21,42,.500,8,21,29,102,25,1,47,18,145
2344,WSB,1983,Billy Ray Bates,26,15,3,277,53,129,.411,2,5,.400,51,124,.411,.419,10,20,.500,10,8,18,14,13,3,12,18,118
2345,WSB,1983,Kevin Porter,32,11,0,210,21,40,.525,0,0,,21,40,.525,.525,5,6,.833,2,3,5,46,10,0,21,30,47
2346,WSB,1983,Joe Kopicki,22,17,1,201,23,51,.451,0,1,.000,23,50,.460,.451,21,25,.840,18,44,62,9,9,2,8,21,67
2347,WSB,1983,Chubby Cox,27,7,0,78,13,37,.351,0,2,.000,13,35,.371,.351,3,6,.500,7,3,10,6,0,1,9,16,29
2348,WSB,1983,Steve Lingenfelter,24,7,0,53,4,6,.667,0,0,,4,6,.667,.667,0,4,.000,1,11,12,4,1,3,5,16,8
2349,WSB,1983,Joe Cooper,25,5,0,47,5,9,.556,0,0,,5,9,.556,.556,5,9,.556,4,9,13,2,0,0,6,7,15
2350,WSB,1982,Greg Ballard,27,79,79,2946,621,1307,.475,9,22,.409,612,1285,.476,.479,235,283,.830,136,497,633,250,137,22,119,204,1486
2351,WSB,1982,Rick Mahorn,23,80,80,2664,414,816,.507,0,3,.000,414,813,.509,.507,148,234,.632,149,555,704,150,57,138,162,349,976
2352,WSB,1982,Jeff Ruland,23,82,0,2214,420,749,.561,1,3,.333,419,746,.562,.561,342,455,.752,253,509,762,134,44,58,237,319,1183
2353,WSB,1982,Kevin Grevey,28,71,62,2164,376,857,.439,28,82,.341,348,775,.449,.455,165,193,.855,57,138,195,149,44,23,96,151,945
2354,WSB,1982,Spencer Haywood,32,76,63,2086,395,829,.476,0,3,.000,395,826,.478,.476,219,260,.842,144,278,422,64,45,68,175,249,1009
2355,WSB,1982,Frank Johnson,23,79,29,2027,336,812,.414,17,79,.215,319,733,.435,.424,153,204,.750,34,113,147,380,76,7,160,196,842
2356,WSB,1982,John Lucas,28,79,53,1940,263,618,.426,2,22,.091,261,596,.438,.427,138,176,.784,40,126,166,551,95,6,156,105,666
2357,WSB,1982,Don Collins,23,79,18,1609,334,653,.511,1,12,.083,333,641,.520,.512,121,169,.716,101,95,196,148,89,24,135,195,790
2358,WSB,1982,Jim Chones,32,59,13,867,74,171,.433,0,0,,74,171,.433,.433,36,46,.783,39,146,185,64,15,32,41,114,184
2359,WSB,1982,Charles Davis,23,54,10,575,88,184,.478,0,2,.000,88,182,.484,.478,30,37,.811,54,79,133,31,10,13,43,89,206
2360,WSB,1982,Garry Witts,22,46,0,493,49,84,.583,1,2,.500,48,82,.585,.589,33,40,.825,29,33,62,38,17,4,35,74,132
2361,WSB,1982,Brad Holland,25,13,3,185,27,73,.370,0,3,.000,27,70,.386,.370,3,4,.750,6,7,13,16,11,1,7,12,57
2362,WSB,1982,Carlos Terry,25,13,0,60,3,15,.200,0,3,.000,3,12,.250,.200,3,4,.750,5,7,12,8,3,1,5,15,9
2363,WSB,1981,Elvin Hayes,35,81,,2931,584,1296,.451,0,10,.000,584,1286,.454,.451,271,439,.617,235,554,789,98,68,171,189,300,1439
2364,WSB,1981,Kevin Grevey,27,75,,2616,500,1103,.453,45,136,.331,455,967,.471,.474,244,290,.841,67,152,219,300,68,17,144,161,1289
2365,WSB,1981,Greg Ballard,26,82,,2610,549,1186,.463,7,32,.219,542,1154,.470,.466,166,196,.847,167,413,580,195,118,39,117,194,1271
2366,WSB,1981,Kevin Porter,30,81,,2577,446,859,.519,3,12,.250,443,847,.523,.521,191,247,.773,35,89,124,734,110,10,251,257,1086
2367,WSB,1981,Wes Unseld,34,63,,2032,225,429,.524,2,4,.500,223,425,.525,.527,55,86,.640,207,466,673,170,52,36,97,171,507
2368,WSB,1981,Mitch Kupchak,26,82,,1934,392,747,.525,0,1,.000,392,746,.525,.525,240,340,.706,198,371,569,62,36,26,161,195,1024
2369,WSB,1981,Wes Matthews,21,45,,1161,224,449,.499,5,15,.333,219,434,.505,.504,99,129,.767,30,37,67,199,46,10,149,120,552
2370,WSB,1981,Rick Mahorn,22,52,,696,111,219,.507,0,0,,111,219,.507,.507,27,40,.675,67,148,215,25,21,44,38,134,249
2371,WSB,1981,Don Collins,22,34,,661,130,281,.463,0,3,.000,130,278,.468,.463,74,110,.673,33,48,81,75,35,14,67,93,334
2372,WSB,1981,Austin Carr,32,39,,580,80,206,.388,0,7,.000,80,199,.402,.388,32,50,.640,18,34,52,49,14,2,32,43,192
2373,WSB,1981,Bob Dandridge,33,23,,545,101,237,.426,0,1,.000,101,236,.428,.426,28,39,.718,19,64,83,60,16,9,33,54,230
2374,WSB,1981,Carlos Terry,24,26,,504,80,160,.500,0,6,.000,80,154,.519,.500,28,42,.667,43,73,116,70,27,13,57,68,188
2375,WSB,1981,Andre McCarter,27,43,,448,51,135,.378,2,8,.250,49,127,.386,.385,18,24,.750,16,23,39,73,14,0,24,36,122
2376,WSB,1981,Anthony Roberts,25,26,,350,54,144,.375,0,0,,54,144,.375,.375,19,29,.655,18,50,68,20,11,0,28,52,127
2377,WSB,1981,John Williamson,29,9,,112,18,56,.321,1,6,.167,17,50,.340,.330,5,6,.833,0,7,7,17,4,1,12,13,42
2378,WSB,1981,Keith McCord,23,2,,9,2,4,.500,0,0,,2,4,.500,.500,0,0,,1,1,2,1,0,0,2,0,4
2379,WSB,1981,Dave Britton,22,2,,9,2,3,.667,0,0,,2,3,.667,.667,0,0,,0,2,2,3,1,0,2,2,4
2380,WSB,1981,Lewis Brown,25,2,,5,0,3,.000,0,0,,0,3,.000,.000,2,5,.400,1,1,2,0,0,0,1,2,2
2381,WSB,1980,Elvin Hayes,34,81,,3183,761,1677,.454,3,13,.231,758,1664,.456,.455,334,478,.699,269,627,896,129,62,189,215,309,1859
2382,WSB,1980,Wes Unseld,33,82,82,2973,327,637,.513,1,2,.500,326,635,.513,.514,139,209,.665,334,760,1094,366,65,61,153,249,794
2383,WSB,1980,Greg Ballard,25,82,,2438,545,1101,.495,16,47,.340,529,1054,.502,.502,171,227,.753,240,398,638,159,90,36,133,197,1277
2384,WSB,1980,Kevin Grevey,26,65,,1818,331,804,.412,34,92,.370,297,712,.417,.433,216,249,.867,80,107,187,177,56,16,102,158,912
2385,WSB,1980,Jim Cleamons,30,57,,1535,184,381,.483,4,23,.174,180,358,.503,.488,72,98,.735,43,90,133,248,44,9,92,120,444
2386,WSB,1980,Kevin Porter,29,70,,1494,201,438,.459,0,4,.000,201,434,.463,.459,110,137,.803,25,57,82,457,59,11,164,180,512
2387,WSB,1980,Bob Dandridge,32,45,,1457,329,729,.451,2,11,.182,327,718,.455,.453,123,152,.809,63,183,246,178,29,36,123,112,783
2388,WSB,1980,Larry Wright,25,76,,1286,229,500,.458,4,16,.250,225,484,.465,.462,96,108,.889,40,82,122,222,49,18,108,144,558
2389,WSB,1980,Roger Phegley,23,50,,971,224,473,.474,2,5,.400,222,468,.474,.476,104,120,.867,49,66,115,70,19,3,70,106,554
2390,WSB,1980,Dave Corzine,23,78,,826,90,216,.417,0,0,,90,216,.417,.417,45,68,.662,104,166,270,63,9,31,60,120,225
2391,WSB,1980,John Williamson,28,30,,603,153,356,.430,3,16,.188,150,340,.441,.434,40,50,.800,14,31,45,39,10,10,49,66,349
2392,WSB,1980,Phil Chenier,29,20,,470,84,214,.393,3,6,.500,81,208,.389,.400,31,41,.756,10,33,43,42,18,5,29,26,202
2393,WSB,1980,Mitch Kupchak,25,40,,451,67,160,.419,0,2,.000,67,158,.424,.419,52,75,.693,32,73,105,16,8,8,40,49,186
2394,WSB,1980,Gus Bailey,28,20,,180,16,35,.457,1,1,1.000,15,34,.441,.471,5,13,.385,6,22,28,26,7,4,11,18,38
2395,WSB,1980,Lawrence Boston,23,13,,125,24,52,.462,0,0,,24,52,.462,.462,8,13,.615,19,20,39,2,4,2,8,25,56
2396,WSB,1980,Ron Behagen,29,6,,64,9,23,.391,0,0,,9,23,.391,.391,5,6,.833,6,8,14,7,0,4,4,14,23
2397,WSB,1980,Steve Malovic,23,1,,6,0,0,,0,0,,0,0,,,1,4,.250,0,0,0,0,1,0,0,0,1
2398,TOR,2024,Scottie Barnes,22,60,60,2094,447,942,.475,101,296,.341,346,646,.536,.528,196,251,.781,141,353,494,363,75,88,165,118,1191
2399,TOR,2024,Gary Trent Jr.,25,71,41,1994,361,847,.426,178,453,.393,183,394,.464,.531,74,96,.771,25,163,188,119,77,10,47,96,974
2400,TOR,2024,Dennis Schröder,30,51,33,1559,247,559,.442,77,220,.350,170,339,.501,.511,127,149,.852,22,118,140,313,46,8,83,105,698
2401,TOR,2024,Pascal Siakam,29,39,39,1354,325,623,.522,46,145,.317,279,478,.584,.559,169,223,.758,54,192,246,190,32,10,83,87,865
2402,TOR,2024,Jakob Poeltl,28,50,50,1319,248,378,.656,0,0,,248,378,.656,.656,59,107,.551,146,283,429,127,35,76,77,149,555
2403,TOR,2024,Gradey Dick,20,60,17,1268,189,445,.425,88,241,.365,101,204,.495,.524,44,51,.863,27,105,132,68,34,2,50,87,510
2404,TOR,2024,Immanuel Quickley,24,38,38,1265,236,559,.422,107,271,.395,129,288,.448,.518,127,151,.841,12,170,182,257,34,7,70,75,706
2405,TOR,2024,RJ Barrett,23,32,32,1072,272,492,.553,47,120,.392,225,372,.605,.601,105,167,.629,34,170,204,130,19,13,79,84,696
2406,TOR,2024,OG Anunoby,26,27,27,900,157,321,.489,61,163,.374,96,158,.608,.584,33,46,.717,24,82,106,72,28,13,43,62,408
2407,TOR,2024,Bruce Brown,27,34,11,885,129,268,.481,20,63,.317,109,205,.532,.519,50,60,.833,28,102,130,92,24,9,45,67,328
2408,TOR,2024,Kelly Olynyk,32,28,19,740,131,239,.548,24,71,.338,107,168,.637,.598,70,85,.824,45,112,157,128,37,18,71,98,356
2409,TOR,2024,Chris Boucher,31,50,0,705,110,217,.507,31,94,.330,79,123,.642,.578,71,92,.772,62,145,207,23,14,24,28,68,322
2410,TOR,2024,Ochai Agbaji,23,27,18,638,72,184,.391,15,69,.217,57,115,.496,.432,22,36,.611,39,51,90,36,20,15,30,51,181
2411,TOR,2024,Jalen McDaniels,26,50,1,538,65,189,.344,12,71,.169,53,118,.449,.376,27,37,.730,18,61,79,37,19,6,30,52,169
2412,TOR,2024,Jordan Nwora,25,34,1,529,101,217,.465,33,95,.347,68,122,.557,.541,35,42,.833,20,96,116,44,20,12,41,29,270
2413,TOR,2024,Malachi Flynn,25,31,0,474,56,137,.409,28,80,.350,28,57,.491,.511,17,22,.773,13,52,65,73,18,6,33,42,157
2414,TOR,2024,Precious Achiuwa,24,25,0,437,78,170,.459,13,47,.277,65,123,.528,.497,24,42,.571,50,86,136,44,16,12,29,40,193
2415,TOR,2024,Javon Freeman-Liberty,24,22,6,403,55,124,.444,10,42,.238,45,82,.549,.484,33,36,.917,16,54,70,40,10,4,25,28,153
2416,TOR,2024,Jontay Porter,24,26,5,360,40,104,.385,20,60,.333,20,44,.455,.481,15,18,.833,26,56,82,60,20,20,21,35,115
2417,TOR,2024,Thaddeus Young,35,23,6,350,54,87,.621,1,6,.167,53,81,.654,.626,5,12,.417,29,46,75,50,18,3,11,38,114
2418,TOR,2024,Garrett Temple,37,27,2,289,29,78,.372,12,40,.300,17,38,.447,.449,18,22,.818,18,27,45,28,12,3,14,28,88
2419,TOR,2024,Otto Porter Jr.,30,15,1,174,14,33,.424,8,23,.348,6,10,.600,.545,3,3,1.000,6,23,29,8,5,5,2,19,39
2420,TOR,2024,Jahmi'us Ramsey,22,7,1,121,18,41,.439,6,22,.273,12,19,.632,.512,5,6,.833,4,18,22,8,7,0,7,10,47
2421,TOR,2024,Mouhamadou Gueye,25,11,0,120,11,38,.289,0,3,.000,11,35,.314,.289,4,9,.444,12,11,23,5,3,18,12,15,26
2422,TOR,2024,Malik Williams,25,7,2,107,9,34,.265,1,5,.200,8,29,.276,.279,0,2,.000,15,23,38,2,3,4,3,15,19
2423,TOR,2024,Kobi Simmons,26,4,0,67,9,21,.429,2,8,.250,7,13,.538,.476,0,0,,1,6,7,12,6,2,1,5,20
2424,TOR,2024,D.J. Carton,23,4,0,36,3,8,.375,1,4,.250,2,4,.500,.438,4,5,.800,2,2,4,3,1,0,1,3,11
2425,TOR,2024,Markquis Nowell,24,1,0,4,0,1,.000,0,0,,0,1,.000,.000,2,2,1.000,2,0,2,2,1,0,0,0,2
2426,TOR,2024,Ron Harper Jr.,23,1,0,4,0,0,,0,0,,0,0,,,0,0,,0,0,0,1,0,0,0,2,0
2427,TOR,2024,Kira Lewis Jr.,22,1,0,2,0,0,,0,0,,0,0,,,0,0,,0,0,0,0,0,0,0,1,0
2428,TOR,2023,Scottie Barnes,21,77,76,2678,463,1016,.456,63,224,.281,400,792,.505,.487,190,246,.772,179,333,512,371,83,61,154,170,1179
2429,TOR,2023,Pascal Siakam,28,71,71,2652,630,1313,.480,93,287,.324,537,1026,.523,.515,367,474,.774,131,425,556,415,65,36,169,228,1720
2430,TOR,2023,Fred VanVleet,28,69,69,2535,437,1112,.393,207,606,.342,230,506,.455,.486,254,283,.898,30,250,280,495,123,38,140,193,1335
2431,TOR,2023,OG Anunoby,25,67,67,2386,421,885,.476,142,367,.387,279,518,.539,.556,140,167,.838,95,237,332,131,128,50,132,200,1124
2432,TOR,2023,Gary Trent Jr.,24,66,44,2118,405,935,.433,166,450,.369,239,485,.493,.522,172,205,.839,30,143,173,106,104,14,55,102,1148
2433,TOR,2023,Chris Boucher,30,76,0,1523,261,529,.493,62,189,.328,199,340,.585,.552,128,168,.762,157,264,421,29,47,64,41,143,712
2434,TOR,2023,Precious Achiuwa,23,55,12,1140,196,404,.485,29,108,.269,167,296,.564,.521,87,124,.702,100,228,328,50,31,30,59,102,508
2435,TOR,2023,Christian Koloko,22,58,19,802,72,150,.480,1,12,.083,71,138,.514,.483,37,59,.627,84,87,171,31,21,57,20,128,182
2436,TOR,2023,Thaddeus Young,34,54,9,795,108,198,.545,6,34,.176,102,164,.622,.561,18,26,.692,71,95,166,75,54,5,42,88,240
2437,TOR,2023,Jakob Poeltl,27,26,25,707,150,230,.652,0,0,,150,230,.652,.652,41,72,.569,84,153,237,56,30,34,29,77,341
2438,TOR,2023,Malachi Flynn,24,53,2,691,87,242,.360,47,133,.353,40,109,.367,.457,25,33,.758,15,61,76,70,21,4,25,65,246
2439,TOR,2023,Juancho Hernangómez,27,42,10,614,48,114,.421,17,67,.254,31,47,.660,.496,9,16,.563,27,96,123,25,16,6,15,43,122
2440,TOR,2023,Dalano Banton,23,31,2,279,55,130,.423,15,51,.294,40,79,.506,.481,17,24,.708,11,34,45,36,13,13,18,34,142
2441,TOR,2023,Jeff Dowtin,25,25,0,259,25,57,.439,5,16,.313,20,41,.488,.482,6,9,.667,6,17,23,31,9,3,5,13,61
2442,TOR,2023,Will Barton,32,16,2,211,28,79,.354,14,42,.333,14,37,.378,.443,2,2,1.000,5,21,26,17,11,3,3,17,72
2443,TOR,2023,Khem Birch,30,20,0,162,19,32,.594,1,2,.500,18,30,.600,.609,4,5,.800,8,17,25,7,5,5,8,24,43
2444,TOR,2023,Otto Porter Jr.,29,8,2,146,15,30,.500,6,17,.353,9,13,.692,.600,8,8,1.000,6,13,19,8,11,0,4,7,44
2445,TOR,2023,Joe Wieskamp,23,9,0,50,3,14,.214,3,12,.250,0,2,.000,.321,0,0,,0,4,4,3,0,0,1,3,9
2446,TOR,2023,Ron Harper Jr.,22,9,0,48,8,16,.500,3,9,.333,5,7,.714,.594,1,1,1.000,3,4,7,4,0,1,0,3,20
2447,TOR,2023,Justin Champagnie,21,3,0,11,3,3,1.000,0,0,,3,3,1.000,1.000,0,0,,1,3,4,1,0,0,0,1,6
2448,TOR,2022,Scottie Barnes,20,74,74,2617,459,932,.492,58,193,.301,401,739,.543,.524,158,215,.735,195,362,557,256,80,55,136,192,1134
2449,TOR,2022,Pascal Siakam,27,68,68,2578,596,1207,.494,75,218,.344,521,989,.527,.525,284,379,.749,128,452,580,360,85,42,181,225,1551
2450,TOR,2022,Fred VanVleet,27,65,65,2462,442,1097,.403,242,642,.377,200,455,.440,.513,194,222,.874,44,245,289,434,111,35,170,162,1320
2451,TOR,2022,Gary Trent Jr.,23,70,69,2448,450,1086,.414,209,545,.383,241,541,.445,.511,174,204,.853,26,165,191,141,122,19,73,144,1283
2452,TOR,2022,OG Anunoby,24,48,48,1728,309,697,.443,115,317,.363,194,380,.511,.526,89,118,.754,74,190,264,125,71,25,80,131,822
2453,TOR,2022,Precious Achiuwa,22,73,28,1725,265,603,.439,56,156,.359,209,447,.468,.486,78,131,.595,146,327,473,82,37,41,84,151,664
2454,TOR,2022,Chris Boucher,29,80,9,1690,268,577,.464,68,229,.297,200,348,.575,.523,150,193,.777,179,315,494,25,49,75,42,174,754
2455,TOR,2022,Khem Birch,29,55,28,991,97,200,.485,0,14,.000,97,186,.522,.485,53,71,.746,122,117,239,56,30,26,29,104,247
2456,TOR,2022,Svi Mykhailiuk,24,56,5,716,91,234,.389,41,134,.306,50,100,.500,.476,32,37,.865,20,72,92,45,26,4,32,54,255
2457,TOR,2022,Dalano Banton,22,64,1,696,83,202,.411,13,51,.255,70,151,.464,.443,26,44,.591,38,86,124,99,28,10,53,68,205
2458,TOR,2022,Malachi Flynn,23,44,5,537,72,183,.393,30,90,.333,42,93,.452,.475,15,24,.625,10,53,63,70,20,4,13,45,189
2459,TOR,2022,Thaddeus Young,33,26,0,475,67,144,.465,17,43,.395,50,101,.495,.524,13,27,.481,40,75,115,45,31,11,22,43,164
2460,TOR,2022,Yuta Watanabe,27,38,4,445,56,138,.406,27,79,.342,29,59,.492,.504,24,40,.600,18,74,92,21,11,16,19,38,163
2461,TOR,2022,Justin Champagnie,20,36,0,281,31,67,.463,10,28,.357,21,39,.538,.537,9,9,1.000,37,35,72,11,8,4,8,32,81
2462,TOR,2022,Armoni Brooks,23,13,3,154,11,38,.289,10,36,.278,1,2,.500,.421,2,2,1.000,8,14,22,13,7,3,4,14,34
2463,TOR,2022,Goran Dragić,35,5,2,90,13,34,.382,4,14,.286,9,20,.450,.441,10,10,1.000,2,12,14,9,5,1,1,8,40
2464,TOR,2022,Isaac Bonga,22,15,0,69,3,13,.231,1,4,.250,2,9,.222,.269,5,8,.625,4,3,7,4,8,2,2,10,12
2465,TOR,2022,D.J. Wilson,25,4,1,54,11,15,.733,0,2,.000,11,13,.846,.733,8,10,.800,1,15,16,5,5,1,2,6,30
2466,TOR,2022,Tremont Waters,24,2,0,42,3,12,.250,2,9,.222,1,3,.333,.333,0,0,,0,4,4,7,4,0,4,2,8
2467,TOR,2022,Juwan Morgan,24,1,0,27,2,3,.667,1,2,.500,1,1,1.000,.833,0,0,,2,2,4,1,0,0,0,3,5
2468,TOR,2022,Daniel Oturu,22,3,0,27,3,6,.500,0,1,.000,3,5,.600,.500,3,5,.600,1,4,5,0,0,2,0,1,9
2469,TOR,2022,David Johnson,20,2,0,2,0,1,.000,0,1,.000,0,0,,.000,0,0,,0,0,0,0,0,0,0,0,0
2470,TOR,2022,Sam Dekker,27,1,0,1,0,0,,0,0,,0,0,,,0,0,,0,0,0,0,0,0,0,0,0
2471,TOR,2021,Pascal Siakam,26,56,56,2006,437,961,.455,73,246,.297,364,715,.509,.493,249,301,.827,95,310,405,250,64,37,130,174,1196
2472,TOR,2021,Fred VanVleet,26,52,52,1899,338,870,.389,174,476,.366,164,394,.416,.489,169,191,.885,32,188,220,328,87,37,95,119,1019
2473,TOR,2021,Kyle Lowry,34,46,46,1601,260,596,.436,131,331,.396,129,265,.487,.546,140,160,.875,35,212,247,338,45,14,126,143,791
2474,TOR,2021,Chris Boucher,28,60,14,1453,288,560,.514,90,235,.383,198,325,.609,.595,152,193,.788,117,287,404,63,35,111,46,166,818
2475,TOR,2021,OG Anunoby,23,43,43,1433,249,519,.480,104,261,.398,145,258,.562,.580,80,102,.784,54,183,237,94,66,32,75,114,682
2476,TOR,2021,Norman Powell,27,42,31,1277,282,566,.498,118,269,.439,164,297,.552,.602,141,163,.865,19,107,126,77,47,8,77,98,823
2477,TOR,2021,Stanley Johnson,24,61,13,1006,89,233,.382,45,137,.328,44,96,.458,.479,44,55,.800,29,124,153,89,52,18,54,116,267
2478,TOR,2021,Aron Baynes,34,53,31,980,134,304,.441,27,103,.262,107,201,.532,.485,29,41,.707,87,186,273,47,17,23,46,119,324
2479,TOR,2021,DeAndre' Bembry,26,51,12,972,117,228,.513,14,53,.264,103,175,.589,.544,45,66,.682,33,113,146,107,53,18,71,87,293
2480,TOR,2021,Malachi Flynn,22,47,14,928,127,340,.374,54,168,.321,73,172,.424,.453,45,56,.804,10,106,116,137,38,7,43,68,353
2481,TOR,2021,Yuta Watanabe,26,50,4,723,79,180,.439,36,90,.400,43,90,.478,.539,24,29,.828,36,123,159,40,26,19,19,57,218
2482,TOR,2021,Khem Birch,28,19,17,577,95,171,.556,9,31,.290,86,140,.614,.582,28,44,.636,57,87,144,36,16,22,21,46,227
2483,TOR,2021,Gary Trent Jr.,22,17,15,540,103,261,.395,44,124,.355,59,137,.431,.479,25,31,.806,6,55,61,22,19,4,12,29,275
2484,TOR,2021,Terence Davis,23,34,4,493,87,210,.414,44,122,.361,43,88,.489,.519,16,18,.889,9,57,66,37,17,7,29,48,234
2485,TOR,2021,Freddie Gillespie,23,20,2,392,44,84,.524,0,0,,44,84,.524,.524,23,33,.697,42,55,97,9,13,20,12,43,111
2486,TOR,2021,Paul Watson,26,27,2,297,38,82,.463,30,64,.469,8,18,.444,.646,5,8,.625,4,41,45,17,6,3,9,36,111
2487,TOR,2021,Rodney Hood,28,17,0,216,21,59,.356,9,29,.310,12,30,.400,.432,15,16,.938,5,25,30,6,4,3,5,15,66
2488,TOR,2021,Matt Thomas,26,26,0,192,24,62,.387,17,41,.415,7,21,.333,.524,6,7,.857,3,18,21,9,2,0,6,10,71
2489,TOR,2021,Jalen Harris,22,13,2,172,36,72,.500,17,36,.472,19,36,.528,.618,7,9,.778,3,15,18,17,8,0,14,15,96
2490,TOR,2021,Alex Len,27,7,2,76,5,10,.500,3,6,.500,2,4,.500,.650,3,6,.500,0,11,11,3,1,6,8,10,16
2491,TOR,2021,Henry Ellenson,24,2,0,38,5,14,.357,2,9,.222,3,5,.600,.429,3,4,.750,3,9,12,5,0,0,0,7,15
2492,TOR,2021,Patrick McCaw,25,5,0,33,1,1,1.000,0,0,,1,1,1.000,1.000,3,3,1.000,1,2,3,4,2,0,0,6,5
2493,TOR,2020,Pascal Siakam,25,60,60,2110,500,1104,.453,131,365,.359,369,739,.499,.512,240,303,.792,64,375,439,207,61,53,148,170,1371
2494,TOR,2020,Kyle Lowry,33,58,58,2098,334,803,.416,164,466,.352,170,337,.504,.518,294,343,.857,32,260,292,433,82,26,178,190,1126
2495,TOR,2020,OG Anunoby,22,69,68,2066,286,566,.505,89,228,.390,197,338,.583,.584,72,102,.706,80,284,364,108,96,45,79,167,733
2496,TOR,2020,Fred VanVleet,25,54,54,1928,319,773,.413,146,374,.390,173,399,.434,.507,168,198,.848,18,185,203,357,100,17,121,132,952
2497,TOR,2020,Serge Ibaka,30,55,27,1485,343,670,.512,70,182,.385,273,488,.559,.564,89,124,.718,114,338,452,77,28,46,109,153,845
2498,TOR,2020,Norman Powell,26,52,26,1479,296,598,.495,109,273,.399,187,325,.575,.586,129,153,.843,26,164,190,91,60,21,77,108,830
2499,TOR,2020,Terence Davis,22,72,4,1209,199,436,.456,94,242,.388,105,194,.541,.564,51,59,.864,50,187,237,115,39,14,76,124,543
2500,TOR,2020,Marc Gasol,35,44,43,1161,119,279,.427,57,148,.385,62,131,.473,.529,36,49,.735,31,244,275,147,34,38,59,124,331
2501,TOR,2020,Rondae Hollis-Jefferson,25,60,6,1122,155,329,.471,3,23,.130,152,306,.497,.476,105,143,.734,110,173,283,106,46,23,59,115,418
2502,TOR,2020,Patrick McCaw,24,37,12,908,67,162,.414,23,71,.324,44,91,.484,.485,13,18,.722,19,67,86,79,39,4,29,60,170
2503,TOR,2020,Chris Boucher,27,62,0,819,141,299,.472,38,118,.322,103,181,.569,.535,91,116,.784,107,170,277,26,22,61,28,114,411
2504,TOR,2020,Matt Thomas,25,41,1,440,73,150,.487,47,99,.475,26,51,.510,.643,9,12,.750,9,52,61,22,10,1,16,38,202
2505,TOR,2020,Malcolm Miller,26,28,1,162,12,29,.414,8,22,.364,4,7,.571,.552,3,8,.375,2,14,16,11,5,2,4,18,35
2506,TOR,2020,Stanley Johnson,23,25,0,150,22,59,.373,7,24,.292,15,35,.429,.432,9,16,.563,7,30,37,20,6,4,15,16,60
2507,TOR,2020,Oshae Brissett,21,19,0,135,13,36,.361,3,15,.200,10,21,.476,.403,8,10,.800,9,17,26,7,4,1,7,18,37
2508,TOR,2020,Paul Watson,25,8,0,70,10,19,.526,4,9,.444,6,10,.600,.632,7,9,.778,2,13,15,5,3,1,3,4,31
2509,TOR,2020,Dewan Hernandez,23,6,0,28,5,14,.357,1,2,.500,4,12,.333,.393,3,5,.600,5,9,14,3,1,0,3,6,14
2510,TOR,2020,Shamorie Ponds,21,4,0,11,3,5,.600,1,2,.500,2,3,.667,.700,2,2,1.000,0,1,1,2,0,1,0,2,9
2511,TOR,2019,Pascal Siakam,24,80,79,2548,519,945,.549,79,214,.369,440,731,.602,.591,237,302,.785,124,425,549,248,73,52,154,241,1354
2512,TOR,2019,Danny Green,31,80,80,2216,293,630,.465,198,435,.455,95,195,.487,.622,37,44,.841,60,257,317,126,73,53,75,171,821
2513,TOR,2019,Kyle Lowry,32,65,65,2213,304,739,.411,157,453,.347,147,286,.514,.518,161,194,.830,41,271,312,564,91,31,182,166,926
2514,TOR,2019,Kawhi Leonard,27,60,60,2040,560,1129,.496,112,302,.371,448,827,.542,.546,364,426,.854,78,361,439,199,106,24,121,87,1596
2515,TOR,2019,Serge Ibaka,29,74,51,2010,464,877,.529,49,169,.290,415,708,.586,.557,135,177,.763,156,445,601,99,29,103,114,211,1112
2516,TOR,2019,Fred VanVleet,24,64,28,1760,246,600,.410,112,296,.378,134,304,.441,.503,97,115,.843,21,146,167,307,57,20,82,110,701
2517,TOR,2019,OG Anunoby,21,67,6,1352,183,404,.453,67,202,.332,116,202,.574,.536,36,62,.581,58,139,197,47,46,22,55,140,469
2518,TOR,2019,Norman Powell,25,60,3,1126,193,400,.483,68,170,.400,125,230,.543,.568,62,75,.827,16,123,139,91,39,13,65,96,516
2519,TOR,2019,Delon Wright,26,49,2,897,127,293,.433,30,90,.333,97,203,.478,.485,53,61,.869,39,86,125,110,46,15,37,53,337
2520,TOR,2019,Marc Gasol,34,26,19,648,87,187,.465,23,52,.442,64,135,.474,.527,40,52,.769,24,148,172,101,24,23,36,70,237
2521,TOR,2019,Jonas Valančiūnas,26,30,10,564,149,259,.575,9,30,.300,140,229,.611,.593,77,94,.819,54,162,216,29,13,23,39,82,384
2522,TOR,2019,C.J. Miles,31,40,1,562,70,206,.340,43,137,.314,27,69,.391,.444,35,44,.795,12,56,68,22,18,10,21,62,218
2523,TOR,2019,Jeremy Lin,30,23,3,433,58,155,.374,11,55,.200,47,100,.470,.410,34,42,.810,6,54,60,50,9,6,26,48,161
2524,TOR,2019,Greg Monroe,28,38,2,423,74,161,.460,0,4,.000,74,157,.471,.460,35,61,.574,60,96,156,16,13,8,31,61,183
2525,TOR,2019,Patrick McCaw,23,26,1,344,24,54,.444,8,24,.333,16,30,.533,.519,13,15,.867,7,38,45,27,21,2,14,37,69
2526,TOR,2019,Lorenzo Brown,28,26,0,212,23,71,.324,6,28,.214,17,43,.395,.366,3,3,1.000,5,26,31,28,12,5,16,22,55
2527,TOR,2019,Chris Boucher,26,28,0,163,34,76,.447,12,37,.324,22,39,.564,.526,13,15,.867,16,40,56,2,6,24,7,31,93
2528,TOR,2019,Jodie Meeks,31,8,0,104,21,39,.538,8,18,.444,13,21,.619,.641,1,1,1.000,1,11,12,8,1,1,2,5,51
2529,TOR,2019,Malachi Richardson,23,22,0,103,9,29,.310,8,25,.320,1,4,.250,.448,4,5,.800,2,11,13,0,1,0,8,13,30
2530,TOR,2019,Malcolm Miller,25,10,0,67,11,26,.423,10,21,.476,1,5,.200,.615,3,4,.750,1,4,5,1,1,1,1,5,35
2531,TOR,2019,Jordan Loyd,25,12,0,55,8,18,.444,4,8,.500,4,10,.400,.556,9,11,.818,1,8,9,6,0,0,2,5,29
2532,TOR,2019,Eric Moreland,27,4,0,38,3,7,.429,1,1,1.000,2,6,.333,.500,0,0,,4,13,17,4,1,1,5,8,7
2533,TOR,2018,DeMar DeRozan,28,80,80,2711,645,1413,.456,89,287,.310,556,1126,.494,.488,461,559,.825,59,256,315,417,85,22,175,151,1840
2534,TOR,2018,Kyle Lowry,31,78,78,2510,403,944,.427,238,596,.399,165,348,.474,.553,223,261,.854,66,368,434,537,85,19,183,192,1267
2535,TOR,2018,Serge Ibaka,28,76,76,2093,379,784,.483,107,297,.360,272,487,.559,.552,94,118,.797,78,400,478,62,29,99,90,209,959
2536,TOR,2018,Jonas Valančiūnas,25,77,77,1727,390,687,.568,30,74,.405,360,613,.587,.590,170,211,.806,183,477,660,81,29,69,115,192,980
2537,TOR,2018,Pascal Siakam,23,81,5,1679,253,498,.508,29,132,.220,224,366,.612,.537,54,87,.621,79,285,364,159,62,42,67,166,589
2538,TOR,2018,Jakob Poeltl,22,82,0,1524,253,384,.659,1,2,.500,252,382,.660,.660,60,101,.594,165,228,393,57,39,100,85,212,567
2539,TOR,2018,Fred VanVleet,23,76,0,1520,232,545,.426,108,261,.414,124,284,.437,.525,84,101,.832,25,159,184,243,68,19,74,130,656
2540,TOR,2018,OG Anunoby,20,74,62,1481,163,346,.471,73,197,.371,90,149,.604,.577,39,62,.629,44,140,184,55,52,14,45,130,438
2541,TOR,2018,Delon Wright,25,69,4,1433,201,432,.465,56,153,.366,145,279,.520,.530,97,117,.829,45,153,198,200,72,33,78,81,555
2542,TOR,2018,C.J. Miles,30,70,3,1337,227,599,.379,164,454,.361,63,145,.434,.516,81,97,.835,18,134,152,55,37,21,39,134,699
2543,TOR,2018,Norman Powell,24,70,18,1062,150,374,.401,53,186,.285,97,188,.516,.472,32,39,.821,14,105,119,89,37,16,66,111,385
2544,TOR,2018,Lucas Nogueira,25,49,3,418,49,80,.613,5,19,.263,44,61,.721,.644,19,28,.679,18,69,87,22,23,43,16,49,122
2545,TOR,2018,Lorenzo Brown,27,14,0,139,14,34,.412,2,12,.167,12,22,.545,.441,2,2,1.000,1,14,15,13,5,0,3,7,32
2546,TOR,2018,Malcolm Miller,24,15,4,126,13,28,.464,8,21,.381,5,7,.714,.607,4,4,1.000,4,11,15,3,1,2,5,10,38
2547,TOR,2018,Alfonzo McKinnie,25,14,0,53,8,15,.533,3,9,.333,5,6,.833,.633,2,3,.667,1,6,7,1,1,1,3,8,21
2548,TOR,2018,Bruno Caboclo,22,2,0,7,0,2,.000,0,2,.000,0,0,,.000,0,0,,0,1,1,1,1,0,0,1,0
2549,TOR,2018,Nigel Hayes,23,2,0,6,2,2,1.000,2,2,1.000,0,0,,1.500,0,0,,0,0,0,0,0,0,1,0,6
2550,TOR,2018,Malachi Richardson,22,1,0,5,1,2,.500,0,1,.000,1,1,1.000,.500,0,0,,0,1,1,0,0,0,0,0,2
2551,TOR,2017,DeMar DeRozan,27,74,74,2620,721,1545,.467,33,124,.266,688,1421,.484,.477,545,647,.842,70,316,386,290,78,13,180,134,2020
2552,TOR,2017,Kyle Lowry,30,60,60,2244,426,918,.464,193,468,.412,233,450,.518,.569,299,365,.819,48,238,286,417,88,19,173,170,1344
2553,TOR,2017,Jonas Valančiūnas,24,80,80,2066,391,702,.557,1,2,.500,390,700,.557,.558,176,217,.811,226,533,759,57,37,63,106,216,959
2554,TOR,2017,Cory Joseph,25,80,22,2003,299,661,.452,48,135,.356,251,526,.477,.489,94,122,.770,51,184,235,265,66,13,108,140,740
2555,TOR,2017,DeMarre Carroll,30,72,72,1882,220,550,.400,109,320,.341,111,230,.483,.499,89,117,.761,63,212,275,74,81,27,54,143,638
2556,TOR,2017,Patrick Patterson,27,65,8,1599,154,384,.401,94,253,.372,60,131,.458,.523,43,60,.717,62,231,293,76,40,23,38,120,445
2557,TOR,2017,Norman Powell,23,76,18,1368,227,506,.449,56,173,.324,171,333,.514,.504,126,159,.792,26,143,169,82,52,14,70,127,636
2558,TOR,2017,Terrence Ross,25,54,0,1207,211,479,.441,96,256,.375,115,223,.516,.541,41,50,.820,14,124,138,45,53,20,33,82,559
2559,TOR,2017,Lucas Nogueira,24,57,6,1088,103,156,.660,3,12,.250,100,144,.694,.670,44,67,.657,82,162,244,42,52,89,46,137,253
2560,TOR,2017,Pascal Siakam,22,55,38,859,103,205,.502,1,7,.143,102,198,.515,.505,22,32,.688,64,121,185,17,26,45,33,109,229
2561,TOR,2017,Serge Ibaka,27,23,23,712,128,279,.459,41,103,.398,87,176,.494,.532,30,34,.882,29,127,156,15,7,33,39,76,327
2562,TOR,2017,Jakob Poeltl,21,54,4,626,67,115,.583,0,0,,67,115,.583,.583,31,57,.544,78,87,165,12,17,20,29,113,165
2563,TOR,2017,P.J. Tucker,31,24,4,609,52,128,.406,24,60,.400,28,68,.412,.500,11,16,.688,23,106,129,26,31,5,14,53,139
2564,TOR,2017,Delon Wright,24,27,0,446,49,116,.422,10,30,.333,39,86,.453,.466,42,55,.764,16,32,48,57,27,11,25,31,150
2565,TOR,2017,Fred VanVleet,22,37,0,294,39,111,.351,11,29,.379,28,82,.341,.401,18,22,.818,4,38,42,35,16,3,15,36,107
2566,TOR,2017,Jared Sullinger,24,11,1,118,15,47,.319,3,18,.167,12,29,.414,.351,4,8,.500,10,17,27,3,4,1,4,17,37
2567,TOR,2017,Bruno Caboclo,21,9,0,40,6,16,.375,2,6,.333,4,10,.400,.438,0,0,,5,5,10,4,2,1,2,4,14
2568,TOR,2016,Kyle Lowry,29,77,77,2851,512,1198,.427,212,547,.388,300,651,.461,.516,398,491,.811,55,310,365,494,158,34,225,211,1634
2569,TOR,2016,DeMar DeRozan,26,78,78,2804,614,1377,.446,47,139,.338,567,1238,.458,.463,555,653,.850,64,285,349,315,81,21,175,167,1830
2570,TOR,2016,Cory Joseph,24,80,4,2046,257,585,.439,30,110,.273,227,475,.478,.465,133,174,.764,39,171,210,250,63,20,102,131,677
2571,TOR,2016,Patrick Patterson,26,79,0,2020,204,493,.414,106,293,.362,98,200,.490,.521,29,34,.853,77,265,342,94,53,32,65,128,543
2572,TOR,2016,Bismack Biyombo,23,82,22,1808,156,288,.542,0,1,.000,156,287,.544,.542,142,226,.628,182,473,655,29,19,133,71,225,454
2573,TOR,2016,Terrence Ross,24,73,7,1747,270,626,.431,131,339,.386,139,287,.484,.536,49,62,.790,21,164,185,56,54,25,46,120,720
2574,TOR,2016,Luis Scola,35,76,76,1636,269,598,.450,65,161,.404,204,437,.467,.504,61,84,.726,84,276,360,66,46,27,68,178,664
2575,TOR,2016,Jonas Valančiūnas,23,60,59,1557,303,536,.565,0,0,,303,536,.565,.565,162,213,.761,184,363,547,42,25,80,85,158,768
2576,TOR,2016,James Johnson,28,57,32,926,114,240,.475,20,66,.303,94,174,.540,.517,39,68,.574,28,98,126,67,29,33,54,84,287
2577,TOR,2016,DeMarre Carroll,29,26,22,786,105,270,.389,46,118,.390,59,152,.388,.474,30,50,.600,31,91,122,27,44,6,28,63,286
2578,TOR,2016,Norman Powell,22,49,24,725,97,229,.424,36,89,.404,61,140,.436,.502,43,53,.811,16,95,111,47,29,10,32,59,273
2579,TOR,2016,Jason Thompson,29,19,6,292,32,66,.485,5,15,.333,27,51,.529,.523,18,22,.818,22,58,80,10,8,12,8,40,87
2580,TOR,2016,Delon Wright,23,27,1,229,36,80,.450,5,13,.385,31,67,.463,.481,26,35,.743,8,29,37,31,8,3,16,7,103
2581,TOR,2016,Lucas Nogueira,23,29,1,225,28,44,.636,1,3,.333,27,41,.659,.648,8,15,.533,18,28,46,7,12,12,11,29,65
2582,TOR,2016,Anthony Bennett,22,19,0,84,8,27,.296,3,14,.214,5,13,.385,.352,9,10,.900,6,17,23,0,5,0,4,8,28
2583,TOR,2016,Bruno Caboclo,20,6,1,43,1,12,.083,1,7,.143,0,5,.000,.125,0,0,,1,1,2,1,2,1,4,2,3
2584,TOR,2015,Kyle Lowry,28,70,70,2414,430,1043,.412,132,391,.338,298,652,.457,.476,252,312,.808,54,274,328,473,109,13,173,212,1244
2585,TOR,2015,Patrick Patterson,25,81,4,2156,240,535,.449,105,283,.371,135,252,.536,.547,63,80,.788,127,306,433,155,60,44,54,149,648
2586,TOR,2015,DeMar DeRozan,25,60,60,2100,409,990,.413,25,88,.284,384,902,.426,.426,361,434,.832,41,236,277,210,73,11,137,122,1204
2587,TOR,2015,Jonas Valančiūnas,22,80,80,2096,373,652,.572,0,1,.000,373,651,.573,.572,217,276,.786,215,478,693,39,33,95,109,222,963
2588,TOR,2015,Terrence Ross,23,82,61,2092,309,753,.410,145,390,.372,164,363,.452,.507,44,56,.786,32,194,226,86,53,25,69,136,807
2589,TOR,2015,Lou Williams,28,80,0,2016,375,928,.404,152,447,.340,223,481,.464,.486,340,395,.861,24,127,151,164,88,10,101,103,1242
2590,TOR,2015,Greivis Vásquez,28,82,29,1991,296,725,.408,133,351,.379,163,374,.436,.500,50,66,.758,22,194,216,302,46,10,119,177,775
2591,TOR,2015,Amir Johnson,27,75,72,1979,298,519,.574,19,46,.413,279,473,.590,.592,79,129,.612,159,297,456,117,44,59,110,225,694
2592,TOR,2015,James Johnson,27,70,17,1370,238,404,.589,11,51,.216,227,353,.643,.603,67,102,.657,61,196,257,95,54,70,79,155,554
2593,TOR,2015,Tyler Hansbrough,29,74,8,1058,86,165,.521,1,7,.143,85,158,.538,.524,97,139,.698,106,159,265,21,30,15,20,141,270
2594,TOR,2015,Chuck Hayes,31,29,0,255,22,46,.478,0,0,,22,46,.478,.478,6,11,.545,18,33,51,20,10,4,8,37,50
2595,TOR,2015,Landry Fields,26,26,9,216,20,41,.488,1,2,.500,19,39,.487,.500,5,6,.833,10,16,26,15,11,0,8,9,46
2596,TOR,2015,Greg Stiemsma,29,17,0,66,6,8,.750,0,0,,6,8,.750,.750,2,4,.500,9,6,15,3,2,0,7,15,14
2597,TOR,2015,Bruno Caboclo,19,8,0,23,4,12,.333,2,3,.667,2,9,.222,.417,0,0,,1,1,2,0,0,1,4,3,10
2598,TOR,2015,Lucas Nogueira,22,6,0,23,2,8,.250,0,0,,2,8,.250,.250,2,4,.500,2,9,11,1,2,0,2,6,6
2599,TOR,2014,DeMar DeRozan,24,79,79,3017,604,1407,.429,64,210,.305,540,1197,.451,.452,519,630,.824,51,292,343,313,86,28,176,197,1791
2600,TOR,2014,Kyle Lowry,27,79,79,2862,457,1080,.423,190,500,.380,267,580,.460,.511,313,385,.813,88,281,369,586,121,15,194,267,1417
2601,TOR,2014,Jonas Valančiūnas,21,81,81,2282,359,676,.531,0,1,.000,359,675,.532,.531,198,260,.762,226,488,714,57,24,71,136,249,916
2602,TOR,2014,Amir Johnson,26,77,72,2214,344,612,.562,20,66,.303,324,546,.593,.578,91,143,.636,172,333,505,115,56,88,123,271,799
2603,TOR,2014,Terrence Ross,22,81,62,2159,318,751,.423,161,408,.395,157,343,.458,.531,82,98,.837,43,209,252,79,64,27,88,183,879
2604,TOR,2014,Greivis Vásquez,27,61,5,1314,212,508,.417,93,239,.389,119,269,.442,.509,65,76,.855,15,124,139,228,25,4,101,105,582
2605,TOR,2014,John Salmons,34,60,0,1281,109,296,.368,47,121,.388,62,175,.354,.448,33,45,.733,12,105,117,103,35,11,40,92,298
2606,TOR,2014,Patrick Patterson,24,48,7,1118,175,367,.477,46,112,.411,129,255,.506,.540,41,55,.745,83,160,243,63,42,34,49,120,437
2607,TOR,2014,Tyler Hansbrough,28,64,4,978,93,196,.474,0,2,.000,93,194,.479,.474,126,185,.681,120,167,287,17,28,19,47,132,312
2608,TOR,2014,Rudy Gay,27,18,18,639,130,335,.388,22,59,.373,108,276,.391,.421,68,88,.773,29,104,133,40,28,23,59,47,350
2609,TOR,2014,Chuck Hayes,30,45,0,575,42,98,.429,0,1,.000,42,97,.433,.429,15,18,.833,49,114,163,29,23,10,26,77,99
2610,TOR,2014,Steve Novak,30,54,1,540,60,146,.411,52,122,.426,8,24,.333,.589,6,6,1.000,8,50,58,13,12,4,5,44,178
2611,TOR,2014,Landry Fields,25,30,2,322,27,67,.403,0,5,.000,27,62,.435,.403,14,22,.636,15,44,59,20,10,3,11,25,68
2612,TOR,2014,Nando De Colo,26,21,0,193,22,60,.367,8,22,.364,14,38,.368,.433,13,13,1.000,8,20,28,33,7,3,14,23,65
2613,TOR,2014,Dwight Buycks,24,14,0,146,15,48,.313,5,17,.294,10,31,.323,.365,8,9,.889,4,19,23,10,8,0,10,11,43
2614,TOR,2014,Julyan Stone,25,21,0,120,7,17,.412,2,8,.250,5,9,.556,.471,2,3,.667,2,18,20,12,3,0,5,13,18
2615,TOR,2014,D.J. Augustin,26,10,0,82,7,24,.292,1,11,.091,6,13,.462,.313,6,6,1.000,0,4,4,10,1,0,9,7,21
2616,TOR,2014,Quincy Acy,23,7,0,61,6,14,.429,2,5,.400,4,9,.444,.500,5,8,.625,5,10,15,4,4,3,2,8,19
2617,TOR,2014,Austin Daye,25,8,0,33,3,13,.231,0,8,.000,3,5,.600,.231,2,3,.667,2,5,7,2,0,0,0,4,8
2618,TOR,2014,Aaron Gray,29,4,0,20,2,3,.667,0,0,,2,3,.667,.667,1,2,.500,3,5,8,3,0,0,4,7,5
2619,TOR,2013,DeMar DeRozan,23,82,82,3013,548,1231,.445,34,120,.283,514,1111,.463,.459,355,427,.831,48,272,320,204,76,24,151,173,1485
2620,TOR,2013,Amir Johnson,25,81,38,2325,336,606,.554,5,13,.385,331,593,.558,.559,136,187,.727,227,384,611,122,81,110,117,301,813
2621,TOR,2013,Kyle Lowry,26,68,52,2020,250,623,.401,101,279,.362,149,344,.433,.482,190,239,.795,56,265,321,435,94,24,157,218,791
2622,TOR,2013,Alan Anderson,30,65,2,1495,236,616,.383,95,285,.333,141,331,.426,.460,126,147,.857,34,114,148,103,48,7,80,131,693
2623,TOR,2013,Jonas Valančiūnas,20,62,57,1482,204,366,.557,0,0,,204,366,.557,.557,146,185,.789,121,251,372,45,17,78,94,188,554
2624,TOR,2013,José Calderón,31,45,30,1273,187,398,.470,79,184,.429,108,214,.505,.569,47,52,.904,14,92,106,333,28,6,75,58,500
2625,TOR,2013,Terrence Ross,21,73,2,1239,186,457,.407,65,196,.332,121,261,.464,.478,30,42,.714,35,109,144,53,43,14,48,122,467
2626,TOR,2013,Rudy Gay,26,33,32,1146,240,565,.425,44,131,.336,196,434,.452,.464,119,139,.856,43,169,212,94,57,22,94,95,643
2627,TOR,2013,Ed Davis,23,45,24,1087,186,339,.549,0,0,,186,339,.549,.549,66,102,.647,95,205,300,55,25,38,45,111,438
2628,TOR,2013,Landry Fields,24,51,22,1037,102,223,.457,2,14,.143,100,209,.478,.462,34,53,.642,59,149,208,60,32,8,42,63,240
2629,TOR,2013,Andrea Bargnani,27,35,25,1003,170,426,.399,38,123,.309,132,303,.436,.444,65,77,.844,26,102,128,38,21,23,54,64,443
2630,TOR,2013,John Lucas III,30,63,0,827,129,334,.386,57,151,.377,72,183,.393,.472,18,25,.720,8,57,65,105,23,1,26,50,333
2631,TOR,2013,Aaron Gray,28,42,16,513,48,90,.533,0,0,,48,90,.533,.533,23,44,.523,48,85,133,33,7,5,36,85,119
2632,TOR,2013,Mickaël Piétrus,30,19,16,386,34,98,.347,20,64,.313,14,34,.412,.449,12,18,.667,5,31,36,9,12,6,16,33,100
2633,TOR,2013,Linas Kleiza,28,20,3,376,48,144,.333,20,66,.303,28,78,.359,.403,32,38,.842,10,42,52,16,4,2,14,45,148
2634,TOR,2013,Quincy Acy,22,29,0,342,42,75,.560,1,2,.500,41,73,.562,.567,31,38,.816,30,47,77,11,13,15,17,53,116
2635,TOR,2013,Dominic McGuire,27,15,9,230,15,32,.469,0,0,,15,32,.469,.469,2,6,.333,11,37,48,10,5,8,7,26,32
2636,TOR,2013,Sebastian Telfair,27,13,0,185,18,62,.290,10,37,.270,8,25,.320,.371,10,12,.833,1,15,16,39,9,1,11,20,56
2637,TOR,2012,DeMar DeRozan,22,63,63,2206,381,903,.422,24,92,.261,357,811,.440,.435,268,331,.810,40,171,211,128,48,17,123,162,1054
2638,TOR,2012,José Calderón,30,53,53,1799,218,477,.457,59,159,.371,159,318,.500,.519,60,68,.882,19,141,160,468,47,3,104,94,555
2639,TOR,2012,James Johnson,24,62,40,1561,233,518,.450,19,60,.317,214,458,.467,.468,81,115,.704,74,218,292,122,71,84,101,177,566
2640,TOR,2012,Amir Johnson,24,64,43,1553,196,340,.576,2,5,.400,194,335,.579,.579,58,84,.690,149,259,408,79,33,69,94,209,452
2641,TOR,2012,Ed Davis,22,66,9,1534,172,335,.513,0,1,.000,172,334,.515,.513,71,106,.670,134,304,438,60,40,63,67,156,415
2642,TOR,2012,Linas Kleiza,27,49,3,1057,165,410,.402,62,179,.346,103,231,.446,.478,81,100,.810,42,157,199,46,23,4,64,119,473
2643,TOR,2012,Andrea Bargnani,26,31,31,1032,209,484,.432,34,115,.296,175,369,.474,.467,151,173,.873,24,148,172,61,18,15,69,52,603
2644,TOR,2012,Leandro Barbosa,29,42,0,946,198,454,.436,40,111,.360,158,343,.461,.480,76,91,.835,21,58,79,63,36,7,68,101,512
2645,TOR,2012,Aaron Gray,27,49,40,813,83,161,.516,0,0,,83,161,.516,.516,25,47,.532,83,198,281,27,22,17,51,127,191
2646,TOR,2012,Gary Forbes,26,48,2,713,112,271,.413,29,83,.349,83,188,.441,.467,66,91,.725,27,75,102,54,24,4,54,56,319
2647,TOR,2012,Jerryd Bayless,23,31,11,705,117,276,.424,44,104,.423,73,172,.424,.504,75,88,.852,8,58,66,118,24,4,53,70,353
2648,TOR,2012,Alan Anderson,29,17,12,461,55,142,.387,24,61,.393,31,81,.383,.472,29,34,.853,8,26,34,26,5,3,25,35,163
2649,TOR,2012,Rasual Butler,32,34,14,453,41,133,.308,21,77,.273,20,56,.357,.387,7,12,.583,6,60,66,19,7,5,15,39,110
2650,TOR,2012,Jamaal Magloire,33,34,1,374,17,45,.378,0,0,,17,45,.378,.378,7,27,.259,25,88,113,6,4,10,22,66,41
2651,TOR,2012,Ben Uzoh,23,16,8,357,33,94,.351,0,1,.000,33,93,.355,.351,11,19,.579,17,46,63,59,16,3,19,30,77
2652,TOR,2012,Anthony Carter,36,24,0,209,17,53,.321,5,17,.294,12,36,.333,.368,8,10,.800,5,28,33,34,8,4,17,20,47
2653,TOR,2012,Solomon Alabi,23,14,0,122,13,36,.361,0,0,,13,36,.361,.361,7,8,.875,15,32,47,3,2,9,5,11,33
2654,TOR,2012,Justin Dentmon,26,4,0,72,8,22,.364,2,10,.200,6,12,.500,.409,4,6,.667,0,7,7,9,1,0,6,8,22
2655,TOR,2011,DeMar DeRozan,21,82,82,2851,539,1154,.467,5,52,.096,534,1102,.485,.469,327,402,.813,75,240,315,148,85,31,144,217,1410
2656,TOR,2011,Andrea Bargnani,25,66,66,2353,525,1173,.448,77,223,.345,448,950,.472,.480,287,350,.820,74,269,343,119,34,46,152,160,1414
2657,TOR,2011,José Calderón,29,68,55,2102,262,596,.440,57,156,.365,205,440,.466,.487,88,103,.854,30,172,202,605,81,7,148,143,669
2658,TOR,2011,Amir Johnson,23,72,54,1853,281,495,.568,0,1,.000,281,494,.569,.568,126,160,.788,189,272,461,81,53,88,69,263,688
2659,TOR,2011,Ed Davis,21,65,17,1602,215,373,.576,0,0,,215,373,.576,.576,71,128,.555,168,294,462,40,39,67,48,183,501
2660,TOR,2011,Sonny Weems,24,59,28,1413,228,513,.444,17,61,.279,211,452,.467,.461,72,94,.766,39,114,153,104,34,2,86,87,545
2661,TOR,2011,Leandro Barbosa,28,58,0,1395,294,653,.450,72,213,.338,222,440,.505,.505,109,137,.796,14,85,99,119,50,6,84,112,769
2662,TOR,2011,Jerryd Bayless,22,60,14,1347,201,468,.429,46,132,.348,155,336,.461,.479,153,189,.810,24,126,150,238,36,4,110,133,601
2663,TOR,2011,Linas Kleiza,26,39,23,1032,178,406,.438,39,131,.298,139,275,.505,.486,41,65,.631,37,140,177,40,19,7,65,99,436
2664,TOR,2011,Reggie Evans,30,30,18,798,42,103,.408,0,1,.000,42,102,.412,.408,48,88,.545,119,226,345,38,29,6,39,89,132
2665,TOR,2011,Julian Wright,23,52,6,766,82,160,.513,2,10,.200,80,150,.533,.519,22,43,.512,47,71,118,58,39,20,43,45,188
2666,TOR,2011,James Johnson,23,25,25,699,91,196,.464,6,25,.240,85,171,.497,.480,41,58,.707,31,87,118,75,25,28,46,70,229
2667,TOR,2011,Joey Dorsey,27,43,9,522,52,99,.525,0,0,,52,99,.525,.525,31,65,.477,79,111,190,27,24,17,39,78,135
2668,TOR,2011,Jarrett Jack,27,13,13,347,48,122,.393,4,24,.167,44,98,.449,.410,40,46,.870,6,36,42,59,14,0,34,25,140
2669,TOR,2011,Alexis Ajinça,22,24,0,265,47,101,.465,9,27,.333,38,74,.514,.510,11,15,.733,12,49,61,8,8,14,17,60,114
2670,TOR,2011,David Andersen,30,11,0,150,23,47,.489,3,10,.300,20,37,.541,.521,7,7,1.000,8,26,34,7,3,3,8,11,56
2671,TOR,2011,Sundiata Gaines,24,6,0,90,15,35,.429,3,15,.200,12,20,.600,.471,2,6,.333,2,6,8,11,4,1,8,10,35
2672,TOR,2011,Trey Johnson,26,7,0,81,10,30,.333,1,3,.333,9,27,.333,.350,7,8,.875,2,5,7,11,1,1,5,11,28
2673,TOR,2011,Solomon Alabi,22,12,0,59,3,15,.200,0,0,,3,15,.200,.200,0,2,.000,7,7,14,2,2,2,3,5,6
2674,TOR,2011,Peja Stojaković,33,2,0,22,7,10,.700,4,6,.667,3,4,.750,.900,2,2,1.000,0,3,3,1,0,0,2,0,20
2675,TOR,2011,Marcus Banks,29,3,0,22,0,2,.000,0,0,,0,2,.000,.000,6,8,.750,0,1,1,3,1,0,2,4,6
2676,TOR,2011,Ronald Dupree,30,3,0,13,1,4,.250,0,1,.000,1,3,.333,.250,0,0,,0,3,3,1,0,0,0,2,2
2677,TOR,2010,Andrea Bargnani,24,80,80,2799,537,1143,.470,121,325,.372,416,818,.509,.523,181,234,.774,105,388,493,93,25,111,120,215,1376
2678,TOR,2010,Chris Bosh,25,70,70,2526,600,1158,.518,8,22,.364,592,1136,.521,.522,470,590,.797,205,554,759,166,43,68,169,170,1678
2679,TOR,2010,Hedo Türkoğlu,30,74,69,2272,276,674,.409,108,289,.374,168,385,.436,.490,175,226,.774,42,301,343,304,55,32,125,220,835
2680,TOR,2010,Jarrett Jack,26,82,43,2243,323,671,.481,82,199,.412,241,472,.511,.542,203,241,.842,30,192,222,413,60,6,163,151,931
2681,TOR,2010,José Calderón,28,68,39,1817,274,568,.482,68,171,.398,206,397,.519,.542,83,104,.798,23,119,142,404,47,7,99,135,699
2682,TOR,2010,DeMar DeRozan,20,77,65,1664,255,512,.498,4,16,.250,251,496,.506,.502,148,194,.763,66,157,223,53,43,18,62,176,662
2683,TOR,2010,Amir Johnson,22,82,5,1453,208,334,.623,0,4,.000,208,330,.630,.623,95,149,.638,154,241,395,48,44,66,63,255,511
2684,TOR,2010,Antoine Wright,25,67,10,1392,162,399,.406,58,173,.335,104,226,.460,.479,53,77,.688,38,152,190,71,30,11,58,134,435
2685,TOR,2010,Sonny Weems,23,69,19,1368,236,458,.515,2,15,.133,234,443,.528,.517,44,64,.688,42,150,192,101,39,25,65,126,518
2686,TOR,2010,Marco Belinelli,23,66,1,1121,154,379,.406,60,158,.380,94,221,.425,.485,101,121,.835,14,81,95,89,42,5,60,80,469
2687,TOR,2010,Rasho Nesterović,33,42,8,413,81,149,.544,0,0,,81,149,.544,.544,1,5,.200,37,52,89,25,10,17,16,54,163
2688,TOR,2010,Reggie Evans,29,28,1,311,34,69,.493,0,0,,34,69,.493,.493,27,60,.450,30,75,105,8,14,4,22,44,95
2689,TOR,2010,Marcus Banks,28,22,0,244,39,73,.534,7,24,.292,32,49,.653,.582,24,29,.828,3,20,23,26,12,2,20,30,109
2690,TOR,2010,Pops Mensah-Bonsu,26,16,0,107,12,29,.414,0,0,,12,29,.414,.414,10,18,.556,15,16,31,2,3,8,10,17,34
2691,TOR,2010,Patrick O'Bryant,23,11,0,51,8,15,.533,0,1,.000,8,14,.571,.533,3,6,.500,2,9,11,1,2,4,5,12,19
2692,TOR,2009,Chris Bosh,24,77,77,2928,615,1263,.487,12,49,.245,603,1214,.497,.492,504,617,.817,215,556,771,191,67,77,174,189,1746
2693,TOR,2009,Anthony Parker,33,80,71,2637,321,754,.426,94,241,.390,227,513,.442,.488,121,145,.834,45,272,317,269,100,15,114,145,857
2694,TOR,2009,Andrea Bargnani,23,78,59,2453,431,958,.450,119,291,.409,312,667,.468,.512,221,266,.831,70,346,416,94,34,97,135,242,1202
2695,TOR,2009,José Calderón,27,68,68,2333,320,644,.497,82,202,.406,238,442,.538,.561,151,154,.981,16,178,194,607,74,7,143,114,873
2696,TOR,2009,Jason Kapono,27,80,12,1831,261,604,.432,98,229,.428,163,375,.435,.513,34,42,.810,26,137,163,105,22,3,70,144,654
2697,TOR,2009,Joey Graham,26,78,10,1541,231,480,.481,3,16,.188,228,464,.491,.484,132,160,.825,95,197,292,48,35,12,74,191,597
2698,TOR,2009,Jamario Moon,28,54,39,1379,150,317,.473,38,110,.345,112,207,.541,.533,55,65,.846,48,201,249,70,65,44,31,85,393
2699,TOR,2009,Jermaine O'Neal,30,41,34,1216,220,465,.473,0,1,.000,220,464,.474,.473,115,142,.810,71,217,288,67,18,82,92,130,555
2700,TOR,2009,Shawn Marion,30,27,27,954,167,342,.488,2,13,.154,165,329,.502,.491,50,62,.806,73,151,224,62,31,21,49,40,386
2701,TOR,2009,Roko Ukić,24,72,0,890,123,324,.380,11,62,.177,112,262,.427,.397,44,60,.733,27,48,75,153,30,2,60,77,301
2702,TOR,2009,Will Solomon,30,39,9,544,79,181,.436,15,57,.263,64,124,.516,.478,20,24,.833,9,34,43,123,20,4,49,60,193
2703,TOR,2009,Kris Humphries,23,29,0,265,38,90,.422,0,0,,38,90,.422,.422,38,48,.792,24,46,70,10,8,6,8,31,114
2704,TOR,2009,Pops Mensah-Bonsu,25,19,0,263,34,96,.354,0,2,.000,34,94,.362,.354,28,41,.683,50,53,103,6,8,4,17,37,96
2705,TOR,2009,Jake Voskuhl,31,38,1,240,12,45,.267,0,0,,12,45,.267,.267,11,14,.786,21,38,59,8,3,4,17,60,35
2706,TOR,2009,Patrick O'Bryant,22,13,3,147,29,53,.547,0,2,.000,29,51,.569,.547,3,8,.375,6,26,32,3,3,11,5,32,61
2707,TOR,2009,Quincy Douby,24,7,0,73,12,22,.545,4,9,.444,8,13,.615,.636,3,4,.750,3,4,7,12,3,0,7,4,31
2708,TOR,2009,Hassan Adams,24,12,0,52,4,13,.308,0,0,,4,13,.308,.308,3,6,.500,1,6,7,1,1,1,4,4,11
2709,TOR,2009,Marcus Banks,27,6,0,40,6,18,.333,1,5,.200,5,13,.385,.361,1,3,.333,1,2,3,6,1,0,3,5,14
2710,TOR,2009,Nathan Jawai,22,6,0,19,1,4,.250,0,0,,1,4,.250,.250,0,0,,1,1,2,0,0,0,2,3,2
2711,TOR,2008,Anthony Parker,32,82,82,2634,395,829,.476,133,304,.438,262,525,.499,.557,102,125,.816,50,284,334,183,79,17,87,157,1025
2712,TOR,2008,José Calderón,26,82,56,2484,367,707,.519,79,184,.429,288,523,.551,.575,109,120,.908,34,202,236,678,87,6,126,134,922
2713,TOR,2008,Chris Bosh,23,67,67,2425,507,1027,.494,10,25,.400,497,1002,.496,.499,472,559,.844,174,409,583,171,63,67,153,157,1496
2714,TOR,2008,Jamario Moon,27,78,75,2166,279,575,.485,40,122,.328,239,453,.528,.520,63,85,.741,92,392,484,90,80,108,51,152,661
2715,TOR,2008,Carlos Delfino,25,82,0,1928,251,632,.397,120,314,.382,131,318,.412,.492,116,156,.744,66,293,359,145,69,11,75,177,738
2716,TOR,2008,Andrea Bargnani,22,78,53,1861,280,725,.386,90,261,.345,190,464,.409,.448,142,169,.840,50,238,288,89,23,37,88,211,792
2717,TOR,2008,Jason Kapono,26,81,7,1530,243,498,.488,57,118,.483,186,380,.489,.545,37,43,.860,31,89,120,65,34,2,58,131,580
2718,TOR,2008,Rasho Nesterović,31,71,39,1486,257,467,.550,1,3,.333,256,464,.552,.551,37,49,.755,130,212,342,82,20,52,60,132,552
2719,TOR,2008,T.J. Ford,24,51,26,1199,246,524,.469,15,51,.294,231,473,.488,.484,110,125,.880,23,77,100,313,54,0,102,93,617
2720,TOR,2008,Kris Humphries,22,70,0,925,161,333,.483,0,2,.000,161,331,.486,.483,75,124,.605,90,169,259,28,25,28,47,107,397
2721,TOR,2008,Juan Dixon,29,36,0,424,59,160,.369,17,39,.436,42,121,.347,.422,18,19,.947,9,38,47,65,21,2,35,38,153
2722,TOR,2008,Joey Graham,25,38,3,331,49,113,.434,2,3,.667,47,110,.427,.442,38,45,.844,18,49,67,15,3,0,23,47,138
2723,TOR,2008,Darrick Martin,36,17,0,141,10,43,.233,2,16,.125,8,27,.296,.256,5,6,.833,3,4,7,21,6,0,1,12,27
2724,TOR,2008,Primož Brezec,28,13,0,110,17,38,.447,0,0,,17,38,.447,.447,14,21,.667,9,9,18,1,1,2,4,25,48
2725,TOR,2008,Maceo Baston,32,15,2,103,17,25,.680,0,0,,17,25,.680,.680,7,10,.700,9,17,26,3,2,4,4,20,41
2726,TOR,2008,Jorge Garbajosa,30,7,0,74,8,25,.320,6,16,.375,2,9,.222,.440,0,0,,2,13,15,3,3,0,1,2,22
2727,TOR,2008,Linton Johnson,27,2,0,10,2,5,.400,0,1,.000,2,4,.500,.400,2,2,1.000,0,1,1,1,0,0,3,1,6
2728,TOR,2007,Chris Bosh,22,69,69,2658,543,1094,.496,12,35,.343,531,1059,.501,.502,463,590,.785,186,555,741,175,39,90,179,163,1561
2729,TOR,2007,Anthony Parker,31,73,73,2437,328,687,.477,115,261,.441,213,426,.500,.561,132,158,.835,60,223,283,153,73,11,71,135,903
2730,TOR,2007,T.J. Ford,23,75,71,2243,393,902,.436,21,69,.304,372,833,.447,.447,240,293,.819,53,183,236,595,101,8,231,186,1047
2731,TOR,2007,Jorge Garbajosa,29,67,60,1909,222,529,.420,66,193,.342,156,336,.464,.482,57,78,.731,48,282,330,125,78,15,64,90,567
2732,TOR,2007,Rasho Nesterović,30,80,73,1676,230,421,.546,0,1,.000,230,420,.548,.546,34,50,.680,115,245,360,74,37,84,56,193,494
2733,TOR,2007,Andrea Bargnani,21,65,2,1629,267,625,.427,100,268,.373,167,357,.468,.507,117,142,.824,52,203,255,50,32,53,107,180,751
2734,TOR,2007,José Calderón,25,77,11,1614,263,505,.521,25,75,.333,238,430,.553,.546,117,143,.818,21,113,134,387,63,5,110,136,668
2735,TOR,2007,Morris Peterson,29,71,12,1515,222,517,.429,106,295,.359,116,222,.523,.532,84,123,.683,32,205,237,47,45,12,53,126,634
2736,TOR,2007,Joey Graham,24,79,21,1319,192,388,.495,9,31,.290,183,357,.513,.506,110,131,.840,55,193,248,44,30,4,49,161,503
2737,TOR,2007,Fred Jones,27,39,9,870,96,249,.386,32,101,.317,64,148,.432,.450,73,88,.830,16,66,82,55,30,12,50,80,297
2738,TOR,2007,Juan Dixon,28,26,5,683,110,259,.425,27,83,.325,83,176,.472,.477,41,44,.932,11,62,73,41,27,2,24,65,288
2739,TOR,2007,Kris Humphries,21,60,2,670,87,185,.470,0,0,,87,185,.470,.470,53,79,.671,78,109,187,18,14,21,32,98,227
2740,TOR,2007,Darrick Martin,35,31,0,220,33,94,.351,13,37,.351,20,57,.351,.420,15,21,.714,2,10,12,43,3,0,12,22,94
2741,TOR,2007,Luke Jackson,25,10,2,122,18,35,.514,4,13,.308,14,22,.636,.571,5,9,.556,2,7,9,9,5,1,6,12,45
2742,TOR,2007,P.J. Tucker,21,17,0,83,11,22,.500,0,0,,11,22,.500,.500,8,14,.571,11,12,23,3,2,0,6,12,30
2743,TOR,2007,Uroš Slokar,23,20,0,72,14,26,.538,1,2,.500,13,24,.542,.558,9,13,.692,7,7,14,1,1,2,9,11,38
2744,TOR,2007,Pape Sow,25,7,0,34,3,9,.333,0,0,,3,9,.333,.333,4,6,.667,6,5,11,2,1,1,1,2,10
2745,TOR,2006,Morris Peterson,28,82,77,3140,478,1096,.436,177,448,.395,301,648,.465,.517,241,294,.820,65,316,381,190,104,15,126,223,1374
2746,TOR,2006,Mike James,30,79,79,2925,576,1228,.469,169,382,.442,407,846,.481,.538,283,338,.837,45,217,262,460,72,3,206,214,1604
2747,TOR,2006,Chris Bosh,21,70,70,2751,549,1087,.505,0,13,.000,549,1074,.511,.505,474,581,.816,204,443,647,181,50,79,157,209,1572
2748,TOR,2006,Charlie Villanueva,21,81,36,2361,435,940,.463,70,214,.327,365,726,.503,.500,113,160,.706,181,340,521,88,60,63,99,247,1053
2749,TOR,2006,Matt Bonner,25,78,6,1710,209,467,.448,102,243,.420,107,224,.478,.557,63,76,.829,86,198,284,56,49,31,32,216,583
2750,TOR,2006,Joey Graham,23,80,24,1581,198,414,.478,29,87,.333,169,327,.517,.513,108,133,.812,57,187,244,60,37,13,92,228,533
2751,TOR,2006,José Calderón,24,64,11,1487,132,312,.423,7,43,.163,125,269,.465,.434,78,92,.848,30,111,141,288,42,4,101,93,349
2752,TOR,2006,Jalen Rose,33,46,22,1236,180,446,.404,31,115,.270,149,331,.450,.438,166,217,.765,15,114,129,113,20,10,65,101,557
2753,TOR,2006,Rafael Araújo,25,52,34,601,53,145,.366,0,1,.000,53,144,.368,.366,15,28,.536,43,101,144,15,24,6,42,104,121
2754,TOR,2006,Pape Sow,24,42,25,590,53,123,.431,0,0,,53,123,.431,.431,41,57,.719,54,92,146,8,21,19,30,118,147
2755,TOR,2006,Eric Williams,33,28,11,352,29,75,.387,5,18,.278,24,57,.421,.420,28,38,.737,10,40,50,15,7,2,15,55,91
2756,TOR,2006,Darrick Martin,34,40,0,339,34,97,.351,16,40,.400,18,57,.316,.433,18,24,.750,2,18,20,57,17,0,15,42,102
2757,TOR,2006,Loren Woods,27,27,4,324,28,59,.475,0,1,.000,28,58,.483,.475,6,14,.429,44,66,110,4,9,23,16,49,62
2758,TOR,2006,Andre Barrett,23,17,0,261,35,97,.361,2,13,.154,33,84,.393,.371,6,9,.667,8,14,22,50,10,0,14,12,78
2759,TOR,2006,Antonio Davis,37,8,8,191,14,31,.452,0,0,,14,31,.452,.452,7,20,.350,15,21,36,7,3,1,8,26,35
2760,TOR,2006,Aaron Williams,34,14,3,99,10,19,.526,0,0,,10,19,.526,.526,5,6,.833,5,10,15,1,4,3,5,28,25
2761,TOR,2006,Alvin Williams,31,1,0,10,0,3,.000,0,2,.000,0,1,.000,.000,1,2,.500,0,3,3,0,0,0,0,0,1
2762,TOR,2005,Chris Bosh,20,81,81,3017,473,1005,.471,3,10,.300,470,995,.472,.472,412,542,.760,194,524,718,153,76,113,187,226,1361
2763,TOR,2005,Rafer Alston,28,80,78,2717,403,974,.414,139,389,.357,264,585,.451,.485,191,258,.740,42,237,279,514,118,7,170,212,1136
2764,TOR,2005,Jalen Rose,32,81,65,2710,527,1159,.455,108,274,.394,419,885,.473,.501,333,390,.854,44,232,276,209,63,10,180,190,1495
2765,TOR,2005,Morris Peterson,27,82,61,2510,356,848,.420,129,335,.385,227,513,.442,.496,188,226,.832,71,269,340,169,91,18,93,219,1029
2766,TOR,2005,Donyell Marshall,31,65,2,1645,262,592,.443,151,363,.416,111,229,.485,.570,72,91,.791,95,333,428,81,57,46,42,136,747
2767,TOR,2005,Matt Bonner,24,82,0,1553,247,463,.533,39,92,.424,208,371,.561,.576,56,71,.789,108,177,285,48,39,19,40,220,589
2768,TOR,2005,Milt Palacio,26,80,4,1533,175,392,.446,2,12,.167,173,380,.455,.449,115,155,.742,26,108,134,279,48,13,104,126,467
2769,TOR,2005,Lamond Murray,31,62,1,918,132,310,.426,46,105,.438,86,205,.420,.500,61,80,.763,44,120,164,47,32,16,54,85,371
2770,TOR,2005,Rafael Araújo,24,59,41,736,76,175,.434,1,3,.333,75,172,.436,.437,43,55,.782,59,126,185,16,21,8,52,157,196
2771,TOR,2005,Loren Woods,26,45,30,712,71,164,.433,0,1,.000,71,163,.436,.433,34,59,.576,81,139,220,17,8,39,37,78,176
2772,TOR,2005,Vince Carter,28,20,20,608,124,302,.411,19,59,.322,105,243,.432,.442,50,72,.694,28,38,66,61,25,15,22,56,317
2773,TOR,2005,Eric Williams,32,34,18,583,55,145,.379,11,33,.333,44,112,.393,.417,38,53,.717,16,61,77,50,22,2,26,67,159
2774,TOR,2005,Pape Sow,23,27,4,255,23,58,.397,0,0,,23,58,.397,.397,16,27,.593,18,39,57,2,12,4,10,46,62
2775,TOR,2005,Aaron Williams,33,23,4,165,15,36,.417,0,0,,15,36,.417,.417,6,7,.857,10,19,29,2,1,3,6,45,36
2776,TOR,2005,Omar Cook,23,5,0,74,10,24,.417,0,4,.000,10,20,.500,.417,3,6,.500,2,5,7,22,6,1,6,6,23
2777,TOR,2005,Jérôme Moïso,26,8,1,69,3,9,.333,0,1,.000,3,8,.375,.333,8,9,.889,6,17,23,0,2,3,6,7,14
2778,TOR,2004,Vince Carter,27,73,73,2785,608,1457,.417,93,243,.383,515,1214,.424,.449,336,417,.806,95,254,349,348,88,65,223,212,1645
2779,TOR,2004,Donyell Marshall,30,66,66,2580,413,884,.467,120,298,.403,293,586,.500,.535,120,162,.741,182,527,709,94,80,104,95,200,1066
2780,TOR,2004,Chris Bosh,19,75,63,2510,327,712,.459,5,14,.357,322,698,.461,.463,202,288,.701,191,366,557,78,59,106,107,215,861
2781,TOR,2004,Morris Peterson,26,82,29,2148,238,587,.405,126,340,.371,112,247,.453,.513,76,94,.809,35,226,261,113,88,14,69,206,678
2782,TOR,2004,Jalen Rose,31,50,50,1968,308,752,.410,46,148,.311,262,604,.434,.440,148,180,.822,27,175,202,273,39,18,171,139,810
2783,TOR,2004,Alvin Williams,29,56,54,1730,201,496,.405,26,89,.292,175,407,.430,.431,66,85,.776,18,132,150,224,55,10,78,114,494
2784,TOR,2004,Michael Curry,35,70,15,1229,76,196,.388,3,15,.200,73,181,.403,.395,49,58,.845,22,65,87,53,23,5,48,153,204
2785,TOR,2004,Milt Palacio,25,59,13,1211,104,298,.349,4,26,.154,100,272,.368,.356,45,68,.662,15,87,102,184,41,11,87,90,257
2786,TOR,2004,Antonio Davis,35,15,15,538,46,120,.383,0,0,,46,120,.383,.383,37,49,.755,49,94,143,14,8,8,21,45,129
2787,TOR,2004,Lamond Murray,30,33,4,518,76,215,.353,21,60,.350,55,155,.355,.402,24,35,.686,14,76,90,28,15,7,38,47,197
2788,TOR,2004,Lonny Baxter,25,36,4,487,60,128,.469,0,1,.000,60,127,.472,.469,30,56,.536,42,79,121,10,14,18,22,69,150
2789,TOR,2004,Jérôme Moïso,25,35,1,417,40,84,.476,0,1,.000,40,83,.482,.476,22,38,.579,41,72,113,8,17,12,25,42,102
2790,TOR,2004,Jerome Williams,30,15,12,407,28,57,.491,0,1,.000,28,56,.500,.491,21,29,.724,35,93,128,11,19,3,23,30,77
2791,TOR,2004,Corie Blount,35,16,0,294,18,47,.383,0,0,,18,47,.383,.383,2,3,.667,22,47,69,10,11,5,8,49,38
2792,TOR,2004,Roger Mason,23,23,3,285,31,87,.356,12,33,.364,19,54,.352,.425,19,22,.864,1,27,28,23,10,6,18,31,93
2793,TOR,2004,Rod Strickland,37,15,1,282,28,84,.333,0,3,.000,28,81,.346,.333,15,22,.682,10,27,37,59,8,4,18,17,71
2794,TOR,2004,Robert Archibald,23,30,3,246,8,30,.267,0,0,,8,30,.267,.267,13,27,.481,21,29,50,12,13,3,9,49,29
2795,TOR,2004,Dion Glover,25,14,4,178,25,65,.385,4,14,.286,21,51,.412,.415,10,14,.714,4,25,29,15,10,2,19,17,64
2796,TOR,2004,Jannero Pargo,24,5,0,71,9,29,.310,0,5,.000,9,24,.375,.310,0,0,,0,4,4,12,4,1,5,7,18
2797,TOR,2004,Mengke Bateer,28,7,0,40,4,7,.571,0,0,,4,7,.571,.571,0,0,,5,3,8,1,1,0,2,10,8
2798,TOR,2004,Michael Bradley,24,5,0,38,1,3,.333,0,0,,1,3,.333,.333,1,2,.500,1,10,11,1,1,0,3,6,3
2799,TOR,2004,Rick Brunson,31,3,0,10,2,4,.500,0,0,,2,4,.500,.500,0,0,,0,0,0,2,0,0,0,0,4
2800,TOR,2004,Chris Jefferies,23,2,0,8,3,6,.500,1,3,.333,2,3,.667,.583,1,1,1.000,0,1,1,1,0,0,1,0,8
2801,TOR,2003,Morris Peterson,25,82,80,2949,421,1073,.392,116,344,.337,305,729,.418,.446,195,247,.789,97,266,363,188,88,32,128,232,1153
2802,TOR,2003,Alvin Williams,28,78,78,2638,396,905,.438,48,146,.329,348,759,.458,.464,187,239,.782,55,190,245,416,111,21,128,170,1027
2803,TOR,2003,Jerome Williams,29,71,63,2346,267,535,.499,1,6,.167,266,529,.503,.500,156,281,.555,231,419,650,95,116,26,98,197,691
2804,TOR,2003,Voshon Lenard,29,63,24,1929,325,809,.402,92,252,.365,233,557,.418,.459,156,194,.804,48,164,212,144,59,21,103,156,898
2805,TOR,2003,Antonio Davis,34,53,52,1894,261,641,.407,0,0,,261,641,.407,.407,216,280,.771,130,307,437,131,23,62,118,150,738
2806,TOR,2003,Vince Carter,26,43,42,1471,355,760,.467,45,131,.344,310,629,.493,.497,129,160,.806,59,129,188,143,48,41,74,121,884
2807,TOR,2003,Jelani McCoy,25,67,25,1367,194,395,.491,0,0,,194,395,.491,.491,69,126,.548,95,260,355,43,28,60,96,162,457
2808,TOR,2003,Michael Bradley,23,67,11,1314,151,314,.481,1,6,.167,150,308,.487,.482,35,67,.522,162,247,409,67,16,32,76,125,338
2809,TOR,2003,Rafer Alston,26,47,4,980,139,335,.415,51,130,.392,88,205,.429,.491,37,54,.685,21,86,107,192,38,15,86,120,366
2810,TOR,2003,Lindsey Hunter,32,29,0,673,106,302,.351,34,107,.318,72,195,.369,.407,34,47,.723,15,44,59,71,35,5,57,50,280
2811,TOR,2003,Chris Jefferies,22,51,10,666,75,194,.387,18,54,.333,57,140,.407,.433,29,43,.674,16,43,59,22,19,16,45,56,197
2812,TOR,2003,Greg Foster,34,29,9,539,47,122,.385,1,4,.250,46,118,.390,.389,26,32,.813,30,72,102,13,1,9,30,82,121
2813,TOR,2003,Mamadou N'Diaye,27,22,8,364,43,96,.448,0,0,,43,96,.448,.448,34,47,.723,29,53,82,7,8,32,21,58,120
2814,TOR,2003,Jermaine Jackson,26,24,1,286,21,68,.309,1,9,.111,20,59,.339,.316,23,27,.852,10,15,25,39,9,3,19,24,66
2815,TOR,2003,Damone Brown,23,5,3,115,11,35,.314,0,2,.000,11,33,.333,.314,6,8,.750,3,12,15,3,1,0,6,14,28
2816,TOR,2003,Maceo Baston,27,16,0,106,15,25,.600,0,0,,15,25,.600,.600,10,12,.833,4,19,23,0,4,11,6,16,40
2817,TOR,2003,Art Long,30,7,0,80,9,25,.360,1,2,.500,8,23,.348,.380,1,5,.200,8,12,20,4,3,3,11,13,20
2818,TOR,2003,Nate Huffman,27,7,0,76,9,25,.360,0,0,,9,25,.360,.360,5,8,.625,9,14,23,5,1,3,3,13,23
2819,TOR,2003,Zendon Hamilton,27,3,0,12,2,5,.400,0,0,,2,5,.400,.400,2,2,1.000,1,3,4,0,1,0,1,2,6
2820,TOR,2002,Antonio Davis,33,77,77,2978,410,963,.426,0,1,.000,410,962,.426,.426,293,358,.818,254,486,740,155,54,83,159,225,1113
2821,TOR,2002,Alvin Williams,27,82,82,2927,403,971,.415,62,193,.321,341,778,.438,.447,103,140,.736,58,223,281,468,135,26,150,191,971
2822,TOR,2002,Vince Carter,25,60,60,2385,559,1307,.428,121,313,.387,438,994,.441,.474,245,307,.798,138,175,313,239,94,43,154,191,1484
2823,TOR,2002,Keon Clark,26,81,31,2185,380,775,.490,0,5,.000,380,770,.494,.490,155,230,.674,182,421,603,88,58,122,140,258,915
2824,TOR,2002,Morris Peterson,24,63,56,1988,336,768,.438,84,231,.364,252,537,.469,.492,127,169,.751,91,132,223,153,73,11,86,174,883
2825,TOR,2002,Jerome Williams,28,68,32,1641,190,388,.490,0,0,,190,388,.490,.490,138,204,.676,165,221,386,75,78,25,68,153,518
2826,TOR,2002,Chris Childs,34,69,4,1576,97,296,.328,33,120,.275,64,176,.364,.383,58,71,.817,18,136,154,351,56,5,123,177,285
2827,TOR,2002,Hakeem Olajuwon,39,61,37,1378,194,418,.464,0,2,.000,194,416,.466,.464,47,84,.560,98,268,366,66,74,90,98,147,435
2828,TOR,2002,Dell Curry,37,56,4,886,141,347,.406,45,131,.344,96,216,.444,.471,33,37,.892,23,58,81,61,22,6,41,50,360
2829,TOR,2002,Eric Montross,30,49,24,655,53,132,.402,0,1,.000,53,131,.405,.402,10,31,.323,36,104,140,16,12,23,25,92,116
2830,TOR,2002,Tracy Murray,30,40,3,473,85,207,.411,40,104,.385,45,103,.437,.507,17,21,.810,18,35,53,19,11,8,25,38,227
2831,TOR,2002,Jermaine Jackson,25,24,0,280,20,42,.476,1,2,.500,19,40,.475,.488,16,24,.667,3,24,27,57,9,1,14,24,57
2832,TOR,2002,Michael Bradley,22,26,0,118,13,25,.520,0,2,.000,13,23,.565,.520,4,8,.500,7,17,24,3,0,6,6,10,30
2833,TOR,2002,Carlos Arroyo,22,17,0,96,13,29,.448,0,0,,13,29,.448,.448,4,6,.667,3,9,12,21,6,0,12,12,30
2834,TOR,2002,Michael Stewart,26,11,0,93,8,23,.348,0,0,,8,23,.348,.348,6,11,.545,12,13,25,3,4,3,4,22,22
2835,TOR,2002,Derrick Dial,26,7,0,50,11,26,.423,1,4,.250,10,22,.455,.442,5,6,.833,2,9,11,4,2,0,3,1,28
2836,TOR,2002,Mamadou N'Diaye,26,5,0,46,6,10,.600,0,0,,6,10,.600,.600,8,10,.800,6,5,11,0,0,2,1,6,20
2837,TOR,2001,Vince Carter,24,75,75,2979,762,1656,.460,162,397,.408,600,1259,.477,.509,384,502,.765,176,240,416,291,114,82,167,205,2070
2838,TOR,2001,Charles Oakley,37,78,77,2767,305,786,.388,11,49,.224,294,737,.399,.395,127,152,.836,142,599,741,264,76,48,139,258,748
2839,TOR,2001,Antonio Davis,32,78,77,2729,375,866,.433,0,1,.000,375,865,.434,.433,319,423,.754,274,513,787,106,22,151,135,230,1069
2840,TOR,2001,Alvin Williams,26,82,34,2394,330,767,.430,33,108,.306,297,659,.451,.452,109,145,.752,50,162,212,407,123,26,103,171,802
2841,TOR,2001,Morris Peterson,23,80,49,1809,290,673,.431,63,165,.382,227,508,.447,.478,104,145,.717,112,147,259,105,63,20,78,164,747
2842,TOR,2001,Mark Jackson,35,54,54,1802,170,403,.422,57,165,.345,113,238,.475,.493,64,76,.842,42,143,185,498,63,7,117,83,461
2843,TOR,2001,Keon Clark,25,46,0,968,167,320,.522,0,1,.000,167,319,.524,.522,79,135,.585,78,170,248,38,16,110,42,143,413
2844,TOR,2001,Dell Curry,36,71,1,956,162,382,.424,62,145,.428,100,237,.422,.505,43,51,.843,16,69,85,75,27,8,39,66,429
2845,TOR,2001,Corliss Williamson,27,42,31,886,153,325,.471,0,2,.000,153,323,.474,.471,84,130,.646,57,96,153,33,15,13,65,98,390
2846,TOR,2001,Kevin Willis,38,35,9,771,124,269,.461,0,2,.000,124,267,.464,.461,61,81,.753,68,155,223,21,19,21,40,78,309
2847,TOR,2001,Chris Childs,33,26,0,550,42,113,.372,12,42,.286,30,71,.423,.425,21,25,.840,10,54,64,119,22,8,58,82,117
2848,TOR,2001,Tracy Murray,29,38,1,453,77,193,.399,29,80,.363,48,113,.425,.474,24,32,.750,18,41,59,14,8,6,20,45,207
2849,TOR,2001,Jerome Williams,27,26,0,378,48,93,.516,0,1,.000,48,92,.522,.516,35,45,.778,35,69,104,13,18,10,16,43,131
2850,TOR,2001,Kornél Dávid,29,17,0,140,15,29,.517,0,0,,15,29,.517,.517,12,13,.923,9,24,33,4,2,3,7,20,42
2851,TOR,2001,Michael Stewart,25,26,0,123,11,34,.324,0,0,,11,34,.324,.324,11,18,.611,16,13,29,2,4,3,5,19,33
2852,TOR,2001,Tyrone Corbin,38,15,1,117,9,38,.237,0,5,.000,9,33,.273,.237,2,4,.500,3,10,13,4,2,0,3,18,20
2853,TOR,2001,Eric Montross,29,12,1,81,6,17,.353,0,0,,6,17,.353,.353,1,5,.200,9,20,29,4,3,3,4,15,13
2854,TOR,2001,Muggsy Bogues,36,3,0,34,0,2,.000,0,1,.000,0,1,.000,.000,0,0,,0,3,3,5,2,0,4,3,0
2855,TOR,2001,Mamadou N'Diaye,25,3,0,10,1,4,.250,0,0,,1,4,.250,.250,2,2,1.000,1,1,2,0,0,0,0,3,4
2856,TOR,2001,Garth Joseph,27,2,0,8,1,2,.500,0,0,,1,2,.500,.500,0,0,,2,0,2,1,0,0,1,1,2
2857,TOR,2000,Vince Carter,23,82,82,3126,788,1696,.465,95,236,.403,693,1460,.475,.493,436,551,.791,150,326,476,322,110,92,178,263,2107
2858,TOR,2000,Antonio Davis,31,79,78,2479,313,712,.440,0,0,,313,712,.440,.440,284,371,.765,235,461,696,105,38,100,121,267,910
2859,TOR,2000,Tracy McGrady,20,79,34,2462,459,1018,.451,18,65,.277,441,953,.463,.460,277,392,.707,188,313,501,263,90,151,160,201,1213
2860,TOR,2000,Charles Oakley,36,80,80,2431,234,560,.418,14,41,.341,220,519,.424,.430,66,85,.776,117,423,540,253,102,45,154,294,548
2861,TOR,2000,Doug Christie,29,73,73,2264,311,764,.407,99,275,.360,212,489,.434,.472,182,216,.843,63,222,285,321,102,43,144,167,903
2862,TOR,2000,Muggsy Bogues,35,80,5,1731,157,358,.439,17,51,.333,140,307,.456,.462,79,87,.908,25,110,135,299,65,4,59,119,410
2863,TOR,2000,Kevin Willis,37,79,1,1679,236,569,.415,1,3,.333,235,566,.415,.416,131,164,.799,201,281,482,49,36,48,98,256,604
2864,TOR,2000,Dell Curry,35,67,9,1095,194,454,.427,95,242,.393,99,212,.467,.532,24,32,.750,11,89,100,89,32,9,40,66,507
2865,TOR,2000,Alvin Williams,25,55,28,779,114,287,.397,16,55,.291,98,232,.422,.425,48,65,.738,27,58,85,126,34,11,47,78,292
2866,TOR,2000,Dee Brown,31,38,12,673,93,258,.360,67,187,.358,26,71,.366,.490,11,16,.688,9,45,54,86,24,5,39,62,264
2867,TOR,2000,John Thomas,24,55,6,477,49,107,.458,0,1,.000,49,106,.462,.458,16,41,.390,37,38,75,9,12,14,14,106,114
2868,TOR,2000,Michael Stewart,24,42,1,389,20,53,.377,0,0,,20,53,.377,.377,18,32,.563,33,61,94,6,5,19,17,81,58
2869,TOR,2000,Haywoode Workman,34,13,1,102,8,28,.286,3,14,.214,5,14,.357,.339,1,2,.500,0,9,9,17,9,0,4,14,20
2870,TOR,2000,Antonio Lang,27,7,0,32,0,5,.000,0,0,,0,5,.000,.000,3,4,.750,0,5,5,1,4,1,2,7,3
2871,TOR,2000,Aleksandar Radojević,23,3,0,24,2,7,.286,0,0,,2,7,.286,.286,3,6,.500,2,6,8,1,2,1,5,5,7
2872,TOR,2000,Sean Marks,24,5,0,12,2,6,.333,0,1,.000,2,5,.400,.333,4,4,1.000,0,2,2,0,1,1,3,3,8
2873,TOR,1999,Doug Christie,28,50,50,1768,252,650,.388,49,161,.304,203,489,.415,.425,207,246,.841,59,148,207,187,113,26,119,111,760
2874,TOR,1999,Vince Carter,22,50,49,1760,345,766,.450,19,66,.288,326,700,.466,.463,204,268,.761,94,189,283,149,55,77,110,140,913
2875,TOR,1999,Charles Oakley,35,50,50,1633,140,327,.428,1,5,.200,139,322,.432,.430,67,83,.807,96,278,374,168,46,21,96,182,348
2876,TOR,1999,Dee Brown,30,49,0,1377,187,495,.378,135,349,.387,52,146,.356,.514,40,55,.727,15,88,103,143,56,8,80,75,549
2877,TOR,1999,Kevin Willis,36,42,38,1216,187,447,.418,0,2,.000,187,445,.420,.418,130,155,.839,109,241,350,67,28,28,86,134,504
2878,TOR,1999,Tracy McGrady,19,49,2,1106,168,385,.436,8,35,.229,160,350,.457,.447,114,157,.726,120,158,278,113,52,66,80,94,458
2879,TOR,1999,Alvin Williams,24,50,45,1051,95,237,.401,14,42,.333,81,195,.415,.430,44,52,.846,19,63,82,130,51,12,56,94,248
2880,TOR,1999,John Wallace,24,48,3,812,153,354,.432,0,0,,153,354,.432,.432,105,150,.700,54,117,171,46,12,43,70,92,411
2881,TOR,1999,John Thomas,23,39,11,593,71,123,.577,0,1,.000,71,122,.582,.577,27,48,.563,65,69,134,15,17,9,21,82,169
2882,TOR,1999,Michael Stewart,23,42,2,394,22,53,.415,0,0,,22,53,.415,.415,17,25,.680,43,56,99,5,4,28,12,76,61
2883,TOR,1999,Reggie Slater,28,30,0,263,31,81,.383,0,0,,31,81,.383,.383,53,85,.624,36,34,70,5,3,3,25,50,115
2884,TOR,1999,Negele Knight,31,6,0,56,3,8,.375,0,1,.000,3,7,.429,.375,2,4,.500,1,5,6,8,1,0,7,5,8
2885,TOR,1999,Sean Marks,23,8,0,28,5,8,.625,0,0,,5,8,.625,.625,1,2,.500,0,1,1,0,1,0,3,3,11
2886,TOR,1999,Micheal Williams,32,2,0,15,1,5,.200,0,0,,1,5,.200,.200,0,0,,1,0,1,0,0,0,1,1,2
2887,TOR,1999,Mark Baker,29,1,0,2,0,1,.000,0,0,,0,1,.000,.000,0,0,,0,0,0,0,0,0,1,0,0
2888,TOR,1999,William Cunningham,24,1,0,1,0,0,,0,0,,0,0,,,0,0,,0,0,0,0,0,0,0,0,0
2889,TOR,1998,Doug Christie,27,78,78,2939,458,1071,.428,100,307,.326,358,764,.469,.474,271,327,.829,94,310,404,282,190,57,228,198,1287
2890,TOR,1998,John Wallace,23,82,36,2361,468,979,.478,1,2,.500,467,977,.478,.479,210,293,.717,117,256,373,110,62,101,172,239,1147
2891,TOR,1998,Damon Stoudamire,24,49,49,2033,354,833,.425,65,205,.317,289,628,.460,.464,179,212,.844,63,154,217,399,80,5,159,112,952
2892,TOR,1998,Marcus Camby,23,63,58,2002,308,747,.412,0,2,.000,308,745,.413,.412,149,244,.611,203,263,466,111,68,230,134,200,765
2893,TOR,1998,Reggie Slater,27,78,28,1662,211,459,.460,0,0,,211,459,.460,.460,203,322,.630,134,171,305,74,45,30,102,201,625
2894,TOR,1998,Oliver Miller,27,64,53,1628,170,369,.461,0,4,.000,170,365,.466,.461,61,101,.604,146,254,400,196,58,72,131,184,401
2895,TOR,1998,Tracy McGrady,18,64,17,1179,179,398,.450,14,41,.341,165,357,.462,.467,79,111,.712,105,164,269,98,49,61,66,86,451
2896,TOR,1998,Chauncey Billups,21,29,26,920,103,295,.349,43,136,.316,60,159,.377,.422,79,86,.919,22,55,77,97,30,2,56,54,328
2897,TOR,1998,Dee Brown,29,31,2,908,137,307,.446,65,158,.411,72,149,.483,.552,39,43,.907,14,76,90,101,38,17,41,47,378
2898,TOR,1998,Walt Williams,27,28,16,876,125,319,.392,49,129,.380,76,190,.400,.469,49,60,.817,27,91,118,69,40,23,52,100,348
2899,TOR,1998,Žan Tabak,27,39,29,752,116,249,.466,0,1,.000,116,248,.468,.466,16,48,.333,59,95,154,36,15,27,44,117,248
2900,TOR,1998,Shawn Respert,25,47,4,696,94,209,.450,25,67,.373,69,142,.486,.510,44,54,.815,30,43,73,44,29,1,33,58,257
2901,TOR,1998,Gary Trent,23,13,7,355,64,146,.438,0,3,.000,64,143,.448,.438,31,49,.633,43,61,104,14,8,8,22,46,159
2902,TOR,1998,Popeye Jones,27,14,4,352,52,127,.409,2,3,.667,50,124,.403,.417,14,19,.737,50,52,102,18,10,3,16,39,120
2903,TOR,1998,Carlos Rogers,26,18,0,351,45,87,.517,0,1,.000,45,86,.523,.517,18,32,.563,34,31,65,16,9,8,13,34,108
2904,TOR,1998,Chris Garner,22,38,0,293,23,70,.329,4,14,.286,19,56,.339,.357,3,7,.429,7,17,24,45,21,4,25,50,53
2905,TOR,1998,Alvin Williams,23,13,3,207,16,44,.364,2,4,.500,14,40,.350,.386,7,11,.636,5,16,21,20,8,1,8,19,41
2906,TOR,1998,John Thomas,22,21,0,167,14,33,.424,0,0,,14,33,.424,.424,15,21,.714,16,20,36,4,3,3,13,32,43
2907,TOR,1998,Lloyd Daniels,30,6,0,82,12,29,.414,2,9,.222,10,20,.500,.448,8,10,.800,4,3,7,4,3,2,4,4,34
2908,TOR,1998,Roy Rogers,24,6,0,69,6,17,.353,0,0,,6,17,.353,.353,1,4,.250,8,4,12,1,1,4,4,12,13
2909,TOR,1998,Sharone Wright,25,7,0,44,7,14,.500,0,0,,7,14,.500,.500,2,4,.500,1,8,9,4,0,0,2,7,16
2910,TOR,1998,Tim Kempton,34,5,0,32,2,7,.286,0,0,,2,7,.286,.286,0,0,,4,1,5,2,1,2,4,7,4
2911,TOR,1998,Ed Stokes,26,4,0,17,1,3,.333,0,0,,1,3,.333,.333,1,2,.500,1,3,4,1,1,2,2,4,3
2912,TOR,1998,Bob McCann,33,1,0,5,0,1,.000,0,0,,0,1,.000,.000,0,0,,0,1,1,0,0,0,0,1,0
2913,TOR,1997,Damon Stoudamire,23,81,81,3311,564,1407,.401,176,496,.355,388,911,.426,.463,330,401,.823,86,244,330,709,123,13,288,162,1634
2914,TOR,1997,Doug Christie,26,81,81,3127,396,949,.417,147,383,.384,249,566,.440,.495,237,306,.775,85,347,432,315,201,45,200,245,1176
2915,TOR,1997,Walt Williams,26,73,73,2647,419,982,.427,175,437,.400,244,545,.448,.516,186,243,.765,103,264,367,197,97,62,174,282,1199
2916,TOR,1997,Popeye Jones,26,79,61,2421,258,537,.480,1,13,.077,257,524,.490,.481,99,121,.818,270,410,680,84,58,39,116,269,616
2917,TOR,1997,Marcus Camby,22,63,38,1897,375,778,.482,2,14,.143,373,764,.488,.483,183,264,.693,131,263,394,97,66,130,134,214,935
2918,TOR,1997,Carlos Rogers,25,56,3,1397,212,404,.525,25,66,.379,187,338,.553,.556,102,170,.600,120,184,304,37,42,69,53,140,551
2919,TOR,1997,Sharone Wright,24,60,28,1009,161,403,.400,0,1,.000,161,402,.400,.400,68,133,.511,79,107,186,28,15,50,93,146,390
2920,TOR,1997,Clifford Rozier,24,41,29,732,79,173,.457,0,2,.000,79,171,.462,.457,31,61,.508,102,132,234,31,24,44,29,97,189
2921,TOR,1997,Hubert Davis,26,36,0,623,74,184,.402,16,70,.229,58,114,.509,.446,17,23,.739,11,29,40,34,11,2,21,40,181
2922,TOR,1997,Acie Earl,26,38,0,457,59,157,.376,0,5,.000,59,152,.388,.376,44,70,.629,33,52,85,18,12,27,33,54,162
2923,TOR,1997,Shawn Respert,24,27,0,412,53,120,.442,19,48,.396,34,72,.472,.521,27,32,.844,11,21,32,32,20,2,22,35,152
2924,TOR,1997,Reggie Slater,26,26,0,406,82,149,.550,0,2,.000,82,147,.558,.550,39,75,.520,40,55,95,21,9,6,29,34,203
2925,TOR,1997,John Long,40,32,0,370,46,117,.393,12,34,.353,34,83,.410,.444,25,28,.893,6,34,40,21,9,2,24,28,129
2926,TOR,1997,Oliver Miller,26,19,8,316,47,84,.560,0,1,.000,47,83,.566,.560,20,26,.769,23,50,73,29,13,13,20,48,114
2927,TOR,1997,Donald Whiteside,27,27,1,259,18,55,.327,12,36,.333,6,19,.316,.436,11,15,.733,2,10,12,36,11,0,17,23,59
2928,TOR,1997,Žan Tabak,26,13,4,218,32,71,.451,0,0,,32,71,.451,.451,20,29,.690,20,29,49,14,6,11,21,35,84
2929,TOR,1997,Martin Lewis,21,9,0,50,6,14,.429,1,3,.333,5,11,.455,.464,1,2,.500,4,2,6,4,1,2,1,8,14
2930,TOR,1997,Earl Cureton,39,9,0,46,3,8,.375,0,0,,3,8,.375,.375,1,3,.333,4,5,9,4,0,0,1,10,7
2931,TOR,1997,Brad Lohaus,32,6,0,45,4,15,.267,2,7,.286,2,8,.250,.333,0,0,,1,6,7,1,1,0,1,6,10
2932,TOR,1997,Benoit Benjamin,32,4,3,44,5,12,.417,0,0,,5,12,.417,.417,3,4,.750,3,6,9,1,1,0,2,5,13
2933,TOR,1997,Jimmy Oliver,27,4,0,43,4,13,.308,1,6,.167,3,7,.429,.346,2,2,1.000,1,4,5,1,2,0,3,2,11
2934,TOR,1996,Damon Stoudamire,22,70,70,2865,481,1129,.426,133,337,.395,348,792,.439,.485,236,296,.797,59,222,281,653,98,19,267,166,1331
2935,TOR,1996,Oliver Miller,25,76,72,2516,418,795,.526,0,11,.000,418,784,.533,.526,146,221,.661,177,385,562,219,108,143,202,277,982
2936,TOR,1996,Alvin Robertson,33,77,69,2478,285,607,.470,41,151,.272,244,456,.535,.503,107,158,.677,110,232,342,323,166,36,183,268,718
2937,TOR,1996,Tracy Murray,24,82,37,2458,496,1092,.454,151,358,.422,345,734,.470,.523,182,219,.831,114,238,352,131,87,40,132,208,1325
2938,TOR,1996,Willie Anderson,29,49,42,1564,232,527,.440,29,95,.305,203,432,.470,.468,113,132,.856,35,151,186,149,58,51,119,171,606
2939,TOR,1996,Žan Tabak,25,67,18,1332,225,414,.543,0,1,.000,225,413,.545,.543,64,114,.561,117,203,320,62,24,31,101,204,514
2940,TOR,1996,Carlos Rogers,24,56,18,1043,178,344,.517,3,21,.143,175,323,.542,.522,71,130,.546,80,90,170,35,25,48,61,87,430
2941,TOR,1996,Ed Pinckney,32,47,24,1031,117,233,.502,0,3,.000,117,230,.509,.502,94,124,.758,115,167,282,50,31,17,54,101,328
2942,TOR,1996,Jimmy King,22,62,1,868,110,255,.431,5,34,.147,105,221,.475,.441,54,77,.701,43,67,110,88,21,13,60,76,279
2943,TOR,1996,Doug Christie,25,32,17,818,115,264,.436,36,87,.414,79,177,.446,.504,56,71,.789,26,94,120,92,58,16,76,100,322
2944,TOR,1996,Tony Massenburg,28,24,20,659,100,196,.510,0,0,,100,196,.510,.510,43,65,.662,52,114,166,18,13,9,35,67,243
2945,TOR,1996,Acie Earl,25,42,7,655,117,276,.424,0,3,.000,117,273,.429,.424,82,114,.719,51,78,129,27,18,37,49,73,316
2946,TOR,1996,John Salley,31,25,6,482,51,105,.486,0,0,,51,105,.486,.486,47,65,.723,26,71,97,39,11,12,39,72,149
2947,TOR,1996,Sharone Wright,23,11,6,298,65,128,.508,1,3,.333,64,125,.512,.512,50,73,.685,24,33,57,11,6,10,28,38,181
2948,TOR,1996,Vincenzo Esposito,26,30,0,282,36,100,.360,13,56,.232,23,44,.523,.425,31,39,.795,4,12,16,23,7,0,39,27,116
2949,TOR,1996,Martin Lewis,20,16,0,189,29,60,.483,2,7,.286,27,53,.509,.500,15,25,.600,15,14,29,3,8,3,14,21,75
2950,TOR,1996,Dan O'Sullivan,27,5,2,139,13,35,.371,0,1,.000,13,34,.382,.371,7,8,.875,13,19,32,2,2,4,5,13,33
2951,TOR,1996,Dwayne Whitfield,23,8,1,122,13,30,.433,0,0,,13,30,.433,.433,14,22,.636,9,16,25,2,3,2,8,14,40
2952,TOR,1996,Herb Williams,37,1,0,31,3,8,.375,0,0,,3,8,.375,.375,0,0,,1,7,8,0,1,2,0,4,6
2953,PHI,2024,Tyrese Maxey,23,70,70,2626,638,1419,.450,212,569,.373,426,850,.501,.524,328,378,.868,36,222,258,433,69,33,116,151,1816
2954,PHI,2024,Tobias Harris,31,70,70,2368,463,951,.487,91,258,.353,372,693,.537,.535,187,213,.878,80,373,453,217,70,46,93,115,1204
2955,PHI,2024,Kelly Oubre Jr.,28,68,52,2055,387,878,.441,101,325,.311,286,553,.517,.498,174,232,.750,94,247,341,101,77,47,87,194,1049
2956,PHI,2024,Paul Reed,24,82,24,1590,259,480,.540,21,57,.368,238,423,.563,.561,61,85,.718,193,295,488,109,67,84,67,198,600
2957,PHI,2024,Nicolas Batum,35,57,38,1475,113,248,.456,71,178,.399,42,70,.600,.599,15,21,.714,70,171,241,123,45,34,39,104,312
2958,PHI,2024,Joel Embiid,29,39,39,1309,450,851,.529,54,139,.388,396,712,.556,.561,399,452,.883,95,335,430,219,46,66,150,112,1353
2959,PHI,2024,De'Anthony Melton,25,38,33,1023,139,360,.386,77,214,.360,62,146,.425,.493,66,79,.835,28,113,141,114,60,16,39,84,421
2960,PHI,2024,Patrick Beverley,35,47,5,919,104,241,.432,35,109,.321,69,132,.523,.504,51,63,.810,30,115,145,144,24,18,49,83,294
2961,PHI,2024,Buddy Hield,31,32,14,824,142,333,.426,82,211,.389,60,122,.492,.550,24,26,.923,27,75,102,97,27,11,41,66,390
2962,PHI,2024,Mo Bamba,25,57,17,740,97,198,.490,25,64,.391,72,134,.537,.553,34,50,.680,77,161,238,41,22,60,39,101,253
2963,PHI,2024,KJ Martin,23,58,2,715,93,171,.544,7,23,.304,86,148,.581,.564,21,39,.538,40,88,128,50,20,11,30,97,214
2964,PHI,2024,Kyle Lowry,37,23,20,653,60,135,.444,36,89,.404,24,46,.522,.578,28,33,.848,9,56,65,106,20,6,32,52,184
2965,PHI,2024,Marcus Morris,34,37,7,637,90,205,.439,36,90,.400,54,115,.470,.527,31,36,.861,18,91,109,26,13,11,19,61,247
2966,PHI,2024,Cameron Payne,29,31,8,602,107,259,.413,52,136,.382,55,123,.447,.514,21,23,.913,16,39,55,96,20,8,35,53,287
2967,PHI,2024,Danuel House Jr.,30,34,4,509,47,105,.448,15,50,.300,32,55,.582,.519,35,46,.761,16,42,58,28,15,5,19,45,144
2968,PHI,2024,Robert Covington,33,26,3,419,40,89,.449,17,48,.354,23,41,.561,.545,21,24,.875,29,60,89,17,33,16,11,49,118
2969,PHI,2024,Jaden Springer,21,32,1,377,46,118,.390,8,37,.216,38,81,.469,.424,28,34,.824,25,33,58,35,25,11,26,49,128
2970,PHI,2024,Furkan Korkmaz,26,35,0,300,30,76,.395,14,40,.350,16,36,.444,.487,14,20,.700,4,26,30,25,14,3,10,17,88
2971,PHI,2024,Ricky Council IV,22,32,0,289,54,112,.482,12,32,.375,42,80,.525,.536,53,71,.746,14,32,46,16,8,1,5,17,173
2972,PHI,2024,Jeff Dowtin,26,12,0,142,20,36,.556,9,19,.474,11,17,.647,.681,3,4,.750,3,17,20,27,7,1,5,1,52
2973,PHI,2024,Terquavion Smith,21,16,0,84,18,46,.391,13,35,.371,5,11,.455,.533,3,5,.600,0,4,4,12,8,0,7,8,52
2974,PHI,2024,P.J. Tucker,38,3,3,66,2,5,.400,2,5,.400,0,0,,.600,0,0,,1,13,14,0,3,2,2,9,6
2975,PHI,2024,Danny Green,36,2,0,18,0,2,.000,0,1,.000,0,1,.000,.000,0,0,,0,2,2,1,1,0,0,1,0
2976,PHI,2024,D.J. Wilson,27,2,0,15,4,6,.667,2,2,1.000,2,4,.500,.833,0,0,,1,1,2,2,0,2,0,1,10
2977,PHI,2024,Darius Bazley,23,3,0,10,0,1,.000,0,0,,0,1,.000,.000,0,0,,0,1,1,2,0,0,1,0,0
2978,PHI,2024,Kenneth Lofton Jr.,21,2,0,9,1,6,.167,0,2,.000,1,4,.250,.167,0,0,,0,3,3,0,0,0,2,0,2
2979,PHI,2024,Filip Petrušev,23,1,0,3,0,0,,0,0,,0,0,,,0,0,,0,1,1,0,0,0,0,0,0
2980,PHI,2024,Javonte Smart,24,1,0,1,0,0,,0,0,,0,0,,,0,0,,0,0,0,0,0,0,0,0,0
2981,PHI,2023,Tobias Harris,30,74,74,2436,423,845,.501,126,324,.389,297,521,.570,.575,113,129,.876,67,357,424,186,68,40,89,149,1085
2982,PHI,2023,Joel Embiid,28,66,66,2284,728,1328,.548,66,200,.330,662,1128,.587,.573,661,771,.857,113,557,670,274,66,112,226,205,2183
2983,PHI,2023,De'Anthony Melton,24,77,58,2150,277,651,.425,157,403,.390,120,248,.484,.546,69,87,.793,69,243,312,197,126,41,102,191,780
2984,PHI,2023,James Harden,33,58,58,2135,371,842,.441,161,418,.385,210,424,.495,.536,313,361,.867,40,314,354,618,71,31,195,112,1216
2985,PHI,2023,Tyrese Maxey,22,60,41,2016,439,913,.481,160,369,.434,279,544,.513,.568,180,213,.845,23,153,176,212,49,8,80,132,1218
2986,PHI,2023,P.J. Tucker,37,75,75,1920,96,225,.427,55,140,.393,41,85,.482,.549,19,23,.826,95,200,295,60,39,15,44,180,266
2987,PHI,2023,Shake Milton,26,76,11,1567,241,503,.479,56,148,.378,185,355,.521,.535,99,116,.853,39,152,191,240,25,13,94,123,637
2988,PHI,2023,Georges Niang,29,78,1,1512,222,502,.442,154,384,.401,68,118,.576,.596,39,45,.867,19,166,185,77,30,14,54,145,637
2989,PHI,2023,Danuel House Jr.,29,56,5,807,93,197,.472,37,110,.336,56,87,.644,.566,45,60,.750,9,85,94,44,14,9,26,69,268
2990,PHI,2023,Paul Reed,23,69,2,755,124,209,.593,1,6,.167,123,203,.606,.596,38,51,.745,112,150,262,27,46,51,45,123,287
2991,PHI,2023,Montrezl Harrell,29,57,7,681,125,209,.598,0,6,.000,125,203,.616,.598,70,101,.693,67,92,159,33,17,25,35,75,320
2992,PHI,2023,Matisse Thybulle,25,49,6,591,50,116,.431,21,63,.333,29,53,.547,.522,9,12,.750,20,43,63,23,45,14,8,65,130
2993,PHI,2023,Jalen McDaniels,25,24,3,419,60,123,.488,12,30,.400,48,93,.516,.537,28,34,.824,19,57,76,19,17,5,13,51,160
2994,PHI,2023,Furkan Korkmaz,25,37,0,353,48,111,.432,18,46,.391,30,65,.462,.514,26,36,.722,6,36,42,22,10,3,24,18,140
2995,PHI,2023,Jaden Springer,20,16,2,89,17,35,.486,2,5,.400,15,30,.500,.514,6,8,.750,6,8,14,8,7,3,3,15,42
2996,PHI,2023,Dewayne Dedmon,33,8,1,76,13,22,.591,1,2,.500,12,20,.600,.614,1,5,.200,6,19,25,10,2,5,6,14,28
2997,PHI,2023,Mac McClung,24,2,0,41,9,20,.450,4,11,.364,5,9,.556,.550,3,5,.600,3,7,10,9,0,0,3,3,25
2998,PHI,2023,Louis King,23,1,0,29,8,13,.615,4,8,.500,4,5,.800,.769,0,1,.000,2,2,4,2,1,0,2,4,20
2999,PHI,2023,Saben Lee,23,2,0,10,3,4,.750,0,1,.000,3,3,1.000,.750,0,0,,0,0,0,2,1,0,3,1,6
3000,PHI,2023,Julian Champagnie,21,2,0,7,0,2,.000,0,1,.000,0,1,.000,.000,0,0,,0,0,0,0,1,0,0,0,0
3001,PHI,2023,Michael Foster Jr.,20,1,0,1,0,0,,0,0,,0,0,,,0,0,,0,0,0,0,0,0,0,0,0
3002,PHI,2022,Tyrese Maxey,21,75,74,2650,483,995,.485,132,309,.427,351,686,.512,.552,213,246,.866,26,214,240,321,55,32,88,156,1311
3003,PHI,2022,Tobias Harris,29,73,73,2543,493,1022,.482,101,275,.367,392,747,.525,.532,170,202,.842,77,419,496,252,47,43,116,164,1257
3004,PHI,2022,Joel Embiid,27,68,68,2297,666,1334,.499,93,251,.371,573,1083,.529,.534,654,803,.814,146,650,796,284,77,99,214,181,2079
3005,PHI,2022,Georges Niang,28,76,7,1736,246,563,.437,156,387,.403,90,176,.511,.575,52,59,.881,25,178,203,102,30,13,59,190,700
3006,PHI,2022,Matisse Thybulle,24,66,50,1685,150,300,.500,45,144,.313,105,156,.673,.575,34,43,.791,42,109,151,75,115,71,39,158,379
3007,PHI,2022,Seth Curry,31,45,45,1566,256,528,.485,100,250,.400,156,278,.561,.580,64,73,.877,17,134,151,181,36,11,84,101,676
3008,PHI,2022,Furkan Korkmaz,24,67,19,1414,182,470,.387,77,266,.289,105,204,.515,.469,68,84,.810,22,153,175,127,33,9,48,58,509
3009,PHI,2022,Danny Green,34,62,28,1353,126,320,.394,103,271,.380,23,49,.469,.555,11,14,.786,32,125,157,64,60,37,45,105,366
3010,PHI,2022,Shake Milton,25,55,6,1179,173,403,.429,43,133,.323,130,270,.481,.483,61,73,.836,30,112,142,139,28,17,44,99,450
3011,PHI,2022,Andre Drummond,28,49,12,902,128,238,.538,0,2,.000,128,236,.542,.538,42,82,.512,136,297,433,97,56,45,79,121,298
3012,PHI,2022,James Harden,32,21,21,792,115,286,.402,46,141,.326,69,145,.476,.483,166,186,.892,13,136,149,220,26,5,72,48,442
3013,PHI,2022,Isaiah Joe,22,55,1,609,62,177,.350,45,135,.333,17,42,.405,.477,29,31,.935,6,50,56,35,14,3,19,47,198
3014,PHI,2022,Paul Reed,22,38,2,302,54,96,.563,2,8,.250,52,88,.591,.573,6,14,.429,44,48,92,16,33,14,10,57,116
3015,PHI,2022,DeAndre Jordan,33,16,1,214,32,54,.593,0,0,,32,54,.593,.593,10,14,.714,32,60,92,8,2,9,16,21,74
3016,PHI,2022,Charles Bassey,21,23,0,168,30,47,.638,0,4,.000,30,43,.698,.638,9,12,.750,22,40,62,7,5,17,8,32,69
3017,PHI,2022,Charlie Brown Jr.,24,19,2,162,9,34,.265,1,9,.111,8,25,.320,.279,9,10,.900,14,17,31,5,8,3,5,16,28
3018,PHI,2022,Paul Millsap,36,9,1,106,13,30,.433,2,8,.250,11,22,.500,.467,5,7,.714,12,13,25,5,5,2,8,19,33
3019,PHI,2022,Myles Powell,24,11,0,52,5,17,.294,1,6,.167,4,11,.364,.324,2,2,1.000,1,5,6,3,1,0,3,8,13
3020,PHI,2022,Tyler Johnson,29,3,0,38,4,10,.400,3,7,.429,1,3,.333,.550,0,0,,1,5,6,2,1,1,1,4,11
3021,PHI,2022,Aaron Henry,22,6,0,17,1,5,.200,0,1,.000,1,4,.250,.200,0,0,,0,1,1,0,0,2,2,2,2
3022,PHI,2022,Braxton Key,24,2,0,6,1,2,.500,0,1,.000,1,1,1.000,.500,0,0,,1,1,2,1,1,0,2,1,2
3023,PHI,2022,Jaden Springer,19,2,0,6,1,1,1.000,0,0,,1,1,1.000,1.000,0,0,,1,1,2,0,0,2,1,0,2
3024,PHI,2022,Willie Cauley-Stein,28,2,0,6,0,0,,0,0,,0,0,,,0,0,,0,2,2,1,0,0,0,2,0
3025,PHI,2021,Tobias Harris,28,62,62,2014,473,924,.512,82,208,.394,391,716,.546,.556,182,204,.892,62,357,419,220,55,51,107,119,1210
3026,PHI,2021,Danny Green,33,69,69,1934,224,544,.412,175,432,.405,49,112,.438,.573,31,40,.775,55,205,260,118,92,56,67,125,654
3027,PHI,2021,Ben Simmons,24,58,58,1877,325,583,.557,3,10,.300,322,573,.562,.560,176,287,.613,93,324,417,401,93,35,173,171,829
3028,PHI,2021,Seth Curry,30,57,57,1638,258,552,.467,126,280,.450,132,272,.485,.582,69,77,.896,10,126,136,155,44,8,65,96,711
3029,PHI,2021,Joel Embiid,26,51,51,1585,461,899,.513,58,154,.377,403,745,.541,.545,471,548,.859,113,426,539,145,50,69,159,123,1451
3030,PHI,2021,Shake Milton,24,63,4,1461,300,667,.450,71,203,.350,229,464,.494,.503,146,176,.830,33,115,148,193,39,18,103,130,817
3031,PHI,2021,Matisse Thybulle,23,65,8,1298,102,243,.420,43,143,.301,59,100,.590,.508,8,18,.444,30,94,124,63,105,71,32,127,255
3032,PHI,2021,Dwight Howard,35,69,6,1196,178,303,.587,5,20,.250,173,283,.611,.596,121,210,.576,190,390,580,61,30,62,112,200,482
3033,PHI,2021,Furkan Korkmaz,23,55,11,1062,170,424,.401,101,269,.375,69,155,.445,.520,60,82,.732,17,96,113,82,49,9,46,64,501
3034,PHI,2021,Tyrese Maxey,20,61,8,935,198,429,.462,31,103,.301,167,326,.512,.498,61,70,.871,11,93,104,120,26,13,41,79,488
3035,PHI,2021,Mike Scott,32,51,12,852,76,211,.360,53,155,.342,23,56,.411,.486,8,12,.667,11,109,120,40,24,14,19,72,213
3036,PHI,2021,Isaiah Joe,21,41,1,383,48,133,.361,39,106,.368,9,27,.333,.508,18,24,.750,6,30,36,20,12,4,11,34,153
3037,PHI,2021,George Hill,34,16,3,303,34,77,.442,9,23,.391,25,54,.463,.500,19,25,.760,8,24,32,30,11,3,19,19,96
3038,PHI,2021,Tony Bradley,23,20,8,287,51,75,.680,0,1,.000,51,74,.689,.680,7,11,.636,39,65,104,17,6,13,6,28,109
3039,PHI,2021,Paul Reed,21,26,0,177,42,78,.538,0,6,.000,42,72,.583,.538,4,8,.500,30,31,61,12,10,13,12,29,88
3040,PHI,2021,Dakota Mathias,25,8,2,123,19,48,.396,8,26,.308,11,22,.500,.479,2,6,.333,1,6,7,13,1,3,1,7,48
3041,PHI,2021,Anthony Tolliver,35,11,0,99,4,17,.235,4,14,.286,0,3,.000,.353,5,6,.833,3,7,10,2,3,2,3,7,17
3042,PHI,2021,Rayjon Tucker,23,14,0,68,9,18,.500,2,7,.286,7,11,.636,.556,14,19,.737,1,10,11,6,2,0,4,8,34
3043,PHI,2021,Terrance Ferguson,22,13,0,49,1,7,.143,0,5,.000,1,2,.500,.143,0,0,,0,1,1,2,1,0,4,7,2
3044,PHI,2021,Vincent Poirier,27,10,0,39,3,12,.250,0,1,.000,3,11,.273,.250,2,6,.333,6,8,14,2,0,3,4,8,8
3045,PHI,2021,Mason Jones,22,6,0,27,5,9,.556,1,2,.500,4,7,.571,.611,5,7,.714,3,1,4,3,1,0,1,2,16
3046,PHI,2021,Gary Clark,26,2,0,13,0,1,.000,0,0,,0,1,.000,.000,0,0,,0,2,2,1,1,0,0,1,0
3047,PHI,2021,Ignas Brazdeikis,22,1,0,8,0,3,.000,0,1,.000,0,2,.000,.000,0,0,,0,2,2,0,0,0,0,0,0
3048,PHI,2020,Tobias Harris,27,72,72,2469,553,1173,.471,131,357,.367,422,816,.517,.527,174,216,.806,69,426,495,227,53,40,104,165,1411
3049,PHI,2020,Al Horford,33,67,61,2025,319,709,.450,99,283,.350,220,426,.516,.520,61,80,.763,103,353,456,270,52,61,80,142,798
3050,PHI,2020,Ben Simmons,23,57,57,2017,375,647,.580,2,7,.286,373,640,.583,.581,185,298,.621,113,331,444,455,119,33,200,186,937
3051,PHI,2020,Josh Richardson,26,55,53,1693,278,646,.430,85,249,.341,193,397,.486,.496,114,141,.809,41,133,174,162,52,36,104,136,755
3052,PHI,2020,Furkan Korkmaz,22,72,12,1559,242,563,.430,143,356,.402,99,207,.478,.557,77,102,.755,18,150,168,79,41,16,59,98,704
3053,PHI,2020,Joel Embiid,25,51,51,1506,382,801,.477,57,172,.331,325,629,.517,.512,351,435,.807,141,452,593,152,45,65,159,174,1172
3054,PHI,2020,Matisse Thybulle,22,65,14,1287,112,265,.423,56,157,.357,56,108,.519,.528,25,41,.610,44,63,107,79,94,47,51,141,305
3055,PHI,2020,Mike Scott,31,68,11,1207,149,350,.426,80,217,.369,69,133,.519,.540,30,37,.811,65,183,248,56,21,5,26,96,408
3056,PHI,2020,Shake Milton,23,40,24,805,134,277,.484,58,135,.430,76,142,.535,.588,51,65,.785,15,73,88,104,20,7,47,92,377
3057,PHI,2020,James Ennis III,29,49,0,776,100,226,.442,37,106,.349,63,120,.525,.524,48,61,.787,48,102,150,41,23,14,31,85,285
3058,PHI,2020,Raul Neto,27,54,3,668,101,222,.455,34,88,.386,67,134,.500,.532,39,47,.830,11,50,61,95,24,6,47,50,275
3059,PHI,2020,Alec Burks,28,18,1,364,77,167,.461,32,77,.416,45,90,.500,.557,34,41,.829,11,45,56,38,12,0,15,21,220
3060,PHI,2020,Trey Burke,27,25,0,329,59,127,.465,16,38,.421,43,89,.483,.528,13,18,.722,15,20,35,53,7,1,12,21,147
3061,PHI,2020,Kyle O'Quinn,29,29,2,313,42,85,.494,7,27,.259,35,58,.603,.535,11,20,.550,34,82,116,51,7,24,20,37,102
3062,PHI,2020,Glenn Robinson III,26,14,4,270,44,85,.518,9,27,.333,35,58,.603,.571,11,12,.917,15,29,44,11,9,2,5,18,108
3063,PHI,2020,Norvel Pelle,26,24,0,232,25,48,.521,0,1,.000,25,47,.532,.521,7,14,.500,20,52,72,8,3,31,18,55,57
3064,PHI,2020,Zhaire Smith,20,7,0,32,3,11,.273,0,3,.000,3,8,.375,.273,2,4,.500,0,2,2,2,3,0,2,4,8
3065,PHI,2020,Marial Shayok,24,4,0,28,3,12,.250,2,6,.333,1,6,.167,.333,3,4,.750,1,6,7,1,0,1,3,4,11
3066,PHI,2020,Jonah Bolden,24,4,0,14,2,3,.667,0,1,.000,2,2,1.000,.667,0,2,.000,0,1,1,0,1,0,2,4,4
3067,PHI,2019,Ben Simmons,22,79,79,2700,540,960,.563,0,6,.000,540,954,.566,.563,257,428,.600,172,525,697,610,112,61,274,209,1337
3068,PHI,2019,JJ Redick,34,76,63,2379,452,1027,.440,240,605,.397,212,422,.502,.557,228,255,.894,20,166,186,206,32,17,101,129,1372
3069,PHI,2019,Joel Embiid,24,64,64,2154,580,1199,.484,79,263,.300,501,936,.535,.517,522,649,.804,160,711,871,234,46,122,226,211,1761
3070,PHI,2019,Jimmy Butler,29,55,55,1824,344,747,.461,50,148,.338,294,599,.491,.494,264,304,.868,105,185,290,220,99,29,81,93,1002
3071,PHI,2019,T.J. McConnell,26,76,3,1470,220,419,.525,14,42,.333,206,377,.546,.542,29,37,.784,28,146,174,258,79,17,91,105,483
3072,PHI,2019,Landry Shamet,21,54,4,1108,153,347,.441,99,245,.404,54,102,.529,.584,44,54,.815,14,64,78,59,24,8,26,106,449
3073,PHI,2019,Mike Muscala,27,47,6,1041,109,278,.392,68,199,.342,41,79,.519,.514,63,77,.818,51,149,200,62,18,27,43,112,349
3074,PHI,2019,Wilson Chandler,31,36,32,951,91,207,.440,46,118,.390,45,89,.506,.551,13,18,.722,44,124,168,72,22,18,39,94,241
3075,PHI,2019,Tobias Harris,26,27,27,944,187,399,.469,44,135,.326,143,264,.542,.524,74,88,.841,32,181,213,79,11,13,42,61,492
3076,PHI,2019,Furkan Korkmaz,21,48,7,679,98,245,.400,47,144,.326,51,101,.505,.496,36,44,.818,16,91,107,52,29,2,25,62,279
3077,PHI,2019,Mike Scott,30,27,3,647,76,190,.400,49,119,.412,27,71,.380,.529,10,15,.667,19,83,102,22,9,5,17,68,211
3078,PHI,2019,Jonah Bolden,23,44,10,639,80,162,.494,34,96,.354,46,66,.697,.599,13,27,.481,47,118,165,40,17,39,36,99,207
3079,PHI,2019,Amir Johnson,31,51,6,529,79,157,.503,12,40,.300,67,117,.573,.541,31,41,.756,47,100,147,60,16,13,45,99,201
3080,PHI,2019,Robert Covington,28,13,13,440,50,117,.427,30,77,.390,20,40,.500,.556,17,23,.739,7,60,67,14,24,23,22,45,147
3081,PHI,2019,Markelle Fultz,20,19,15,427,65,155,.419,4,14,.286,61,141,.433,.432,21,37,.568,26,44,70,59,17,5,25,52,155
3082,PHI,2019,Dario Šarić,24,13,13,396,48,132,.364,21,70,.300,27,62,.435,.443,27,30,.900,21,65,86,26,4,3,25,39,144
3083,PHI,2019,Boban Marjanović,30,22,3,305,75,120,.625,4,8,.500,71,112,.634,.642,26,36,.722,32,81,113,32,5,10,22,33,180
3084,PHI,2019,James Ennis III,28,18,2,281,34,83,.410,11,36,.306,23,47,.489,.476,16,23,.696,23,42,65,14,3,7,11,39,95
3085,PHI,2019,Shake Milton,22,20,0,268,34,87,.391,14,44,.318,20,43,.465,.471,5,7,.714,9,26,35,18,8,8,6,29,87
3086,PHI,2019,Jonathon Simmons,29,15,0,219,29,64,.453,9,21,.429,20,43,.465,.523,16,25,.640,4,22,26,33,11,1,12,21,83
3087,PHI,2019,Corey Brewer,32,7,3,140,20,49,.408,4,14,.286,16,35,.457,.449,9,13,.692,4,13,17,10,12,2,8,16,53
3088,PHI,2019,Zhaire Smith,19,6,2,111,14,34,.412,6,16,.375,8,18,.444,.500,6,8,.750,3,10,13,10,2,2,6,8,40
3089,PHI,2019,Greg Monroe,28,3,0,52,15,23,.652,1,1,1.000,14,22,.636,.674,10,11,.909,4,9,13,7,1,0,1,5,41
3090,PHI,2019,Haywood Highsmith,22,5,0,40,4,10,.400,1,5,.200,3,5,.600,.450,0,2,.000,0,5,5,2,1,0,1,1,9
3091,PHI,2019,Demetrius Jackson,24,6,0,39,8,15,.533,2,6,.333,6,9,.667,.600,4,4,1.000,2,1,3,5,2,0,1,4,22
3092,PHI,2019,Justin Patton,21,3,0,21,2,7,.286,0,2,.000,2,5,.400,.286,1,2,.500,2,4,6,3,2,0,0,5,5
3093,PHI,2018,Ben Simmons,21,81,81,2732,544,998,.545,0,11,.000,544,987,.551,.545,191,341,.560,145,514,659,661,140,70,278,211,1279
3094,PHI,2018,Robert Covington,27,80,80,2532,345,836,.413,203,550,.369,142,286,.497,.534,116,136,.853,55,378,433,156,137,72,126,238,1009
3095,PHI,2018,Dario Šarić,23,78,73,2310,403,890,.453,157,399,.393,246,491,.501,.541,178,207,.860,154,366,520,202,51,20,148,160,1141
3096,PHI,2018,JJ Redick,33,70,70,2116,404,879,.460,193,460,.420,211,419,.504,.569,197,218,.904,9,169,178,210,35,6,103,123,1198
3097,PHI,2018,Joel Embiid,23,63,63,1912,510,1056,.483,66,214,.308,444,842,.527,.514,359,467,.769,143,547,690,199,40,111,234,209,1445
3098,PHI,2018,T.J. McConnell,25,76,1,1706,210,421,.499,27,62,.435,183,359,.510,.531,31,39,.795,37,189,226,303,92,13,112,122,478
3099,PHI,2018,Amir Johnson,30,74,18,1171,140,260,.538,10,32,.313,130,228,.570,.558,52,85,.612,123,207,330,118,45,44,55,192,342
3100,PHI,2018,Jerryd Bayless,29,39,11,925,109,262,.416,54,146,.370,55,116,.474,.519,35,44,.795,15,65,80,54,23,6,46,91,307
3101,PHI,2018,Timothé Luwawu-Cabarrot,22,52,7,807,100,267,.375,53,158,.335,47,109,.431,.474,46,58,.793,14,58,72,54,12,5,38,97,299
3102,PHI,2018,Richaun Holmes,24,48,2,746,135,241,.560,4,31,.129,131,210,.624,.568,37,56,.661,57,154,211,61,20,29,25,97,311
3103,PHI,2018,Marco Belinelli,31,28,1,737,138,279,.495,57,148,.385,81,131,.618,.597,47,54,.870,6,45,51,45,20,9,40,50,380
3104,PHI,2018,Ersan İlyasova,30,23,3,554,93,212,.439,30,83,.361,63,129,.488,.509,33,45,.733,44,110,154,39,17,9,29,65,249
3105,PHI,2018,Justin Anderson,24,38,0,519,87,202,.431,34,103,.330,53,99,.535,.515,28,38,.737,25,68,93,25,15,7,16,54,236
3106,PHI,2018,Trevor Booker,30,33,0,494,61,109,.560,2,7,.286,59,102,.578,.569,32,39,.821,47,75,122,27,16,11,20,50,156
3107,PHI,2018,Markelle Fultz,19,14,0,253,45,111,.405,0,1,.000,45,110,.409,.405,10,21,.476,11,32,43,53,12,4,17,22,100
3108,PHI,2018,Furkan Korkmaz,20,14,0,80,8,28,.286,5,17,.294,3,11,.273,.375,2,4,.500,2,9,11,4,2,1,2,12,23
3109,PHI,2018,James Young,22,6,0,61,5,14,.357,3,10,.300,2,4,.500,.464,4,6,.667,0,2,2,2,0,0,1,4,17
3110,PHI,2018,Nik Stauskas,24,6,0,45,1,4,.250,0,1,.000,1,3,.333,.250,2,2,1.000,0,1,1,1,4,0,4,3,4
3111,PHI,2018,Jahlil Okafor,22,2,0,25,4,9,.444,0,0,,4,9,.444,.444,2,4,.500,4,5,9,1,0,2,3,7,10
3112,PHI,2018,James Michael McAdoo,25,3,0,18,2,7,.286,2,7,.286,0,0,,.429,2,2,1.000,0,2,2,0,0,1,1,1,8
3113,PHI,2018,Demetrius Jackson,23,3,0,17,3,4,.750,1,1,1.000,2,3,.667,.875,1,2,.500,1,0,1,4,1,0,1,1,8
3114,PHI,2018,Larry Drew II,27,3,0,15,1,7,.143,0,3,.000,1,4,.250,.143,0,0,,1,0,1,2,0,0,1,2,2
3115,PHI,2018,Jacob Pullen,28,3,0,6,1,2,.500,0,1,.000,1,1,1.000,.500,0,0,,0,0,0,0,0,0,1,0,2
3116,PHI,2017,Nik Stauskas,23,80,27,2188,251,634,.396,132,359,.368,119,275,.433,.500,122,150,.813,21,205,226,188,45,32,128,144,756
3117,PHI,2017,T.J. McConnell,24,81,51,2133,236,512,.461,11,55,.200,225,457,.492,.472,73,90,.811,39,212,251,534,134,10,159,139,556
3118,PHI,2017,Dario Šarić,22,81,36,2129,381,927,.411,106,341,.311,275,586,.469,.468,172,220,.782,112,401,513,182,57,30,183,162,1040
3119,PHI,2017,Robert Covington,26,67,67,2119,292,732,.399,137,412,.333,155,320,.484,.492,143,174,.822,92,344,436,102,127,69,131,203,864
3120,PHI,2017,Gerald Henderson,29,72,41,1667,234,553,.423,61,173,.353,173,380,.455,.478,133,165,.806,34,151,185,112,40,15,62,129,662
3121,PHI,2017,Sergio Rodríguez,30,68,30,1518,210,536,.392,92,252,.365,118,284,.415,.478,18,27,.667,21,136,157,344,49,4,128,95,530
3122,PHI,2017,Ersan İlyasova,29,53,40,1447,285,648,.440,107,298,.359,178,350,.509,.522,109,142,.768,71,243,314,97,33,14,78,133,786
3123,PHI,2017,Richaun Holmes,23,57,17,1193,230,412,.558,27,77,.351,203,335,.606,.591,72,103,.699,94,217,311,58,42,55,55,136,559
3124,PHI,2017,Timothé Luwawu-Cabarrot,21,69,19,1190,145,361,.402,50,161,.311,95,200,.475,.471,105,123,.854,25,124,149,75,32,10,73,154,445
3125,PHI,2017,Jahlil Okafor,21,50,33,1134,242,471,.514,0,0,,242,471,.514,.514,106,158,.671,81,159,240,58,20,49,91,122,590
3126,PHI,2017,Joel Embiid,22,31,31,786,200,429,.466,36,98,.367,164,331,.495,.508,191,244,.783,61,182,243,66,27,76,117,112,627
3127,PHI,2017,Nerlens Noel,22,29,7,564,107,175,.611,0,1,.000,107,174,.615,.611,43,63,.683,46,98,144,30,43,26,29,71,257
3128,PHI,2017,Hollis Thompson,25,31,1,561,66,159,.415,26,71,.366,40,88,.455,.497,13,20,.650,15,69,84,26,14,6,9,55,171
3129,PHI,2017,Justin Anderson,23,24,8,518,75,162,.463,21,72,.292,54,90,.600,.528,32,41,.780,30,66,96,34,13,7,26,45,203
3130,PHI,2017,Shawn Long,24,18,0,234,61,109,.560,7,19,.368,54,90,.600,.592,19,35,.543,41,44,85,13,9,9,13,49,148
3131,PHI,2017,Alex Poythress,23,6,1,157,25,54,.463,6,19,.316,19,35,.543,.519,8,10,.800,11,18,29,5,3,2,3,14,64
3132,PHI,2017,Tiago Splitter,32,8,0,76,14,31,.452,2,6,.333,12,25,.480,.484,9,11,.818,8,14,22,4,1,1,6,8,39
3133,PHI,2017,Chasson Randle,23,8,0,74,12,26,.462,6,15,.400,6,11,.545,.577,12,12,1.000,0,5,5,6,3,1,3,11,42
3134,PHI,2017,Jerryd Bayless,28,3,1,71,11,32,.344,2,5,.400,9,27,.333,.375,9,10,.900,3,9,12,13,0,0,9,4,33
3135,PHI,2017,Jerami Grant,22,2,0,41,6,17,.353,0,2,.000,6,15,.400,.353,4,8,.500,0,6,6,0,0,4,3,5,16
3136,PHI,2017,Justin Harper,27,3,0,31,5,12,.417,2,7,.286,3,5,.600,.500,0,0,,2,3,5,2,0,0,4,2,12
3137,PHI,2016,Hollis Thompson,24,77,17,2154,270,680,.397,149,392,.380,121,288,.420,.507,69,96,.719,54,218,272,99,36,24,76,187,758
3138,PHI,2016,Jerami Grant,21,77,52,2066,251,599,.419,35,146,.240,216,453,.477,.448,212,322,.658,99,262,361,135,54,127,110,215,749
3139,PHI,2016,Isaiah Canaan,24,77,39,1966,260,722,.360,176,485,.363,84,237,.354,.482,150,180,.833,20,154,174,137,56,12,91,133,846
3140,PHI,2016,Nerlens Noel,21,67,62,1965,306,587,.521,1,2,.500,305,585,.521,.522,134,227,.590,154,388,542,122,118,100,158,192,747
3141,PHI,2016,Robert Covington,25,67,49,1903,274,712,.385,170,482,.353,104,230,.452,.504,140,177,.791,65,354,419,97,105,40,143,232,858
3142,PHI,2016,Nik Stauskas,22,73,35,1809,210,545,.385,106,325,.326,104,220,.473,.483,91,118,.771,23,160,183,138,44,20,94,115,617
3143,PHI,2016,Ish Smith,27,50,50,1622,299,739,.405,46,137,.336,253,602,.420,.436,89,133,.669,29,184,213,348,64,18,130,95,733
3144,PHI,2016,T.J. McConnell,23,81,17,1606,218,464,.470,31,89,.348,187,375,.499,.503,26,41,.634,43,207,250,367,95,10,140,114,493
3145,PHI,2016,Jahlil Okafor,20,53,48,1591,397,781,.508,1,6,.167,396,775,.511,.509,133,194,.686,122,251,373,65,22,61,124,140,928
3146,PHI,2016,Richaun Holmes,22,51,1,702,114,222,.514,8,44,.182,106,178,.596,.532,51,74,.689,62,73,135,33,19,40,32,92,287
3147,PHI,2016,JaKarr Sampson,22,47,18,691,86,202,.426,6,34,.176,80,168,.476,.441,62,97,.639,30,99,129,30,11,16,51,91,240
3148,PHI,2016,Carl Landry,32,36,12,569,139,250,.556,6,13,.462,133,237,.561,.568,67,91,.736,49,97,146,32,12,9,22,69,351
3149,PHI,2016,Kendall Marshall,24,30,6,400,43,118,.364,16,49,.327,27,69,.391,.432,9,13,.692,2,26,28,73,16,2,43,30,111
3150,PHI,2016,Elton Brand,36,17,1,225,31,72,.431,0,1,.000,31,71,.437,.431,8,9,.889,9,54,63,18,9,8,11,32,70
3151,PHI,2016,Phil Pressey,24,14,0,170,21,55,.382,4,13,.308,17,42,.405,.418,9,18,.500,0,23,23,46,11,1,19,14,55
3152,PHI,2016,Christian Wood,20,17,0,145,22,53,.415,4,11,.364,18,42,.429,.453,13,21,.619,13,25,38,3,5,7,2,11,61
3153,PHI,2016,Tony Wroten,22,8,3,144,22,65,.338,3,17,.176,19,48,.396,.362,20,37,.541,2,19,21,20,3,0,29,11,67
3154,PHI,2016,Sonny Weems,29,7,0,78,7,21,.333,2,9,.222,5,12,.417,.381,1,2,.500,1,11,12,2,0,0,4,7,17
3155,PHI,2015,Nerlens Noel,20,75,71,2311,302,653,.462,0,0,,302,653,.462,.462,140,230,.609,185,426,611,128,133,142,146,208,744
3156,PHI,2015,Robert Covington,24,70,49,1956,299,756,.396,167,446,.374,132,310,.426,.506,178,217,.820,65,251,316,105,97,31,128,189,943
3157,PHI,2015,Luc Mbah a Moute,28,67,61,1916,251,636,.395,62,202,.307,189,434,.435,.443,96,163,.589,82,246,328,106,81,21,99,104,660
3158,PHI,2015,Hollis Thompson,23,71,23,1776,224,543,.413,115,287,.401,109,256,.426,.518,63,89,.708,53,145,198,85,57,26,66,141,626
3159,PHI,2015,Henry Sims,24,73,32,1399,238,502,.474,4,22,.182,234,480,.488,.478,106,137,.774,121,238,359,79,39,30,99,135,586
3160,PHI,2015,Michael Carter-Williams,23,41,38,1391,232,611,.380,32,125,.256,200,486,.412,.406,117,182,.643,43,211,254,302,60,18,174,103,613
3161,PHI,2015,Jerami Grant,20,65,11,1377,124,352,.352,49,156,.314,75,196,.383,.422,114,193,.591,49,149,198,79,40,68,85,144,411
3162,PHI,2015,K.J. McDaniels,21,52,15,1319,167,419,.399,43,147,.293,124,272,.456,.450,99,131,.756,64,131,195,70,44,68,104,121,476
3163,PHI,2015,JaKarr Sampson,21,74,32,1131,146,346,.422,31,127,.244,115,219,.525,.467,63,94,.670,35,128,163,77,38,26,76,135,386
3164,PHI,2015,Tony Wroten,21,30,15,895,175,434,.403,37,142,.261,138,292,.473,.446,120,180,.667,22,64,86,157,48,8,113,72,507
3165,PHI,2015,Ish Smith,26,25,14,677,128,322,.398,17,55,.309,111,267,.416,.424,28,48,.583,10,63,73,152,32,5,69,38,301
3166,PHI,2015,Isaiah Canaan,23,22,12,569,93,247,.377,59,162,.364,34,85,.400,.496,33,39,.846,7,47,54,69,15,3,39,55,278
3167,PHI,2015,Furkan Aldemir,23,41,9,540,40,78,.513,0,5,.000,40,73,.548,.513,13,27,.481,78,98,176,28,17,16,17,96,93
3168,PHI,2015,Jason Richardson,34,19,15,416,62,178,.348,31,96,.323,31,82,.378,.435,17,22,.773,13,53,66,38,13,3,16,28,172
3169,PHI,2015,Thomas Robinson,23,22,0,407,79,169,.467,0,2,.000,79,167,.473,.467,35,58,.603,62,108,170,24,16,9,26,50,193
3170,PHI,2015,Brandon Davies,23,20,6,379,49,119,.412,7,30,.233,42,89,.472,.441,21,33,.636,35,38,73,28,17,4,25,54,126
3171,PHI,2015,Alexey Shved,26,17,0,285,52,130,.400,17,57,.298,35,73,.479,.465,48,57,.842,8,14,22,46,14,1,18,21,169
3172,PHI,2015,Larry Drew II,24,12,1,219,20,58,.345,4,26,.154,16,32,.500,.379,2,3,.667,1,14,15,45,6,0,25,13,46
3173,PHI,2015,Malcolm Thomas,26,17,0,194,18,40,.450,0,7,.000,18,33,.545,.450,9,13,.692,16,40,56,7,3,1,13,17,45
3174,PHI,2015,Chris Johnson,24,9,2,187,19,60,.317,10,39,.256,9,21,.429,.400,6,8,.750,3,23,26,3,9,5,9,19,54
3175,PHI,2015,Tim Frazier,24,6,3,171,13,43,.302,3,11,.273,10,32,.313,.337,5,15,.333,4,15,19,43,6,0,18,16,34
3176,PHI,2015,Glenn Robinson III,21,10,1,153,18,43,.419,4,13,.308,14,30,.467,.465,4,8,.500,11,14,25,8,3,1,8,10,44
3177,PHI,2015,Drew Gordon,24,9,0,71,8,19,.421,0,3,.000,8,16,.500,.421,1,2,.500,7,11,18,2,1,0,8,7,17
3178,PHI,2015,JaVale McGee,27,6,0,61,8,18,.444,0,0,,8,18,.444,.444,2,4,.500,4,9,13,2,0,1,5,2,18
3179,PHI,2015,Malcolm Lee,24,1,0,2,0,1,.000,0,0,,0,1,.000,.000,0,0,,0,0,0,0,0,0,0,0,0
3180,PHI,2014,Thaddeus Young,25,79,78,2718,582,1283,.454,90,292,.308,492,991,.496,.489,163,229,.712,166,310,476,182,167,36,165,213,1417
3181,PHI,2014,Michael Carter-Williams,22,70,70,2414,427,1054,.405,55,208,.264,372,846,.440,.431,258,367,.703,101,336,437,441,130,43,247,213,1167
3182,PHI,2014,James Anderson,24,80,62,2309,309,717,.431,115,351,.328,194,366,.530,.511,77,106,.726,59,241,300,149,74,28,106,154,810
3183,PHI,2014,Evan Turner,25,54,54,1886,356,831,.428,38,132,.288,318,699,.455,.451,189,228,.829,50,272,322,198,56,5,155,147,939
3184,PHI,2014,Tony Wroten,20,72,16,1765,345,808,.427,40,188,.213,305,620,.492,.452,209,326,.641,69,159,228,217,78,16,204,151,939
3185,PHI,2014,Hollis Thompson,22,77,41,1742,171,372,.460,67,167,.401,104,205,.507,.550,52,73,.712,73,174,247,73,53,12,60,144,461
3186,PHI,2014,Spencer Hawes,25,53,53,1666,264,586,.451,81,203,.399,183,383,.478,.520,79,101,.782,88,364,452,176,31,67,119,154,688
3187,PHI,2014,Elliot Williams,24,67,2,1157,140,337,.415,37,125,.296,103,212,.486,.470,87,119,.731,30,100,130,72,35,3,68,126,404
3188,PHI,2014,Lavoy Allen,24,51,2,960,117,266,.440,2,13,.154,115,253,.455,.444,27,40,.675,106,171,277,65,22,27,40,115,263
3189,PHI,2014,Henry Sims,23,26,25,707,112,229,.489,0,1,.000,112,228,.491,.489,82,107,.766,82,99,181,47,23,13,33,84,306
3190,PHI,2014,Brandon Davies,22,51,0,575,54,128,.422,2,10,.200,52,118,.441,.430,34,53,.642,38,71,109,28,24,8,35,92,144
3191,PHI,2014,Jarvis Varnado,25,23,0,337,36,60,.600,0,0,,36,60,.600,.600,27,52,.519,19,44,63,13,10,29,10,61,99
3192,PHI,2014,Daniel Orton,23,22,4,251,21,47,.447,0,0,,21,47,.447,.447,23,30,.767,16,45,61,15,6,16,18,38,65
3193,PHI,2014,Byron Mullens,24,18,0,247,47,101,.465,20,50,.400,27,51,.529,.564,8,14,.571,17,43,60,8,9,8,14,31,122
3194,PHI,2014,Lorenzo Brown,23,26,0,224,26,86,.302,3,30,.100,23,56,.411,.320,9,13,.692,8,20,28,41,13,3,16,19,64
3195,PHI,2014,Darius Morris,23,12,0,193,29,67,.433,10,24,.417,19,43,.442,.507,15,21,.714,3,10,13,31,8,0,19,21,83
3196,PHI,2014,Arnett Moultrie,23,12,2,187,16,38,.421,0,0,,16,38,.421,.421,4,5,.800,11,24,35,2,8,4,7,22,36
3197,PHI,2014,Dewayne Dedmon,24,11,0,150,15,29,.517,0,0,,15,29,.517,.517,7,13,.538,11,38,49,3,0,9,9,28,37
3198,PHI,2014,Casper Ware,24,9,0,116,18,42,.429,7,21,.333,11,21,.524,.512,5,6,.833,0,9,9,10,8,0,5,11,48
3199,PHI,2014,Eric Maynor,26,8,0,112,11,29,.379,4,12,.333,7,17,.412,.448,4,8,.500,2,13,15,12,4,2,12,4,30
3200,PHI,2014,James Nunnally,23,9,0,111,9,28,.321,5,15,.333,4,13,.308,.411,3,5,.600,0,11,11,6,5,1,3,9,26
3201,PHI,2014,Darius Johnson-Odom,24,3,0,15,0,7,.000,0,3,.000,0,4,.000,.000,0,2,.000,0,2,2,1,1,0,2,3,0
3202,PHI,2014,Adonis Thomas,20,2,1,13,3,5,.600,1,2,.500,2,3,.667,.700,0,0,,0,0,0,1,0,0,1,4,7
3203,PHI,2013,Jrue Holiday,22,78,78,2926,555,1288,.431,91,247,.368,464,1041,.446,.466,182,242,.752,89,240,329,625,123,32,292,170,1383
3204,PHI,2013,Evan Turner,24,82,82,2892,441,1053,.419,58,159,.365,383,894,.428,.446,154,208,.740,56,461,517,354,71,17,187,197,1094
3205,PHI,2013,Thaddeus Young,24,76,76,2629,509,958,.531,1,8,.125,508,950,.535,.532,108,188,.574,182,389,571,125,133,55,90,191,1127
3206,PHI,2013,Spencer Hawes,24,82,40,2233,376,811,.464,31,87,.356,345,724,.477,.483,122,157,.777,173,417,590,183,24,113,131,233,905
3207,PHI,2013,Dorell Wright,27,79,8,1783,237,599,.396,135,361,.374,102,238,.429,.508,120,141,.851,42,260,302,150,62,35,64,98,729
3208,PHI,2013,Lavoy Allen,23,79,37,1669,206,454,.454,0,1,.000,206,453,.455,.454,43,60,.717,159,236,395,73,24,55,55,180,455
3209,PHI,2013,Nick Young,27,59,17,1411,224,542,.413,75,210,.357,149,332,.449,.482,105,128,.820,24,106,130,84,36,14,50,84,628
3210,PHI,2013,Damien Wilkins,33,61,21,1095,145,316,.459,17,51,.333,128,265,.483,.486,81,109,.743,32,73,105,91,37,18,49,98,388
3211,PHI,2013,Jason Richardson,32,33,33,936,135,336,.402,57,167,.341,78,169,.462,.487,20,33,.606,19,108,127,51,40,15,26,57,347
3212,PHI,2013,Royal Ivey,31,53,5,698,62,144,.431,37,88,.420,25,56,.446,.559,9,16,.563,16,41,57,32,23,3,20,73,170
3213,PHI,2013,Arnett Moultrie,22,47,0,542,78,134,.582,0,0,,78,134,.582,.582,18,28,.643,76,69,145,10,17,10,19,43,174
3214,PHI,2013,Kwame Brown,30,22,11,269,17,37,.459,0,0,,17,37,.459,.459,7,19,.368,23,51,74,9,6,10,8,37,41
3215,PHI,2013,Jeremy Pargo,26,14,0,208,24,63,.381,7,17,.412,17,46,.370,.437,14,21,.667,1,16,17,28,1,0,13,14,69
3216,PHI,2013,Maalik Wayns,21,21,1,165,19,72,.264,5,25,.200,14,47,.298,.299,13,15,.867,1,4,5,20,3,0,13,18,56
3217,PHI,2013,Charles Jenkins,23,12,1,150,14,38,.368,0,0,,14,38,.368,.368,2,4,.500,3,8,11,16,6,1,2,4,30
3218,PHI,2013,Justin Holiday,23,9,0,142,16,48,.333,4,16,.250,12,32,.375,.375,6,8,.750,0,14,14,15,3,6,9,7,42
3219,PHI,2013,Shelvin Mack,22,4,0,7,1,2,.500,0,1,.000,1,1,1.000,.500,0,0,,0,0,0,1,0,0,2,1,2
3220,PHI,2012,Andre Iguodala,28,62,62,2209,287,632,.454,76,193,.394,211,439,.481,.514,121,196,.617,56,325,381,339,107,30,115,92,771
3221,PHI,2012,Jrue Holiday,21,65,65,2196,360,834,.432,65,171,.380,295,663,.445,.471,94,120,.783,57,155,212,290,103,18,135,137,879
3222,PHI,2012,Thaddeus Young,23,63,1,1755,348,687,.507,1,4,.250,347,683,.508,.507,111,144,.771,137,188,325,74,64,41,55,127,808
3223,PHI,2012,Elton Brand,32,60,60,1732,287,581,.494,0,1,.000,287,580,.495,.494,85,116,.733,145,284,429,97,58,97,65,176,659
3224,PHI,2012,Evan Turner,23,65,20,1713,263,590,.446,11,49,.224,252,541,.466,.455,73,108,.676,27,349,376,180,40,20,105,117,610
3225,PHI,2012,Lou Williams,25,64,0,1682,318,782,.407,83,229,.362,235,553,.425,.460,237,292,.812,30,125,155,221,53,18,71,90,956
3226,PHI,2012,Jodie Meeks,24,66,50,1644,191,467,.409,97,266,.365,94,201,.468,.513,77,85,.906,17,144,161,54,40,3,29,82,556
3227,PHI,2012,Spencer Hawes,23,37,29,920,156,319,.489,3,12,.250,153,307,.498,.494,40,55,.727,78,192,270,98,16,48,55,100,355
3228,PHI,2012,Nikola Vučević,21,51,15,812,131,291,.450,3,8,.375,128,283,.452,.455,18,34,.529,88,158,246,31,20,34,33,111,283
3229,PHI,2012,Lavoy Allen,22,41,15,624,79,167,.473,0,0,,79,167,.473,.473,11,14,.786,47,124,171,34,13,18,20,73,169
3230,PHI,2012,Tony Battie,35,27,11,295,19,51,.373,0,1,.000,19,50,.380,.373,4,4,1.000,8,59,67,16,4,6,4,26,42
3231,PHI,2012,Sam Young,26,14,0,135,13,44,.295,5,8,.625,8,36,.222,.352,9,14,.643,6,15,21,6,6,4,7,11,40
3232,PHI,2012,Craig Brackins,24,14,1,88,9,33,.273,3,9,.333,6,24,.250,.318,1,2,.500,5,10,15,8,0,1,4,6,22
3233,PHI,2012,Andrés Nocioni,32,11,1,56,5,20,.250,1,6,.167,4,14,.286,.275,6,11,.545,1,13,14,1,1,1,5,4,17
3234,PHI,2012,Xavier Silas,24,2,0,39,4,15,.267,1,6,.167,3,9,.333,.300,2,3,.667,2,2,4,3,0,0,3,5,11
3235,PHI,2012,Francisco Elson,35,5,0,16,1,3,.333,0,0,,1,3,.333,.333,0,0,,0,1,1,1,1,1,1,0,2
3236,PHI,2011,Jrue Holiday,20,82,82,2901,446,999,.446,81,222,.365,365,777,.470,.487,172,209,.823,68,264,332,531,120,29,218,203,1145
3237,PHI,2011,Elton Brand,31,81,81,2809,502,981,.512,0,1,.000,502,980,.512,.512,213,273,.780,237,439,676,120,92,106,101,244,1217
3238,PHI,2011,Andre Iguodala,27,67,67,2469,338,759,.445,61,181,.337,277,578,.479,.486,208,300,.693,61,326,387,422,101,38,138,109,945
3239,PHI,2011,Thaddeus Young,22,82,1,2135,458,847,.541,6,22,.273,452,825,.548,.544,123,174,.707,153,281,434,82,90,26,99,170,1045
3240,PHI,2011,Jodie Meeks,23,74,64,2062,242,570,.425,138,348,.397,104,222,.468,.546,152,170,.894,21,150,171,78,63,4,60,97,774
3241,PHI,2011,Evan Turner,22,78,14,1797,225,529,.425,14,44,.318,211,485,.435,.439,101,125,.808,42,264,306,159,49,14,80,138,565
3242,PHI,2011,Lou Williams,24,75,0,1747,323,795,.406,88,253,.348,235,542,.434,.462,293,356,.823,32,117,149,252,47,17,102,128,1027
3243,PHI,2011,Spencer Hawes,22,81,81,1718,264,568,.465,9,37,.243,255,531,.480,.473,47,88,.534,129,336,465,121,29,71,97,201,584
3244,PHI,2011,Andrés Nocioni,31,54,17,931,118,277,.426,42,118,.356,76,159,.478,.502,49,61,.803,19,150,169,45,14,15,47,100,327
3245,PHI,2011,Marreese Speights,23,64,1,734,144,291,.495,1,4,.250,143,287,.498,.497,55,73,.753,64,146,210,30,8,19,40,120,344
3246,PHI,2011,Tony Battie,34,38,0,377,45,96,.469,2,3,.667,43,93,.462,.479,8,14,.571,17,82,99,12,5,15,12,59,100
3247,PHI,2011,Jason Kapono,29,24,2,112,7,28,.250,1,8,.125,6,20,.300,.268,1,2,.500,3,8,11,4,2,1,2,4,16
3248,PHI,2011,Darius Songaila,32,10,0,71,7,15,.467,0,0,,7,15,.467,.467,2,4,.500,2,8,10,2,0,0,4,16,16
3249,PHI,2011,Antonio Daniels,35,4,0,35,2,5,.400,0,2,.000,2,3,.667,.400,2,2,1.000,0,5,5,2,0,0,1,0,6
3250,PHI,2011,Craig Brackins,23,3,0,33,4,16,.250,0,5,.000,4,11,.364,.250,0,0,,2,2,4,1,1,0,0,3,8
3251,PHI,2010,Andre Iguodala,26,82,82,3193,496,1120,.443,94,303,.310,402,817,.492,.485,315,430,.733,82,447,529,472,141,55,218,145,1401
3252,PHI,2010,Elton Brand,30,76,57,2297,412,858,.480,0,1,.000,412,857,.481,.480,172,233,.738,179,282,461,109,82,80,131,232,996
3253,PHI,2010,Thaddeus Young,21,67,45,2145,382,813,.470,48,138,.348,334,675,.495,.499,114,165,.691,130,220,350,97,81,15,126,133,926
3254,PHI,2010,Samuel Dalembert,28,82,80,2124,285,523,.545,0,0,,285,523,.545,.545,97,133,.729,239,545,784,64,42,151,123,252,667
3255,PHI,2010,Lou Williams,23,64,38,1912,318,677,.470,70,206,.340,248,471,.527,.521,192,233,.824,25,162,187,268,80,15,106,110,898
3256,PHI,2010,Jrue Holiday,19,73,51,1767,230,520,.442,62,159,.390,168,361,.465,.502,65,86,.756,56,135,191,280,79,18,156,153,587
3257,PHI,2010,Willie Green,28,73,18,1553,248,543,.457,47,136,.346,201,407,.494,.500,95,114,.833,20,109,129,152,32,11,67,135,638
3258,PHI,2010,Marreese Speights,22,62,1,1016,212,444,.477,0,5,.000,212,439,.483,.477,108,145,.745,85,167,252,36,29,34,51,152,532
3259,PHI,2010,Jason Kapono,28,57,12,976,126,301,.419,63,171,.368,63,130,.485,.523,9,15,.600,14,52,66,39,21,6,34,80,324
3260,PHI,2010,Rodney Carney,25,68,0,857,113,282,.401,41,135,.304,72,147,.490,.473,52,63,.825,26,111,137,37,25,20,21,79,319
3261,PHI,2010,Allen Iverson,34,25,24,798,121,290,.417,8,24,.333,113,266,.425,.431,98,119,.824,15,60,75,102,18,2,57,43,348
3262,PHI,2010,Jason Smith,23,56,2,658,75,174,.431,10,29,.345,65,145,.448,.460,29,42,.690,54,81,135,33,21,28,35,110,189
3263,PHI,2010,Royal Ivey,28,26,0,236,26,55,.473,12,24,.500,14,31,.452,.582,6,7,.857,5,21,26,17,10,2,5,25,70
3264,PHI,2010,Jodie Meeks,22,19,0,233,40,91,.440,19,50,.380,21,41,.512,.544,13,18,.722,4,23,27,17,5,1,5,19,112
3265,PHI,2010,Primož Brezec,30,7,0,36,2,13,.154,0,0,,2,13,.154,.154,1,2,.500,6,6,12,0,1,1,0,9,5
3266,PHI,2010,Francisco Elson,33,1,0,4,1,2,.500,0,0,,1,2,.500,.500,0,3,.000,1,0,1,0,0,0,0,0,2
3267,PHI,2009,Andre Iguodala,25,82,82,3269,542,1147,.473,80,261,.307,462,886,.521,.507,377,521,.724,92,379,471,434,131,36,222,152,1541
3268,PHI,2009,Andre Miller,32,82,82,2976,492,1041,.473,15,53,.283,477,988,.483,.480,338,409,.826,123,245,368,534,109,14,199,196,1337
3269,PHI,2009,Thaddeus Young,20,75,71,2580,475,960,.495,56,164,.341,419,796,.526,.524,139,189,.735,139,238,377,86,100,23,118,165,1145
3270,PHI,2009,Samuel Dalembert,27,82,82,2036,216,434,.498,0,2,.000,216,432,.500,.498,91,124,.734,214,487,701,18,33,146,117,248,523
3271,PHI,2009,Lou Williams,22,81,0,1919,336,844,.398,63,220,.286,273,624,.438,.435,304,385,.790,36,129,165,242,85,14,151,128,1039
3272,PHI,2009,Willie Green,27,81,60,1828,286,658,.435,51,161,.317,235,497,.473,.473,62,85,.729,29,97,126,158,53,13,64,154,685
3273,PHI,2009,Marreese Speights,21,79,2,1263,252,502,.502,2,8,.250,250,494,.506,.504,102,132,.773,123,170,293,30,27,56,46,181,608
3274,PHI,2009,Reggie Evans,28,79,7,1137,79,178,.444,0,1,.000,79,177,.446,.444,104,175,.594,135,226,361,26,41,8,69,161,262
3275,PHI,2009,Elton Brand,29,29,23,920,163,365,.447,0,0,,163,365,.447,.447,73,108,.676,77,177,254,37,17,45,68,78,399
3276,PHI,2009,Royal Ivey,27,71,0,861,69,208,.332,39,114,.342,30,94,.319,.425,34,43,.791,19,57,76,43,36,7,23,76,211
3277,PHI,2009,Theo Ratliff,35,46,0,579,34,64,.531,0,0,,34,64,.531,.531,21,35,.600,46,82,128,9,17,47,14,77,89
3278,PHI,2009,Kareem Rush,28,25,1,199,20,58,.345,10,33,.303,10,25,.400,.431,4,4,1.000,0,15,15,15,5,1,10,10,54
3279,PHI,2009,Donyell Marshall,35,25,0,189,33,73,.452,25,55,.455,8,18,.444,.623,3,6,.500,6,34,40,15,4,5,6,24,94
3280,PHI,2008,Andre Iguodala,24,82,82,3242,582,1277,.456,101,307,.329,481,970,.496,.495,365,506,.721,85,361,446,391,171,49,214,187,1630
3281,PHI,2008,Andre Miller,31,82,82,3016,569,1156,.492,3,34,.088,566,1122,.504,.494,257,333,.772,95,229,324,565,105,6,206,181,1398
3282,PHI,2008,Samuel Dalembert,26,82,82,2724,339,661,.513,0,1,.000,339,660,.514,.513,186,263,.707,304,545,849,45,40,192,155,269,864
3283,PHI,2008,Willie Green,26,74,74,1970,379,870,.436,51,179,.285,328,691,.475,.465,112,148,.757,32,150,182,151,54,22,109,119,921
3284,PHI,2008,Reggie Evans,27,81,61,1879,152,346,.439,1,1,1.000,151,345,.438,.441,120,257,.467,224,387,611,65,86,8,108,213,425
3285,PHI,2008,Lou Williams,21,80,0,1862,319,752,.424,55,153,.359,264,599,.441,.461,227,290,.783,41,126,167,253,81,13,125,130,920
3286,PHI,2008,Thaddeus Young,19,74,22,1554,264,490,.539,6,19,.316,258,471,.548,.545,76,103,.738,120,192,312,58,73,8,64,126,610
3287,PHI,2008,Jason Smith,21,76,1,1107,141,310,.455,4,14,.286,137,296,.463,.461,54,82,.659,77,153,230,20,22,50,48,142,340
3288,PHI,2008,Rodney Carney,23,70,6,1039,158,392,.403,38,120,.317,120,272,.441,.452,55,81,.679,50,99,149,32,39,23,34,96,409
3289,PHI,2008,Kyle Korver,26,25,0,657,90,227,.396,38,108,.352,52,119,.437,.480,31,34,.912,12,61,73,33,20,6,28,67,249
3290,PHI,2008,Kevin Ollie,35,40,0,300,29,69,.420,0,1,.000,29,68,.426,.420,12,15,.800,4,15,19,38,10,0,5,28,70
3291,PHI,2008,Calvin Booth,31,31,0,204,9,27,.333,0,0,,9,27,.333,.333,6,10,.600,6,32,38,8,6,18,4,35,24
3292,PHI,2008,Gordan Giriček,30,12,0,110,13,41,.317,5,15,.333,8,26,.308,.378,6,8,.750,1,13,14,11,3,1,8,9,37
3293,PHI,2008,Lou Amundson,25,16,0,64,8,16,.500,0,0,,8,16,.500,.500,2,7,.286,7,5,12,0,1,1,2,13,18
3294,PHI,2008,Shavlik Randolph,24,9,0,27,4,14,.286,0,0,,4,14,.286,.286,0,0,,9,2,11,3,1,3,2,5,8
3295,PHI,2007,Andre Iguodala,23,76,76,3062,443,991,.447,48,155,.310,395,836,.472,.471,452,551,.820,77,357,434,432,152,33,261,200,1386
3296,PHI,2007,Samuel Dalembert,25,82,82,2535,356,658,.541,0,2,.000,356,656,.543,.541,167,224,.746,239,494,733,64,47,159,161,287,879
3297,PHI,2007,Kyle Korver,25,74,1,2288,372,845,.440,132,307,.430,240,538,.446,.518,191,209,.914,30,229,259,105,57,20,117,188,1067
3298,PHI,2007,Andre Miller,30,57,56,2144,307,661,.464,1,19,.053,306,642,.477,.465,160,198,.808,72,176,248,416,73,6,152,126,775
3299,PHI,2007,Willie Green,25,74,36,1842,357,868,.411,51,157,.325,306,711,.430,.441,74,111,.667,42,116,158,112,56,4,106,144,839
3300,PHI,2007,Steven Hunter,25,70,41,1605,188,326,.577,0,0,,188,326,.577,.577,74,151,.490,114,221,335,26,13,76,65,137,450
3301,PHI,2007,Joe Smith,31,54,11,1355,191,429,.445,0,4,.000,191,425,.449,.445,115,136,.846,107,253,360,46,31,20,63,125,497
3302,PHI,2007,Rodney Carney,22,67,35,1169,182,392,.464,25,72,.347,157,320,.491,.496,53,87,.609,39,89,128,26,38,23,43,118,442
3303,PHI,2007,Kevin Ollie,34,53,23,919,81,187,.433,0,2,.000,81,185,.438,.433,37,45,.822,8,66,74,130,21,1,47,76,199
3304,PHI,2007,Lou Williams,20,61,0,688,93,211,.441,12,37,.324,81,174,.466,.469,64,92,.696,17,53,70,110,22,1,46,42,262
3305,PHI,2007,Allen Iverson,31,15,15,640,151,366,.413,12,53,.226,139,313,.444,.429,154,174,.885,7,34,41,109,33,1,66,21,468
3306,PHI,2007,Chris Webber,33,18,18,544,89,230,.387,2,5,.400,87,225,.387,.391,18,28,.643,37,112,149,61,18,15,33,36,198
3307,PHI,2007,Alan Henderson,34,38,5,418,43,67,.642,0,0,,43,67,.642,.642,33,47,.702,48,59,107,10,9,12,12,62,119
3308,PHI,2007,Bobby Jones,23,44,5,336,43,93,.462,1,9,.111,42,84,.500,.468,23,41,.561,22,35,57,16,11,1,18,59,110
3309,PHI,2007,Shavlik Randolph,23,13,6,179,23,48,.479,0,0,,23,48,.479,.479,12,22,.545,19,35,54,4,7,10,9,23,58
3310,PHI,2007,Lou Amundson,24,10,0,87,6,15,.400,0,0,,6,15,.400,.400,4,10,.400,13,15,28,1,1,8,5,15,16
3311,PHI,2007,Ivan McFarlin,24,11,0,41,5,13,.385,0,1,.000,5,12,.417,.385,5,7,.714,7,4,11,1,0,0,1,8,15
3312,PHI,2007,Steven Smith,23,8,0,28,2,8,.250,0,0,,2,8,.250,.250,1,2,.500,1,5,6,0,1,0,2,4,5
3313,PHI,2006,Allen Iverson,30,72,72,3103,815,1822,.447,72,223,.323,743,1599,.465,.467,675,829,.814,44,188,232,532,140,10,248,121,2377
3314,PHI,2006,Andre Iguodala,22,82,82,3086,344,688,.500,56,158,.354,288,530,.543,.541,263,349,.754,117,364,481,255,135,21,153,198,1007
3315,PHI,2006,Chris Webber,32,75,75,2893,617,1422,.434,21,77,.273,596,1345,.443,.441,263,348,.756,184,557,741,256,103,62,182,219,1518
3316,PHI,2006,Kyle Korver,24,82,43,2563,327,761,.430,184,438,.420,143,323,.443,.551,101,119,.849,27,243,270,163,65,26,98,224,939
3317,PHI,2006,John Salmons,26,82,24,2059,219,521,.420,26,87,.299,193,434,.445,.445,155,200,.775,48,172,220,223,73,13,125,178,619
3318,PHI,2006,Samuel Dalembert,24,66,52,1761,196,369,.531,0,1,.000,196,368,.533,.531,93,132,.705,159,382,541,25,34,160,107,244,485
3319,PHI,2006,Steven Hunter,24,69,35,1312,175,291,.601,0,0,,175,291,.601,.601,71,138,.514,110,161,271,17,12,76,64,120,421
3320,PHI,2006,Kevin Ollie,33,70,23,1069,75,174,.431,1,3,.333,74,171,.433,.434,41,49,.837,13,85,98,101,33,3,29,103,192
3321,PHI,2006,Matt Barnes,25,50,0,538,59,110,.536,2,11,.182,57,99,.576,.545,29,43,.674,41,56,97,22,16,7,24,92,149
3322,PHI,2006,Shavlik Randolph,22,57,1,487,44,97,.454,0,0,,44,97,.454,.454,43,71,.606,55,78,133,19,19,12,21,83,131
3323,PHI,2006,Michael Bradley,26,46,1,367,32,79,.405,1,5,.200,31,74,.419,.411,2,3,.667,40,67,107,17,5,7,19,39,67
3324,PHI,2006,Lee Nailon,30,22,0,237,40,80,.500,0,0,,40,80,.500,.500,13,15,.867,23,19,42,7,8,4,10,32,93
3325,PHI,2006,Willie Green,24,10,2,153,28,66,.424,10,19,.526,18,47,.383,.500,4,5,.800,1,14,15,5,2,0,12,13,70
3326,PHI,2006,Lou Williams,19,30,0,145,23,52,.442,2,9,.222,21,43,.488,.462,8,13,.615,3,16,19,10,5,0,13,13,56
3327,PHI,2006,James Thomas,25,15,0,124,7,13,.538,0,0,,7,13,.538,.538,8,14,.571,8,23,31,1,0,3,7,32,22
3328,PHI,2006,Deng Gai,23,2,0,5,0,0,,0,0,,0,0,,,0,0,,0,0,0,0,0,0,0,0,0
3329,PHI,2006,Zendon Hamilton,30,1,0,3,0,1,.000,0,0,,0,1,.000,.000,1,2,.500,0,0,0,0,1,0,0,1,1
3330,PHI,2005,Allen Iverson,29,75,75,3174,771,1818,.424,104,338,.308,667,1480,.451,.453,656,786,.835,51,248,299,596,180,9,344,140,2302
3331,PHI,2005,Andre Iguodala,21,82,82,2686,269,546,.493,47,142,.331,222,404,.550,.536,156,210,.743,89,375,464,246,138,48,139,204,741
3332,PHI,2005,Kyle Korver,23,82,57,2667,317,759,.418,226,558,.405,91,201,.453,.567,82,96,.854,40,339,379,182,103,33,106,265,942
3333,PHI,2005,Marc Jackson,30,81,23,1976,340,731,.465,0,2,.000,340,729,.466,.465,289,349,.828,184,222,406,81,32,18,131,171,969
3334,PHI,2005,Samuel Dalembert,23,72,60,1785,250,477,.524,0,0,,250,477,.524,.524,89,148,.601,187,355,542,35,46,121,114,241,589
3335,PHI,2005,Kenny Thomas,27,47,43,1344,217,476,.456,1,4,.250,216,472,.458,.457,95,119,.798,106,202,308,77,40,6,83,151,530
3336,PHI,2005,Aaron McKie,32,68,3,1118,61,142,.430,20,62,.323,41,80,.513,.500,10,16,.625,20,152,172,103,48,17,31,116,152
3337,PHI,2005,Willie Green,23,57,21,1066,155,423,.366,30,105,.286,125,318,.393,.402,97,125,.776,22,111,133,100,34,6,75,121,437
3338,PHI,2005,Corliss Williamson,31,48,5,1056,194,417,.465,0,2,.000,194,415,.467,.465,130,165,.788,73,105,178,43,26,12,60,144,518
3339,PHI,2005,John Salmons,25,58,8,993,85,210,.405,31,91,.341,54,119,.454,.479,35,48,.729,12,109,121,114,40,13,51,92,236
3340,PHI,2005,Chris Webber,31,21,21,702,143,366,.391,4,15,.267,139,351,.396,.396,38,49,.776,36,129,165,66,26,19,49,70,328
3341,PHI,2005,Rodney Rogers,33,28,7,485,63,161,.391,23,76,.303,40,85,.471,.463,20,28,.714,33,71,104,26,22,8,20,69,169
3342,PHI,2005,Josh Davis,24,42,5,328,42,111,.378,19,53,.358,23,58,.397,.464,14,17,.824,29,50,79,12,8,4,15,45,117
3343,PHI,2005,Brian Skinner,28,24,0,246,22,57,.386,0,1,.000,22,56,.393,.386,5,17,.294,23,39,62,5,5,6,13,29,49
3344,PHI,2005,Kevin Ollie,32,26,0,158,11,31,.355,0,0,,11,31,.355,.355,6,9,.667,3,16,19,19,5,0,6,16,28
3345,PHI,2005,Kedrick Brown,23,8,0,55,2,6,.333,0,3,.000,2,3,.667,.333,8,10,.800,1,10,11,4,3,1,5,4,12
3346,PHI,2005,Michael Bradley,25,2,0,16,4,5,.800,0,1,.000,4,4,1.000,.800,1,2,.500,0,3,3,1,0,0,1,0,9
3347,PHI,2004,Eric Snow,30,82,82,2966,295,715,.413,2,18,.111,293,697,.420,.414,252,316,.797,62,219,281,563,97,6,187,213,844
3348,PHI,2004,Kenny Thomas,26,74,72,2699,381,813,.469,1,5,.200,380,808,.470,.469,243,323,.752,261,489,750,111,82,33,172,219,1006
3349,PHI,2004,Samuel Dalembert,22,82,53,2197,270,499,.541,0,1,.000,270,498,.542,.541,112,174,.644,194,432,626,21,44,189,86,273,652
3350,PHI,2004,Aaron McKie,31,75,41,2112,265,577,.459,75,172,.436,190,405,.469,.524,84,111,.757,45,208,253,195,85,23,103,142,689
3351,PHI,2004,Allen Iverson,28,48,47,2040,435,1125,.387,57,199,.286,378,926,.408,.412,339,455,.745,34,144,178,324,115,5,209,87,1266
3352,PHI,2004,John Salmons,24,77,24,1603,161,416,.387,50,147,.340,111,269,.413,.447,71,92,.772,38,158,196,134,62,16,77,122,443
3353,PHI,2004,Glenn Robinson,31,42,42,1336,275,614,.448,34,100,.340,241,514,.469,.476,114,137,.832,46,143,189,57,42,9,106,96,698
3354,PHI,2004,Kyle Korver,22,74,0,882,115,327,.352,81,207,.391,34,120,.283,.476,19,24,.792,30,81,111,40,25,8,41,102,330
3355,PHI,2004,Derrick Coleman,36,34,30,843,107,259,.413,8,36,.222,99,223,.444,.429,49,65,.754,45,147,192,46,23,26,57,79,271
3356,PHI,2004,Willie Green,22,53,0,767,143,357,.401,19,61,.311,124,296,.419,.427,59,81,.728,16,49,65,53,26,5,59,83,364
3357,PHI,2004,Greg Buckner,27,53,3,703,66,175,.377,12,44,.273,54,131,.412,.411,20,27,.741,28,75,103,45,21,4,34,77,164
3358,PHI,2004,Amal McCaskill,30,59,3,636,47,117,.402,0,1,.000,47,116,.405,.402,19,27,.704,48,85,133,20,12,20,25,89,113
3359,PHI,2004,Marc Jackson,29,22,13,598,71,171,.415,0,1,.000,71,170,.418,.415,64,81,.790,45,81,126,18,12,6,24,45,206
3360,PHI,2004,Zendon Hamilton,28,46,0,473,51,95,.537,0,0,,51,95,.537,.537,67,96,.698,49,97,146,13,8,8,27,74,169
3361,PHI,2003,Allen Iverson,27,82,82,3485,804,1940,.414,84,303,.277,720,1637,.440,.436,570,736,.774,68,276,344,454,225,13,286,149,2262
3362,PHI,2003,Eric Snow,29,82,82,3108,361,799,.452,7,32,.219,354,767,.462,.456,325,379,.858,71,230,301,544,133,11,194,235,1054
3363,PHI,2003,Aaron McKie,30,80,40,2374,286,666,.429,37,112,.330,249,554,.449,.457,112,134,.836,61,289,350,278,131,9,109,177,721
3364,PHI,2003,Keith Van Horn,27,74,73,2337,459,952,.482,65,176,.369,394,776,.508,.516,193,240,.804,159,365,524,93,63,30,150,251,1176
3365,PHI,2003,Derrick Coleman,35,64,35,1742,223,498,.448,22,67,.328,201,431,.466,.470,134,171,.784,151,299,450,87,53,69,96,171,602
3366,PHI,2003,Greg Buckner,26,75,5,1514,185,398,.465,15,55,.273,170,343,.496,.484,65,81,.802,72,144,216,96,72,16,62,203,450
3367,PHI,2003,Kenny Thomas,25,46,28,1392,178,369,.482,0,0,,178,369,.482,.482,114,152,.750,140,252,392,73,46,22,76,120,470
3368,PHI,2003,Brian Skinner,26,77,9,1381,182,331,.550,0,0,,182,331,.550,.550,97,161,.602,136,230,366,19,47,53,62,176,461
3369,PHI,2003,Todd MacCulloch,27,42,35,812,123,238,.517,0,0,,123,238,.517,.517,53,79,.671,66,130,196,20,19,32,35,107,299
3370,PHI,2003,John Salmons,23,64,1,504,48,116,.414,10,31,.323,38,85,.447,.457,26,35,.743,16,43,59,47,17,6,29,53,132
3371,PHI,2003,Tyrone Hill,34,24,18,496,44,109,.404,0,0,,44,109,.404,.404,21,35,.600,56,68,124,9,15,7,16,68,109
3372,PHI,2003,Monty Williams,31,21,2,276,34,80,.425,0,2,.000,34,78,.436,.425,24,32,.750,12,33,45,26,12,5,17,33,92
3373,PHI,2003,Efthimios Rentzias,27,35,0,144,20,59,.339,4,8,.500,16,51,.314,.373,8,9,.889,10,16,26,7,6,2,4,21,52
3374,PHI,2003,Art Long,30,19,0,131,19,50,.380,1,1,1.000,18,49,.367,.390,1,5,.200,13,27,40,2,2,8,9,22,40
3375,PHI,2003,Kenny Satterfield,21,17,0,82,4,18,.222,0,0,,4,18,.222,.222,1,2,.500,4,4,8,15,2,0,7,6,9
3376,PHI,2003,Mark Bryant,37,11,0,77,5,17,.294,0,0,,5,17,.294,.294,2,2,1.000,7,9,16,1,1,1,5,12,12
3377,PHI,2002,Dikembe Mutombo,35,80,80,2907,321,641,.501,0,0,,321,641,.501,.501,278,364,.764,254,609,863,83,29,190,156,242,920
3378,PHI,2002,Allen Iverson,26,60,59,2622,665,1669,.398,78,268,.291,587,1401,.419,.422,475,585,.812,44,225,269,331,168,13,237,102,1883
3379,PHI,2002,Matt Harpring,25,81,81,2541,386,838,.461,21,69,.304,365,769,.475,.473,165,222,.743,203,370,573,107,70,5,127,201,958
3380,PHI,2002,Eric Snow,28,61,61,2225,276,624,.442,3,27,.111,273,597,.457,.445,183,227,.806,33,182,215,400,95,9,138,167,738
3381,PHI,2002,Derrick Coleman,34,58,58,2080,331,735,.450,28,83,.337,303,652,.465,.469,185,227,.815,167,342,509,98,42,51,119,158,875
3382,PHI,2002,Speedy Claxton,23,67,18,1528,181,452,.400,4,33,.121,177,419,.422,.405,114,136,.838,46,114,160,198,95,6,95,145,480
3383,PHI,2002,Aaron McKie,29,48,16,1471,220,490,.449,51,128,.398,169,362,.467,.501,96,122,.787,26,166,192,179,56,14,93,74,587
3384,PHI,2002,Corie Blount,33,72,21,1426,115,251,.458,0,1,.000,115,250,.460,.458,29,45,.644,149,219,368,44,49,26,52,176,259
3385,PHI,2002,Raja Bell,25,74,12,890,103,240,.429,12,44,.273,91,196,.464,.454,36,48,.750,31,80,111,71,21,4,48,109,254
3386,PHI,2002,Derrick McKey,35,41,1,784,52,122,.426,5,12,.417,47,110,.427,.447,10,14,.714,48,79,127,45,41,4,22,90,119
3387,PHI,2002,Vonteego Cummings,25,58,1,501,78,187,.417,12,46,.261,66,141,.468,.449,24,32,.750,14,38,52,60,18,5,36,53,192
3388,PHI,2002,Samuel Dalembert,20,34,0,177,22,50,.440,0,0,,22,50,.440,.440,7,18,.389,25,43,68,5,6,13,14,30,51
3389,PHI,2002,Michael Ruffin,25,15,0,169,7,26,.269,0,0,,7,26,.269,.269,2,8,.250,23,28,51,5,5,8,11,23,16
3390,PHI,2002,Alvin Jones,23,23,2,126,8,20,.400,0,0,,8,20,.400,.400,10,20,.500,13,23,36,3,3,9,11,35,26
3391,PHI,2002,Jabari Smith,24,11,0,110,20,42,.476,0,2,.000,20,40,.500,.476,15,20,.750,6,8,14,5,4,2,3,19,55
3392,PHI,2002,Damone Brown,22,17,0,67,8,21,.381,0,1,.000,8,20,.400,.381,7,8,.875,2,2,4,2,1,1,9,11,23
3393,PHI,2002,Tim James,25,9,0,41,5,13,.385,0,0,,5,13,.385,.385,2,6,.333,5,2,7,1,0,1,3,5,12
3394,PHI,2002,Matt Geiger,32,4,0,36,1,8,.125,0,0,,1,8,.125,.125,1,2,.500,3,3,6,0,0,2,2,2,3
3395,PHI,2002,Ira Bowman,28,3,0,29,5,7,.714,0,1,.000,5,6,.833,.714,0,0,,0,1,1,1,2,0,0,3,10
3396,PHI,2001,Allen Iverson,25,71,71,2979,762,1813,.420,98,306,.320,664,1507,.441,.447,585,719,.814,50,223,273,325,178,20,237,147,2207
3397,PHI,2001,George Lynch,30,82,80,2649,274,616,.445,15,57,.263,259,559,.463,.457,123,171,.719,200,390,590,139,99,30,109,222,686
3398,PHI,2001,Aaron McKie,28,76,33,2394,338,714,.473,53,170,.312,285,544,.524,.511,149,194,.768,33,278,311,377,106,8,203,178,878
3399,PHI,2001,Tyrone Hill,32,76,75,2363,278,587,.474,0,1,.000,278,586,.474,.474,172,273,.630,239,448,687,48,37,27,127,242,728
3400,PHI,2001,Theo Ratliff,27,50,50,1800,228,457,.499,0,0,,228,457,.499,.499,165,217,.760,125,288,413,58,30,187,126,165,621
3401,PHI,2001,Eric Snow,27,50,50,1740,182,435,.418,5,19,.263,177,416,.425,.424,122,154,.792,27,139,166,369,77,7,124,123,491
3402,PHI,2001,Toni Kukoč,32,48,5,979,151,330,.458,32,78,.410,119,252,.472,.506,52,88,.591,47,115,162,93,35,6,60,62,386
3403,PHI,2001,Dikembe Mutombo,34,26,26,875,100,202,.495,0,0,,100,202,.495,.495,104,137,.759,119,203,322,22,9,66,52,65,304
3404,PHI,2001,Jumaine Jones,21,65,0,866,122,275,.444,20,60,.333,102,215,.474,.480,40,53,.755,63,126,189,32,30,15,39,68,304
3405,PHI,2001,Kevin Ollie,28,51,4,764,71,165,.430,1,3,.333,70,162,.432,.433,51,70,.729,13,59,72,121,25,1,40,70,194
3406,PHI,2001,Todd MacCulloch,25,63,3,597,109,185,.589,0,0,,109,185,.589,.589,42,66,.636,69,99,168,10,7,19,27,96,260
3407,PHI,2001,Rodney Buford,23,47,0,573,104,241,.432,16,38,.421,88,203,.433,.465,24,29,.828,16,58,74,17,17,6,29,68,248
3408,PHI,2001,Matt Geiger,31,35,4,542,88,224,.393,0,2,.000,88,222,.396,.393,37,54,.685,50,89,139,14,12,8,25,73,213
3409,PHI,2001,Vernon Maxwell,35,24,6,375,42,125,.336,21,64,.328,21,61,.344,.420,15,22,.682,3,34,37,29,12,0,18,33,120
3410,PHI,2001,Nazr Mohammed,23,30,3,196,41,88,.466,0,0,,41,88,.466,.466,14,28,.500,18,37,55,2,6,7,9,40,96
3411,PHI,2001,Pepe Sánchez,23,24,0,116,9,21,.429,0,1,.000,9,20,.450,.429,2,2,1.000,2,12,14,36,9,1,3,18,20
3412,PHI,2001,Raja Bell,24,5,0,30,2,7,.286,1,3,.333,1,4,.250,.357,0,0,,0,1,1,0,1,0,2,1,5
3413,PHI,2001,Roshown McLeod,25,1,0,15,1,2,.500,0,1,.000,1,1,1.000,.500,0,0,,1,1,2,0,0,0,1,2,2
3414,PHI,2001,Anthony Miller,29,1,0,2,0,0,,0,0,,0,0,,,0,0,,0,0,0,0,0,0,0,0,0
3415,PHI,2000,Eric Snow,26,82,80,2866,257,597,.430,11,45,.244,246,552,.446,.440,126,177,.712,42,219,261,624,140,8,162,243,651
3416,PHI,2000,Allen Iverson,24,70,70,2853,729,1733,.421,89,261,.341,640,1472,.435,.446,442,620,.713,71,196,267,328,144,5,230,162,1989
3417,PHI,2000,George Lynch,29,75,75,2416,297,644,.461,15,36,.417,282,608,.464,.473,113,183,.617,216,366,582,136,119,38,120,231,722
3418,PHI,2000,Tyrone Hill,31,68,65,2155,318,656,.485,0,1,.000,318,655,.485,.485,179,259,.691,220,405,625,52,64,27,124,243,815
3419,PHI,2000,Aaron McKie,27,82,14,1952,244,593,.411,44,121,.364,200,472,.424,.449,121,146,.829,47,199,246,240,108,18,113,194,653
3420,PHI,2000,Theo Ratliff,26,57,56,1795,247,491,.503,0,0,,247,491,.503,.503,182,236,.771,140,295,435,36,32,171,108,185,676
3421,PHI,2000,Matt Geiger,30,65,20,1406,260,589,.441,0,4,.000,260,585,.444,.441,109,140,.779,154,233,387,39,29,22,91,194,629
3422,PHI,2000,Larry Hughes,21,50,5,1018,192,461,.416,11,51,.216,181,410,.441,.428,106,142,.746,52,107,159,75,54,12,95,94,501
3423,PHI,2000,Billy Owens,30,46,7,919,112,258,.434,9,27,.333,103,231,.446,.452,38,64,.594,63,129,192,59,26,16,61,119,271
3424,PHI,2000,Toni Kukoč,31,32,8,916,149,340,.438,26,90,.289,123,250,.492,.476,74,110,.673,38,105,143,141,33,9,71,61,398
3425,PHI,2000,Todd MacCulloch,24,56,6,528,89,161,.553,0,0,,89,161,.553,.553,28,54,.519,48,98,146,13,11,37,26,94,206
3426,PHI,2000,Bruce Bowen,28,42,0,311,26,73,.356,1,2,.500,25,71,.352,.363,6,12,.500,14,22,36,16,9,5,5,37,59
3427,PHI,2000,Kevin Ollie,27,40,0,290,22,49,.449,0,0,,22,49,.449,.449,28,37,.757,4,27,31,46,10,0,10,27,72
3428,PHI,2000,Nazr Mohammed,22,28,3,190,21,54,.389,0,0,,21,54,.389,.389,12,22,.545,16,34,50,2,4,12,18,29,54
3429,PHI,2000,Jumaine Jones,20,33,0,138,22,58,.379,2,4,.500,20,54,.370,.397,11,18,.611,16,22,38,5,6,5,14,10,57
3430,PHI,2000,Stanley Roberts,29,5,1,51,5,16,.313,0,1,.000,5,15,.333,.313,0,3,.000,6,9,15,3,1,1,2,15,10
3431,PHI,2000,Ira Bowman,26,11,0,20,2,2,1.000,0,0,,2,2,1.000,1.000,1,2,.500,0,2,2,1,1,0,1,0,5
3432,PHI,2000,Antonio Lang,27,3,0,6,1,1,1.000,0,0,,1,1,1.000,1.000,1,1,1.000,0,0,0,1,0,0,0,1,3
3433,PHI,1999,Allen Iverson,23,48,48,1990,435,1056,.412,58,199,.291,377,857,.440,.439,356,474,.751,66,170,236,223,110,7,167,98,1284
3434,PHI,1999,Eric Snow,25,48,48,1716,149,348,.428,5,21,.238,144,327,.440,.435,110,150,.733,25,137,162,301,100,1,111,149,413
3435,PHI,1999,Theo Ratliff,25,50,50,1627,197,419,.470,0,0,,197,419,.470,.470,166,229,.725,139,268,407,30,45,149,92,180,560
3436,PHI,1999,Matt Geiger,29,50,40,1540,266,555,.479,1,5,.200,265,550,.482,.480,141,177,.797,137,225,362,58,39,40,101,157,674
3437,PHI,1999,George Lynch,28,43,43,1315,147,349,.421,9,23,.391,138,326,.423,.434,53,84,.631,110,169,279,76,85,22,79,142,356
3438,PHI,1999,Larry Hughes,20,50,1,988,170,414,.411,8,52,.154,162,362,.448,.420,107,151,.709,83,106,189,77,44,14,68,97,455
3439,PHI,1999,Aaron McKie,26,50,4,959,95,237,.401,6,31,.194,89,206,.432,.414,44,62,.710,27,113,140,100,63,3,57,90,240
3440,PHI,1999,Harvey Grant,33,47,10,798,62,168,.369,1,6,.167,61,162,.377,.372,21,29,.724,36,74,110,23,20,16,21,73,146
3441,PHI,1999,Tyrone Hill,30,21,6,587,72,150,.480,0,0,,72,150,.480,.480,35,69,.507,64,89,153,18,16,8,35,77,179
3442,PHI,1999,Tim Thomas,21,17,0,188,27,67,.403,5,19,.263,22,48,.458,.440,19,24,.792,7,26,33,15,3,3,15,21,78
3443,PHI,1999,Rick Mahorn,40,16,0,127,5,18,.278,0,0,,5,18,.278,.278,3,8,.375,7,16,23,2,5,1,6,22,13
3444,PHI,1999,Nazr Mohammed,21,26,0,121,15,42,.357,0,0,,15,42,.357,.357,12,21,.571,18,19,37,2,5,4,12,22,42
3445,PHI,1999,Jerald Honeycutt,24,13,0,90,7,27,.259,5,14,.357,2,13,.154,.352,6,8,.750,3,8,11,3,4,2,8,10,25
3446,PHI,1999,Doug Overton,29,10,0,37,5,15,.333,0,1,.000,5,14,.357,.333,0,0,,0,2,2,4,1,0,2,2,10
3447,PHI,1999,Benoit Benjamin,34,6,0,33,2,7,.286,0,0,,2,7,.286,.286,0,0,,3,5,8,1,0,0,3,6,4
3448,PHI,1999,Scott Williams,30,2,0,17,0,2,.000,0,0,,0,2,.000,.000,0,0,,1,1,2,1,2,1,2,4,0
3449,PHI,1999,Casey Shaw,23,9,0,14,1,8,.125,0,0,,1,8,.125,.125,0,0,,3,0,3,0,0,0,2,2,2
3450,PHI,1999,Anthony Parker,23,2,0,3,1,1,1.000,0,0,,1,1,1.000,1.000,0,0,,0,0,0,0,0,0,0,0,2
3451,PHI,1998,Allen Iverson,22,80,80,3150,649,1407,.461,70,235,.298,579,1172,.494,.486,390,535,.729,86,210,296,494,176,25,244,200,1758
3452,PHI,1998,Derrick Coleman,30,59,58,2135,356,867,.411,26,98,.265,330,769,.429,.426,302,391,.772,149,438,587,145,46,68,157,144,1040
3453,PHI,1998,Theo Ratliff,24,58,55,1861,249,486,.512,0,0,,249,486,.512,.512,154,218,.706,175,251,426,42,38,203,82,209,652
3454,PHI,1998,Jim Jackson,27,48,47,1788,246,535,.460,39,112,.348,207,423,.489,.496,126,154,.818,69,158,227,223,41,6,145,112,657
3455,PHI,1998,Tim Thomas,20,77,48,1779,306,684,.447,62,171,.363,244,513,.476,.493,171,231,.740,107,181,288,90,54,17,118,185,845
3456,PHI,1998,Aaron McKie,25,57,31,1341,96,277,.347,9,46,.196,87,231,.377,.363,22,32,.688,34,129,163,137,78,12,52,117,223
3457,PHI,1998,Clarence Weatherspoon,27,48,18,1290,141,331,.426,0,0,,141,331,.426,.426,123,174,.707,109,227,336,40,43,52,69,108,405
3458,PHI,1998,Mark Davis,24,71,12,906,109,244,.447,0,6,.000,109,238,.458,.447,64,101,.634,64,94,158,73,49,18,91,95,282
3459,PHI,1998,Eric Snow,24,47,0,844,69,161,.429,2,16,.125,67,145,.462,.435,44,61,.721,19,58,77,164,60,4,51,99,184
3460,PHI,1998,Scott Williams,29,58,7,801,93,213,.437,0,5,.000,93,208,.447,.437,51,63,.810,87,124,211,29,17,21,30,132,237
3461,PHI,1998,Jerry Stackhouse,23,22,22,748,128,283,.452,16,46,.348,112,237,.473,.481,81,101,.802,28,48,76,67,31,21,74,56,353
3462,PHI,1998,Joe Smith,22,30,6,699,121,270,.448,0,1,.000,121,269,.450,.448,67,85,.788,58,75,133,27,18,13,52,94,309
3463,PHI,1998,Terry Cummings,36,44,2,656,97,212,.458,0,1,.000,97,211,.460,.458,39,58,.672,55,93,148,21,22,5,17,102,233
3464,PHI,1998,Brian Shaw,31,20,2,502,51,139,.367,7,28,.250,44,111,.396,.392,12,19,.632,17,47,64,88,14,3,24,55,121
3465,PHI,1998,Eric Montross,26,20,20,337,30,76,.395,0,0,,30,76,.395,.395,7,19,.368,28,64,92,7,7,12,15,61,67
3466,PHI,1998,Doug Overton,28,23,2,277,24,63,.381,0,3,.000,24,60,.400,.381,14,16,.875,2,12,14,37,8,1,23,34,62
3467,PHI,1998,Benoit Benjamin,33,14,0,197,22,41,.537,0,0,,22,41,.537,.537,19,30,.633,18,35,53,3,4,4,12,26,63
3468,PHI,1998,Anthony Parker,22,37,0,196,25,63,.397,9,28,.321,16,35,.457,.468,13,20,.650,8,18,26,19,11,3,11,17,72
3469,PHI,1998,Rex Walters,27,19,0,127,11,29,.379,3,14,.214,8,15,.533,.431,17,17,1.000,3,6,9,21,5,0,17,17,42
3470,PHI,1998,Kebu Stewart,24,15,0,110,12,26,.462,0,0,,12,26,.462,.462,16,25,.640,9,22,31,2,5,2,8,13,40
3471,PHI,1998,Tom Chambers,38,1,0,10,2,2,1.000,0,0,,2,2,1.000,1.000,2,2,1.000,0,2,2,0,2,0,1,2,6
3472,PHI,1998,William Cunningham,23,1,0,1,0,0,,0,0,,0,0,,,0,0,,0,2,2,0,0,0,0,0,0
3473,PHI,1997,Jerry Stackhouse,22,81,81,3166,533,1308,.407,102,342,.298,431,966,.446,.446,511,667,.766,156,182,338,253,93,63,316,219,1679
3474,PHI,1997,Allen Iverson,21,76,74,3045,625,1504,.416,155,455,.341,470,1049,.448,.467,382,544,.702,115,197,312,567,157,24,337,233,1787
3475,PHI,1997,Clarence Weatherspoon,26,82,82,2949,398,811,.491,1,6,.167,397,805,.493,.491,206,279,.738,219,460,679,140,74,86,137,187,1003
3476,PHI,1997,Derrick Coleman,29,57,54,2102,364,836,.435,32,119,.269,332,717,.463,.455,272,365,.745,157,416,573,193,50,75,184,164,1032
3477,PHI,1997,Mark Davis,23,75,17,1705,251,535,.469,24,93,.258,227,442,.514,.492,113,168,.673,138,185,323,135,85,31,118,230,639
3478,PHI,1997,Scott Williams,28,62,52,1317,162,318,.509,0,2,.000,162,316,.513,.509,38,55,.691,155,242,397,41,44,41,50,206,362
3479,PHI,1997,Michael Cage,35,82,24,1247,66,141,.468,0,0,,66,141,.468,.468,19,41,.463,112,208,320,43,48,42,17,118,151
3480,PHI,1997,Rex Walters,26,59,16,1041,148,325,.455,57,148,.385,91,177,.514,.543,49,62,.790,21,86,107,113,28,3,61,75,402
3481,PHI,1997,Lucious Harris,26,54,3,813,112,294,.381,36,99,.364,76,195,.390,.442,33,47,.702,27,44,71,50,41,3,34,45,293
3482,PHI,1997,Don MacLean,27,37,2,733,163,365,.447,12,38,.316,151,327,.462,.463,64,97,.660,41,99,140,37,12,10,47,71,402
3483,PHI,1997,Doug Overton,27,61,4,634,81,190,.426,10,40,.250,71,150,.473,.453,45,48,.938,18,50,68,101,24,0,39,44,217
3484,PHI,1997,Adrian Caldwell,30,27,0,365,30,57,.526,0,0,,30,57,.526,.526,12,33,.364,38,73,111,7,8,7,16,60,72
3485,PHI,1997,Mark Hendrickson,22,29,1,301,32,77,.416,3,12,.250,29,65,.446,.435,18,26,.692,35,57,92,3,10,4,14,32,85
3486,PHI,1997,Mark Bradtke,28,36,0,251,25,58,.431,0,0,,25,58,.431,.431,9,13,.692,26,42,68,7,5,5,9,34,59
3487,PHI,1997,Frankie King,24,7,0,59,7,17,.412,1,2,.500,6,15,.400,.441,5,5,1.000,4,10,14,5,4,0,3,7,20
3488,PHI,1997,Joe Courtney,27,4,0,52,6,14,.429,0,0,,6,14,.429,.429,0,0,,5,4,9,0,0,0,1,8,12
3489,PHI,1996,Clarence Weatherspoon,25,78,75,3096,491,1015,.484,0,2,.000,491,1013,.485,.484,318,426,.746,237,516,753,158,112,108,179,214,1300
3490,PHI,1996,Jerry Stackhouse,21,72,71,2701,452,1091,.414,93,292,.318,359,799,.449,.457,387,518,.747,90,175,265,278,76,79,252,179,1384
3491,PHI,1996,Vernon Maxwell,30,75,57,2467,410,1052,.390,146,460,.317,264,592,.446,.459,251,332,.756,39,190,229,330,96,12,215,182,1217
3492,PHI,1996,Derrick Alston,23,73,41,1614,198,387,.512,1,3,.333,197,384,.513,.513,55,112,.491,127,175,302,61,56,52,59,191,452
3493,PHI,1996,Trevor Ruffin,25,61,23,1551,263,648,.406,104,284,.366,159,364,.437,.486,148,182,.813,21,111,132,269,43,2,149,132,778
3494,PHI,1996,Sharone Wright,23,46,32,1136,183,384,.477,0,0,,183,384,.477,.477,117,186,.629,124,175,299,27,24,39,81,125,483
3495,PHI,1996,Sean Higgins,27,44,4,916,134,323,.415,48,129,.372,86,194,.443,.489,35,37,.946,20,72,92,55,24,11,49,90,351
3496,PHI,1996,Tony Massenburg,28,30,8,804,114,236,.483,0,3,.000,114,233,.489,.483,68,92,.739,75,111,186,12,15,11,38,73,296
3497,PHI,1996,LaSalle Thompson,34,44,11,773,33,83,.398,0,0,,33,83,.398,.398,19,24,.792,62,137,199,26,19,20,37,125,85
3498,PHI,1996,Richard Dumas,26,39,14,739,95,203,.468,2,9,.222,93,194,.479,.473,49,70,.700,42,57,99,44,42,6,49,79,241
3499,PHI,1996,Ed Pinckney,32,27,23,679,54,102,.529,0,0,,54,102,.529,.529,42,55,.764,74,102,176,22,33,11,23,55,150
3500,PHI,1996,Rex Walters,25,33,8,523,49,115,.426,19,54,.352,30,61,.492,.509,36,46,.783,11,37,48,95,22,4,34,49,153
3501,PHI,1996,Greg Sutton,28,30,2,465,65,167,.389,40,96,.417,25,71,.352,.509,20,27,.741,4,31,35,63,17,2,45,56,190
3502,PHI,1996,Jeff Malone,34,25,3,407,63,160,.394,5,16,.313,58,144,.403,.409,24,26,.923,8,24,32,19,13,0,19,19,155
3503,PHI,1996,Shawn Bradley,23,12,11,334,43,97,.443,0,0,,43,97,.443,.443,19,25,.760,34,72,106,8,8,38,31,42,105
3504,PHI,1996,Derrick Coleman,28,11,11,294,48,118,.407,7,21,.333,41,97,.423,.436,20,32,.625,13,59,72,31,4,10,28,30,123
3505,PHI,1996,Greg Grant,29,11,2,280,18,48,.375,4,18,.222,14,30,.467,.417,5,6,.833,3,18,21,60,12,2,15,28,45
3506,PHI,1996,Scott Skiles,31,10,9,236,20,57,.351,15,34,.441,5,23,.217,.482,8,10,.800,1,15,16,38,7,0,16,21,63
3507,PHI,1996,Scott Williams,27,13,1,193,15,29,.517,0,2,.000,15,27,.556,.517,10,12,.833,13,33,46,5,6,7,8,27,40
3508,PHI,1996,Mike Brown,32,9,1,162,9,16,.563,0,0,,9,16,.563,.563,8,17,.471,14,23,37,3,3,2,6,24,26
3509,PHI,1996,Greg Graham,25,8,3,128,17,32,.531,7,14,.500,10,18,.556,.641,15,17,.882,5,10,15,11,5,0,17,16,56
3510,PHI,1996,Tim Perry,30,8,0,87,8,18,.444,1,1,1.000,7,17,.412,.472,2,3,.667,6,7,13,2,2,3,3,5,19
3511,PHI,1996,Trevor Wilson,27,6,0,79,10,20,.500,0,0,,10,20,.500,.500,3,4,.750,7,7,14,4,3,0,1,9,23
3512,PHI,1996,Elmer Bennett,25,8,0,66,4,17,.235,0,0,,4,17,.235,.235,3,4,.750,1,4,5,8,1,1,7,6,11
3513,PHI,1995,Dana Barros,27,82,82,3318,571,1165,.490,197,425,.464,374,740,.505,.575,347,386,.899,27,247,274,619,149,4,242,159,1686
3514,PHI,1995,Clarence Weatherspoon,24,76,76,2991,543,1238,.439,4,21,.190,539,1217,.443,.440,283,377,.751,144,382,526,215,115,67,191,195,1373
3515,PHI,1995,Shawn Bradley,22,82,59,2365,315,693,.455,0,3,.000,315,690,.457,.455,148,232,.638,243,416,659,53,54,274,142,338,778
3516,PHI,1995,Sharone Wright,22,79,49,2044,361,776,.465,0,8,.000,361,768,.470,.465,182,282,.645,191,281,472,48,37,104,151,246,904
3517,PHI,1995,Scott Williams,26,77,43,1781,206,434,.475,0,7,.000,206,427,.482,.475,79,107,.738,173,312,485,59,71,40,84,237,491
3518,PHI,1995,Willie Burton,26,53,31,1564,243,606,.401,106,275,.385,137,331,.414,.488,220,267,.824,49,115,164,96,32,19,122,167,812
3519,PHI,1995,Jeff Grayer,29,47,25,1098,163,381,.428,5,15,.333,158,366,.432,.434,58,83,.699,58,91,149,74,27,4,56,80,389
3520,PHI,1995,Derrick Alston,22,64,1,1032,120,258,.465,0,4,.000,120,254,.472,.465,59,120,.492,98,121,219,33,39,35,53,107,299
3521,PHI,1995,B.J. Tyler,23,55,8,809,72,189,.381,16,51,.314,56,138,.406,.423,35,50,.700,13,49,62,174,36,2,97,58,195
3522,PHI,1995,Greg Graham,24,50,7,775,95,223,.426,6,28,.214,89,195,.456,.439,55,73,.753,19,43,62,66,29,6,48,76,251
3523,PHI,1995,Jeff Malone,33,19,19,660,144,284,.507,11,28,.393,133,256,.520,.526,51,59,.864,11,44,55,29,15,0,29,35,350
3524,PHI,1995,Tim Perry,29,42,1,446,27,78,.346,0,14,.000,27,64,.422,.346,22,40,.550,38,51,89,12,10,15,21,51,76
3525,PHI,1995,Corey Gaines,29,11,8,280,24,51,.471,2,15,.133,22,36,.611,.490,5,11,.455,1,17,18,33,8,1,14,23,55
3526,PHI,1995,Jaren Jackson,27,21,1,257,25,68,.368,4,15,.267,21,53,.396,.397,16,24,.667,18,24,42,19,9,5,17,33,70
3527,PHI,1995,Jerome Harmon,25,10,0,158,21,53,.396,1,1,1.000,20,52,.385,.406,3,6,.500,9,14,23,12,9,0,7,12,46
3528,PHI,1995,Alphonso Ford,23,5,0,98,9,39,.231,0,9,.000,9,30,.300,.231,1,2,.500,8,12,20,9,1,0,8,5,19
3529,PHI,1995,Lloyd Daniels,27,5,0,63,9,27,.333,3,14,.214,6,13,.462,.389,2,2,1.000,2,5,7,4,2,0,8,8,23
3530,PHI,1995,Kevin Pritchard,27,5,0,36,0,3,.000,0,3,.000,0,0,,.000,1,4,.250,0,1,1,11,0,0,5,3,1
3531,PHI,1995,Alaa Abdelnaby,26,3,0,30,1,11,.091,0,0,,1,11,.091,.091,0,0,,3,5,8,0,0,0,5,2,2
3532,PHI,1994,Clarence Weatherspoon,23,82,82,3147,602,1246,.483,4,17,.235,598,1229,.487,.485,298,430,.693,254,578,832,192,100,116,195,152,1506
3533,PHI,1994,Dana Barros,26,81,70,2519,412,878,.469,135,354,.381,277,524,.529,.546,116,145,.800,28,168,196,424,107,5,167,96,1075
3534,PHI,1994,Tim Perry,28,80,68,2336,272,625,.435,73,200,.365,199,425,.468,.494,102,176,.580,117,287,404,94,60,82,80,154,719
3535,PHI,1994,Jeff Hornacek,30,53,53,1994,325,715,.455,52,166,.313,273,549,.497,.491,178,204,.873,41,171,212,315,95,10,138,115,880
3536,PHI,1994,Orlando Woolridge,34,74,1,1955,364,773,.471,1,14,.071,363,759,.478,.472,208,302,.689,103,195,298,139,41,56,142,186,937
3537,PHI,1994,Shawn Bradley,21,49,45,1385,201,491,.409,0,3,.000,201,488,.412,.409,102,168,.607,98,208,306,98,45,147,148,170,504
3538,PHI,1994,Johnny Dawkins,30,72,12,1343,177,423,.418,37,105,.352,140,318,.440,.462,84,100,.840,28,95,123,263,63,5,111,74,475
3539,PHI,1994,Eric Leckner,27,71,36,1163,139,286,.486,0,2,.000,139,284,.489,.486,84,130,.646,75,207,282,86,18,34,86,190,362
3540,PHI,1994,Jeff Malone,32,27,23,903,187,389,.481,4,6,.667,183,383,.478,.486,76,94,.809,23,61,84,59,14,0,28,46,454
3541,PHI,1994,Greg Graham,23,70,6,889,122,305,.400,2,25,.080,120,280,.429,.403,92,110,.836,21,65,86,66,61,4,65,54,338
3542,PHI,1994,Warren Kidd,23,68,14,884,100,169,.592,0,0,,100,169,.592,.592,47,86,.547,76,157,233,19,19,23,44,129,247
3543,PHI,1994,Moses Malone,38,55,0,618,102,232,.440,0,1,.000,102,231,.442,.440,90,117,.769,106,120,226,34,11,17,59,52,294
3544,PHI,1994,Sean Green,23,35,0,332,63,182,.346,10,41,.244,53,141,.376,.374,13,18,.722,10,24,34,16,18,6,27,21,149
3545,PHI,1994,Isaac Austin,24,14,0,201,29,66,.439,0,1,.000,29,65,.446,.439,14,23,.609,25,44,69,17,5,10,17,29,72
3546,PHI,1994,Manute Bol,31,4,0,49,3,7,.429,0,0,,3,7,.429,.429,0,0,,2,4,6,0,2,9,0,8,6
3547,PHI,1994,Bill Edwards,22,3,0,44,2,18,.111,0,5,.000,2,13,.154,.111,2,5,.400,5,9,14,4,3,1,4,6,6
3548,PHI,1994,Michael Curry,25,10,0,43,3,14,.214,0,2,.000,3,12,.250,.214,3,4,.750,0,1,1,1,1,0,3,6,9
3549,PHI,1993,Hersey Hawkins,26,81,81,2977,551,1172,.470,122,307,.397,429,865,.496,.522,419,487,.860,91,255,346,317,137,30,180,189,1643
3550,PHI,1993,Jeff Hornacek,29,79,78,2860,582,1239,.470,97,249,.390,485,990,.490,.509,250,289,.865,84,258,342,548,131,21,222,203,1511
3551,PHI,1993,Clarence Weatherspoon,22,82,82,2654,494,1053,.469,1,4,.250,493,1049,.470,.470,291,408,.713,179,410,589,147,85,67,176,188,1280
3552,PHI,1993,Tim Perry,27,81,51,2104,287,613,.468,10,49,.204,277,564,.491,.476,147,207,.710,154,255,409,126,40,91,123,159,731
3553,PHI,1993,Andrew Lang,26,73,59,1861,149,351,.425,1,5,.200,148,346,.428,.426,87,114,.763,136,300,436,79,46,141,89,261,386
3554,PHI,1993,Armen Gilliam,28,80,26,1742,359,774,.464,0,1,.000,359,773,.464,.464,274,325,.843,136,336,472,116,37,54,157,123,992
3555,PHI,1993,Johnny Dawkins,29,74,10,1598,258,590,.437,26,84,.310,232,506,.458,.459,113,142,.796,33,103,136,339,80,4,121,91,655
3556,PHI,1993,Ron Anderson,34,69,0,1263,225,544,.414,39,120,.325,186,424,.439,.449,72,89,.809,62,122,184,93,31,5,63,75,561
3557,PHI,1993,Greg Grant,26,72,0,996,77,220,.350,20,68,.294,57,152,.375,.395,20,31,.645,24,43,67,206,43,1,54,73,194
3558,PHI,1993,Manute Bol,30,58,23,855,52,127,.409,10,32,.313,42,95,.442,.449,12,19,.632,44,149,193,18,14,119,50,87,126
3559,PHI,1993,Charles Shackleford,26,48,0,568,80,164,.488,0,2,.000,80,162,.494,.488,31,49,.633,65,140,205,26,13,25,36,92,191
3560,PHI,1993,Eddie Lee Wilkins,30,26,0,192,55,97,.567,0,2,.000,55,95,.579,.567,48,78,.615,14,26,40,2,7,1,17,34,158
3561,PHI,1993,Kenny Payne,26,13,0,154,38,90,.422,4,18,.222,34,72,.472,.444,4,4,1.000,4,20,24,18,5,2,7,15,84
3562,PHI,1993,Thomas Jordan,24,4,0,106,18,41,.439,0,0,,18,41,.439,.439,8,17,.471,5,14,19,3,3,5,12,14,44
3563,PHI,1992,Hersey Hawkins,25,81,81,3013,521,1127,.462,91,229,.397,430,898,.479,.503,403,461,.874,53,218,271,248,157,43,189,174,1536
3564,PHI,1992,Charles Barkley,28,75,75,2881,622,1126,.552,32,137,.234,590,989,.597,.567,454,653,.695,271,559,830,308,136,44,235,196,1730
3565,PHI,1992,Johnny Dawkins,28,82,82,2815,394,902,.437,36,101,.356,358,801,.447,.457,164,186,.882,42,185,227,567,89,5,183,158,988
3566,PHI,1992,Armen Gilliam,27,81,81,2771,512,1001,.511,0,2,.000,512,999,.513,.511,343,425,.807,234,426,660,118,51,85,166,176,1367
3567,PHI,1992,Ron Anderson,33,82,11,2432,469,1008,.465,42,127,.331,427,881,.485,.486,143,163,.877,96,182,278,135,86,11,109,128,1123
3568,PHI,1992,Charles Shackleford,25,72,62,1399,205,422,.486,0,1,.000,205,421,.487,.486,63,95,.663,145,270,415,46,38,51,62,205,473
3569,PHI,1992,Manute Bol,29,71,2,1267,49,128,.383,0,9,.000,49,119,.412,.383,12,26,.462,54,168,222,22,11,205,41,139,110
3570,PHI,1992,Greg Grant,25,55,0,834,99,217,.456,7,18,.389,92,199,.462,.472,19,22,.864,13,52,65,199,37,2,41,73,224
3571,PHI,1992,Jayson Williams,23,50,8,646,75,206,.364,0,0,,75,206,.364,.364,56,88,.636,62,83,145,12,20,20,44,110,206
3572,PHI,1992,Mitchell Wiggins,32,49,0,569,88,229,.384,0,1,.000,88,228,.386,.384,35,51,.686,43,51,94,22,20,1,25,67,211
3573,PHI,1992,Kenny Payne,25,49,3,353,65,145,.448,5,12,.417,60,133,.451,.466,9,13,.692,13,41,54,17,16,8,19,34,144
3574,PHI,1992,Brian Oliver,23,34,0,279,33,100,.330,0,4,.000,33,96,.344,.330,15,22,.682,10,20,30,20,10,2,24,33,81
3575,PHI,1992,Tharon Mayes,23,21,0,215,28,94,.298,14,39,.359,14,55,.255,.372,20,30,.667,3,12,15,32,14,1,28,32,90
3576,PHI,1992,Jeff Ruland,33,13,5,209,20,38,.526,0,0,,20,38,.526,.526,11,16,.688,16,31,47,5,7,4,20,45,51
3577,PHI,1992,Dave Hoppen,27,11,0,40,2,7,.286,0,0,,2,7,.286,.286,5,10,.500,1,9,10,2,0,0,3,6,9
3578,PHI,1992,Michael Ansley,24,8,0,32,5,11,.455,0,0,,5,11,.455,.455,5,6,.833,2,2,4,2,0,0,3,6,15
3579,PHI,1991,Hersey Hawkins,24,80,80,3110,590,1251,.472,108,270,.400,482,981,.491,.515,479,550,.871,48,262,310,299,178,39,213,182,1767
3580,PHI,1991,Charles Barkley,27,67,67,2498,665,1167,.570,44,155,.284,621,1012,.614,.589,475,658,.722,258,422,680,284,110,33,210,173,1849
3581,PHI,1991,Rick Mahorn,32,80,74,2439,261,559,.467,0,9,.000,261,550,.475,.467,189,240,.788,151,470,621,118,79,56,127,276,711
3582,PHI,1991,Ron Anderson,32,82,13,2340,512,1055,.485,9,43,.209,503,1012,.497,.490,165,198,.833,103,264,367,115,65,13,100,163,1198
3583,PHI,1991,Rickey Green,36,79,75,2248,334,722,.463,8,36,.222,326,686,.475,.468,117,141,.830,33,104,137,413,57,6,108,130,793
3584,PHI,1991,Armen Gilliam,26,50,50,1695,292,621,.470,0,2,.000,292,619,.472,.470,164,201,.816,134,230,364,78,35,32,110,120,748
3585,PHI,1991,Manute Bol,28,82,6,1522,65,164,.396,1,14,.071,64,150,.427,.399,24,41,.585,66,284,350,20,16,247,63,184,155
3586,PHI,1991,Andre Turner,26,70,1,1407,168,383,.439,12,33,.364,156,350,.446,.454,64,87,.736,36,116,152,311,63,0,95,124,412
3587,PHI,1991,Brian Oliver,22,73,4,800,111,272,.408,5,18,.278,106,254,.417,.417,52,71,.732,18,62,80,88,34,4,50,76,279
3588,PHI,1991,Mike Gminski,31,30,29,791,109,284,.384,1,8,.125,108,276,.391,.386,53,63,.841,71,130,201,33,16,34,31,41,272
3589,PHI,1991,Jayson Williams,22,52,1,508,72,161,.447,1,2,.500,71,159,.447,.450,37,56,.661,41,70,111,16,9,6,40,92,182
3590,PHI,1991,Kenny Payne,24,47,6,444,68,189,.360,4,18,.222,64,171,.374,.370,26,29,.897,17,49,66,16,10,6,21,43,166
3591,PHI,1991,Johnny Dawkins,27,4,4,124,26,41,.634,1,4,.250,25,37,.676,.646,10,11,.909,0,16,16,28,3,0,8,4,63
3592,PHI,1991,Dave Hoppen,26,11,0,43,6,12,.500,0,1,.000,6,11,.545,.500,8,12,.667,4,5,9,0,1,0,1,11,20
3593,PHI,1991,Tony Harris,23,6,0,41,4,16,.250,0,2,.000,4,14,.286,.250,2,4,.500,0,1,1,0,1,0,3,5,10
3594,PHI,1991,Robert Reid,35,3,0,37,2,14,.143,0,0,,2,14,.143,.143,0,0,,2,7,9,4,1,3,3,3,4
3595,PHI,1991,Mario Elie,27,3,0,20,2,7,.286,1,2,.500,1,5,.200,.357,1,2,.500,0,1,1,1,0,0,3,2,6
3596,PHI,1991,Jim Farmer,26,2,0,13,2,7,.286,0,1,.000,2,6,.333,.286,2,2,1.000,2,3,5,0,0,0,1,0,6
3597,PHI,1990,Charles Barkley,26,79,79,3085,706,1177,.600,20,92,.217,686,1085,.632,.608,557,744,.749,361,548,909,307,148,50,243,250,1989
3598,PHI,1990,Johnny Dawkins,26,81,81,2865,465,950,.489,22,66,.333,443,884,.501,.501,210,244,.861,48,199,247,601,121,9,214,159,1162
3599,PHI,1990,Hersey Hawkins,23,82,82,2856,522,1136,.460,84,200,.420,438,936,.468,.496,387,436,.888,85,219,304,261,130,28,185,217,1515
3600,PHI,1990,Mike Gminski,30,81,81,2659,458,1002,.457,3,17,.176,455,985,.462,.459,193,235,.821,196,491,687,128,43,102,98,136,1112
3601,PHI,1990,Rick Mahorn,31,75,66,2271,313,630,.497,2,9,.222,311,621,.501,.498,183,256,.715,167,401,568,98,44,103,104,251,811
3602,PHI,1990,Ron Anderson,31,78,3,2089,379,841,.451,3,21,.143,376,820,.459,.452,165,197,.838,81,214,295,143,72,13,78,143,926
3603,PHI,1990,Derek Smith,28,75,7,1405,261,514,.508,16,36,.444,245,478,.513,.523,130,186,.699,62,110,172,109,35,20,85,198,668
3604,PHI,1990,Scott Brooks,24,72,1,975,119,276,.431,31,79,.392,88,197,.447,.487,50,57,.877,15,49,64,207,47,0,38,105,319
3605,PHI,1990,Bob Thornton,27,56,0,592,48,112,.429,1,3,.333,47,109,.431,.433,26,51,.510,45,88,133,17,20,12,35,105,123
3606,PHI,1990,Kurt Nimphius,31,38,1,314,38,91,.418,0,1,.000,38,90,.422,.418,14,30,.467,22,39,61,6,4,18,12,45,90
3607,PHI,1990,Jay Vincent,30,17,5,259,45,105,.429,1,1,1.000,44,104,.423,.433,33,37,.892,13,23,36,8,10,2,14,23,124
3608,PHI,1990,Kenny Payne,23,35,4,216,47,108,.435,4,10,.400,43,98,.439,.454,16,18,.889,11,15,26,10,7,6,20,37,114
3609,PHI,1990,Lanard Copeland,24,23,0,110,31,68,.456,1,5,.200,30,63,.476,.463,11,14,.786,4,6,10,9,1,1,19,12,74
3610,PHI,1990,Corey Gaines,24,9,0,81,4,12,.333,1,2,.500,3,10,.300,.375,1,4,.250,1,4,5,26,4,0,10,11,10
3611,PHI,1990,Dexter Shouse,26,3,0,18,0,4,.000,0,1,.000,0,3,.000,.000,0,0,,0,0,0,2,1,1,2,2,0
3612,PHI,1990,Lewis Lloyd,30,2,0,10,1,2,.500,0,0,,1,2,.500,.500,0,0,,0,0,0,0,0,0,4,3,2
3613,PHI,1989,Charles Barkley,25,79,79,3088,700,1208,.579,35,162,.216,665,1046,.636,.594,602,799,.753,403,583,986,325,126,67,254,262,2037
3614,PHI,1989,Mike Gminski,29,82,82,2739,556,1166,.477,0,6,.000,556,1160,.479,.477,297,341,.871,213,556,769,138,46,106,129,142,1409
3615,PHI,1989,Ron Anderson,30,82,12,2618,566,1152,.491,2,11,.182,564,1141,.494,.492,196,229,.856,167,239,406,139,71,23,126,166,1330
3616,PHI,1989,Hersey Hawkins,22,79,79,2577,442,971,.455,71,166,.428,371,805,.461,.492,241,290,.831,51,174,225,239,120,37,158,184,1196
3617,PHI,1989,Maurice Cheeks,32,71,70,2298,336,696,.483,1,13,.077,335,683,.490,.483,151,195,.774,39,144,183,554,105,17,116,114,824
3618,PHI,1989,Scott Brooks,23,82,6,1372,156,371,.420,55,153,.359,101,218,.463,.495,61,69,.884,19,75,94,306,69,3,65,116,428
3619,PHI,1989,Gerald Henderson,33,65,0,986,144,348,.414,33,107,.308,111,241,.461,.461,104,127,.819,17,51,68,140,42,3,73,121,425
3620,PHI,1989,Chris Welp,25,72,0,843,99,222,.446,0,1,.000,99,221,.448,.446,48,73,.658,59,134,193,29,23,41,42,176,246
3621,PHI,1989,Ben Coleman,27,58,11,703,117,241,.485,0,0,,117,241,.485,.485,61,77,.792,49,128,177,17,10,18,48,120,295
3622,PHI,1989,Derek Smith,27,36,18,695,105,220,.477,4,16,.250,101,204,.495,.486,65,93,.699,31,55,86,68,24,15,44,100,279
3623,PHI,1989,Shelton Jones,22,42,34,577,81,179,.453,0,1,.000,81,178,.455,.453,50,67,.746,24,71,95,33,16,13,39,50,212
3624,PHI,1989,Bob Thornton,26,54,0,449,47,111,.423,1,3,.333,46,108,.426,.428,32,60,.533,36,56,92,15,8,7,23,87,127
3625,PHI,1989,Cliff Robinson,28,14,13,416,90,187,.481,0,1,.000,90,186,.484,.481,32,44,.727,19,56,75,32,17,2,34,37,212
3626,PHI,1989,David Wingate,25,33,6,372,54,115,.470,2,6,.333,52,109,.477,.478,27,34,.794,12,25,37,73,9,2,35,43,137
3627,PHI,1989,Pete Myers,25,4,0,40,6,12,.500,0,0,,6,12,.500,.500,2,4,.500,3,7,10,2,3,0,4,3,14
3628,PHI,1989,Jim Rowinski,28,3,0,7,1,2,.500,0,0,,1,2,.500,.500,1,2,.500,1,2,3,0,0,0,0,0,3
3629,PHI,1988,Charles Barkley,24,80,80,3170,753,1283,.587,44,157,.280,709,1126,.630,.604,714,951,.751,385,566,951,254,100,103,304,278,2264
3630,PHI,1988,Maurice Cheeks,31,79,79,2871,428,865,.495,3,22,.136,425,843,.504,.497,227,275,.825,59,194,253,635,167,22,160,116,1086
3631,PHI,1988,Cliff Robinson,27,62,51,2110,483,1041,.464,2,9,.222,481,1032,.466,.465,210,293,.717,116,289,405,131,79,39,161,192,1178
3632,PHI,1988,Mike Gminski,28,47,47,1767,290,652,.445,0,0,,290,652,.445,.445,212,226,.938,163,331,494,84,36,85,94,98,792
3633,PHI,1988,Albert King,28,72,44,1593,211,540,.391,17,49,.347,194,491,.395,.406,78,103,.757,71,145,216,109,39,18,93,219,517
3634,PHI,1988,Gerald Henderson,32,69,3,1436,189,439,.431,67,159,.421,122,280,.436,.507,136,168,.810,26,71,97,218,67,5,125,173,581
3635,PHI,1988,David Wingate,24,61,22,1419,218,545,.400,10,40,.250,208,505,.412,.409,99,132,.750,44,57,101,119,47,22,104,125,545
3636,PHI,1988,Roy Hinson,26,29,10,845,123,272,.452,0,1,.000,123,271,.454,.452,89,124,.718,53,116,169,27,24,68,63,90,335
3637,PHI,1988,Ben Coleman,26,43,14,841,110,213,.516,0,1,.000,110,212,.519,.516,76,101,.752,58,119,177,23,15,25,55,120,296
3638,PHI,1988,Danny Vranes,29,57,5,772,53,121,.438,0,3,.000,53,118,.449,.438,15,35,.429,45,72,117,36,27,33,25,100,121
3639,PHI,1988,Tim McCormick,25,23,17,601,71,138,.514,0,0,,71,138,.514,.514,37,53,.698,49,95,144,26,14,8,35,75,179
3640,PHI,1988,Mark McNamara,28,42,18,581,52,133,.391,0,0,,52,133,.391,.391,48,66,.727,66,91,157,18,4,12,26,67,152
3641,PHI,1988,Andrew Toney,30,29,15,522,72,171,.421,9,27,.333,63,144,.438,.447,58,72,.806,8,39,47,108,11,6,50,35,211
3642,PHI,1988,Bob Thornton,25,41,2,508,59,111,.532,0,2,.000,59,109,.541,.532,29,47,.617,41,58,99,11,9,3,27,80,147
3643,PHI,1988,Dave Henderson,23,22,1,351,47,116,.405,0,1,.000,47,115,.409,.405,32,47,.681,11,24,35,34,12,5,40,41,126
3644,PHI,1988,Vincent Askew,21,14,2,234,22,74,.297,0,0,,22,74,.297,.297,8,11,.727,6,16,22,33,10,6,12,12,52
3645,PHI,1988,Steve Colter,25,12,0,152,15,40,.375,0,0,,15,40,.375,.375,7,9,.778,7,11,18,26,6,0,11,20,37
3646,PHI,1988,Chris Welp,24,10,0,132,18,31,.581,0,0,,18,31,.581,.581,12,18,.667,11,13,24,5,5,5,9,25,48
3647,PHI,1987,Tim McCormick,24,81,79,2817,391,718,.545,0,4,.000,391,714,.548,.545,251,349,.719,180,431,611,114,36,64,153,270,1033
3648,PHI,1987,Charles Barkley,23,68,62,2740,557,937,.594,21,104,.202,536,833,.643,.606,429,564,.761,390,604,994,331,119,104,322,252,1564
3649,PHI,1987,Maurice Cheeks,30,68,68,2624,415,788,.527,4,17,.235,411,771,.533,.529,227,292,.777,47,168,215,538,180,15,173,109,1061
3650,PHI,1987,Roy Hinson,25,76,58,2489,393,823,.478,0,1,.000,393,822,.478,.478,273,360,.758,150,338,488,60,45,161,149,281,1059
3651,PHI,1987,Julius Erving,36,60,60,1918,400,850,.471,14,53,.264,386,797,.484,.479,191,235,.813,115,149,264,191,76,94,158,137,1005
3652,PHI,1987,David Wingate,23,77,9,1612,259,602,.430,13,52,.250,246,550,.447,.441,149,201,.741,70,86,156,155,93,19,128,169,680
3653,PHI,1987,Cliff Robinson,26,55,30,1586,338,729,.464,0,4,.000,338,725,.466,.464,139,184,.755,86,221,307,89,86,30,123,150,815
3654,PHI,1987,Andrew Toney,29,52,12,1058,197,437,.451,22,67,.328,175,370,.473,.476,133,167,.796,16,69,85,188,18,8,112,78,549
3655,PHI,1987,Steve Colter,24,43,13,849,120,255,.471,4,8,.500,116,247,.470,.478,49,68,.721,14,52,66,116,37,6,38,61,293
3656,PHI,1987,Danny Vranes,28,58,6,817,59,138,.428,1,5,.200,58,133,.436,.431,21,45,.467,51,95,146,30,35,25,26,127,140
3657,PHI,1987,Sedale Threatt,25,28,8,668,108,261,.414,7,16,.438,101,245,.412,.427,42,53,.792,18,39,57,82,32,4,47,76,265
3658,PHI,1987,World B. Free,33,20,2,285,39,123,.317,2,9,.222,37,114,.325,.325,36,47,.766,5,14,19,30,5,4,18,26,116
3659,PHI,1987,Kenny Green,22,19,0,172,25,70,.357,0,0,,25,70,.357,.357,14,19,.737,6,22,28,7,4,2,15,8,64
3660,PHI,1987,Jeff Ruland,28,5,2,116,19,28,.679,0,0,,19,28,.679,.679,9,12,.750,12,16,28,10,0,4,10,13,47
3661,PHI,1987,Mark McNamara,27,11,1,113,14,30,.467,0,0,,14,30,.467,.467,7,19,.368,17,19,36,2,1,0,8,17,35
3662,PHI,1987,Jim Lampley,26,1,0,16,1,3,.333,0,0,,1,3,.333,.333,1,2,.500,1,4,5,0,1,0,1,0,3
3663,PHI,1986,Maurice Cheeks,29,82,82,3270,490,913,.537,4,17,.235,486,896,.542,.539,282,335,.842,55,180,235,753,207,27,238,160,1266
3664,PHI,1986,Charles Barkley,22,80,80,2952,595,1041,.572,17,75,.227,578,966,.598,.580,396,578,.685,354,672,1026,312,173,125,350,333,1603
3665,PHI,1986,Moses Malone,30,74,74,2706,571,1246,.458,0,1,.000,571,1245,.459,.458,617,784,.787,339,533,872,90,67,71,261,194,1759
3666,PHI,1986,Julius Erving,35,74,74,2474,521,1085,.480,9,32,.281,512,1053,.486,.484,289,368,.785,169,201,370,248,113,82,214,196,1340
3667,PHI,1986,Sedale Threatt,24,70,27,1754,310,684,.453,1,24,.042,309,660,.468,.454,75,90,.833,21,100,121,193,93,5,102,157,696
3668,PHI,1986,Bobby Jones,34,70,42,1519,189,338,.559,0,1,.000,189,337,.561,.559,114,145,.786,49,120,169,126,48,50,90,159,492
3669,PHI,1986,Terry Catledge,22,64,7,1092,202,431,.469,0,4,.000,202,427,.473,.469,90,139,.647,107,165,272,21,31,8,69,127,494
3670,PHI,1986,Clemon Johnson,29,75,2,1069,105,223,.471,0,0,,105,223,.471,.471,51,81,.630,106,149,255,15,23,62,38,129,261
3671,PHI,1986,Perry Moss,27,60,0,852,95,239,.397,5,25,.200,90,214,.421,.408,54,74,.730,25,65,90,89,50,12,61,106,249
3672,PHI,1986,Bob McAdoo,34,29,0,609,116,251,.462,0,0,,116,251,.462,.462,62,81,.765,25,78,103,35,10,18,49,64,294
3673,PHI,1986,Leon Wood,23,29,1,455,57,136,.419,13,29,.448,44,107,.411,.467,27,34,.794,9,18,27,75,14,0,7,24,154
3674,PHI,1986,Paul Thompson,24,23,8,432,70,194,.361,2,12,.167,68,182,.374,.366,37,43,.860,27,36,63,24,15,17,30,49,179
3675,PHI,1986,Greg Stokes,22,31,13,350,56,119,.471,0,1,.000,56,118,.475,.471,14,21,.667,27,30,57,17,14,11,19,56,126
3676,PHI,1986,Kenny Green,21,21,0,232,39,91,.429,0,0,,39,91,.429,.429,14,23,.609,10,25,35,6,1,2,18,27,92
3677,PHI,1986,Andrew Toney,28,6,0,84,11,36,.306,0,2,.000,11,34,.324,.306,3,8,.375,2,3,5,12,2,0,7,8,25
3678,PHI,1986,Butch Carter,27,4,0,36,5,16,.313,0,0,,5,16,.313,.313,5,6,.833,0,1,1,1,0,0,1,8,15
3679,PHI,1986,Voise Winters,23,4,0,17,3,13,.231,0,1,.000,3,12,.250,.231,0,0,,1,2,3,0,1,0,2,1,6
3680,PHI,1986,Michael Young,25,2,0,2,0,2,.000,0,0,,0,2,.000,.000,0,0,,0,0,0,0,0,0,0,0,0
3681,PHI,1985,Moses Malone,29,79,79,2957,602,1284,.469,0,2,.000,602,1282,.470,.469,737,904,.815,385,646,1031,130,67,123,286,216,1941
3682,PHI,1985,Maurice Cheeks,28,78,78,2616,422,741,.570,6,26,.231,416,715,.582,.574,175,199,.879,54,163,217,497,169,24,155,184,1025
3683,PHI,1985,Julius Erving,34,78,78,2535,610,1236,.494,3,14,.214,607,1222,.497,.495,338,442,.765,172,242,414,233,135,109,208,199,1561
3684,PHI,1985,Charles Barkley,21,82,60,2347,427,783,.545,1,6,.167,426,777,.548,.546,293,400,.733,266,437,703,155,95,80,209,301,1148
3685,PHI,1985,Andrew Toney,27,70,65,2237,450,914,.492,39,105,.371,411,809,.508,.514,306,355,.862,35,142,177,363,65,24,224,211,1245
3686,PHI,1985,Bobby Jones,33,80,8,1633,207,385,.538,0,4,.000,207,381,.543,.538,186,216,.861,105,192,297,155,84,50,118,183,600
3687,PHI,1985,Clint Richardson,28,74,20,1531,183,404,.453,1,3,.333,182,401,.454,.454,76,89,.854,60,95,155,157,37,15,78,143,443
3688,PHI,1985,Sedale Threatt,23,82,0,1304,188,416,.452,4,22,.182,184,394,.467,.457,66,90,.733,21,78,99,175,80,16,99,171,446
3689,PHI,1985,Clemon Johnson,28,58,0,875,117,235,.498,0,1,.000,117,234,.500,.498,36,49,.735,92,129,221,33,15,44,43,112,270
3690,PHI,1985,George Johnson,28,55,3,756,107,263,.407,1,10,.100,106,253,.419,.409,49,56,.875,48,116,164,38,31,16,49,99,264
3691,PHI,1985,Sam Williams,25,46,8,488,58,148,.392,0,1,.000,58,147,.395,.392,28,47,.596,38,68,106,11,26,26,44,92,144
3692,PHI,1985,Leon Wood,22,38,1,269,50,134,.373,4,30,.133,46,104,.442,.388,18,26,.692,3,15,18,45,8,0,25,17,122
3693,PHI,1985,Marc Iavaroni,28,12,10,156,12,31,.387,0,0,,12,31,.387,.387,6,6,1.000,11,18,29,6,4,3,16,24,30
3694,PHI,1985,Steve Hayes,29,11,0,101,10,18,.556,0,0,,10,18,.556,.556,2,4,.500,11,23,34,1,1,4,2,19,22
3695,PHI,1984,Julius Erving,33,77,77,2683,678,1324,.512,7,21,.333,671,1303,.515,.515,364,483,.754,190,342,532,309,141,139,230,217,1727
3696,PHI,1984,Moses Malone,28,71,71,2613,532,1101,.483,0,4,.000,532,1097,.485,.483,545,727,.750,352,598,950,96,71,110,250,188,1609
3697,PHI,1984,Andrew Toney,26,78,72,2556,593,1125,.527,12,38,.316,581,1087,.534,.532,390,465,.839,57,136,193,373,70,23,297,251,1588
3698,PHI,1984,Maurice Cheeks,27,75,75,2494,386,702,.550,8,20,.400,378,682,.554,.556,170,232,.733,44,161,205,478,171,20,182,196,950
3699,PHI,1984,Bobby Jones,32,75,0,1761,226,432,.523,0,1,.000,226,431,.524,.523,167,213,.784,92,231,323,187,107,103,101,199,619
3700,PHI,1984,Clemon Johnson,27,80,10,1721,193,412,.468,0,0,,193,412,.468,.468,69,113,.611,131,267,398,55,35,65,95,205,455
3701,PHI,1984,Clint Richardson,27,69,12,1571,221,473,.467,0,4,.000,221,469,.471,.467,79,103,.767,62,103,165,155,49,23,100,145,521
3702,PHI,1984,Marc Iavaroni,27,78,71,1532,149,322,.463,0,2,.000,149,320,.466,.463,97,131,.740,91,219,310,95,36,55,124,222,395
3703,PHI,1984,Sam Williams,24,70,12,1375,193,405,.477,0,1,.000,193,404,.478,.477,86,133,.647,117,209,326,60,62,103,96,203,472
3704,PHI,1984,Franklin Edwards,24,60,0,654,84,221,.380,0,1,.000,84,220,.382,.380,34,48,.708,12,47,59,90,31,5,46,78,202
3705,PHI,1984,Sedale Threatt,22,45,0,464,62,148,.419,1,8,.125,61,140,.436,.422,23,28,.821,17,23,40,41,13,2,33,65,148
3706,PHI,1984,Wes Matthews,24,14,5,292,45,101,.446,1,7,.143,44,94,.468,.450,9,14,.643,6,17,23,62,11,2,30,32,100
3707,PHI,1984,Leo Rautins,23,28,3,196,21,58,.362,0,0,,21,58,.362,.362,6,10,.600,9,24,33,29,9,2,19,31,48
3708,PHI,1984,Bruce Kuczenski,22,3,2,40,1,8,.125,0,0,,1,8,.125,.125,1,2,.500,1,5,6,2,1,1,5,7,3
3709,PHI,1984,Charles Jones,26,1,0,3,0,1,.000,0,0,,0,1,.000,.000,1,4,.250,0,0,0,0,0,0,0,1,1
3710,PHI,1983,Moses Malone,27,78,78,2922,654,1305,.501,0,1,.000,654,1304,.502,.501,600,788,.761,445,749,1194,101,89,157,264,206,1908
3711,PHI,1983,Andrew Toney,25,81,81,2474,626,1250,.501,22,76,.289,604,1174,.514,.510,324,411,.788,42,183,225,365,80,17,271,255,1598
3712,PHI,1983,Maurice Cheeks,26,79,79,2465,404,745,.542,1,6,.167,403,739,.545,.543,181,240,.754,53,156,209,543,184,31,179,182,990
3713,PHI,1983,Julius Erving,32,72,72,2421,605,1170,.517,2,7,.286,603,1163,.518,.518,330,435,.759,173,318,491,263,112,131,196,202,1542
3714,PHI,1983,Clint Richardson,26,77,1,1755,259,559,.463,0,6,.000,259,553,.468,.463,71,111,.640,98,149,247,168,71,18,99,164,589
3715,PHI,1983,Bobby Jones,31,74,0,1749,250,460,.543,0,1,.000,250,459,.545,.543,165,208,.793,102,242,344,142,85,91,109,199,665
3716,PHI,1983,Marc Iavaroni,26,80,77,1612,163,353,.462,0,2,.000,163,351,.464,.462,78,113,.690,117,212,329,83,32,44,133,238,404
3717,PHI,1983,Franklin Edwards,23,81,3,1266,228,483,.472,0,8,.000,228,475,.480,.472,86,113,.761,23,62,85,221,81,6,110,119,542
3718,PHI,1983,Earl Cureton,25,73,3,987,108,258,.419,0,0,,108,258,.419,.419,33,67,.493,84,185,269,43,37,24,76,144,249
3719,PHI,1983,Russ Schoene,22,46,2,702,106,207,.512,0,1,.000,106,206,.515,.512,21,28,.750,52,102,154,32,13,9,46,118,233
3720,PHI,1983,Clemon Johnson,26,32,4,698,91,182,.500,0,0,,91,182,.500,.500,34,58,.586,75,130,205,24,16,29,36,84,216
3721,PHI,1983,Reggie Johnson,25,29,8,549,69,154,.448,0,0,,69,154,.448,.448,22,30,.733,32,58,90,23,8,17,35,82,160
3722,PHI,1983,Mark McNamara,23,36,2,182,29,64,.453,0,0,,29,64,.453,.453,20,45,.444,34,42,76,7,3,3,36,42,78
3723,PHI,1983,J.J. Anderson,22,13,0,48,8,22,.364,0,1,.000,8,21,.381,.364,1,3,.333,4,8,12,1,1,0,5,6,17
3724,PHI,1982,Julius Erving,31,81,81,2789,780,1428,.546,3,11,.273,777,1417,.548,.547,411,539,.763,220,337,557,319,161,141,214,229,1974
3725,PHI,1982,Maurice Cheeks,25,79,79,2498,352,676,.521,6,22,.273,346,654,.529,.525,171,220,.777,51,197,248,667,209,33,184,247,881
3726,PHI,1982,Caldwell Jones,31,81,47,2446,231,465,.497,0,3,.000,231,462,.500,.497,179,219,.817,164,544,708,100,38,146,155,301,641
3727,PHI,1982,Lionel Hollins,28,81,81,2257,380,797,.477,2,16,.125,378,781,.484,.478,132,188,.702,35,152,187,316,103,20,146,198,894
3728,PHI,1982,Bobby Jones,30,76,73,2181,416,737,.564,0,3,.000,416,734,.567,.564,263,333,.790,109,284,393,189,99,112,145,211,1095
3729,PHI,1982,Andrew Toney,24,77,1,1909,511,979,.522,25,59,.424,486,920,.528,.535,227,306,.742,43,91,134,283,64,17,214,269,1274
3730,PHI,1982,Steve Mix,34,75,0,1235,202,399,.506,1,4,.250,201,395,.509,.508,136,172,.791,92,133,225,93,42,17,67,86,541
3731,PHI,1982,Darryl Dawkins,25,48,36,1124,207,367,.564,0,2,.000,207,365,.567,.564,114,164,.695,68,237,305,55,19,55,96,193,528
3732,PHI,1982,Clint Richardson,25,77,0,1040,140,310,.452,2,2,1.000,138,308,.448,.455,69,88,.784,55,63,118,109,36,9,79,109,351
3733,PHI,1982,Mike Bantom,30,43,1,979,156,306,.510,1,3,.333,155,303,.512,.511,67,114,.588,87,139,226,46,25,37,64,133,380
3734,PHI,1982,Earl Cureton,24,66,8,956,149,306,.487,0,2,.000,149,304,.490,.487,51,94,.543,90,180,270,32,31,27,44,142,349
3735,PHI,1982,Franklin Edwards,22,42,3,291,65,150,.433,0,9,.000,65,141,.461,.433,20,27,.741,10,17,27,45,16,5,24,37,150
3736,PHI,1982,Ollie Johnson,32,26,0,150,27,54,.500,1,3,.333,26,51,.510,.509,6,7,.857,7,15,22,10,13,3,13,28,61
3737,PHI,1981,Julius Erving,30,82,82,2874,794,1524,.521,4,18,.222,790,1506,.525,.522,422,536,.787,244,413,657,364,173,147,266,233,2014
3738,PHI,1981,Caldwell Jones,30,81,81,2639,218,485,.449,0,0,,218,485,.449,.449,148,193,.767,200,613,813,122,53,134,168,271,584
3739,PHI,1981,Maurice Cheeks,24,81,81,2415,310,581,.534,3,8,.375,307,573,.536,.536,140,178,.787,67,178,245,560,193,39,174,231,763
3740,PHI,1981,Lionel Hollins,27,82,13,2154,327,696,.470,2,15,.133,325,681,.477,.471,125,171,.731,47,144,191,352,104,18,207,205,781
3741,PHI,1981,Darryl Dawkins,24,76,76,2088,423,697,.607,0,0,,423,697,.607,.607,219,304,.720,106,439,545,109,38,112,220,316,1065
3742,PHI,1981,Bobby Jones,29,81,0,2046,407,755,.539,0,3,.000,407,752,.541,.539,282,347,.813,142,293,435,226,95,74,149,226,1096
3743,PHI,1981,Andrew Toney,23,75,57,1768,399,806,.495,9,29,.310,390,777,.502,.501,161,226,.712,32,111,143,273,59,10,219,234,968
3744,PHI,1981,Steve Mix,33,72,1,1327,288,575,.501,0,3,.000,288,572,.503,.501,200,240,.833,105,159,264,114,59,18,88,107,776
3745,PHI,1981,Clint Richardson,24,77,1,1313,227,464,.489,0,1,.000,227,463,.490,.489,84,108,.778,83,93,176,152,36,10,110,102,538
3746,PHI,1981,Earl Cureton,23,52,6,528,93,205,.454,0,1,.000,93,204,.456,.454,33,64,.516,51,104,155,25,20,23,29,68,219
3747,PHI,1981,Ollie Johnson,31,40,0,372,87,158,.551,1,6,.167,86,152,.566,.554,27,31,.871,8,47,55,30,20,2,25,45,202
3748,PHI,1981,Doug Collins,29,12,12,329,62,126,.492,0,0,,62,126,.492,.492,24,29,.828,6,23,29,42,7,4,22,23,148
3749,PHI,1981,Monti Davis,22,1,0,2,1,1,1.000,0,0,,1,1,1.000,1.000,0,0,,0,1,1,0,0,0,0,0,2
3750,PHI,1980,Julius Erving,29,78,78,2812,838,1614,.519,4,20,.200,834,1594,.523,.520,420,534,.787,215,361,576,355,170,140,284,208,2100
3751,PHI,1980,Caldwell Jones,29,80,80,2771,232,532,.436,0,2,.000,232,530,.438,.436,124,178,.697,219,731,950,164,43,162,218,298,588
3752,PHI,1980,Maurice Cheeks,23,79,79,2623,357,661,.540,4,9,.444,353,652,.541,.543,180,231,.779,75,199,274,556,183,32,216,197,898
3753,PHI,1980,Darryl Dawkins,23,80,80,2541,494,946,.522,0,6,.000,494,940,.526,.522,190,291,.653,197,496,693,149,49,142,230,328,1178
3754,PHI,1980,Bobby Jones,28,81,3,2125,398,748,.532,0,3,.000,398,745,.534,.532,257,329,.781,152,298,450,146,102,118,146,223,1053
3755,PHI,1980,Henry Bibby,30,82,8,2035,251,626,.401,11,52,.212,240,574,.418,.410,226,286,.790,65,143,208,307,62,6,147,161,739
3756,PHI,1980,Steve Mix,32,81,5,1543,363,703,.516,4,10,.400,359,693,.518,.519,207,249,.831,114,176,290,149,67,9,132,114,937
3757,PHI,1980,Clint Richardson,23,52,34,988,159,348,.457,1,3,.333,158,345,.458,.458,28,45,.622,55,68,123,107,24,15,64,97,347
3758,PHI,1980,Doug Collins,28,36,17,963,191,410,.466,0,1,.000,191,409,.467,.466,113,124,.911,29,65,94,100,30,7,82,76,495
3759,PHI,1980,Lionel Hollins,26,27,26,796,130,313,.415,2,10,.200,128,303,.422,.419,67,87,.770,24,45,69,112,46,9,68,68,329
3760,PHI,1980,Jim Spanarkel,22,40,0,442,72,153,.471,0,2,.000,72,151,.477,.471,54,65,.831,27,27,54,51,12,6,57,58,198
3761,PHI,1980,Bernard Toone,23,23,0,124,23,64,.359,1,7,.143,22,57,.386,.367,8,10,.800,12,22,34,12,4,5,16,20,55
3762,PHI,1980,Eric Money,24,6,0,82,14,36,.389,0,0,,14,36,.389,.389,2,2,1.000,3,4,7,16,0,1,12,11,30
3763,PHI,1980,Al Skinner,27,2,0,10,1,2,.500,0,0,,1,2,.500,.500,0,0,,0,0,0,2,0,0,2,1,2
3764,ORL,2024,Paolo Banchero,21,80,80,2799,640,1407,.455,119,351,.339,521,1056,.493,.497,405,559,.725,82,472,554,431,71,47,247,153,1804
3765,ORL,2024,Franz Wagner,22,72,72,2337,528,1096,.482,94,334,.281,434,762,.570,.525,271,319,.850,72,309,381,269,76,28,137,168,1421
3766,ORL,2024,Jalen Suggs,22,75,75,2025,336,714,.471,153,385,.397,183,329,.556,.578,118,156,.756,48,181,229,205,106,47,132,205,943
3767,ORL,2024,Cole Anthony,23,81,0,1817,332,763,.435,93,275,.338,239,488,.490,.496,180,218,.826,64,247,311,236,64,37,126,175,937
3768,ORL,2024,Moritz Wagner,26,80,1,1415,332,552,.601,38,115,.330,294,437,.673,.636,166,204,.814,117,230,347,96,39,21,97,160,868
3769,ORL,2024,Wendell Carter Jr.,24,55,48,1406,223,425,.525,64,171,.374,159,254,.626,.600,93,134,.694,112,269,381,95,35,28,68,121,603
3770,ORL,2024,Gary Harris,29,54,27,1297,131,297,.441,76,205,.371,55,92,.598,.569,34,45,.756,24,67,91,87,49,14,31,91,372
3771,ORL,2024,Joe Ingles,36,68,0,1169,99,227,.436,70,161,.435,29,66,.439,.590,28,34,.824,18,124,142,203,43,5,67,88,296
3772,ORL,2024,Anthony Black,20,69,33,1164,115,247,.466,37,94,.394,78,153,.510,.540,49,80,.613,33,106,139,91,35,21,56,110,316
3773,ORL,2024,Goga Bitadze,24,62,33,957,126,209,.603,2,14,.143,124,195,.636,.608,57,87,.655,109,177,286,79,32,72,44,107,311
3774,ORL,2024,Jonathan Isaac,26,58,2,914,146,286,.510,42,112,.375,104,174,.598,.584,59,82,.720,73,187,260,30,43,70,27,64,393
3775,ORL,2024,Markelle Fultz,25,43,18,910,154,326,.472,4,18,.222,150,308,.487,.479,23,33,.697,56,82,138,120,42,15,50,65,335
3776,ORL,2024,Caleb Houstan,21,59,13,815,80,206,.388,72,193,.373,8,13,.615,.563,21,26,.808,28,56,84,29,15,4,16,61,253
3777,ORL,2024,Chuma Okeke,25,47,8,432,40,112,.357,23,82,.280,17,30,.567,.460,4,7,.571,18,62,80,20,9,7,16,19,107
3778,ORL,2024,Trevelin Queen,26,14,0,165,14,38,.368,3,17,.176,11,21,.524,.408,9,12,.750,3,17,20,18,7,5,7,15,40
3779,ORL,2024,Admiral Schofield,26,23,0,84,10,26,.385,6,16,.375,4,10,.400,.500,0,2,.000,3,14,17,7,1,0,5,9,26
3780,ORL,2024,Jett Howard,20,18,0,67,10,30,.333,7,25,.280,3,5,.600,.450,2,4,.500,1,6,7,6,2,2,3,4,29
3781,ORL,2024,Kevon Harris,26,2,0,6,2,3,.667,0,0,,2,3,.667,.667,0,0,,0,2,2,1,0,0,1,3,4
3782,ORL,2023,Franz Wagner,21,80,80,2609,542,1118,.485,130,360,.361,412,758,.544,.543,271,322,.842,70,259,329,283,77,17,167,183,1485
3783,ORL,2023,Paolo Banchero,20,72,72,2430,479,1122,.427,85,285,.298,394,837,.471,.465,394,534,.738,84,413,497,269,60,39,200,160,1437
3784,ORL,2023,Markelle Fultz,24,60,60,1778,349,679,.514,27,87,.310,322,592,.544,.534,112,143,.783,69,165,234,341,87,26,139,131,837
3785,ORL,2023,Wendell Carter Jr.,23,57,54,1690,322,613,.525,80,225,.356,242,388,.624,.591,144,195,.738,120,377,497,132,30,33,106,159,868
3786,ORL,2023,Cole Anthony,22,60,4,1552,277,610,.454,75,206,.364,202,404,.500,.516,152,170,.894,47,241,288,235,37,31,91,158,781
3787,ORL,2023,Bol Bol,23,70,33,1505,261,478,.546,30,113,.265,231,365,.633,.577,82,108,.759,69,336,405,69,30,85,112,92,634
3788,ORL,2023,Jalen Suggs,21,53,19,1246,186,444,.419,66,202,.327,120,242,.496,.493,86,119,.723,55,106,161,155,67,27,94,120,524
3789,ORL,2023,Gary Harris,28,48,42,1184,138,307,.450,94,218,.431,44,89,.494,.603,27,30,.900,21,77,98,59,45,12,28,93,397
3790,ORL,2023,Moritz Wagner,25,57,18,1109,198,396,.500,51,163,.313,147,233,.631,.564,153,182,.841,69,190,259,84,37,13,68,136,600
3791,ORL,2023,Terrence Ross,31,42,9,944,129,299,.431,61,160,.381,68,139,.489,.533,15,20,.750,10,75,85,54,25,8,37,53,334
3792,ORL,2023,Caleb Houstan,20,51,4,812,66,182,.363,46,136,.338,20,46,.435,.489,15,18,.833,34,65,99,30,12,7,18,63,193
3793,ORL,2023,Mo Bamba,24,40,6,681,106,214,.495,43,108,.398,63,106,.594,.596,35,51,.686,47,137,184,42,12,38,22,86,290
3794,ORL,2023,Chuma Okeke,24,27,8,518,43,122,.352,26,86,.302,17,36,.472,.459,16,21,.762,26,70,96,37,19,11,17,40,128
3795,ORL,2023,Kevon Harris,25,34,0,457,47,107,.439,16,43,.372,31,64,.484,.514,31,41,.756,28,42,70,16,17,5,21,53,141
3796,ORL,2023,Admiral Schofield,25,37,0,451,55,122,.451,24,74,.324,31,48,.646,.549,21,23,.913,23,39,62,31,8,5,16,61,155
3797,ORL,2023,R.J. Hampton,21,26,0,361,50,114,.439,18,53,.340,32,61,.525,.518,31,37,.838,9,30,39,34,16,4,21,22,149
3798,ORL,2023,Goga Bitadze,23,17,1,255,42,73,.575,2,12,.167,40,61,.656,.589,12,18,.667,36,52,88,21,7,16,10,30,98
3799,ORL,2023,Jonathan Isaac,25,11,0,124,22,53,.415,6,15,.400,16,38,.421,.472,5,9,.556,15,29,44,6,14,4,4,5,55
3800,ORL,2023,Michael Carter-Williams,31,4,0,44,6,14,.429,1,3,.333,5,11,.455,.464,4,7,.571,1,4,5,7,1,1,4,5,17
3801,ORL,2023,Jay Scrubb,22,2,0,30,5,7,.714,2,2,1.000,3,5,.600,.857,1,2,.500,0,6,6,1,2,0,3,2,13
3802,ORL,2022,Franz Wagner,20,79,79,2429,456,975,.468,96,271,.354,360,704,.511,.517,189,219,.863,84,272,356,231,68,34,119,164,1197
3803,ORL,2022,Cole Anthony,21,65,65,2059,357,912,.391,132,391,.338,225,521,.432,.464,216,253,.854,32,316,348,369,46,17,170,171,1062
3804,ORL,2022,Wendell Carter Jr.,22,62,61,1852,359,684,.525,70,214,.327,289,470,.615,.576,143,207,.691,139,509,648,171,36,43,117,169,931
3805,ORL,2022,Mo Bamba,23,71,69,1824,296,617,.480,107,281,.381,189,336,.563,.566,57,73,.781,148,424,572,85,38,118,77,182,756
3806,ORL,2022,Chuma Okeke,23,70,20,1749,216,575,.376,118,371,.318,98,204,.480,.478,55,65,.846,47,300,347,118,97,42,57,95,605
3807,ORL,2022,Gary Harris,27,61,30,1730,240,553,.434,116,302,.384,124,251,.494,.539,83,95,.874,36,86,122,108,59,9,61,112,679
3808,ORL,2022,Terrence Ross,30,63,0,1448,220,554,.397,77,264,.292,143,290,.493,.467,112,130,.862,20,141,161,116,28,12,75,68,629
3809,ORL,2022,R.J. Hampton,20,64,14,1402,175,457,.383,64,183,.350,111,274,.405,.453,75,117,.641,23,171,194,158,42,13,87,101,489
3810,ORL,2022,Jalen Suggs,20,48,45,1307,198,548,.361,42,196,.214,156,352,.443,.400,126,163,.773,26,145,171,209,59,19,143,142,564
3811,ORL,2022,Moritz Wagner,24,63,3,960,197,396,.497,66,201,.328,131,195,.672,.581,104,129,.806,42,190,232,87,20,13,56,123,564
3812,ORL,2022,Robin Lopez,33,36,9,612,110,199,.553,2,6,.333,108,193,.560,.558,32,54,.593,68,58,126,54,2,18,44,67,254
3813,ORL,2022,Ignas Brazdeikis,23,42,1,536,81,188,.431,27,87,.310,54,101,.535,.503,21,32,.656,23,49,72,37,10,3,17,48,210
3814,ORL,2022,Admiral Schofield,24,38,1,469,54,129,.419,26,79,.329,28,50,.560,.519,12,15,.800,17,72,89,25,4,5,21,58,146
3815,ORL,2022,Markelle Fultz,23,18,3,360,83,175,.474,4,17,.235,79,158,.500,.486,25,31,.806,4,45,49,99,20,5,40,22,195
3816,ORL,2022,Tim Frazier,31,10,3,200,13,43,.302,6,17,.353,7,26,.269,.372,5,9,.556,5,14,19,33,3,1,13,24,37
3817,ORL,2022,Mychal Mulder,27,15,2,195,20,67,.299,13,46,.283,7,21,.333,.396,2,2,1.000,2,19,21,3,4,1,8,12,55
3818,ORL,2022,Hassani Gravett,25,8,3,171,18,38,.474,11,26,.423,7,12,.583,.618,3,4,.750,1,20,21,20,5,1,9,13,50
3819,ORL,2022,Devin Cannady,25,5,0,145,15,44,.341,15,37,.405,0,7,.000,.511,5,7,.714,1,5,6,10,5,3,5,9,50
3820,ORL,2022,Freddie Gillespie,24,9,2,119,9,22,.409,0,1,.000,9,21,.429,.409,3,7,.429,13,23,36,5,3,9,5,18,21
3821,ORL,2022,Jeff Dowtin,24,4,0,77,5,19,.263,1,7,.143,4,12,.333,.289,2,2,1.000,7,4,11,7,5,0,4,3,13
3822,ORL,2022,Aleem Ford,24,5,0,74,6,20,.300,2,15,.133,4,5,.800,.350,0,0,,2,13,15,2,1,0,4,7,14
3823,ORL,2022,B.J. Johnson,26,4,0,65,11,25,.440,4,10,.400,7,15,.467,.520,0,0,,6,9,15,0,0,1,0,4,26
3824,ORL,2021,Dwayne Bacon,25,72,50,1853,292,726,.402,59,207,.285,233,519,.449,.443,145,176,.824,31,193,224,93,45,5,46,103,788
3825,ORL,2021,Nikola Vučević,30,44,44,1500,436,908,.480,117,288,.406,319,620,.515,.545,91,110,.827,87,430,517,167,42,28,83,79,1080
3826,ORL,2021,Terrence Ross,29,46,2,1347,254,616,.412,89,264,.337,165,352,.469,.485,120,138,.870,15,143,158,108,47,21,74,88,717
3827,ORL,2021,Cole Anthony,20,47,34,1273,219,552,.397,58,172,.337,161,380,.424,.449,109,131,.832,38,183,221,192,30,18,106,98,605
3828,ORL,2021,Chuma Okeke,22,45,19,1133,135,324,.417,49,141,.348,86,183,.470,.492,30,40,.750,42,139,181,101,48,22,38,48,349
3829,ORL,2021,James Ennis III,30,41,37,986,115,243,.473,45,104,.433,70,139,.504,.566,70,87,.805,43,123,166,62,32,7,36,84,345
3830,ORL,2021,Khem Birch,28,48,5,952,94,209,.450,4,21,.190,90,188,.479,.459,63,85,.741,117,126,243,53,32,28,23,67,255
3831,ORL,2021,Chasson Randle,27,41,5,837,92,237,.388,44,130,.338,48,107,.449,.481,38,48,.792,7,75,82,74,22,5,46,64,266
3832,ORL,2021,Michael Carter-Williams,29,31,25,800,105,270,.389,15,61,.246,90,209,.431,.417,49,80,.613,39,100,139,129,25,17,69,81,274
3833,ORL,2021,Evan Fournier,28,26,26,787,170,369,.461,73,188,.388,97,181,.536,.560,98,123,.797,5,70,75,95,27,9,54,55,511
3834,ORL,2021,Aaron Gordon,25,25,25,736,128,293,.437,42,112,.375,86,181,.475,.509,66,105,.629,39,127,166,105,16,20,67,49,364
3835,ORL,2021,Mo Bamba,22,46,5,725,142,301,.472,38,118,.322,104,183,.568,.535,45,66,.682,76,189,265,35,14,58,36,87,367
3836,ORL,2021,R.J. Hampton,19,26,1,655,111,253,.439,22,69,.319,89,184,.484,.482,46,70,.657,19,110,129,73,16,8,42,39,290
3837,ORL,2021,Gary Clark,26,35,11,637,40,131,.305,31,108,.287,9,23,.391,.424,8,10,.800,33,79,112,30,12,7,17,34,119
3838,ORL,2021,Wendell Carter Jr.,21,22,19,583,101,205,.493,7,29,.241,94,176,.534,.510,49,68,.721,62,131,193,35,17,18,29,50,258
3839,ORL,2021,Gary Harris,26,20,19,499,69,189,.365,24,66,.364,45,123,.366,.429,42,48,.875,8,24,32,46,11,7,23,34,204
3840,ORL,2021,Al-Farouq Aminu,30,17,14,367,36,89,.404,7,31,.226,29,58,.500,.444,14,17,.824,20,71,91,29,17,9,25,22,93
3841,ORL,2021,Moritz Wagner,23,11,10,286,38,93,.409,16,43,.372,22,50,.440,.495,29,33,.879,11,43,54,12,4,9,13,36,121
3842,ORL,2021,Ignas Brazdeikis,22,8,0,234,35,79,.443,11,27,.407,24,52,.462,.513,8,12,.667,10,31,41,16,4,3,11,22,89
3843,ORL,2021,Markelle Fultz,22,8,8,215,41,104,.394,4,16,.250,37,88,.420,.413,17,19,.895,5,20,25,43,8,2,18,18,103
3844,ORL,2021,Jordan Bone,23,14,0,196,23,54,.426,10,32,.313,13,22,.591,.519,0,0,,4,20,24,18,2,0,3,11,56
3845,ORL,2021,Donta Hall,23,13,0,179,25,35,.714,0,0,,25,35,.714,.714,23,34,.676,24,38,62,11,5,10,8,18,73
3846,ORL,2021,Sindarius Thornwell,26,7,0,144,8,25,.320,4,14,.286,4,11,.364,.400,4,6,.667,2,11,13,17,8,1,3,12,24
3847,ORL,2021,Robert Franks,24,7,0,101,13,28,.464,5,15,.333,8,13,.615,.554,12,13,.923,6,8,14,5,3,3,2,8,43
3848,ORL,2021,Karim Mané,20,10,0,88,3,13,.231,1,2,.500,2,11,.182,.269,4,5,.800,1,13,14,4,0,2,3,10,11
3849,ORL,2021,Frank Mason III,26,4,1,79,9,24,.375,2,5,.400,7,19,.368,.417,5,7,.714,3,9,12,12,0,0,5,7,25
3850,ORL,2021,Devin Cannady,24,8,0,74,11,28,.393,6,16,.375,5,12,.417,.500,6,7,.857,0,5,5,1,5,1,2,9,34
3851,ORL,2021,Otto Porter Jr.,27,3,0,66,9,25,.360,1,9,.111,8,16,.500,.380,5,5,1.000,0,14,14,5,4,0,0,4,24
3852,ORL,2020,Evan Fournier,27,66,66,2076,434,929,.467,173,434,.399,261,495,.527,.560,180,220,.818,18,153,171,209,71,15,125,161,1221
3853,ORL,2020,Aaron Gordon,24,62,62,2017,335,767,.437,73,237,.308,262,530,.494,.484,151,224,.674,107,368,475,228,51,39,100,125,894
3854,ORL,2020,Nikola Vučević,29,62,62,1998,493,1033,.477,98,289,.339,395,744,.531,.525,131,167,.784,140,533,673,222,54,47,88,135,1215
3855,ORL,2020,Markelle Fultz,21,72,60,1996,359,772,.465,36,135,.267,323,637,.507,.488,116,159,.730,41,197,238,369,90,11,147,142,870
3856,ORL,2020,Terrence Ross,28,69,0,1889,341,846,.403,177,504,.351,164,342,.480,.508,157,184,.853,13,209,222,82,77,24,70,109,1016
3857,ORL,2020,D.J. Augustin,32,57,13,1420,184,461,.399,70,201,.348,114,260,.438,.475,161,181,.890,22,100,122,262,34,1,86,72,599
3858,ORL,2020,Jonathan Isaac,22,34,32,980,156,332,.470,32,94,.340,124,238,.521,.518,60,77,.779,58,173,231,48,53,78,49,83,404
3859,ORL,2020,Wes Iwundu,25,52,21,953,97,233,.416,28,82,.341,69,151,.457,.476,78,97,.804,24,107,131,60,25,13,26,80,300
3860,ORL,2020,Khem Birch,27,48,24,922,73,143,.510,0,1,.000,73,142,.514,.510,66,101,.653,91,129,220,50,20,23,31,91,212
3861,ORL,2020,Mo Bamba,21,62,0,878,132,286,.462,37,107,.346,95,179,.531,.526,31,46,.674,100,202,302,42,23,86,42,116,332
3862,ORL,2020,Michael Carter-Williams,28,45,0,833,111,260,.427,22,75,.293,89,185,.481,.469,79,95,.832,46,101,147,109,49,22,52,87,323
3863,ORL,2020,James Ennis III,29,20,18,489,60,133,.451,18,63,.286,42,70,.600,.519,31,37,.838,23,72,95,22,12,8,27,52,169
3864,ORL,2020,Al-Farouq Aminu,29,18,2,380,25,86,.291,9,36,.250,16,50,.320,.343,19,29,.655,24,63,87,21,18,8,17,27,78
3865,ORL,2020,Gary Clark,25,24,5,355,31,74,.419,21,60,.350,10,14,.714,.561,3,3,1.000,26,44,70,5,4,15,8,25,86
3866,ORL,2020,Melvin Frazier,23,19,0,126,15,34,.441,8,16,.500,7,18,.389,.559,2,4,.500,2,8,10,3,9,2,5,11,40
3867,ORL,2020,B.J. Johnson,24,10,0,83,9,32,.281,3,9,.333,6,23,.261,.328,9,10,.900,3,12,15,3,3,0,6,3,30
3868,ORL,2020,Amile Jefferson,26,18,0,74,5,14,.357,0,0,,5,14,.357,.357,5,14,.357,10,13,23,4,1,3,3,7,15
3869,ORL,2020,Vic Law,24,8,0,62,6,18,.333,1,7,.143,5,11,.455,.361,2,6,.333,2,9,11,3,2,0,2,6,15
3870,ORL,2020,Josh Magette,30,8,0,38,5,15,.333,1,4,.250,4,11,.364,.367,1,2,.500,1,5,6,5,3,1,5,4,12
3871,ORL,2019,Aaron Gordon,23,78,78,2633,470,1046,.449,121,347,.349,349,699,.499,.507,185,253,.731,129,445,574,289,57,56,162,172,1246
3872,ORL,2019,Evan Fournier,26,81,81,2553,468,1069,.438,153,450,.340,315,619,.509,.509,137,170,.806,38,220,258,295,71,12,154,225,1226
3873,ORL,2019,Nikola Vučević,28,80,80,2510,701,1354,.518,84,231,.364,617,1123,.549,.549,179,227,.789,224,736,960,307,81,89,159,157,1665
3874,ORL,2019,D.J. Augustin,31,81,81,2269,318,677,.470,131,311,.421,187,366,.511,.566,181,209,.866,41,162,203,426,52,4,128,115,948
3875,ORL,2019,Terrence Ross,27,81,0,2150,440,1027,.428,217,566,.383,223,461,.484,.534,126,144,.875,27,253,280,135,72,29,90,119,1223
3876,ORL,2019,Jonathan Isaac,21,75,64,1996,262,611,.429,86,266,.323,176,345,.510,.499,110,135,.815,99,312,411,80,59,98,75,143,720
3877,ORL,2019,Wes Iwundu,24,68,13,1233,113,274,.412,29,79,.367,84,195,.431,.465,84,103,.816,37,147,184,73,28,22,44,123,339
3878,ORL,2019,Jerian Grant,26,60,1,939,92,220,.418,40,110,.364,52,110,.473,.509,26,40,.650,19,79,98,156,44,6,51,78,250
3879,ORL,2019,Jonathon Simmons,29,41,9,845,104,286,.364,19,83,.229,85,203,.419,.397,56,72,.778,23,77,100,95,18,14,56,68,283
3880,ORL,2019,Mo Bamba,20,47,1,766,117,243,.481,21,70,.300,96,173,.555,.525,37,63,.587,64,169,233,39,13,64,43,102,292
3881,ORL,2019,Khem Birch,26,50,1,643,91,151,.603,0,1,.000,91,150,.607,.603,58,83,.699,79,111,190,38,18,29,20,72,240
3882,ORL,2019,Isaiah Briscoe,22,39,0,559,55,138,.399,11,34,.324,44,104,.423,.438,15,26,.577,5,69,74,87,11,2,31,66,136
3883,ORL,2019,Jarell Martin,24,42,1,328,43,104,.413,20,57,.351,23,47,.489,.510,9,11,.818,11,62,73,18,3,8,11,51,115
3884,ORL,2019,Michael Carter-Williams,27,12,0,227,21,62,.339,3,19,.158,18,43,.419,.363,20,27,.741,16,41,57,49,11,9,10,21,65
3885,ORL,2019,Amile Jefferson,25,12,0,68,10,16,.625,0,0,,10,16,.625,.625,7,8,.875,6,15,21,3,3,3,1,8,27
3886,ORL,2019,Melvin Frazier,22,10,0,44,7,21,.333,0,6,.000,7,15,.467,.333,1,4,.250,3,2,5,1,1,0,1,6,15
3887,ORL,2019,Troy Caupain,23,4,0,16,4,8,.500,2,3,.667,2,5,.400,.625,0,0,,1,2,3,4,1,0,0,0,10
3888,ORL,2018,Jonathon Simmons,28,69,50,2029,354,761,.465,69,204,.338,285,557,.512,.511,185,241,.768,61,178,239,171,58,16,146,175,962
3889,ORL,2018,Aaron Gordon,22,58,57,1909,375,865,.434,115,342,.336,260,523,.497,.500,157,225,.698,87,370,457,136,59,45,107,111,1022
3890,ORL,2018,Evan Fournier,25,57,57,1837,368,802,.459,127,335,.379,241,467,.516,.538,150,173,.867,23,157,180,165,47,16,95,138,1013
3891,ORL,2018,D.J. Augustin,30,75,36,1760,244,540,.452,114,272,.419,130,268,.485,.557,164,189,.868,30,130,160,287,54,0,123,94,766
3892,ORL,2018,Nikola Vučević,27,57,57,1683,399,840,.475,64,204,.314,335,636,.527,.513,77,94,.819,101,422,523,191,56,62,109,144,939
3893,ORL,2018,Mario Hezonja,22,75,30,1657,273,617,.442,90,267,.337,183,350,.523,.515,86,105,.819,41,240,281,106,81,31,86,134,722
3894,ORL,2018,Bismack Biyombo,25,82,25,1495,183,352,.520,0,1,.000,183,351,.521,.520,102,157,.650,144,324,468,66,21,95,84,158,468
3895,ORL,2018,Shelvin Mack,27,69,3,1365,178,414,.430,48,139,.345,130,275,.473,.488,69,97,.711,23,143,166,272,54,8,89,91,473
3896,ORL,2018,Elfrid Payton,23,44,44,1257,238,458,.520,25,67,.373,213,391,.545,.547,72,114,.632,47,127,174,275,64,16,114,97,573
3897,ORL,2018,Wes Iwundu,23,62,12,1020,93,218,.427,9,46,.196,84,172,.488,.447,34,47,.723,36,101,137,57,33,12,30,81,229
3898,ORL,2018,Arron Afflalo,32,53,3,682,65,162,.401,27,70,.386,38,92,.413,.485,22,26,.846,4,62,66,30,4,9,21,56,179
3899,ORL,2018,Marreese Speights,30,52,3,675,138,349,.395,86,233,.369,52,116,.448,.519,40,55,.727,21,112,133,40,8,22,40,106,402
3900,ORL,2018,Terrence Ross,26,24,20,600,76,191,.398,30,93,.323,46,98,.469,.476,27,36,.750,10,63,73,38,27,11,29,45,209
3901,ORL,2018,Khem Birch,25,42,0,578,68,126,.540,0,0,,68,126,.540,.540,42,61,.689,70,110,180,34,15,21,21,56,178
3902,ORL,2018,Jonathan Isaac,20,27,10,536,55,145,.379,16,46,.348,39,99,.394,.434,19,25,.760,16,83,99,18,33,30,27,48,145
3903,ORL,2018,Rodney Purvis,23,16,2,290,35,107,.327,13,52,.250,22,55,.400,.388,13,15,.867,1,26,27,17,3,3,10,26,96
3904,ORL,2018,Jamel Artis,25,15,1,279,31,79,.392,8,29,.276,23,50,.460,.443,7,12,.583,4,34,38,18,2,3,8,11,77
3905,ORL,2018,Adreian Payne,26,5,0,43,7,10,.700,2,3,.667,5,7,.714,.800,5,6,.833,2,7,9,0,2,0,2,6,21
3906,ORL,2018,Rashad Vaughn,21,5,0,35,2,6,.333,1,2,.500,1,4,.250,.417,0,0,,1,3,4,0,1,0,2,2,5
3907,ORL,2017,Elfrid Payton,22,82,58,2412,430,912,.471,40,146,.274,390,766,.509,.493,146,211,.692,89,298,387,529,88,40,178,177,1046
3908,ORL,2017,Aaron Gordon,21,80,72,2298,393,865,.454,77,267,.288,316,598,.528,.499,156,217,.719,116,289,405,150,65,40,89,172,1019
3909,ORL,2017,Evan Fournier,24,68,66,2234,408,930,.439,128,360,.356,280,570,.491,.508,223,277,.805,44,165,209,202,66,4,141,180,1167
3910,ORL,2017,Nikola Vučević,26,75,55,2163,483,1031,.468,23,75,.307,460,956,.481,.480,107,160,.669,176,603,779,208,76,74,117,180,1096
3911,ORL,2017,Bismack Biyombo,24,81,27,1793,179,339,.528,0,0,,179,339,.528,.528,125,234,.534,157,410,567,74,25,91,95,202,483
3912,ORL,2017,Serge Ibaka,27,56,56,1710,343,703,.488,83,214,.388,260,489,.532,.547,77,91,.846,100,282,382,60,34,91,66,139,846
3913,ORL,2017,D.J. Augustin,29,78,20,1538,195,517,.377,95,274,.347,100,243,.412,.469,131,161,.814,15,102,117,209,31,1,90,101,616
3914,ORL,2017,Jeff Green,30,69,11,1534,220,558,.394,53,193,.275,167,365,.458,.442,145,168,.863,39,175,214,81,37,13,75,103,638
3915,ORL,2017,C.J. Watson,32,62,9,1012,96,248,.387,32,105,.305,64,143,.448,.452,57,66,.864,16,73,89,114,43,2,47,84,281
3916,ORL,2017,Mario Hezonja,21,65,2,960,117,330,.355,43,144,.299,74,186,.398,.420,40,50,.800,20,126,146,62,30,15,58,74,317
3917,ORL,2017,Terrence Ross,25,24,24,748,115,267,.431,46,135,.341,69,132,.523,.517,23,27,.852,4,64,68,43,34,13,35,61,299
3918,ORL,2017,Jodie Meeks,29,36,10,738,103,256,.402,56,137,.409,47,119,.395,.512,65,74,.878,5,72,77,45,34,4,36,41,327
3919,ORL,2017,Damjan Rudež,30,45,0,314,31,88,.352,20,64,.313,11,24,.458,.466,0,0,,5,20,25,20,12,1,9,31,82
3920,ORL,2017,C.J. Wilcox,26,22,0,108,8,31,.258,3,15,.200,5,16,.313,.306,2,2,1.000,4,8,12,12,2,1,6,8,21
3921,ORL,2017,Stephen Zimmerman,20,19,0,108,10,31,.323,0,0,,10,31,.323,.323,3,5,.600,11,24,35,4,2,5,3,17,23
3922,ORL,2017,Marcus Georges-Hunt,22,5,0,48,2,7,.286,1,2,.500,1,5,.200,.357,9,10,.900,1,8,9,3,1,0,2,5,14
3923,ORL,2017,Patricio Garino,23,5,0,43,0,7,.000,0,5,.000,0,2,.000,.000,0,0,,1,6,7,0,0,0,3,4,0
3924,ORL,2017,Arinze Onuaku,29,8,0,28,2,4,.500,0,0,,2,4,.500,.500,0,0,,2,4,6,2,0,1,2,3,4
3925,ORL,2017,Anthony Brown,24,2,0,16,4,9,.444,1,3,.333,3,6,.500,.500,0,0,,2,5,7,2,0,0,1,2,9
3926,ORL,2016,Evan Fournier,23,79,71,2566,429,929,.462,156,390,.400,273,539,.506,.546,199,238,.836,33,192,225,213,96,2,133,214,1213
3927,ORL,2016,Victor Oladipo,23,72,52,2379,425,970,.438,98,282,.348,327,688,.475,.489,205,247,.830,48,297,345,282,116,54,153,174,1153
3928,ORL,2016,Elfrid Payton,21,73,69,2145,318,730,.436,30,92,.326,288,638,.451,.456,112,190,.589,77,184,261,468,89,20,177,159,778
3929,ORL,2016,Nikola Vučević,25,65,60,2037,533,1046,.510,2,9,.222,531,1037,.512,.511,113,150,.753,174,402,576,179,53,70,123,173,1181
3930,ORL,2016,Aaron Gordon,20,78,37,1863,274,579,.473,42,142,.296,232,437,.531,.509,129,193,.668,154,353,507,128,59,55,66,153,719
3931,ORL,2016,Tobias Harris,23,49,49,1610,251,541,.464,47,151,.311,204,390,.523,.507,120,153,.784,71,271,342,99,47,28,78,91,669
3932,ORL,2016,Mario Hezonja,20,79,9,1413,181,418,.433,67,192,.349,114,226,.504,.513,49,54,.907,28,148,176,109,39,17,97,124,478
3933,ORL,2016,Jason Smith,29,76,2,1181,244,503,.485,4,16,.250,240,487,.493,.489,54,67,.806,53,166,219,62,33,65,57,163,546
3934,ORL,2016,Andrew Nicholson,26,56,0,823,146,310,.471,41,114,.360,105,196,.536,.537,51,65,.785,34,167,201,25,10,22,41,69,384
3935,ORL,2016,Channing Frye,32,44,29,754,81,186,.435,48,121,.397,33,65,.508,.565,19,21,.905,23,118,141,45,21,20,30,71,229
3936,ORL,2016,Dewayne Dedmon,26,58,20,705,99,177,.559,0,0,,99,177,.559,.559,57,76,.750,67,161,228,13,22,46,32,109,255
3937,ORL,2016,C.J. Watson,31,33,2,656,47,137,.343,14,48,.292,33,89,.371,.394,34,39,.872,10,56,66,88,19,5,25,49,142
3938,ORL,2016,Shabazz Napier,24,55,0,600,68,201,.338,34,104,.327,34,97,.351,.423,33,45,.733,9,46,55,97,23,1,46,38,203
3939,ORL,2016,Brandon Jennings,26,25,6,452,59,161,.366,27,78,.346,32,83,.386,.450,30,40,.750,11,39,50,100,18,5,35,33,175
3940,ORL,2016,Ersan İlyasova,28,22,4,447,64,153,.418,18,44,.409,46,109,.422,.477,32,45,.711,45,76,121,12,14,6,12,51,178
3941,ORL,2016,Devyn Marble,23,28,0,249,21,71,.296,8,32,.250,13,39,.333,.352,10,24,.417,6,32,38,12,13,1,7,25,60
3942,ORL,2016,Keith Appling,23,5,0,27,2,8,.250,0,3,.000,2,5,.400,.250,2,2,1.000,0,1,1,1,1,0,3,5,6
3943,ORL,2015,Victor Oladipo,22,72,71,2573,473,1086,.436,84,248,.339,389,838,.464,.474,262,320,.819,51,251,302,295,120,19,204,187,1292
3944,ORL,2015,Nikola Vučević,24,74,74,2529,631,1206,.523,2,6,.333,629,1200,.524,.524,164,218,.752,238,572,810,147,54,54,148,220,1428
3945,ORL,2015,Elfrid Payton,20,82,63,2489,301,708,.425,11,42,.262,290,666,.435,.433,118,214,.551,107,242,349,533,142,20,203,193,731
3946,ORL,2015,Tobias Harris,22,68,63,2369,442,949,.466,87,239,.364,355,710,.500,.512,193,245,.788,73,357,430,124,69,36,115,134,1164
3947,ORL,2015,Channing Frye,31,75,51,1870,191,487,.392,136,346,.393,55,141,.390,.532,31,35,.886,27,266,293,94,47,39,78,191,549
3948,ORL,2015,Evan Fournier,22,58,32,1661,253,575,.440,85,225,.378,168,350,.480,.514,107,147,.728,28,125,153,120,40,2,82,116,698
3949,ORL,2015,Willie Green,33,52,2,951,118,306,.386,42,121,.347,76,185,.411,.454,28,34,.824,14,65,79,68,26,5,48,81,306
3950,ORL,2015,Dewayne Dedmon,25,59,15,845,91,162,.562,0,1,.000,91,161,.565,.562,34,64,.531,118,177,295,9,16,50,51,141,216
3951,ORL,2015,Kyle O'Quinn,24,51,17,824,119,242,.492,12,43,.279,107,199,.538,.517,44,57,.772,46,153,199,59,31,39,55,110,294
3952,ORL,2015,Aaron Gordon,19,47,8,797,93,208,.447,13,48,.271,80,160,.500,.478,44,61,.721,46,123,169,33,21,22,38,83,243
3953,ORL,2015,Ben Gordon,31,56,0,790,129,295,.437,35,97,.361,94,198,.475,.497,56,67,.836,6,57,63,50,14,1,55,60,349
3954,ORL,2015,Luke Ridnour,33,47,0,683,75,176,.426,20,63,.317,55,113,.487,.483,18,21,.857,8,60,68,96,20,4,38,67,188
3955,ORL,2015,Maurice Harkless,21,45,4,674,63,158,.399,10,56,.179,53,102,.520,.430,22,41,.537,38,68,106,25,32,9,27,66,158
3956,ORL,2015,Andrew Nicholson,25,40,3,492,83,190,.437,13,41,.317,70,149,.470,.471,15,25,.600,17,65,82,22,6,12,24,51,194
3957,ORL,2015,Devyn Marble,22,16,7,208,14,44,.318,4,22,.182,10,22,.455,.364,5,16,.313,5,26,31,17,9,2,9,14,37
3958,ORL,2014,Arron Afflalo,28,73,73,2552,464,1011,.459,128,300,.427,336,711,.473,.522,274,336,.815,32,230,262,248,35,3,146,136,1330
3959,ORL,2014,Victor Oladipo,21,80,44,2487,392,936,.419,74,226,.327,318,710,.448,.458,248,318,.780,43,286,329,327,129,37,256,210,1106
3960,ORL,2014,Jameer Nelson,31,68,68,2179,294,747,.394,136,391,.348,158,356,.444,.485,96,112,.857,29,202,231,476,52,5,166,146,820
3961,ORL,2014,Maurice Harkless,20,80,41,1950,224,483,.464,59,154,.383,165,329,.502,.525,85,143,.594,69,195,264,80,97,50,86,140,592
3962,ORL,2014,Tobias Harris,21,61,36,1850,332,716,.464,32,126,.254,300,590,.508,.486,197,244,.807,88,336,424,82,41,24,78,143,893
3963,ORL,2014,Nikola Vučević,23,57,57,1812,353,696,.507,0,0,,353,696,.507,.507,105,137,.766,185,441,626,104,60,47,112,169,811
3964,ORL,2014,E'Twaun Moore,24,79,3,1506,195,456,.428,57,161,.354,138,295,.468,.490,52,68,.765,29,107,136,112,60,13,55,106,499
3965,ORL,2014,Glen Davis,28,45,43,1354,232,512,.453,4,10,.400,228,502,.454,.457,77,114,.675,87,195,282,70,46,22,59,111,545
3966,ORL,2014,Kyle O'Quinn,23,69,19,1188,186,371,.501,0,3,.000,186,368,.505,.501,57,83,.687,100,264,364,78,39,88,78,165,429
3967,ORL,2014,Andrew Nicholson,24,76,5,1174,180,420,.429,28,89,.315,152,331,.459,.462,47,57,.825,53,202,255,25,18,23,51,150,435
3968,ORL,2014,Doron Lamb,22,53,0,695,63,160,.394,36,90,.400,27,70,.386,.506,29,36,.806,8,41,49,43,11,1,27,54,191
3969,ORL,2014,Jason Maxiell,30,34,13,488,47,105,.448,0,0,,47,105,.448,.448,15,31,.484,28,58,86,9,8,20,14,47,109
3970,ORL,2014,Ronnie Price,30,31,2,377,28,92,.304,9,43,.209,19,49,.388,.353,9,13,.692,8,35,43,66,25,2,26,50,74
3971,ORL,2014,Dewayne Dedmon,24,16,6,234,23,53,.434,0,0,,23,53,.434,.434,13,17,.765,27,51,78,2,7,13,9,37,59
3972,ORL,2014,Solomon Jones,29,11,0,85,6,17,.353,0,0,,6,17,.353,.353,2,4,.500,8,8,16,2,2,2,2,12,14
3973,ORL,2014,Adonis Thomas,20,4,0,24,3,9,.333,0,3,.000,3,6,.500,.333,1,1,1.000,0,3,3,2,0,0,0,2,7
3974,ORL,2013,Nikola Vučević,22,77,77,2559,461,889,.519,0,3,.000,461,886,.520,.519,86,126,.683,273,644,917,143,61,79,141,218,1008
3975,ORL,2013,Arron Afflalo,27,64,64,2307,397,905,.439,72,240,.300,325,665,.489,.478,191,223,.857,29,210,239,206,40,11,138,137,1057
3976,ORL,2013,Jameer Nelson,30,56,56,1977,306,780,.392,121,355,.341,185,425,.435,.470,89,102,.873,23,186,209,413,71,6,154,161,822
3977,ORL,2013,Maurice Harkless,19,76,59,1974,260,564,.461,32,117,.274,228,447,.510,.489,73,128,.570,122,213,335,50,88,62,69,144,625
3978,ORL,2013,E'Twaun Moore,23,75,21,1682,237,598,.396,67,197,.340,170,401,.424,.452,47,59,.797,48,119,167,206,51,23,105,122,588
3979,ORL,2013,JJ Redick,28,50,11,1575,262,582,.450,117,300,.390,145,282,.514,.551,115,129,.891,9,110,119,220,29,5,105,70,756
3980,ORL,2013,Andrew Nicholson,23,75,28,1249,256,486,.527,0,0,,256,486,.527,.527,75,94,.798,69,189,258,44,24,32,79,133,587
3981,ORL,2013,Glen Davis,27,34,33,1064,214,478,.448,0,2,.000,214,476,.450,.448,84,117,.718,55,191,246,70,32,21,64,88,512
3982,ORL,2013,Tobias Harris,20,27,20,974,180,397,.453,27,87,.310,153,310,.494,.487,80,111,.721,56,174,230,56,24,37,48,89,467
3983,ORL,2013,DeQuan Jones,22,63,17,803,95,218,.436,9,35,.257,86,183,.470,.456,34,51,.667,17,88,105,16,19,22,30,55,233
3984,ORL,2013,Beno Udrih,30,27,9,738,97,238,.408,21,53,.396,76,185,.411,.452,60,70,.857,17,46,63,164,25,1,55,51,275
3985,ORL,2013,Josh McRoberts,25,41,3,685,60,153,.392,17,55,.309,43,98,.439,.448,22,30,.733,41,96,137,70,10,12,28,65,159
3986,ORL,2013,Kyle O'Quinn,22,57,5,638,101,197,.513,0,1,.000,101,196,.515,.513,30,45,.667,65,144,209,52,11,26,37,107,232
3987,ORL,2013,Gustavo Ayón,27,43,3,571,67,125,.536,0,0,,67,125,.536,.536,19,38,.500,40,100,140,59,13,13,38,83,153
3988,ORL,2013,Ish Smith,24,36,3,378,39,116,.336,4,17,.235,35,99,.354,.353,3,7,.429,11,35,46,57,13,6,27,14,85
3989,ORL,2013,Doron Lamb,21,24,0,297,27,68,.397,10,21,.476,17,47,.362,.471,12,19,.632,5,24,29,12,6,0,10,25,76
3990,ORL,2013,Hedo Türkoğlu,33,11,1,189,14,53,.264,1,24,.042,13,29,.448,.274,3,6,.500,4,22,26,23,7,1,12,11,32
3991,ORL,2013,Al Harrington,32,10,0,119,20,57,.351,8,30,.267,12,27,.444,.421,3,4,.750,6,21,27,10,4,1,7,18,51
3992,ORL,2012,Dwight Howard,26,54,54,2070,416,726,.573,0,7,.000,416,719,.579,.573,281,572,.491,200,585,785,104,81,116,175,159,1113
3993,ORL,2012,Ryan Anderson,23,61,61,1964,332,757,.439,166,422,.393,166,335,.496,.548,150,171,.877,224,247,471,54,50,26,57,146,980
3994,ORL,2012,JJ Redick,27,65,22,1765,248,584,.425,112,268,.418,136,316,.430,.521,143,157,.911,18,132,150,164,27,6,68,92,751
3995,ORL,2012,Jameer Nelson,29,57,57,1706,259,606,.427,87,231,.377,172,375,.459,.499,71,88,.807,29,152,181,325,38,5,135,130,676
3996,ORL,2012,Hedo Türkoğlu,32,53,53,1653,209,504,.415,91,258,.353,118,246,.480,.505,67,95,.705,24,175,199,233,45,17,142,139,576
3997,ORL,2012,Jason Richardson,31,54,54,1591,243,596,.408,102,277,.368,141,319,.442,.493,41,69,.594,36,158,194,107,53,22,60,91,629
3998,ORL,2012,Glen Davis,26,61,13,1427,225,534,.421,2,14,.143,223,520,.429,.423,114,167,.683,107,224,331,47,43,19,75,106,566
3999,ORL,2012,Chris Duhon,29,63,9,1226,85,203,.419,50,119,.420,35,84,.417,.542,17,21,.810,14,88,102,151,35,9,81,71,237
4000,ORL,2012,Quentin Richardson,31,48,3,866,74,197,.376,42,121,.347,32,76,.421,.482,25,30,.833,15,108,123,38,28,6,29,74,215
4001,ORL,2012,Earl Clark,24,45,1,559,51,139,.367,0,0,,51,139,.367,.367,21,29,.724,35,89,124,18,12,32,25,72,123
4002,ORL,2012,Von Wafer,26,33,1,469,71,157,.452,14,39,.359,57,118,.483,.497,38,54,.704,6,39,45,29,10,3,35,26,194
4003,ORL,2012,Daniel Orton,21,16,2,187,17,30,.567,0,1,.000,17,29,.586,.567,11,25,.440,19,20,39,5,8,9,7,30,45
4004,ORL,2012,Ish Smith,23,20,0,171,19,51,.373,1,4,.250,18,47,.383,.382,6,8,.750,5,21,26,32,11,2,12,11,45
4005,ORL,2012,DeAndre Liggins,23,17,0,115,12,25,.480,0,4,.000,12,21,.571,.480,9,19,.474,6,9,15,5,6,0,10,6,33
4006,ORL,2012,Larry Hughes,33,9,0,114,5,22,.227,1,7,.143,4,15,.267,.250,1,2,.500,1,4,5,7,2,0,12,10,12
4007,ORL,2012,Justin Harper,22,14,0,84,9,31,.290,2,13,.154,7,18,.389,.323,0,1,.000,3,9,12,2,2,3,6,5,20
4008,ORL,2011,Dwight Howard,25,78,78,2935,619,1044,.593,0,7,.000,619,1037,.597,.593,546,916,.596,309,789,1098,107,107,186,279,258,1784
4009,ORL,2011,Jameer Nelson,28,76,76,2319,374,838,.446,119,297,.401,255,541,.471,.517,130,162,.802,37,189,226,456,75,3,194,209,997
4010,ORL,2011,Brandon Bass,25,76,51,1980,332,645,.515,0,2,.000,332,643,.516,.515,190,233,.815,134,290,424,57,27,52,97,159,854
4011,ORL,2011,Jason Richardson,30,55,55,1919,289,667,.433,127,331,.384,162,336,.482,.528,61,87,.701,34,186,220,111,66,10,65,116,766
4012,ORL,2011,Hedo Türkoğlu,31,56,56,1910,237,529,.448,86,213,.404,151,316,.478,.529,80,120,.667,25,231,256,285,54,20,101,170,640
4013,ORL,2011,JJ Redick,26,59,5,1513,197,447,.441,87,219,.397,110,228,.482,.538,112,128,.875,6,107,113,102,29,3,53,80,593
4014,ORL,2011,Ryan Anderson,22,64,14,1424,226,525,.430,134,341,.393,92,184,.500,.558,95,117,.812,129,226,355,52,30,38,49,137,681
4015,ORL,2011,Gilbert Arenas,29,49,2,1070,139,404,.344,50,182,.275,89,222,.401,.406,64,86,.744,16,103,119,157,44,9,106,112,392
4016,ORL,2011,Quentin Richardson,30,57,19,955,87,255,.341,42,146,.288,45,109,.413,.424,33,44,.750,39,139,178,38,25,5,33,74,249
4017,ORL,2011,Rashard Lewis,31,25,25,810,113,270,.419,44,120,.367,69,150,.460,.500,34,45,.756,23,83,106,29,22,10,35,63,304
4018,ORL,2011,Chris Duhon,28,51,5,774,49,129,.380,13,52,.250,36,77,.468,.430,14,25,.560,9,43,52,118,16,2,61,30,125
4019,ORL,2011,Vince Carter,34,22,22,664,125,266,.470,27,78,.346,98,188,.521,.521,56,75,.747,11,79,90,64,20,3,36,70,333
4020,ORL,2011,Mickaël Piétrus,28,19,0,418,45,115,.391,34,87,.391,11,28,.393,.539,3,6,.500,6,44,50,10,10,3,14,35,127
4021,ORL,2011,Marcin Gortat,26,25,2,396,44,81,.543,0,0,,44,81,.543,.543,12,18,.667,38,80,118,17,7,21,17,52,100
4022,ORL,2011,Earl Clark,23,33,0,392,56,127,.441,0,5,.000,56,122,.459,.441,22,37,.595,33,51,84,5,7,15,26,39,134
4023,ORL,2011,Malik Allen,32,18,0,178,11,31,.355,0,0,,11,31,.355,.355,1,2,.500,12,20,32,4,1,4,3,30,23
4024,ORL,2011,Jason Williams,35,16,0,171,13,38,.342,7,23,.304,6,15,.400,.434,0,0,,3,19,22,24,8,0,11,6,33
4025,ORL,2010,Dwight Howard,24,82,82,2843,510,834,.612,0,7,.000,510,827,.617,.612,483,816,.592,284,798,1082,144,75,228,274,287,1503
4026,ORL,2010,Rashard Lewis,30,72,72,2369,350,805,.435,168,423,.397,182,382,.476,.539,145,180,.806,62,256,318,107,78,28,108,180,1013
4027,ORL,2010,Vince Carter,33,75,74,2310,434,1015,.428,119,324,.367,315,691,.456,.486,257,306,.840,33,260,293,236,53,18,106,189,1244
4028,ORL,2010,Matt Barnes,29,81,58,2097,271,557,.487,66,207,.319,205,350,.586,.546,108,146,.740,106,339,445,134,59,30,112,185,716
4029,ORL,2010,Jameer Nelson,27,65,64,1860,317,706,.449,86,226,.381,231,480,.481,.510,98,116,.845,26,168,194,353,48,2,139,147,818
4030,ORL,2010,JJ Redick,25,82,9,1808,243,553,.439,111,274,.405,132,279,.473,.540,191,222,.860,17,138,155,158,28,4,63,118,788
4031,ORL,2010,Jason Williams,34,82,18,1703,189,426,.444,84,221,.380,105,205,.512,.542,31,41,.756,7,119,126,298,53,3,87,65,493
4032,ORL,2010,Mickaël Piétrus,27,75,24,1687,233,539,.432,116,306,.379,117,233,.502,.540,69,109,.633,39,176,215,49,53,31,69,138,651
4033,ORL,2010,Marcin Gortat,25,81,0,1088,121,227,.533,0,3,.000,121,224,.540,.533,51,75,.680,104,237,341,17,17,70,46,138,293
4034,ORL,2010,Ryan Anderson,21,63,6,911,169,388,.436,78,211,.370,91,177,.514,.536,71,82,.866,70,132,202,37,25,14,56,81,487
4035,ORL,2010,Brandon Bass,24,50,3,648,119,233,.511,0,0,,119,233,.511,.511,52,63,.825,54,73,127,19,12,27,31,69,290
4036,ORL,2010,Anthony Johnson,35,31,0,406,49,111,.441,13,39,.333,36,72,.500,.500,19,20,.950,8,40,48,63,11,1,26,32,130
4037,ORL,2009,Rashard Lewis,29,79,79,2859,478,1089,.439,220,554,.397,258,535,.482,.540,225,269,.836,92,361,453,205,81,51,158,194,1401
4038,ORL,2009,Dwight Howard,23,79,79,2821,560,979,.572,0,2,.000,560,977,.573,.572,504,849,.594,336,757,1093,112,77,231,240,270,1624
4039,ORL,2009,Hedo Türkoğlu,29,77,77,2815,423,1025,.413,134,376,.356,289,649,.445,.478,314,389,.807,45,365,410,375,64,19,204,218,1294
4040,ORL,2009,Courtney Lee,23,77,42,1939,243,540,.450,82,203,.404,161,337,.478,.526,78,94,.830,18,160,178,91,76,14,69,157,646
4041,ORL,2009,Anthony Johnson,34,80,12,1481,154,381,.404,52,133,.391,102,248,.411,.472,61,81,.753,29,118,147,200,46,5,82,111,421
4042,ORL,2009,Mickaël Piétrus,26,54,25,1329,176,426,.413,80,223,.359,96,203,.473,.507,78,110,.709,44,132,176,65,31,24,56,126,510
4043,ORL,2009,Jameer Nelson,26,42,42,1309,267,531,.503,82,181,.453,185,350,.529,.580,86,97,.887,20,125,145,226,51,3,83,123,702
4044,ORL,2009,Tony Battie,32,77,3,1202,158,323,.489,2,9,.222,156,314,.497,.492,54,82,.659,92,186,278,31,26,25,46,112,372
4045,ORL,2009,JJ Redick,24,64,5,1111,117,299,.391,67,179,.374,50,120,.417,.503,81,93,.871,8,101,109,73,21,1,54,72,382
4046,ORL,2009,Rafer Alston,32,29,28,856,123,298,.413,32,101,.317,91,197,.462,.466,70,99,.707,8,75,83,148,51,3,52,63,348
4047,ORL,2009,Marcin Gortat,24,63,3,794,106,187,.567,1,1,1.000,105,186,.565,.570,26,45,.578,96,190,286,14,18,53,25,111,239
4048,ORL,2009,Keith Bogans,28,36,15,787,63,175,.360,42,126,.333,21,49,.429,.480,21,24,.875,15,96,111,31,23,2,19,61,189
4049,ORL,2009,Brian Cook,28,21,0,146,23,60,.383,11,25,.440,12,35,.343,.475,5,6,.833,6,21,27,4,3,0,11,23,62
4050,ORL,2009,Tyronn Lue,31,14,0,129,17,43,.395,6,17,.353,11,26,.423,.465,2,3,.667,0,11,11,14,2,0,2,13,42
4051,ORL,2009,Jeremy Richardson,24,12,0,93,14,49,.286,6,17,.353,8,32,.250,.347,3,6,.500,1,13,14,3,0,0,3,6,37
4052,ORL,2009,Adonal Foyle,33,9,0,59,7,11,.636,0,0,,7,11,.636,.636,3,6,.500,9,17,26,1,0,8,3,4,17
4053,ORL,2008,Dwight Howard,22,82,82,3088,583,974,.599,0,4,.000,583,970,.601,.599,529,897,.590,279,882,1161,110,74,176,263,274,1695
4054,ORL,2008,Rashard Lewis,28,81,81,3076,516,1135,.455,226,553,.409,290,582,.498,.554,218,260,.838,97,340,437,196,99,38,140,214,1476
4055,ORL,2008,Hedo Türkoğlu,28,82,82,3026,556,1219,.456,166,415,.400,390,804,.485,.524,324,391,.829,83,388,471,409,74,25,246,244,1602
4056,ORL,2008,Keith Bogans,27,82,35,2198,241,588,.410,148,409,.362,93,179,.520,.536,81,110,.736,42,224,266,104,59,10,53,164,711
4057,ORL,2008,Jameer Nelson,25,69,62,1961,283,603,.469,64,154,.416,219,449,.488,.522,125,151,.828,28,215,243,383,63,4,141,167,755
4058,ORL,2008,Maurice Evans,29,68,47,1624,253,517,.489,80,202,.396,173,315,.549,.567,47,68,.691,88,121,209,69,41,9,40,132,633
4059,ORL,2008,Keyon Dooling,27,72,1,1334,198,423,.468,22,65,.338,176,358,.492,.494,163,193,.845,7,94,101,133,36,5,61,131,581
4060,ORL,2008,Carlos Arroyo,28,62,20,1269,157,348,.451,29,84,.345,128,264,.485,.493,87,102,.853,10,103,113,219,26,2,77,85,430
4061,ORL,2008,Adonal Foyle,32,82,0,774,70,153,.458,0,0,,70,153,.458,.458,16,34,.471,71,137,208,18,16,45,32,94,156
4062,ORL,2008,Brian Cook,27,45,0,559,84,213,.394,41,105,.390,43,108,.398,.491,15,17,.882,24,75,99,24,11,12,35,87,224
4063,ORL,2008,Pat Garrity,31,31,0,284,27,80,.338,8,37,.216,19,43,.442,.388,4,5,.800,9,35,44,13,6,1,17,35,66
4064,ORL,2008,JJ Redick,23,34,0,276,48,108,.444,17,43,.395,31,65,.477,.523,27,34,.794,1,22,23,16,4,0,15,29,140
4065,ORL,2008,James Augustine,23,25,0,149,18,34,.529,0,0,,18,34,.529,.529,4,8,.500,16,14,30,2,5,2,6,18,40
4066,ORL,2008,Trevor Ariza,22,11,0,115,14,31,.452,0,3,.000,14,28,.500,.452,8,15,.533,5,19,24,8,5,3,5,9,36
4067,ORL,2008,Marcin Gortat,23,6,0,41,8,17,.471,0,0,,8,17,.471,.471,2,3,.667,8,8,16,2,1,1,2,4,18
4068,ORL,2008,Bo Outlaw,36,2,0,7,2,3,.667,0,0,,2,3,.667,.667,0,0,,0,0,0,0,0,0,1,1,4
4069,ORL,2007,Dwight Howard,21,82,82,3023,526,873,.603,1,2,.500,525,871,.603,.603,390,666,.586,283,725,1008,158,70,156,317,245,1443
4070,ORL,2007,Jameer Nelson,24,77,77,2331,376,875,.430,65,194,.335,311,681,.457,.467,183,221,.828,50,186,236,330,73,5,184,225,1000
4071,ORL,2007,Hedo Türkoğlu,27,73,73,2268,345,823,.419,109,281,.388,236,542,.435,.485,171,219,.781,57,236,293,233,70,16,143,221,970
4072,ORL,2007,Grant Hill,34,65,64,2009,342,660,.518,2,12,.167,340,648,.525,.520,248,324,.765,53,184,237,138,61,25,144,146,934
4073,ORL,2007,Darko Miličić,21,80,16,1913,249,548,.454,0,1,.000,249,547,.455,.454,141,230,.613,145,292,437,90,44,140,124,219,639
4074,ORL,2007,Tony Battie,30,66,66,1575,176,360,.489,0,1,.000,176,359,.490,.489,52,77,.675,92,252,344,35,29,30,61,185,404
4075,ORL,2007,Keyon Dooling,26,66,2,1435,188,458,.410,31,96,.323,157,362,.434,.444,114,141,.809,22,64,86,112,52,15,72,125,521
4076,ORL,2007,Carlos Arroyo,27,72,5,1304,203,478,.425,14,51,.275,189,427,.443,.439,132,166,.795,31,103,134,202,39,2,90,131,552
4077,ORL,2007,Trevor Ariza,21,57,7,1278,200,371,.539,0,7,.000,200,364,.549,.539,106,171,.620,98,151,249,65,59,19,84,134,506
4078,ORL,2007,Keith Bogans,26,59,18,990,99,245,.404,53,137,.387,46,108,.426,.512,47,63,.746,16,77,93,59,28,2,46,98,298
4079,ORL,2007,JJ Redick,22,42,0,622,80,195,.410,38,98,.388,42,97,.433,.508,54,60,.900,10,42,52,36,12,0,21,52,252
4080,ORL,2007,Bo Outlaw,35,41,0,460,34,51,.667,0,0,,34,51,.667,.667,13,22,.591,47,59,106,16,17,6,21,57,81
4081,ORL,2007,Travis Diener,24,26,0,288,34,80,.425,18,50,.360,16,30,.533,.538,12,15,.800,3,15,18,35,4,0,13,27,98
4082,ORL,2007,Pat Garrity,30,33,0,277,22,70,.314,11,32,.344,11,38,.289,.393,16,18,.889,12,30,42,14,7,0,14,37,71
4083,ORL,2007,James Augustine,22,2,0,7,1,3,.333,0,0,,1,3,.333,.333,0,0,,1,2,3,2,0,0,0,2,2
4084,ORL,2006,Dwight Howard,20,82,81,3021,468,881,.531,0,2,.000,468,879,.532,.531,356,598,.595,288,734,1022,125,65,115,217,277,1292
4085,ORL,2006,DeShawn Stevenson,24,82,82,2648,359,781,.460,2,15,.133,357,766,.466,.461,180,242,.744,59,182,241,160,58,17,123,178,900
4086,ORL,2006,Hedo Türkoğlu,26,78,59,2615,398,877,.454,114,283,.403,284,594,.478,.519,255,296,.861,70,263,333,216,70,21,130,234,1165
4087,ORL,2006,Tony Battie,29,82,82,2215,280,552,.507,0,6,.000,280,546,.513,.507,89,134,.664,145,312,457,49,46,69,88,250,649
4088,ORL,2006,Jameer Nelson,23,62,33,1784,347,719,.483,70,165,.424,277,554,.500,.531,141,181,.779,39,141,180,302,70,9,148,174,905
4089,ORL,2006,Steve Francis,28,46,45,1734,249,575,.433,18,70,.257,231,505,.457,.449,231,290,.797,60,159,219,262,51,11,156,142,747
4090,ORL,2006,Keyon Dooling,25,50,7,1137,178,405,.440,13,43,.302,165,362,.456,.456,101,121,.835,11,67,78,109,49,4,82,116,470
4091,ORL,2006,Pat Garrity,29,57,0,938,101,242,.417,50,129,.388,51,113,.451,.521,30,37,.811,31,77,108,38,12,9,38,108,282
4092,ORL,2006,Darko Miličić,20,30,1,627,102,201,.507,0,0,,102,201,.507,.507,25,42,.595,34,89,123,32,11,62,36,67,229
4093,ORL,2006,Grant Hill,33,21,17,613,119,243,.490,2,8,.250,117,235,.498,.494,78,102,.765,15,65,80,48,24,6,35,50,318
4094,ORL,2006,Carlos Arroyo,26,27,0,594,111,221,.502,5,14,.357,106,207,.512,.514,64,79,.810,9,51,60,77,19,1,38,42,291
4095,ORL,2006,Stacey Augmon,37,36,3,385,25,73,.342,0,0,,25,73,.342,.342,21,30,.700,18,35,53,23,12,6,11,40,71
4096,ORL,2006,Bo Outlaw,34,32,0,355,35,58,.603,0,0,,35,58,.603,.603,5,8,.625,31,46,77,14,10,12,17,50,75
4097,ORL,2006,Kelvin Cato,31,23,0,299,31,72,.431,0,0,,31,72,.431,.431,26,35,.743,19,44,63,2,6,10,16,48,88
4098,ORL,2006,Trevor Ariza,20,21,0,290,32,80,.400,0,2,.000,32,78,.410,.400,35,50,.700,29,52,81,15,14,2,16,22,99
4099,ORL,2006,Travis Diener,23,23,0,246,29,69,.420,25,57,.439,4,12,.333,.601,5,6,.833,4,17,21,16,7,0,10,22,88
4100,ORL,2006,Mario Kasun,25,28,0,213,31,69,.449,0,0,,31,69,.449,.449,18,23,.783,24,36,60,3,2,3,15,69,80
4101,ORL,2006,Terence Morris,27,22,0,192,16,49,.327,0,2,.000,16,47,.340,.327,3,3,1.000,6,32,38,4,6,5,7,19,35
4102,ORL,2005,Steve Francis,27,78,78,2978,563,1330,.423,38,127,.299,525,1203,.436,.438,499,606,.823,126,324,450,547,112,28,317,273,1663
4103,ORL,2005,Dwight Howard,19,82,82,2670,352,677,.520,0,2,.000,352,675,.521,.520,277,413,.671,287,536,823,75,77,136,165,232,981
4104,ORL,2005,Grant Hill,32,67,67,2338,517,1015,.509,3,13,.231,514,1002,.513,.511,280,341,.821,77,241,318,220,97,28,161,144,1317
4105,ORL,2005,Tony Battie,28,81,32,1894,163,354,.460,0,6,.000,163,348,.468,.460,68,94,.723,109,343,452,42,30,81,81,244,394
4106,ORL,2005,Hedo Türkoğlu,25,67,11,1757,328,782,.419,93,245,.380,235,537,.438,.479,188,225,.836,62,171,233,153,41,18,119,140,937
4107,ORL,2005,Jameer Nelson,22,79,21,1612,286,628,.455,44,141,.312,242,487,.497,.490,73,107,.682,52,141,193,237,78,3,117,199,689
4108,ORL,2005,Kelvin Cato,30,62,50,1525,160,297,.539,0,0,,160,297,.539,.539,112,143,.783,102,314,416,40,55,82,64,170,432
4109,ORL,2005,DeShawn Stevenson,23,55,27,1089,174,426,.408,25,67,.373,149,359,.415,.438,56,101,.554,38,64,102,69,16,9,57,73,429
4110,ORL,2005,Pat Garrity,28,71,0,955,123,306,.402,49,147,.333,74,159,.465,.482,29,33,.879,21,103,124,30,19,9,30,107,324
4111,ORL,2005,Cuttino Mobley,29,23,21,726,128,296,.432,58,125,.464,70,171,.409,.530,55,69,.797,11,52,63,42,23,9,41,49,369
4112,ORL,2005,Stacey Augmon,36,55,7,663,68,167,.407,0,0,,68,167,.407,.407,57,77,.740,45,54,99,36,23,8,31,83,193
4113,ORL,2005,Doug Christie,34,21,13,529,47,128,.367,5,23,.217,42,105,.400,.387,20,22,.909,9,45,54,46,37,5,36,45,119
4114,ORL,2005,Mario Kasun,24,45,0,356,47,98,.480,0,1,.000,47,97,.485,.480,24,43,.558,52,76,128,8,8,13,26,86,118
4115,ORL,2005,Brandon Hunter,24,31,0,224,37,73,.507,0,0,,37,73,.507,.507,21,39,.538,25,44,69,3,4,7,22,42,95
4116,ORL,2005,Andre Barrett,22,11,1,169,25,55,.455,5,15,.333,20,40,.500,.500,7,9,.778,6,15,21,27,5,1,11,16,62
4117,ORL,2005,Mark Jones,29,10,0,116,9,31,.290,0,4,.000,9,27,.333,.290,5,10,.500,6,7,13,6,5,2,3,16,23
4118,ORL,2005,Michael Bradley,25,8,0,55,3,7,.429,0,0,,3,7,.429,.429,0,0,,3,11,14,2,1,2,1,4,6
4119,ORL,2005,Andrew DeClercq,31,8,0,49,4,9,.444,0,0,,4,9,.444,.444,1,3,.333,7,3,10,0,2,0,1,14,9
4120,ORL,2004,Juwan Howard,30,81,77,2877,529,1169,.453,0,1,.000,529,1168,.453,.453,318,393,.809,171,399,570,158,54,22,178,284,1376
4121,ORL,2004,Tracy McGrady,24,67,67,2675,653,1566,.417,174,513,.339,479,1053,.455,.473,398,500,.796,95,307,402,370,93,42,179,129,1878
4122,ORL,2004,Tyronn Lue,26,76,69,2332,309,714,.433,80,209,.383,229,505,.453,.489,101,131,.771,26,161,187,317,61,5,124,185,799
4123,ORL,2004,Drew Gooden,22,79,17,2134,369,829,.445,9,42,.214,360,787,.457,.451,167,262,.637,160,356,516,89,62,72,126,196,914
4124,ORL,2004,Keith Bogans,23,73,36,1787,183,454,.403,67,187,.358,116,267,.434,.477,65,103,.631,106,211,317,98,46,10,75,128,498
4125,ORL,2004,Gordan Giriček,26,48,25,1435,188,427,.440,46,113,.407,142,314,.452,.494,67,81,.827,37,127,164,80,41,10,63,98,489
4126,ORL,2004,Andrew DeClercq,30,71,53,1211,93,195,.477,0,0,,93,195,.477,.477,44,54,.815,131,186,317,44,47,32,54,217,230
4127,ORL,2004,DeShawn Stevenson,22,26,24,933,115,285,.404,12,41,.293,103,244,.422,.425,49,71,.690,36,84,120,66,24,1,40,54,291
4128,ORL,2004,Rod Strickland,37,46,9,915,122,269,.454,10,33,.303,112,236,.475,.472,57,76,.750,24,94,118,185,27,7,67,59,311
4129,ORL,2004,Steven Hunter,22,59,23,789,82,155,.529,0,0,,82,155,.529,.529,23,69,.333,54,116,170,12,5,73,29,101,187
4130,ORL,2004,Zaza Pachulia,19,59,2,664,68,175,.389,0,0,,68,175,.389,.389,58,90,.644,69,105,174,13,21,12,34,87,194
4131,ORL,2004,Shammond Williams,28,37,2,525,59,151,.391,25,74,.338,34,77,.442,.474,40,45,.889,9,34,43,64,23,1,26,40,183
4132,ORL,2004,Reece Gaines,23,38,1,364,25,86,.291,3,10,.300,22,76,.289,.308,16,25,.640,8,31,39,40,11,2,18,22,69
4133,ORL,2004,Donnell Harvey,23,24,1,345,36,89,.404,0,3,.000,36,86,.419,.404,26,39,.667,29,43,72,8,10,11,22,44,98
4134,ORL,2004,Britton Johnsen,24,20,4,290,17,59,.288,1,12,.083,16,47,.340,.297,7,16,.438,15,30,45,12,7,1,14,28,42
4135,ORL,2004,Sean Rooks,34,20,0,270,20,57,.351,0,1,.000,20,56,.357,.351,21,22,.955,14,33,47,18,5,5,7,41,61
4136,ORL,2004,Desmond Penigar,22,10,0,89,14,28,.500,0,0,,14,28,.500,.500,4,4,1.000,6,18,24,3,2,2,6,14,32
4137,ORL,2004,Derrick Dial,28,9,0,86,9,28,.321,2,9,.222,7,19,.368,.357,6,8,.750,5,8,13,2,6,0,1,6,26
4138,ORL,2004,Lee Nailon,28,8,0,83,11,27,.407,0,0,,11,27,.407,.407,7,9,.778,8,6,14,4,1,0,0,9,29
4139,ORL,2004,Pat Garrity,27,2,0,22,1,3,.333,0,0,,1,3,.333,.333,0,0,,0,0,0,1,0,0,0,2,2
4140,ORL,2004,Robert Archibald,23,1,0,4,1,2,.500,0,0,,1,2,.500,.500,0,2,.000,0,1,1,0,1,0,0,0,2
4141,ORL,2003,Tracy McGrady,23,75,74,2954,829,1813,.457,173,448,.386,656,1365,.481,.505,576,726,.793,121,367,488,411,124,59,195,156,2407
4142,ORL,2003,Pat Garrity,26,81,53,2584,312,744,.419,161,407,.396,151,337,.448,.528,83,100,.830,72,234,306,121,62,20,77,255,868
4143,ORL,2003,Darrell Armstrong,34,82,23,2350,263,643,.409,78,232,.336,185,411,.450,.470,165,188,.878,91,204,295,323,135,13,160,167,769
4144,ORL,2003,Mike Miller,22,49,39,1826,296,708,.418,87,256,.340,209,452,.462,.480,127,150,.847,40,246,286,139,36,16,99,139,806
4145,ORL,2003,Jacque Vaughn,27,80,48,1686,184,411,.448,8,34,.235,176,377,.467,.457,97,125,.776,26,92,118,232,64,2,97,169,473
4146,ORL,2003,Shawn Kemp,33,79,55,1633,211,505,.418,0,1,.000,211,504,.419,.418,115,155,.742,147,304,451,55,66,33,102,239,537
4147,ORL,2003,Andrew DeClercq,29,77,21,1327,149,279,.534,0,0,,149,279,.534,.534,67,104,.644,142,197,339,52,39,36,84,258,365
4148,ORL,2003,Jeryl Sasser,23,75,4,1025,64,207,.309,13,44,.295,51,163,.313,.341,53,78,.679,64,120,184,65,45,12,39,91,194
4149,ORL,2003,Gordan Giriček,25,27,27,961,143,325,.440,39,119,.328,104,206,.505,.500,62,76,.816,18,112,130,67,30,2,51,55,387
4150,ORL,2003,Grant Hill,30,29,29,843,151,307,.492,1,4,.250,150,303,.495,.493,118,144,.819,40,166,206,122,28,13,84,46,421
4151,ORL,2003,Pat Burke,29,62,8,783,113,296,.382,1,7,.143,112,289,.388,.383,40,58,.690,57,89,146,23,19,25,47,99,267
4152,ORL,2003,Drew Gooden,21,19,18,544,100,201,.498,0,2,.000,100,199,.503,.498,59,80,.738,58,102,160,20,15,13,45,51,259
4153,ORL,2003,Steven Hunter,21,33,5,447,56,103,.544,0,0,,56,103,.544,.544,18,44,.409,38,55,93,6,9,36,15,56,130
4154,ORL,2003,Ryan Humphrey,23,35,1,322,23,85,.271,0,0,,23,85,.271,.271,18,28,.643,30,39,69,7,4,16,21,57,64
4155,ORL,2003,Chris Whitney,31,22,1,290,30,88,.341,7,36,.194,23,52,.442,.381,11,12,.917,2,19,21,21,12,1,16,15,78
4156,ORL,2003,Olumide Oyedeji,21,27,3,145,10,23,.435,0,0,,10,23,.435,.435,7,11,.636,10,40,50,5,5,3,5,30,27
4157,ORL,2003,Horace Grant,37,5,1,85,13,25,.520,0,0,,13,25,.520,.520,0,0,,2,6,8,7,3,0,1,5,26
4158,ORL,2002,Tracy McGrady,22,76,76,2912,715,1586,.451,103,283,.364,612,1303,.470,.483,415,555,.748,150,447,597,400,119,73,189,139,1948
4159,ORL,2002,Darrell Armstrong,33,82,79,2730,347,828,.419,139,398,.349,208,430,.484,.503,182,205,.888,83,236,319,453,157,10,175,166,1015
4160,ORL,2002,Pat Garrity,25,80,43,2406,327,767,.426,169,396,.427,158,371,.426,.537,61,73,.836,77,261,338,99,61,28,68,230,884
4161,ORL,2002,Horace Grant,36,76,76,2210,264,515,.513,0,0,,264,515,.513,.513,80,111,.721,159,322,481,104,57,49,51,118,608
4162,ORL,2002,Mike Miller,21,63,53,2123,351,802,.438,116,303,.383,235,499,.471,.510,138,181,.762,49,224,273,198,47,23,108,145,956
4163,ORL,2002,Troy Hudson,25,81,4,1854,354,815,.434,66,187,.353,288,628,.459,.475,176,201,.876,30,115,145,255,57,6,163,119,950
4164,ORL,2002,Monty Williams,30,68,19,1284,198,362,.547,0,4,.000,198,358,.553,.547,88,134,.657,80,155,235,96,49,17,86,134,484
4165,ORL,2002,Patrick Ewing,39,65,4,901,148,333,.444,0,1,.000,148,332,.446,.444,94,134,.701,60,203,263,35,22,45,65,129,390
4166,ORL,2002,Don Reid,28,68,5,714,90,190,.474,0,0,,90,190,.474,.474,44,68,.647,65,111,176,27,20,44,54,180,224
4167,ORL,2002,Andrew DeClercq,28,61,14,633,67,149,.450,0,0,,67,149,.450,.450,28,50,.560,74,89,163,22,23,24,34,130,162
4168,ORL,2002,Jud Buechler,33,60,2,630,42,112,.375,19,54,.352,23,58,.397,.460,2,4,.500,27,81,108,29,20,8,14,46,105
4169,ORL,2002,Steven Hunter,20,53,21,516,67,147,.456,0,0,,67,147,.456,.456,55,94,.585,40,57,97,5,5,43,16,81,189
4170,ORL,2002,Grant Hill,29,14,14,512,83,195,.426,0,2,.000,83,193,.430,.426,69,80,.863,29,96,125,64,8,4,37,40,235
4171,ORL,2002,Bo Outlaw,30,10,0,160,13,21,.619,0,0,,13,21,.619,.619,8,18,.444,15,14,29,5,9,9,11,23,34
4172,ORL,2002,Jaren Jackson,34,9,0,144,15,37,.405,7,20,.350,8,17,.471,.500,2,4,.500,1,16,17,8,5,0,8,13,39
4173,ORL,2002,Dee Brown,33,7,0,65,3,20,.150,1,12,.083,2,8,.250,.175,0,0,,0,9,9,2,3,1,4,4,7
4174,ORL,2002,Jeryl Sasser,22,7,0,36,3,14,.214,0,0,,3,14,.214,.214,4,5,.800,3,4,7,2,3,0,2,3,10
4175,ORL,2001,Tracy McGrady,21,77,77,3087,788,1724,.457,59,166,.355,729,1558,.468,.474,430,587,.733,192,388,580,352,116,118,198,160,2065
4176,ORL,2001,Darrell Armstrong,32,75,75,2767,413,1002,.412,143,403,.355,270,599,.451,.484,220,249,.884,94,249,343,524,135,13,200,155,1189
4177,ORL,2001,Bo Outlaw,29,80,69,2534,226,368,.614,1,2,.500,225,366,.615,.615,129,225,.573,211,408,619,225,105,137,141,241,582
4178,ORL,2001,Mike Miller,20,82,62,2390,368,845,.436,148,364,.407,220,481,.457,.523,91,128,.711,66,261,327,140,51,19,97,200,975
4179,ORL,2001,John Amaechi,30,82,36,1710,237,592,.400,0,7,.000,237,585,.405,.400,176,279,.631,77,191,268,74,28,29,124,175,650
4180,ORL,2001,Pat Garrity,24,76,1,1579,223,576,.387,97,224,.433,126,352,.358,.471,85,98,.867,51,159,210,51,40,15,68,241,628
4181,ORL,2001,Michael Doleac,23,77,21,1398,220,527,.417,0,3,.000,220,524,.420,.417,50,59,.847,70,203,273,65,37,41,59,239,490
4182,ORL,2001,Monty Williams,29,82,0,1211,162,364,.445,1,13,.077,161,351,.459,.446,85,133,.639,86,157,243,79,29,16,85,136,410
4183,ORL,2001,Troy Hudson,24,75,7,1008,125,372,.336,22,109,.202,103,263,.392,.366,85,104,.817,38,67,105,162,37,3,92,82,357
4184,ORL,2001,Andrew DeClercq,27,67,51,903,107,193,.554,0,0,,107,193,.554,.554,47,82,.573,91,145,236,32,41,33,51,198,261
4185,ORL,2001,Don Reid,27,65,7,764,82,145,.566,0,0,,82,145,.566,.566,46,75,.613,84,158,242,21,23,54,48,190,210
4186,ORL,2001,Cory Alexander,27,26,0,227,18,56,.321,4,16,.250,14,40,.350,.357,12,18,.667,0,25,25,36,16,0,25,29,52
4187,ORL,2001,Dee Brown,32,7,0,155,16,44,.364,12,32,.375,4,12,.333,.500,4,5,.800,0,11,11,12,4,0,7,10,48
4188,ORL,2001,Grant Hill,28,4,4,133,19,43,.442,1,1,1.000,18,42,.429,.453,16,26,.615,8,17,25,25,5,2,11,9,55
4189,ORL,2001,James Robinson,30,6,0,50,4,11,.364,2,5,.400,2,6,.333,.455,0,0,,0,8,8,0,4,1,4,5,10
4190,ORL,2001,Elliot Perry,31,6,0,39,5,11,.455,0,1,.000,5,10,.500,.455,0,0,,1,3,4,5,3,0,6,1,10
4191,ORL,2000,Darrell Armstrong,31,82,82,2590,484,1119,.433,137,403,.340,347,716,.485,.494,225,247,.911,65,205,270,501,169,9,248,137,1330
4192,ORL,2000,Bo Outlaw,28,82,55,2326,204,339,.602,0,3,.000,204,336,.607,.602,82,162,.506,202,323,525,245,113,148,133,203,490
4193,ORL,2000,Ben Wallace,25,81,81,1959,168,334,.503,0,0,,168,334,.503,.503,54,114,.474,211,454,665,67,72,130,67,162,390
4194,ORL,2000,John Amaechi,29,80,53,1684,306,700,.437,1,6,.167,305,694,.439,.438,223,291,.766,62,204,266,95,35,37,139,161,836
4195,ORL,2000,Chucky Atkins,25,82,0,1626,314,741,.424,57,163,.350,257,578,.445,.462,97,133,.729,20,106,126,306,52,3,142,137,782
4196,ORL,2000,Monty Williams,28,75,23,1501,263,538,.489,2,5,.400,261,533,.490,.491,123,166,.741,96,154,250,106,46,17,109,187,651
4197,ORL,2000,Pat Garrity,23,82,1,1479,258,585,.441,79,197,.401,179,388,.461,.509,80,111,.721,44,166,210,58,31,19,85,197,675
4198,ORL,2000,Corey Maggette,20,77,5,1370,224,469,.478,2,11,.182,222,458,.485,.480,196,261,.751,123,180,303,61,24,26,138,169,646
4199,ORL,2000,Michael Doleac,22,81,29,1335,242,535,.452,1,2,.500,241,533,.452,.453,80,95,.842,89,245,334,63,29,34,65,224,565
4200,ORL,2000,Tariq Abdul-Wahad,25,46,46,1205,223,515,.433,2,21,.095,221,494,.447,.435,115,151,.762,77,162,239,72,53,16,87,116,563
4201,ORL,2000,Chris Gatling,32,45,0,1041,210,462,.455,7,23,.304,203,439,.462,.462,171,245,.698,91,206,297,40,48,10,105,142,598
4202,ORL,2000,Ron Mercer,23,31,31,969,188,468,.402,0,9,.000,188,459,.410,.402,94,119,.790,35,63,98,54,42,8,64,76,470
4203,ORL,2000,Anthony Johnson,25,18,4,214,26,61,.426,1,5,.200,25,56,.446,.434,9,15,.600,6,6,12,13,10,2,8,17,62
4204,ORL,2000,Anthony Parker,24,16,0,185,24,57,.421,1,14,.071,23,43,.535,.430,8,11,.727,5,22,27,10,8,4,11,13,57
4205,ORL,2000,Derek Strong,31,20,0,148,21,48,.438,1,4,.250,20,44,.455,.448,11,14,.786,11,33,44,4,5,2,12,15,54
4206,ORL,2000,Matt Harpring,23,4,0,63,4,17,.235,2,2,1.000,2,15,.133,.294,6,7,.857,5,7,12,8,5,1,1,7,16
4207,ORL,2000,Johnny Taylor,25,5,0,29,5,12,.417,1,1,1.000,4,11,.364,.458,0,0,,2,3,5,1,1,1,2,4,11
4208,ORL,2000,Kiwane Lemorris Garris,25,3,0,23,2,10,.200,0,1,.000,2,9,.222,.200,0,0,,0,1,1,2,0,0,1,0,4
4209,ORL,2000,Earl Boykins,23,1,0,8,3,4,.750,0,0,,3,4,.750,.750,0,0,,1,0,1,3,0,0,0,0,6
4210,ORL,1999,Anfernee Hardaway,27,50,50,1944,301,717,.420,40,140,.286,261,577,.452,.448,149,211,.706,74,210,284,266,111,23,150,111,791
4211,ORL,1999,Horace Grant,33,50,50,1660,198,456,.434,0,2,.000,198,454,.436,.434,47,70,.671,117,234,351,90,46,60,44,99,443
4212,ORL,1999,Nick Anderson,31,47,39,1581,253,640,.395,96,277,.347,157,363,.433,.470,99,162,.611,51,226,277,91,64,15,83,72,701
4213,ORL,1999,Darrell Armstrong,30,50,15,1502,230,522,.441,69,189,.365,161,333,.483,.507,161,178,.904,53,127,180,335,108,4,158,90,690
4214,ORL,1999,Isaac Austin,29,49,49,1259,185,453,.408,2,7,.286,183,446,.410,.411,105,157,.669,83,154,237,89,47,35,114,125,477
4215,ORL,1999,Matt Harpring,22,50,22,1114,148,320,.463,10,25,.400,138,295,.468,.478,102,143,.713,88,126,214,45,30,6,73,112,408
4216,ORL,1999,Bo Outlaw,27,31,22,851,84,154,.545,0,3,.000,84,151,.556,.545,35,81,.432,54,113,167,56,40,43,58,79,203
4217,ORL,1999,Michael Doleac,21,49,0,780,125,267,.468,0,0,,125,267,.468,.468,54,80,.675,66,82,148,20,19,17,26,117,304
4218,ORL,1999,Derek Strong,30,44,0,695,76,180,.422,0,2,.000,76,178,.427,.422,71,99,.717,66,95,161,17,15,7,37,64,223
4219,ORL,1999,Dominique Wilkins,39,27,2,252,50,132,.379,5,19,.263,45,113,.398,.398,29,42,.690,30,41,71,16,4,1,23,19,134
4220,ORL,1999,B.J. Armstrong,31,22,0,180,19,45,.422,1,7,.143,18,38,.474,.433,9,11,.818,1,22,23,34,9,0,15,15,48
4221,ORL,1999,Danny Schayes,39,19,1,143,11,29,.379,0,0,,11,29,.379,.379,6,8,.750,3,11,14,4,1,2,8,23,28
4222,ORL,1999,Doug Overton,29,6,0,33,6,12,.500,0,2,.000,6,10,.600,.500,6,6,1.000,1,1,2,3,1,0,3,2,18
4223,ORL,1999,Gerald Wilkins,35,3,0,28,0,9,.000,0,0,,0,9,.000,.000,2,2,1.000,0,1,1,1,0,0,3,3,2
4224,ORL,1999,Miles Simon,23,5,0,19,1,5,.200,0,2,.000,1,3,.333,.200,0,0,,1,1,2,0,1,0,3,1,2
4225,ORL,1999,Jonathan Kerner,24,1,0,5,0,1,.000,0,0,,0,1,.000,.000,0,0,,0,0,0,0,0,0,0,2,0
4226,ORL,1999,Kevin Ollie,26,1,0,4,0,1,.000,0,0,,0,1,.000,.000,1,2,.500,0,1,1,0,0,0,0,1,1
4227,ORL,1998,Bo Outlaw,26,82,76,2953,301,543,.554,1,4,.250,300,539,.557,.555,180,313,.575,255,382,637,216,107,181,175,260,783
4228,ORL,1998,Horace Grant,32,76,76,2803,393,857,.459,0,7,.000,393,850,.462,.459,135,199,.678,228,390,618,172,81,79,88,180,921
4229,ORL,1998,Derek Harper,36,66,45,1761,226,542,.417,59,164,.360,167,378,.442,.471,55,79,.696,23,80,103,233,72,10,101,140,566
4230,ORL,1998,Nick Anderson,30,58,44,1701,343,754,.455,77,214,.360,266,540,.493,.506,127,199,.638,98,199,297,119,72,23,85,98,890
4231,ORL,1998,Derek Strong,29,58,8,1638,259,617,.420,0,4,.000,259,613,.423,.420,218,279,.781,152,275,427,51,31,24,74,122,736
4232,ORL,1998,Rony Seikaly,32,47,47,1484,237,538,.441,0,2,.000,237,536,.442,.441,230,305,.754,130,227,357,69,25,39,134,137,704
4233,ORL,1998,Mark Price,33,63,33,1430,229,531,.431,52,155,.335,177,376,.471,.480,87,103,.845,24,105,129,297,53,5,162,92,597
4234,ORL,1998,Danny Schayes,38,74,33,1272,155,371,.418,0,0,,155,371,.418,.418,96,119,.807,97,145,242,44,34,33,61,182,406
4235,ORL,1998,Gerald Wilkins,34,72,16,1252,141,434,.325,29,109,.266,112,325,.345,.358,69,98,.704,16,74,90,78,34,6,79,78,380
4236,ORL,1998,Darrell Armstrong,29,48,17,1236,156,380,.411,25,68,.368,131,312,.420,.443,105,123,.854,65,94,159,236,58,5,112,96,442
4237,ORL,1998,Anfernee Hardaway,26,19,15,625,103,273,.377,15,50,.300,88,223,.395,.405,90,118,.763,8,68,76,68,28,15,46,45,311
4238,ORL,1998,Brian Evans,24,44,0,561,77,206,.374,12,45,.267,65,161,.404,.403,40,48,.833,31,54,85,31,22,8,24,57,206
4239,ORL,1998,David Benoit,29,24,0,324,50,139,.360,14,51,.275,36,88,.409,.410,24,30,.800,18,44,62,8,9,4,13,37,138
4240,ORL,1998,Kevin Ollie,25,19,0,216,23,56,.411,0,1,.000,23,55,.418,.411,31,45,.689,3,15,18,33,7,0,28,15,77
4241,ORL,1998,Vernon Maxwell,32,11,0,169,26,78,.333,6,26,.231,20,52,.385,.372,23,26,.885,5,8,13,12,2,1,12,20,81
4242,ORL,1998,Kevin Edwards,32,12,0,135,20,59,.339,2,4,.500,18,55,.327,.356,17,20,.850,9,11,20,13,5,1,10,8,59
4243,ORL,1998,Johnny Taylor,23,12,0,108,13,37,.351,1,2,.500,12,35,.343,.365,11,16,.688,4,9,13,1,3,2,8,22,38
4244,ORL,1998,Jason Lawson,23,17,0,80,9,15,.600,0,0,,9,15,.600,.600,8,10,.800,8,19,27,5,4,4,2,14,26
4245,ORL,1998,Spud Webb,34,4,0,34,5,12,.417,0,1,.000,5,11,.455,.417,2,2,1.000,2,1,3,5,1,0,7,6,12
4246,ORL,1998,Donald Royal,31,2,0,18,1,6,.167,0,0,,1,6,.167,.167,3,4,.750,2,2,4,1,1,0,3,5,5
4247,ORL,1998,Tim Kempton,34,3,0,15,0,2,.000,0,0,,0,2,.000,.000,0,0,,0,1,1,1,0,0,0,3,0
4248,ORL,1998,Carl Thomas,28,4,0,15,4,5,.800,0,0,,4,5,.800,.800,1,2,.500,0,0,0,1,0,1,0,0,9
4249,ORL,1997,Rony Seikaly,31,74,68,2615,460,907,.507,0,3,.000,460,904,.509,.507,357,500,.714,274,427,701,92,49,107,218,275,1277
4250,ORL,1997,Horace Grant,31,67,67,2496,358,695,.515,1,6,.167,357,689,.518,.516,128,179,.715,206,394,600,163,101,65,99,157,845
4251,ORL,1997,Anfernee Hardaway,25,59,59,2221,421,941,.447,85,267,.318,336,674,.499,.493,283,345,.820,82,181,263,332,93,35,145,123,1210
4252,ORL,1997,Gerald Wilkins,33,80,26,2202,323,759,.426,66,203,.325,257,556,.462,.469,136,190,.716,59,114,173,173,54,12,123,144,848
4253,ORL,1997,Dennis Scott,28,66,62,2166,298,749,.398,147,373,.394,151,376,.402,.496,80,101,.792,40,163,203,139,74,19,81,138,823
4254,ORL,1997,Nick Anderson,29,63,61,2163,288,725,.397,143,405,.353,145,320,.453,.496,38,94,.404,66,238,304,182,120,32,86,160,757
4255,ORL,1997,Derek Strong,28,82,21,2004,262,586,.447,0,13,.000,262,573,.457,.447,175,218,.803,174,345,519,73,47,20,102,196,699
4256,ORL,1997,Brian Shaw,30,77,31,1867,189,516,.366,63,194,.325,126,322,.391,.427,111,140,.793,47,147,194,319,67,26,170,197,552
4257,ORL,1997,Darrell Armstrong,28,67,0,1010,132,345,.383,55,181,.304,77,164,.470,.462,92,106,.868,35,41,76,175,61,9,99,114,411
4258,ORL,1997,Danny Schayes,37,45,6,540,47,120,.392,0,1,.000,47,119,.395,.392,39,52,.750,41,84,125,14,15,16,27,74,133
4259,ORL,1997,David Vaughn,23,35,6,298,31,72,.431,0,0,,31,72,.431,.431,19,30,.633,35,60,95,7,8,15,29,43,81
4260,ORL,1997,Amal McCaskill,23,17,1,109,10,32,.313,0,2,.000,10,30,.333,.313,8,12,.667,4,18,22,7,3,5,11,7,28
4261,ORL,1997,Brian Evans,23,14,0,59,8,22,.364,4,8,.500,4,14,.286,.455,0,0,,1,7,8,7,1,2,2,6,20
4262,ORL,1997,Kenny Smith,31,6,0,47,6,13,.462,3,5,.600,3,8,.375,.577,2,2,1.000,1,1,2,4,0,0,6,3,17
4263,ORL,1997,Donald Royal,30,1,1,29,4,10,.400,0,0,,4,10,.400,.400,4,4,1.000,1,0,1,1,0,0,3,3,12
4264,ORL,1997,Felton Spencer,29,1,1,19,2,2,1.000,0,0,,2,2,1.000,1.000,0,0,,5,1,6,1,0,0,1,2,4
4265,ORL,1997,Dell Demps,26,2,0,10,0,3,.000,0,1,.000,0,2,.000,.000,2,2,1.000,0,0,0,0,1,0,0,1,2
4266,ORL,1996,Dennis Scott,27,82,82,3041,491,1117,.440,267,628,.425,224,489,.458,.559,182,222,.820,63,246,309,243,90,29,122,169,1431
4267,ORL,1996,Anfernee Hardaway,24,82,82,3015,623,1215,.513,89,283,.314,534,932,.573,.549,445,580,.767,129,225,354,582,166,41,229,160,1780
4268,ORL,1996,Nick Anderson,28,77,77,2717,400,904,.442,168,430,.391,232,474,.489,.535,166,240,.692,92,323,415,279,121,46,141,135,1134
4269,ORL,1996,Horace Grant,30,63,62,2286,347,677,.513,1,6,.167,346,671,.516,.513,152,207,.734,178,402,580,170,62,74,64,144,847
4270,ORL,1996,Shaquille O'Neal,23,54,52,1946,592,1033,.573,1,2,.500,591,1031,.573,.574,249,511,.487,182,414,596,155,34,115,155,193,1434
4271,ORL,1996,Brian Shaw,29,75,1,1679,182,486,.374,41,144,.285,141,342,.412,.417,91,114,.798,58,166,224,336,58,11,173,160,496
4272,ORL,1996,Jon Koncak,32,67,35,1288,84,175,.480,3,9,.333,81,166,.488,.489,32,57,.561,63,209,272,51,27,44,41,226,203
4273,ORL,1996,Anthony Bowie,32,74,4,1078,128,272,.471,12,31,.387,116,241,.481,.493,40,46,.870,40,83,123,105,34,10,55,112,308
4274,ORL,1996,Joe Wolf,31,63,8,1047,135,262,.515,0,6,.000,135,256,.527,.515,21,29,.724,49,136,185,63,13,5,40,161,291
4275,ORL,1996,Donald Royal,29,64,7,963,106,216,.491,0,2,.000,106,214,.495,.491,125,164,.762,57,96,153,42,29,15,52,97,337
4276,ORL,1996,David Vaughn,22,33,0,266,27,80,.338,0,1,.000,27,79,.342,.338,10,18,.556,33,47,80,8,6,15,18,68,64
4277,ORL,1996,Brooks Thompson,25,33,0,246,48,103,.466,25,64,.391,23,39,.590,.587,19,27,.704,4,20,24,31,12,0,24,35,140
4278,ORL,1996,Jeff Turner,33,13,0,192,18,51,.353,9,27,.333,9,24,.375,.441,2,2,1.000,10,18,28,6,2,1,11,33,47
4279,ORL,1996,Anthony Bonner,27,4,0,43,5,15,.333,0,0,,5,15,.333,.333,3,7,.429,6,13,19,4,3,0,3,11,13
4280,ORL,1996,Darrell Armstrong,27,13,0,41,16,32,.500,6,12,.500,10,20,.500,.594,4,4,1.000,0,2,2,5,6,0,6,4,42
4281,ORL,1996,Geert Hammink,26,3,0,7,1,2,.500,0,0,,1,2,.500,.500,2,4,.500,2,1,3,0,0,0,2,1,4
4282,ORL,1995,Shaquille O'Neal,22,79,79,2923,930,1594,.583,0,5,.000,930,1589,.585,.583,455,854,.533,328,573,901,214,73,192,204,258,2315
4283,ORL,1995,Anfernee Hardaway,23,77,77,2901,585,1142,.512,87,249,.349,498,893,.558,.550,356,463,.769,139,197,336,551,130,26,258,158,1613
4284,ORL,1995,Horace Grant,29,74,74,2693,401,707,.567,0,8,.000,401,699,.574,.567,146,211,.692,223,492,715,173,76,88,85,203,948
4285,ORL,1995,Nick Anderson,27,76,76,2588,439,923,.476,179,431,.415,260,492,.528,.573,143,203,.704,85,250,335,314,125,22,141,124,1200
4286,ORL,1995,Donald Royal,28,70,68,1841,206,434,.475,0,4,.000,206,430,.479,.475,223,299,.746,83,196,279,198,45,16,125,156,635
4287,ORL,1995,Brian Shaw,28,78,9,1836,192,494,.389,48,184,.261,144,310,.465,.437,70,95,.737,52,189,241,406,73,18,184,184,502
4288,ORL,1995,Dennis Scott,26,62,10,1499,283,645,.439,150,352,.426,133,293,.454,.555,86,114,.754,25,121,146,131,45,14,57,119,802
4289,ORL,1995,Anthony Bowie,31,77,4,1261,177,369,.480,12,40,.300,165,329,.502,.496,61,73,.836,54,85,139,159,47,21,86,138,427
4290,ORL,1995,Anthony Avent,25,71,3,1066,105,244,.430,0,0,,105,244,.430,.430,48,75,.640,97,196,293,41,28,50,53,170,258
4291,ORL,1995,Jeff Turner,32,49,5,576,73,178,.410,27,75,.360,46,103,.447,.486,26,29,.897,23,74,97,38,12,3,22,102,199
4292,ORL,1995,Tree Rollins,39,51,3,478,20,42,.476,0,0,,20,42,.476,.476,21,31,.677,31,64,95,9,7,36,23,63,61
4293,ORL,1995,Brooks Thompson,24,38,2,246,45,114,.395,18,58,.310,27,56,.482,.474,8,12,.667,7,16,23,43,10,2,27,46,116
4294,ORL,1995,Darrell Armstrong,26,3,0,8,3,8,.375,2,6,.333,1,2,.500,.500,2,2,1.000,1,0,1,3,1,0,1,3,10
4295,ORL,1995,Geert Hammink,25,1,0,7,1,3,.333,0,0,,1,3,.333,.333,2,2,1.000,0,2,2,1,0,0,0,1,4
4296,ORL,1995,Keith Tower,24,3,0,7,0,2,.000,0,0,,0,2,.000,.000,1,2,.500,1,2,3,0,0,0,1,1,1
4297,ORL,1994,Shaquille O'Neal,21,81,81,3224,953,1591,.599,0,2,.000,953,1589,.600,.599,471,850,.554,384,688,1072,195,76,231,222,281,2377
4298,ORL,1994,Anfernee Hardaway,22,82,82,3015,509,1092,.466,50,187,.267,459,905,.507,.489,245,330,.742,192,247,439,544,190,51,292,205,1313
4299,ORL,1994,Nick Anderson,26,81,81,2811,504,1054,.478,101,314,.322,403,740,.545,.526,168,250,.672,113,363,476,294,134,33,165,148,1277
4300,ORL,1994,Scott Skiles,29,82,46,2303,276,644,.429,68,165,.412,208,479,.434,.481,195,222,.878,42,147,189,503,47,2,193,171,815
4301,ORL,1994,Dennis Scott,25,82,37,2283,384,949,.405,155,388,.399,229,561,.408,.486,123,159,.774,54,164,218,216,81,32,93,161,1046
4302,ORL,1994,Jeff Turner,31,68,51,1536,199,426,.467,18,55,.327,181,371,.488,.488,35,45,.778,79,192,271,60,23,11,75,239,451
4303,ORL,1994,Donald Royal,27,74,0,1357,174,347,.501,0,2,.000,174,345,.504,.501,199,269,.740,94,154,248,61,50,16,76,121,547
4304,ORL,1994,Anthony Bowie,30,70,0,948,139,289,.481,1,18,.056,138,271,.509,.483,41,49,.837,29,91,120,102,32,12,58,81,320
4305,ORL,1994,Larry Krystkowiak,29,34,11,682,71,148,.480,0,1,.000,71,147,.483,.480,31,39,.795,38,85,123,35,14,4,29,74,173
4306,ORL,1994,Anthony Avent,24,41,20,676,58,170,.341,0,0,,58,170,.341,.341,28,44,.636,84,100,184,32,17,11,42,87,144
4307,ORL,1994,Tree Rollins,38,45,1,384,29,53,.547,0,0,,29,53,.547,.547,18,30,.600,33,63,96,9,7,35,13,55,76
4308,ORL,1994,Greg Kite,32,29,0,309,13,35,.371,0,0,,13,35,.371,.371,8,22,.364,22,48,70,4,2,12,17,61,34
4309,ORL,1994,Litterial Green,23,29,0,126,22,57,.386,1,4,.250,21,53,.396,.395,28,37,.757,6,6,12,9,6,1,13,16,73
4310,ORL,1994,Keith Tower,23,11,0,32,4,9,.444,0,0,,4,9,.444,.444,0,0,,0,6,6,1,0,0,0,6,8
4311,ORL,1994,Todd Lichti,27,4,0,20,4,9,.444,0,0,,4,9,.444,.444,0,0,,3,1,4,2,2,0,2,3,8
4312,ORL,1994,Lorenzo Williams,24,3,0,19,1,6,.167,0,1,.000,1,5,.200,.167,0,0,,3,1,4,2,2,3,0,3,2
4313,ORL,1994,Geert Hammink,24,1,0,3,1,3,.333,0,0,,1,3,.333,.333,0,0,,1,0,1,1,0,0,0,1,2
4314,ORL,1994,Anthony Cook,26,2,0,2,0,1,.000,0,0,,0,1,.000,.000,0,0,,0,0,0,0,0,2,1,0,0
4315,ORL,1993,Scott Skiles,28,78,78,3086,416,891,.467,80,235,.340,336,656,.512,.512,289,324,.892,52,238,290,735,86,2,267,244,1201
4316,ORL,1993,Shaquille O'Neal,20,81,81,3071,733,1304,.562,0,2,.000,733,1302,.563,.562,427,721,.592,342,780,1122,152,60,286,307,321,1893
4317,ORL,1993,Nick Anderson,25,79,76,2920,594,1324,.449,88,249,.353,506,1075,.471,.482,298,402,.741,122,355,477,265,128,56,164,200,1574
4318,ORL,1993,Tom Tolbert,27,72,61,1838,226,454,.498,9,28,.321,217,426,.509,.508,122,168,.726,133,279,412,91,33,21,124,192,583
4319,ORL,1993,Anthony Bowie,29,77,45,1761,268,569,.471,15,48,.313,253,521,.486,.484,67,84,.798,36,158,194,175,54,14,84,131,618
4320,ORL,1993,Dennis Scott,24,54,43,1759,329,763,.431,108,268,.403,221,495,.446,.502,92,117,.786,38,148,186,136,57,18,104,131,858
4321,ORL,1993,Donald Royal,26,77,0,1636,194,391,.496,0,3,.000,194,388,.500,.496,318,390,.815,116,179,295,80,36,25,113,179,706
4322,ORL,1993,Jeff Turner,30,75,20,1479,231,437,.529,10,17,.588,221,420,.526,.540,56,70,.800,74,178,252,107,19,9,66,192,528
4323,ORL,1993,Greg Kite,31,64,1,640,38,84,.452,0,1,.000,38,83,.458,.452,13,24,.542,66,127,193,10,13,12,35,133,89
4324,ORL,1993,Litterial Green,22,52,4,626,87,198,.439,1,10,.100,86,188,.457,.442,60,96,.625,11,23,34,116,23,4,42,70,235
4325,ORL,1993,Steve Kerr,27,47,0,440,48,112,.429,6,24,.250,42,88,.477,.455,20,22,.909,5,33,38,59,8,1,25,34,122
4326,ORL,1993,Terry Catledge,29,21,1,262,36,73,.493,0,0,,36,73,.493,.493,27,34,.794,18,28,46,5,4,1,25,31,99
4327,ORL,1993,Bison Dele,23,21,0,240,40,78,.513,0,1,.000,40,77,.519,.513,16,20,.800,24,32,56,5,14,17,25,48,96
4328,ORL,1993,Chris Corchiani,24,9,0,102,13,23,.565,0,3,.000,13,20,.650,.565,16,21,.762,1,6,7,16,6,0,8,17,42
4329,ORL,1993,Lorenzo Williams,23,3,0,10,0,2,.000,0,0,,0,2,.000,.000,0,0,,1,1,2,0,1,1,0,2,0
4330,ORL,1993,Howard Wright,25,4,0,10,4,5,.800,0,0,,4,5,.800,.800,0,2,.000,1,1,2,0,0,0,0,0,8
4331,ORL,1992,Terry Catledge,28,78,67,2430,457,922,.496,0,4,.000,457,918,.498,.496,240,346,.694,257,292,549,109,58,16,138,196,1154
4332,ORL,1992,Scott Skiles,27,75,63,2377,359,868,.414,91,250,.364,268,618,.434,.466,248,277,.895,36,166,202,544,74,5,233,188,1057
4333,ORL,1992,Nick Anderson,24,60,59,2203,482,1042,.463,30,85,.353,452,957,.472,.477,202,303,.667,98,286,384,163,97,33,126,132,1196
4334,ORL,1992,Anthony Bowie,28,52,26,1721,312,633,.493,17,44,.386,295,589,.501,.506,117,136,.860,70,175,245,163,55,38,107,101,758
4335,ORL,1992,Jeff Turner,29,75,42,1591,225,499,.451,1,8,.125,224,491,.456,.452,79,114,.693,62,184,246,92,24,16,106,229,530
4336,ORL,1992,Greg Kite,30,72,44,1479,94,215,.437,0,1,.000,94,214,.439,.437,40,68,.588,156,246,402,44,30,57,61,212,228
4337,ORL,1992,Jerry Reynolds,29,46,16,1159,197,518,.380,3,24,.125,194,494,.393,.383,158,189,.836,47,102,149,151,63,17,96,69,555
4338,ORL,1992,Stanley Roberts,21,55,34,1118,236,446,.529,0,1,.000,236,445,.530,.529,101,196,.515,113,223,336,39,22,83,78,221,573
4339,ORL,1992,Mark Acres,29,68,6,926,78,151,.517,1,3,.333,77,148,.520,.520,51,67,.761,97,155,252,22,25,15,33,140,208
4340,ORL,1992,Bison Dele,22,48,2,905,171,324,.528,0,0,,171,324,.528,.528,95,142,.669,115,157,272,33,41,53,86,139,437
4341,ORL,1992,Sam Vincent,28,39,18,885,150,349,.430,1,13,.077,149,336,.443,.431,110,130,.846,19,82,101,148,35,4,72,55,411
4342,ORL,1992,Otis Smith,28,55,5,877,116,318,.365,8,21,.381,108,297,.364,.377,70,91,.769,40,76,116,57,36,13,62,85,310
4343,ORL,1992,Chris Corchiani,23,51,1,741,77,193,.399,10,37,.270,67,156,.429,.425,91,104,.875,18,60,78,141,45,2,74,94,255
4344,ORL,1992,Dennis Scott,23,18,15,608,133,331,.402,29,89,.326,104,242,.430,.446,64,71,.901,14,52,66,35,20,9,31,49,359
4345,ORL,1992,Sean Higgins,23,32,12,580,123,262,.469,6,24,.250,117,238,.492,.481,24,29,.828,27,67,94,37,14,6,37,52,276
4346,ORL,1992,Morlon Wiley,25,9,0,90,9,28,.321,0,4,.000,9,24,.375,.321,3,5,.600,2,5,7,13,4,0,8,13,21
4347,ORL,1992,Stephen Thompson,23,1,0,15,1,3,.333,0,0,,1,3,.333,.333,0,0,,0,1,1,1,0,0,2,2,2
4348,ORL,1991,Scott Skiles,26,79,66,2714,462,1039,.445,93,228,.408,369,811,.455,.489,340,377,.902,57,213,270,660,89,4,252,192,1357
4349,ORL,1991,Dennis Scott,22,82,73,2336,503,1183,.425,125,334,.374,378,849,.445,.478,153,204,.750,62,173,235,134,62,25,127,203,1284
4350,ORL,1991,Greg Kite,29,82,82,2225,166,338,.491,0,0,,166,338,.491,.491,63,123,.512,189,399,588,59,25,81,102,298,395
4351,ORL,1991,Nick Anderson,23,70,42,1971,400,857,.467,17,58,.293,383,799,.479,.477,173,259,.668,92,294,386,106,74,44,113,145,990
4352,ORL,1991,Otis Smith,27,75,39,1885,407,902,.451,9,46,.196,398,856,.465,.456,221,301,.734,176,213,389,169,85,35,140,190,1044
4353,ORL,1991,Jerry Reynolds,28,80,9,1843,344,793,.434,10,34,.294,334,759,.440,.440,336,419,.802,88,211,299,203,95,56,172,123,1034
4354,ORL,1991,Jeff Turner,28,71,43,1683,259,532,.487,6,15,.400,253,517,.489,.492,85,112,.759,108,255,363,97,29,10,126,234,609
4355,ORL,1991,Terry Catledge,27,51,38,1459,292,632,.462,0,5,.000,292,627,.466,.462,161,258,.624,168,187,355,58,34,9,107,113,745
4356,ORL,1991,Mark Acres,28,68,0,1313,109,214,.509,1,3,.333,108,211,.512,.512,66,101,.653,140,219,359,25,25,25,42,218,285
4357,ORL,1991,Sam Vincent,27,49,17,975,152,353,.431,3,19,.158,149,334,.446,.435,99,120,.825,17,90,107,197,30,5,91,74,406
4358,ORL,1991,Michael Ansley,23,67,1,877,144,263,.548,0,0,,144,263,.548,.548,91,127,.717,122,131,253,25,27,7,32,125,379
4359,ORL,1991,Morlon Wiley,24,34,0,350,45,108,.417,6,12,.500,39,96,.406,.444,17,25,.680,4,13,17,73,24,0,34,37,113
4360,ORL,1991,Howard Wright,23,8,0,136,15,41,.366,0,0,,15,41,.366,.366,13,21,.619,10,27,37,3,3,5,9,23,43
4361,ORL,1991,Mark McNamara,31,2,0,13,0,1,.000,0,0,,0,1,.000,.000,0,0,,0,4,4,0,0,0,0,1,0
4362,ORL,1990,Terry Catledge,26,74,72,2462,546,1152,.474,2,8,.250,544,1144,.476,.475,341,486,.702,271,292,563,72,36,17,181,201,1435
4363,ORL,1990,Reggie Theus,32,76,71,2350,517,1178,.439,26,105,.248,491,1073,.458,.450,378,443,.853,75,146,221,407,60,12,226,194,1438
4364,ORL,1990,Sidney Green,29,73,31,1860,312,667,.468,1,3,.333,311,664,.468,.469,136,209,.651,166,422,588,99,50,26,119,231,761
4365,ORL,1990,Jerry Reynolds,27,67,40,1817,309,741,.417,1,14,.071,308,727,.424,.418,239,322,.742,91,232,323,180,93,64,139,162,858
4366,ORL,1990,Nick Anderson,22,81,9,1785,372,753,.494,1,17,.059,371,736,.504,.495,186,264,.705,107,209,316,124,69,34,138,140,931
4367,ORL,1990,Mark Acres,27,80,50,1691,138,285,.484,3,4,.750,135,281,.480,.489,83,120,.692,154,277,431,67,36,25,70,248,362
4368,ORL,1990,Sam Vincent,26,63,45,1657,258,564,.457,1,14,.071,257,550,.467,.458,188,214,.879,37,157,194,354,65,20,132,108,705
4369,ORL,1990,Otis Smith,26,65,35,1644,348,708,.492,10,40,.250,338,668,.506,.499,169,222,.761,117,183,300,147,76,57,102,174,875
4370,ORL,1990,Scott Skiles,25,70,32,1460,190,464,.409,52,132,.394,138,332,.416,.466,104,119,.874,23,136,159,334,36,4,90,126,536
4371,ORL,1990,Michael Ansley,22,72,5,1221,231,465,.497,0,0,,231,465,.497,.497,164,227,.722,187,175,362,40,24,17,50,152,626
4372,ORL,1990,Jeff Turner,27,60,15,1105,132,308,.429,2,10,.200,130,298,.436,.432,42,54,.778,52,175,227,53,23,12,61,161,308
4373,ORL,1990,Morlon Wiley,23,40,2,638,92,208,.442,17,46,.370,75,162,.463,.483,28,38,.737,13,39,52,114,45,3,63,65,229
4374,ORL,1990,Dave Corzine,33,6,3,79,11,29,.379,0,0,,11,29,.379,.379,0,2,.000,7,11,18,2,2,0,8,7,22
4375,ORL,1990,Jawann Oldham,32,3,0,36,1,3,.333,0,0,,1,3,.333,.333,2,5,.400,4,11,15,0,2,3,3,6,4
4376,NYK,2024,Jalen Brunson,27,77,77,2726,790,1648,.479,211,526,.401,579,1122,.516,.543,421,497,.847,43,235,278,519,70,13,186,144,2212
4377,NYK,2024,Josh Hart,28,81,42,2707,295,679,.434,80,258,.310,215,421,.511,.493,91,115,.791,128,547,675,331,75,23,118,171,761
4378,NYK,2024,Donte DiVincenzo,27,81,63,2360,445,1004,.443,283,705,.401,162,299,.542,.584,86,114,.754,63,234,297,216,107,36,113,166,1259
4379,NYK,2024,Isaiah Hartenstein,25,75,49,1896,235,365,.644,1,3,.333,234,362,.646,.645,111,157,.707,244,382,626,188,87,85,93,210,582
4380,NYK,2024,Julius Randle,29,46,46,1630,395,836,.472,76,244,.311,319,592,.539,.518,236,302,.781,99,324,423,229,25,12,159,125,1102
4381,NYK,2024,Miles McBride,23,68,14,1328,205,454,.452,109,266,.410,96,188,.511,.572,43,50,.860,31,69,100,114,50,7,30,108,562
4382,NYK,2024,Precious Achiuwa,24,49,18,1187,157,299,.525,13,50,.260,144,249,.578,.547,45,70,.643,141,210,351,53,30,56,54,103,372
4383,NYK,2024,Quentin Grimes,23,45,18,910,113,286,.395,77,212,.363,36,74,.486,.530,24,34,.706,14,74,88,52,30,3,21,66,327
4384,NYK,2024,OG Anunoby,26,23,23,802,125,256,.488,41,104,.394,84,152,.553,.568,34,43,.791,23,79,102,35,40,23,38,57,325
4385,NYK,2024,Mitchell Robinson,25,31,21,768,73,127,.575,0,0,,73,127,.575,.575,27,66,.409,142,121,263,18,37,35,25,55,173
4386,NYK,2024,RJ Barrett,23,26,26,766,164,388,.423,43,130,.331,121,258,.469,.478,103,124,.831,19,92,111,63,12,9,47,45,474
4387,NYK,2024,Immanuel Quickley,24,30,0,720,152,335,.454,64,162,.395,88,173,.509,.549,82,94,.872,5,72,77,74,16,3,31,44,450
4388,NYK,2024,Jericho Sims,25,45,11,585,38,55,.691,0,0,,38,55,.691,.691,16,24,.667,56,91,147,25,8,19,16,45,92
4389,NYK,2024,Bojan Bogdanović,34,29,0,557,110,256,.430,47,127,.370,63,129,.488,.521,36,45,.800,9,49,58,26,7,1,38,38,303
4390,NYK,2024,Alec Burks,32,23,1,311,50,163,.307,25,83,.301,25,80,.313,.383,24,33,.727,8,32,40,20,7,1,16,11,149
4391,NYK,2024,Taj Gibson,38,16,1,165,7,23,.304,0,6,.000,7,17,.412,.304,2,2,1.000,10,18,28,9,2,6,5,28,16
4392,NYK,2024,Malachi Flynn,25,14,0,60,9,23,.391,4,13,.308,5,10,.500,.478,9,11,.818,0,6,6,6,1,0,3,3,31
4393,NYK,2024,DaQuan Jeffries,26,17,0,46,6,17,.353,2,10,.200,4,7,.571,.412,0,2,.000,0,5,5,5,0,1,3,2,14
4394,NYK,2024,Ryan Arcidiacono,29,20,0,45,0,6,.000,0,6,.000,0,0,,.000,0,0,,0,8,8,4,2,0,2,5,0
4395,NYK,2024,Evan Fournier,31,3,0,39,4,20,.200,2,15,.133,2,5,.400,.250,2,2,1.000,0,4,4,3,4,0,1,4,12
4396,NYK,2024,Jacob Toppin,23,9,0,38,5,9,.556,1,4,.250,4,5,.800,.611,2,2,1.000,3,4,7,3,0,1,1,3,13
4397,NYK,2024,Charlie Brown Jr.,26,8,0,37,2,10,.200,2,7,.286,0,3,.000,.300,0,0,,1,1,2,0,0,2,2,5,6
4398,NYK,2024,Shake Milton,27,6,0,27,4,9,.444,1,2,.500,3,7,.429,.500,2,2,1.000,0,6,6,4,1,0,0,7,11
4399,NYK,2024,Mamadi Diakite,27,3,0,8,0,1,.000,0,1,.000,0,0,,.000,0,0,,0,1,1,0,1,0,1,1,0
4400,NYK,2024,Dylan Windler,27,3,0,7,1,2,.500,1,2,.500,0,0,,.750,0,0,,0,1,1,1,0,0,0,1,3
4401,NYK,2024,Dmytro Skapintsev,25,2,0,2,0,1,.000,0,0,,0,1,.000,.000,0,0,,0,0,0,0,0,0,0,0,0
4402,NYK,2023,Julius Randle,28,77,77,2737,658,1432,.459,218,636,.343,440,796,.553,.536,402,531,.757,141,626,767,316,49,21,216,233,1936
4403,NYK,2023,RJ Barrett,22,73,73,2475,510,1176,.434,121,390,.310,389,786,.495,.485,290,392,.740,60,308,368,201,31,15,164,179,1431
4404,NYK,2023,Jalen Brunson,26,68,68,2379,587,1195,.491,134,322,.416,453,873,.519,.547,325,392,.829,40,201,241,421,61,15,142,152,1633
4405,NYK,2023,Immanuel Quickley,23,81,21,2344,419,936,.448,168,454,.370,251,482,.521,.537,203,248,.819,58,279,337,279,80,14,100,166,1209
4406,NYK,2023,Quentin Grimes,22,71,66,2121,282,602,.468,157,407,.386,125,195,.641,.599,78,98,.796,49,180,229,150,47,26,69,177,799
4407,NYK,2023,Isaiah Hartenstein,24,82,8,1626,175,327,.535,8,37,.216,167,290,.576,.547,48,71,.676,209,327,536,102,53,64,66,213,406
4408,NYK,2023,Mitchell Robinson,24,59,58,1591,188,280,.671,0,0,,188,280,.671,.671,59,122,.484,267,288,555,53,56,109,41,160,435
4409,NYK,2023,Obi Toppin,24,67,5,1050,187,419,.446,85,247,.344,102,172,.593,.548,38,47,.809,29,158,187,66,23,12,38,68,497
4410,NYK,2023,Jericho Sims,24,52,16,812,83,107,.776,0,1,.000,83,106,.783,.776,12,16,.750,99,143,242,25,15,28,27,96,178
4411,NYK,2023,Miles McBride,22,64,2,760,77,215,.358,40,134,.299,37,81,.457,.451,28,42,.667,13,37,50,72,37,8,25,60,222
4412,NYK,2023,Josh Hart,27,25,1,750,92,157,.586,27,52,.519,65,105,.619,.672,45,57,.789,47,129,176,90,34,12,38,62,256
4413,NYK,2023,Evan Fournier,30,27,7,459,56,166,.337,35,114,.307,21,52,.404,.443,18,21,.857,4,45,49,36,16,3,22,46,165
4414,NYK,2023,Cam Reddish,23,20,8,438,61,136,.449,17,56,.304,44,80,.550,.511,29,33,.879,7,24,31,20,15,8,15,32,168
4415,NYK,2023,Derrick Rose,34,27,0,338,61,159,.384,19,63,.302,42,96,.438,.443,11,12,.917,8,32,40,46,7,5,22,18,152
4416,NYK,2023,Svi Mykhailiuk,25,13,0,40,6,12,.500,6,10,.600,0,2,.000,.750,3,5,.600,0,7,7,1,1,0,2,1,21
4417,NYK,2023,Ryan Arcidiacono,28,11,0,26,1,5,.200,1,3,.333,0,2,.000,.300,0,0,,0,4,4,2,2,0,1,3,3
4418,NYK,2023,Trevor Keels,19,3,0,8,1,4,.250,1,4,.250,0,0,,.375,0,0,,0,2,2,0,0,0,0,0,3
4419,NYK,2022,Julius Randle,27,72,72,2544,512,1246,.411,120,390,.308,392,856,.458,.459,303,401,.756,125,591,716,370,53,39,245,205,1447
4420,NYK,2022,RJ Barrett,21,70,70,2417,487,1194,.408,138,404,.342,349,790,.442,.466,290,406,.714,66,342,408,208,43,16,151,142,1402
4421,NYK,2022,Evan Fournier,29,80,80,2358,402,965,.417,241,619,.389,161,346,.465,.541,80,113,.708,34,176,210,171,79,20,105,180,1125
4422,NYK,2022,Alec Burks,30,81,44,2318,285,728,.391,157,389,.404,128,339,.378,.499,217,264,.822,47,350,397,239,85,26,91,215,944
4423,NYK,2022,Mitchell Robinson,23,72,62,1848,261,343,.761,0,0,,261,343,.761,.761,88,181,.486,295,322,617,38,58,133,60,195,610
4424,NYK,2022,Immanuel Quickley,22,78,3,1802,284,724,.392,137,396,.346,147,328,.448,.487,177,201,.881,31,216,247,275,54,3,99,167,882
4425,NYK,2022,Obi Toppin,23,72,10,1230,251,473,.531,52,169,.308,199,304,.655,.586,94,124,.758,69,199,268,77,25,33,56,102,648
4426,NYK,2022,Kemba Walker,31,37,37,948,149,370,.403,73,199,.367,76,171,.444,.501,60,71,.845,14,97,111,131,26,7,48,37,431
4427,NYK,2022,Taj Gibson,36,52,4,946,86,166,.518,15,38,.395,71,128,.555,.563,42,52,.808,88,141,229,32,22,40,27,137,229
4428,NYK,2022,Quentin Grimes,21,46,6,786,95,235,.404,72,189,.381,23,46,.500,.557,13,19,.684,24,70,94,44,31,11,28,72,275
4429,NYK,2022,Derrick Rose,33,26,4,636,122,274,.445,37,92,.402,85,182,.467,.513,30,31,.968,21,57,78,103,22,12,39,15,311
4430,NYK,2022,Nerlens Noel,27,25,11,562,32,60,.533,0,3,.000,32,57,.561,.533,21,30,.700,48,93,141,23,30,31,20,67,85
4431,NYK,2022,Jericho Sims,23,41,5,555,39,54,.722,0,0,,39,54,.722,.722,12,29,.414,61,108,169,21,11,22,20,66,90
4432,NYK,2022,Miles McBride,21,40,2,372,32,108,.296,17,68,.250,15,40,.375,.375,8,12,.667,4,38,42,41,14,1,5,45,89
4433,NYK,2022,Cam Reddish,22,15,0,215,27,65,.415,8,31,.258,19,34,.559,.477,29,32,.906,5,16,21,10,12,4,13,15,91
4434,NYK,2022,Kevin Knox,22,13,0,111,15,40,.375,10,28,.357,5,12,.417,.500,7,10,.700,8,14,22,3,2,1,5,5,47
4435,NYK,2022,Ryan Arcidiacono,27,10,0,76,6,12,.500,4,9,.444,2,3,.667,.667,0,0,,0,8,8,4,1,0,3,5,16
4436,NYK,2022,Damyean Dotson,27,2,0,21,2,4,.500,0,1,.000,2,3,.667,.500,0,0,,0,2,2,1,0,0,0,0,4
4437,NYK,2022,Wayne Selden,27,3,0,19,1,4,.250,1,2,.500,0,2,.000,.375,2,4,.500,0,1,1,1,0,0,0,1,5
4438,NYK,2022,Feron Hunt,22,2,0,8,0,2,.000,0,0,,0,2,.000,.000,0,0,,1,0,1,1,1,0,1,1,0
4439,NYK,2022,Danuel House Jr.,28,1,0,3,0,1,.000,0,1,.000,0,0,,.000,0,0,,0,0,0,0,0,0,0,0,0
4440,NYK,2022,Matt Mooney,25,1,0,2,0,1,.000,0,1,.000,0,0,,.000,0,0,,0,0,0,0,1,0,1,0,0
4441,NYK,2022,Tyler Hall,24,1,0,2,0,0,,0,0,,0,0,,,0,0,,0,0,0,0,0,0,0,0,0
4442,NYK,2021,Julius Randle,26,71,71,2667,602,1321,.456,160,389,.411,442,932,.474,.516,348,429,.811,84,639,723,427,64,18,241,225,1712
4443,NYK,2021,RJ Barrett,20,72,72,2511,467,1060,.441,124,309,.401,343,751,.457,.499,206,276,.746,68,346,414,217,53,20,139,188,1264
4444,NYK,2021,Reggie Bullock,29,65,64,1949,248,561,.442,163,398,.410,85,163,.521,.587,50,55,.909,16,207,223,99,52,11,45,146,709
4445,NYK,2021,Nerlens Noel,26,64,41,1547,137,223,.614,0,3,.000,137,220,.623,.614,50,70,.714,142,266,408,46,70,141,65,176,324
4446,NYK,2021,Elfrid Payton,26,63,63,1484,269,622,.432,28,98,.286,241,524,.460,.455,73,107,.682,64,152,216,203,47,9,103,116,639
4447,NYK,2021,Alec Burks,29,49,5,1255,210,500,.420,102,246,.415,108,254,.425,.522,101,118,.856,21,206,227,107,31,14,49,102,623
4448,NYK,2021,Immanuel Quickley,21,64,3,1243,229,580,.395,118,303,.389,111,277,.401,.497,155,174,.891,25,112,137,127,30,12,58,114,731
4449,NYK,2021,Derrick Rose,32,35,3,937,208,427,.487,37,90,.411,171,337,.507,.530,68,77,.883,14,87,101,146,31,15,49,39,521
4450,NYK,2021,Taj Gibson,35,45,3,936,99,158,.627,3,15,.200,96,143,.671,.636,40,55,.727,99,151,250,36,31,49,22,99,241
4451,NYK,2021,Mitchell Robinson,22,31,29,853,115,176,.653,0,0,,115,176,.653,.653,26,53,.491,113,139,252,17,35,45,26,86,256
4452,NYK,2021,Obi Toppin,22,62,0,683,104,209,.498,26,85,.306,78,124,.629,.560,19,26,.731,26,112,138,29,17,15,23,55,253
4453,NYK,2021,Kevin Knox,21,42,0,464,56,143,.392,35,89,.393,21,54,.389,.514,16,20,.800,10,51,61,19,12,6,17,37,163
4454,NYK,2021,Austin Rivers,28,21,2,442,58,135,.430,28,77,.364,30,58,.517,.533,10,14,.714,5,42,47,42,12,0,22,32,154
4455,NYK,2021,Frank Ntilikina,22,33,4,322,29,79,.367,23,48,.479,6,31,.194,.513,8,18,.444,6,25,31,19,18,4,11,45,89
4456,NYK,2021,Norvel Pelle,27,9,0,52,5,7,.714,0,0,,5,7,.714,.714,1,2,.500,2,9,11,1,1,6,0,4,11
4457,NYK,2021,Theo Pinson,25,17,0,34,1,9,.111,0,8,.000,1,1,1.000,.111,0,0,,0,5,5,1,0,0,1,4,2
4458,NYK,2021,Dennis Smith Jr.,23,3,0,28,2,10,.200,0,4,.000,2,6,.333,.200,5,6,.833,0,2,2,3,3,0,1,4,9
4459,NYK,2021,Jared Harper,23,8,0,16,0,4,.000,0,1,.000,0,3,.000,.000,3,4,.750,0,2,2,1,0,0,3,1,3
4460,NYK,2021,Ignas Brazdeikis,22,4,0,7,0,1,.000,0,0,,0,1,.000,.000,2,2,1.000,1,1,2,1,0,0,1,0,2
4461,NYK,2020,Julius Randle,25,64,64,2080,463,1006,.460,64,231,.277,399,775,.515,.492,258,352,.733,151,471,622,198,51,22,193,178,1248
4462,NYK,2020,RJ Barrett,19,56,55,1704,292,727,.402,63,197,.320,229,530,.432,.445,156,254,.614,50,229,279,143,55,17,124,122,803
4463,NYK,2020,Mitchell Robinson,21,61,7,1412,253,341,.742,0,0,,253,341,.742,.742,84,148,.568,186,242,428,36,52,119,37,194,590
4464,NYK,2020,Bobby Portis,24,66,5,1393,265,589,.450,67,187,.358,198,402,.493,.507,71,93,.763,80,258,338,98,32,18,73,110,668
4465,NYK,2020,Marcus Morris,30,43,43,1387,281,636,.442,116,264,.439,165,372,.444,.533,163,198,.823,48,185,233,59,34,17,73,128,841
4466,NYK,2020,Elfrid Payton,25,45,36,1246,193,440,.439,14,69,.203,179,371,.482,.455,49,86,.570,52,160,212,323,70,17,96,89,449
4467,NYK,2020,Frank Ntilikina,21,57,26,1187,131,333,.393,44,137,.321,87,196,.444,.459,51,59,.864,23,98,121,172,54,16,71,142,357
4468,NYK,2020,Kevin Knox,20,65,4,1166,144,401,.359,65,199,.327,79,202,.391,.440,66,101,.653,28,156,184,61,23,28,45,106,419
4469,NYK,2020,Taj Gibson,34,62,56,1025,167,286,.584,4,14,.286,163,272,.599,.591,41,56,.732,111,156,267,52,27,30,47,122,379
4470,NYK,2020,Damyean Dotson,25,48,0,836,120,290,.414,59,163,.362,61,127,.480,.516,22,33,.667,10,81,91,57,23,4,21,44,321
4471,NYK,2020,Reggie Bullock,28,29,19,684,90,224,.402,37,111,.333,53,113,.469,.484,17,21,.810,13,55,68,42,25,3,19,56,234
4472,NYK,2020,Wayne Ellington,32,36,1,558,61,174,.351,50,143,.350,11,31,.355,.494,11,13,.846,4,61,65,44,13,4,18,41,183
4473,NYK,2020,Dennis Smith Jr.,22,34,3,537,72,211,.341,16,54,.296,56,157,.357,.379,27,53,.509,21,57,78,98,28,8,58,65,187
4474,NYK,2020,Allonzo Trier,24,24,1,291,51,106,.481,19,53,.358,32,53,.604,.571,34,43,.791,6,23,29,28,3,4,22,29,155
4475,NYK,2020,Maurice Harkless,26,12,10,286,30,66,.455,7,25,.280,23,41,.561,.508,15,24,.625,8,32,40,20,9,3,7,28,82
4476,NYK,2020,Kadeem Allen,27,10,0,117,19,44,.432,5,16,.313,14,28,.500,.489,7,11,.636,2,7,9,21,5,2,8,7,50
4477,NYK,2020,Ignas Brazdeikis,21,9,0,53,6,22,.273,1,9,.111,5,13,.385,.295,4,5,.800,2,3,5,4,0,1,2,3,17
4478,NYK,2019,Kevin Knox,19,75,57,2158,338,914,.370,125,364,.343,213,550,.387,.438,162,226,.717,61,274,335,82,43,24,114,175,963
4479,NYK,2019,Damyean Dotson,24,73,40,2004,290,698,.415,126,342,.368,164,356,.461,.506,73,98,.745,34,228,262,135,58,10,71,135,779
4480,NYK,2019,Noah Vonleh,23,68,57,1722,207,440,.470,46,137,.336,161,303,.531,.523,111,156,.712,113,415,528,129,46,51,88,174,571
4481,NYK,2019,Emmanuel Mudiay,22,59,42,1607,330,740,.446,69,210,.329,261,530,.492,.493,144,186,.774,33,163,196,228,43,19,140,103,873
4482,NYK,2019,Tim Hardaway Jr.,26,46,46,1499,282,726,.388,117,337,.347,165,389,.424,.469,199,233,.854,26,135,161,122,42,6,81,106,880
4483,NYK,2019,Allonzo Trier,23,64,3,1459,232,518,.448,52,132,.394,180,386,.466,.498,179,223,.803,31,166,197,119,28,14,116,117,695
4484,NYK,2019,Mitchell Robinson,20,66,19,1360,202,291,.694,0,0,,202,291,.694,.694,81,135,.600,177,246,423,37,52,161,35,217,485
4485,NYK,2019,Mario Hezonja,23,58,24,1206,191,464,.412,42,152,.276,149,312,.478,.457,87,114,.763,28,211,239,88,57,8,88,110,511
4486,NYK,2019,Enes Freedom,26,44,23,1128,251,468,.536,7,22,.318,244,446,.547,.544,105,129,.814,171,290,461,84,18,17,79,106,614
4487,NYK,2019,Frank Ntilikina,20,43,16,904,95,282,.337,33,115,.287,62,167,.371,.395,23,30,.767,12,75,87,121,30,14,56,104,246
4488,NYK,2019,Luke Kornet,23,46,18,784,107,283,.378,70,193,.363,37,90,.411,.502,38,46,.826,28,107,135,54,27,42,25,41,322
4489,NYK,2019,Lance Thomas,30,46,17,783,78,197,.396,22,79,.278,56,118,.475,.452,27,36,.750,21,96,117,27,17,7,24,83,205
4490,NYK,2019,Trey Burke,26,33,7,689,148,358,.413,30,86,.349,118,272,.434,.455,62,75,.827,15,47,62,94,21,5,29,33,388
4491,NYK,2019,Dennis Smith Jr.,21,21,18,600,121,293,.413,24,83,.289,97,210,.462,.454,42,74,.568,14,44,58,114,27,9,54,47,308
4492,NYK,2019,DeAndre Jordan,30,19,19,493,78,123,.634,0,0,,78,123,.634,.634,51,66,.773,64,152,216,57,9,20,42,42,207
4493,NYK,2019,Kadeem Allen,26,19,1,416,65,141,.461,17,36,.472,48,105,.457,.521,42,54,.778,8,43,51,76,16,4,26,46,189
4494,NYK,2019,John Jenkins,27,22,0,319,40,103,.388,20,56,.357,20,47,.426,.485,15,18,.833,6,30,36,21,0,2,9,10,115
4495,NYK,2019,Henry Ellenson,22,17,0,234,35,85,.412,15,34,.441,20,51,.392,.500,17,23,.739,5,52,57,15,7,2,9,25,102
4496,NYK,2019,Courtney Lee,33,12,2,160,21,47,.447,5,16,.313,16,31,.516,.500,9,14,.643,6,21,27,16,8,2,5,13,56
4497,NYK,2019,Ron Baker,25,11,0,107,4,16,.250,1,9,.111,3,7,.429,.281,5,6,.833,1,6,7,13,5,0,3,16,14
4498,NYK,2019,Billy Garrett,24,4,0,63,11,27,.407,0,8,.000,11,19,.579,.407,4,4,1.000,0,3,3,7,1,1,2,3,26
4499,NYK,2019,Wesley Matthews,32,2,1,54,4,19,.211,2,10,.200,2,9,.222,.263,4,5,.800,1,2,3,5,1,1,2,2,14
4500,NYK,2019,Isaiah Hicks,24,3,0,32,4,8,.500,0,0,,4,8,.500,.500,4,5,.800,2,5,7,2,1,3,1,5,12
4501,NYK,2018,Courtney Lee,32,76,69,2310,343,755,.454,113,278,.406,230,477,.482,.529,114,124,.919,30,194,224,180,80,17,84,109,913
4502,NYK,2018,Tim Hardaway Jr.,25,57,54,1885,360,856,.421,130,410,.317,230,446,.516,.496,146,179,.816,32,192,224,155,62,10,92,123,996
4503,NYK,2018,Enes Freedom,25,71,71,1830,422,713,.592,0,2,.000,422,711,.594,.592,156,184,.848,273,507,780,105,36,37,122,187,1000
4504,NYK,2018,Frank Ntilikina,19,78,9,1706,182,500,.364,50,157,.318,132,343,.385,.414,49,68,.721,37,140,177,250,65,18,131,181,463
4505,NYK,2018,Michael Beasley,29,74,30,1653,409,807,.507,34,86,.395,375,721,.520,.528,124,159,.780,97,317,414,123,36,43,143,145,976
4506,NYK,2018,Kristaps Porziņģis,22,48,48,1553,390,889,.439,90,228,.395,300,661,.454,.489,218,275,.793,62,254,316,57,36,115,93,141,1088
4507,NYK,2018,Jarrett Jack,34,62,56,1548,189,443,.427,25,86,.291,164,357,.459,.455,63,75,.840,22,169,191,348,35,4,115,98,466
4508,NYK,2018,Kyle O'Quinn,27,77,10,1387,224,384,.583,4,17,.235,220,367,.599,.589,98,127,.772,121,349,470,158,36,98,100,192,550
4509,NYK,2018,Lance Thomas,29,73,31,1353,102,267,.382,50,124,.403,52,143,.364,.476,44,53,.830,44,131,175,44,30,14,40,134,298
4510,NYK,2018,Doug McDermott,26,55,1,1172,151,328,.460,53,137,.387,98,191,.513,.541,40,53,.755,33,101,134,50,10,12,34,73,395
4511,NYK,2018,Trey Burke,25,36,9,785,193,384,.503,38,105,.362,155,279,.556,.552,37,57,.649,13,58,71,170,24,4,43,43,461
4512,NYK,2018,Emmanuel Mudiay,21,22,14,493,75,204,.368,9,46,.196,66,158,.418,.390,35,51,.686,10,48,58,85,20,7,41,33,194
4513,NYK,2018,Damyean Dotson,23,44,2,474,72,161,.447,22,68,.324,50,93,.538,.516,16,23,.696,9,75,84,31,12,2,17,34,182
4514,NYK,2018,Ron Baker,24,29,1,385,20,59,.339,11,33,.333,9,26,.346,.432,20,26,.769,5,25,30,47,26,6,18,33,71
4515,NYK,2018,Luke Kornet,22,20,1,326,49,125,.392,28,79,.354,21,46,.457,.504,8,11,.727,11,53,64,26,6,16,12,28,134
4516,NYK,2018,Troy Williams,23,17,1,290,49,100,.490,11,33,.333,38,67,.567,.545,19,27,.704,21,38,59,15,19,4,18,32,128
4517,NYK,2018,Isaiah Hicks,23,18,0,240,33,72,.458,2,9,.222,31,63,.492,.472,12,18,.667,10,31,41,16,2,4,16,45,80
4518,NYK,2018,Willy Hernangómez,23,26,0,233,49,81,.605,1,5,.200,48,76,.632,.611,12,28,.429,22,45,67,21,8,7,26,32,111
4519,NYK,2018,Ramon Sessions,31,13,3,167,17,53,.321,2,11,.182,15,42,.357,.340,12,15,.800,1,17,18,27,7,1,15,14,48
4520,NYK,2018,Joakim Noah,32,7,0,40,5,10,.500,0,0,,5,10,.500,.500,2,4,.500,6,8,14,4,2,2,4,5,12
4521,NYK,2018,Mindaugas Kuzminskas,28,1,0,2,0,2,.000,0,0,,0,2,.000,.000,0,0,,0,0,0,0,0,0,0,0,0
4522,NYK,2017,Carmelo Anthony,32,74,74,2538,602,1389,.433,151,421,.359,451,968,.466,.488,304,365,.833,62,376,438,213,60,34,153,198,1659
4523,NYK,2017,Courtney Lee,31,77,74,2459,321,704,.456,108,269,.401,213,435,.490,.533,85,98,.867,53,206,259,179,81,24,69,141,835
4524,NYK,2017,Kristaps Porziņģis,21,66,65,2164,443,985,.450,112,314,.357,331,671,.493,.507,198,252,.786,111,364,475,97,47,129,118,244,1196
4525,NYK,2017,Derrick Rose,28,64,64,2082,460,977,.471,13,60,.217,447,917,.487,.477,221,253,.874,66,180,246,283,44,17,147,84,1154
4526,NYK,2017,Justin Holiday,27,82,4,1639,233,538,.433,97,273,.355,136,265,.513,.523,66,80,.825,27,198,225,102,65,31,66,109,629
4527,NYK,2017,Brandon Jennings,27,58,11,1428,163,429,.380,68,200,.340,95,229,.415,.459,102,135,.756,21,131,152,287,55,4,106,84,496
4528,NYK,2017,Willy Hernangómez,22,72,22,1324,246,465,.529,4,15,.267,242,450,.538,.533,91,125,.728,170,332,502,96,41,36,100,150,587
4529,NYK,2017,Kyle O'Quinn,26,79,8,1229,215,413,.521,2,17,.118,213,396,.538,.523,64,83,.771,157,282,439,117,36,104,76,174,496
4530,NYK,2017,Mindaugas Kuzminskas,27,68,5,1016,158,369,.428,54,168,.321,104,201,.517,.501,55,68,.809,47,79,126,69,29,11,51,79,425
4531,NYK,2017,Joakim Noah,31,46,46,1015,99,202,.490,0,1,.000,99,201,.493,.490,34,78,.436,162,241,403,103,30,37,58,127,232
4532,NYK,2017,Lance Thomas,28,46,15,968,97,244,.398,38,85,.447,59,159,.371,.475,43,51,.843,32,110,142,35,21,5,25,85,275
4533,NYK,2017,Ron Baker,23,52,13,857,82,217,.378,23,86,.267,59,131,.450,.431,28,43,.651,12,86,98,107,34,8,56,74,215
4534,NYK,2017,Sasha Vujačić,32,42,4,408,42,136,.309,23,74,.311,19,62,.306,.393,17,24,.708,12,47,59,52,13,2,16,38,124
4535,NYK,2017,Maurice Ndour,24,32,4,331,39,86,.453,1,7,.143,38,79,.481,.459,19,26,.731,22,42,64,8,15,8,12,30,98
4536,NYK,2017,Chasson Randle,23,18,0,225,28,72,.389,10,32,.313,18,40,.450,.458,29,31,.935,6,21,27,28,6,1,16,28,95
4537,NYK,2017,Marshall Plumlee,24,21,1,170,16,30,.533,0,0,,16,30,.533,.533,8,19,.421,23,28,51,10,4,4,12,23,40
4538,NYK,2016,Carmelo Anthony,31,72,72,2530,567,1307,.434,105,310,.339,462,997,.463,.474,334,403,.829,98,458,556,299,62,38,176,180,1573
4539,NYK,2016,Arron Afflalo,30,71,57,2371,354,799,.443,91,238,.382,263,561,.469,.500,110,131,.840,23,243,266,144,25,10,82,142,909
4540,NYK,2016,Robin Lopez,27,82,82,2219,357,662,.539,0,1,.000,357,661,.540,.539,128,161,.795,268,334,602,114,16,129,133,182,842
4541,NYK,2016,Kristaps Porziņģis,20,72,72,2047,373,886,.421,81,243,.333,292,643,.454,.467,201,240,.838,132,394,526,94,53,134,121,205,1028
4542,NYK,2016,Langston Galloway,24,82,7,2033,231,588,.393,77,224,.344,154,364,.423,.458,86,114,.754,43,245,288,207,77,22,61,177,625
4543,NYK,2016,José Calderón,34,72,72,2024,209,455,.459,84,203,.414,125,252,.496,.552,42,48,.875,22,207,229,298,63,7,87,135,544
4544,NYK,2016,Derrick Williams,24,80,9,1435,254,565,.450,44,150,.293,210,415,.506,.488,194,256,.758,47,249,296,75,29,9,61,69,746
4545,NYK,2016,Lance Thomas,27,59,5,1313,169,382,.442,44,109,.404,125,273,.458,.500,102,119,.857,34,97,131,53,22,7,57,109,484
4546,NYK,2016,Jerian Grant,23,76,6,1265,154,391,.394,22,100,.220,132,291,.454,.422,96,123,.780,23,120,143,177,50,10,87,97,426
4547,NYK,2016,Sasha Vujačić,31,61,25,908,106,277,.383,52,143,.364,54,134,.403,.477,32,39,.821,26,123,149,84,34,5,44,83,296
4548,NYK,2016,Kyle O'Quinn,25,65,1,764,129,271,.476,5,22,.227,124,249,.498,.485,46,60,.767,76,174,250,72,20,49,61,107,309
4549,NYK,2016,Kevin Séraphin,26,48,0,526,84,205,.410,0,2,.000,84,203,.414,.410,19,23,.826,31,95,126,47,8,36,43,67,187
4550,NYK,2016,Lou Amundson,33,29,0,204,19,53,.358,0,0,,19,53,.358,.358,14,27,.519,23,26,49,12,6,7,15,44,52
4551,NYK,2016,Cleanthony Early,24,17,2,154,12,40,.300,4,15,.267,8,25,.320,.350,3,4,.750,4,22,26,6,2,3,9,16,31
4552,NYK,2016,Thanasis Antetokounmpo,23,2,0,6,3,4,.750,0,1,.000,3,3,1.000,.750,0,0,,0,1,1,0,0,0,0,2,6
4553,NYK,2016,Jimmer Fredette,26,2,0,5,1,1,1.000,1,1,1.000,0,0,,1.500,4,5,.800,0,0,0,0,0,0,1,1,7
4554,NYK,2015,Shane Larkin,22,76,22,1865,187,432,.433,35,116,.302,152,316,.481,.473,61,78,.782,29,147,176,226,93,9,83,150,470
4555,NYK,2015,Jason Smith,28,82,31,1785,257,592,.434,15,42,.357,242,550,.440,.447,127,153,.830,98,226,324,140,32,44,104,205,656
4556,NYK,2015,Tim Hardaway Jr.,22,70,30,1681,279,717,.389,121,354,.342,158,363,.435,.474,125,156,.801,12,144,156,127,20,14,82,119,804
4557,NYK,2015,Langston Galloway,23,45,41,1457,204,511,.399,62,176,.352,142,335,.424,.460,63,78,.808,37,153,190,150,52,12,61,129,533
4558,NYK,2015,Carmelo Anthony,30,40,40,1428,358,806,.444,61,179,.341,297,627,.474,.482,189,237,.797,72,192,264,122,40,17,89,87,966
4559,NYK,2015,Quincy Acy,24,68,22,1287,152,331,.459,18,60,.300,134,271,.494,.486,76,97,.784,79,222,301,68,27,22,60,147,398
4560,NYK,2015,José Calderón,33,42,42,1270,147,354,.415,59,142,.415,88,212,.415,.499,29,32,.906,19,105,124,198,31,0,75,76,382
4561,NYK,2015,Lance Thomas,26,40,24,1040,137,316,.434,7,21,.333,130,295,.441,.445,49,66,.742,37,83,120,49,26,8,57,63,330
4562,NYK,2015,Cole Aldrich,26,61,16,976,144,301,.478,0,0,,144,301,.478,.478,50,64,.781,101,237,338,75,37,65,59,122,338
4563,NYK,2015,Amar'e Stoudemire,32,36,14,865,169,311,.543,0,3,.000,169,308,.549,.543,94,127,.740,83,162,245,37,20,34,63,111,432
4564,NYK,2015,Lou Amundson,32,41,35,858,105,243,.432,0,1,.000,105,242,.434,.432,38,82,.463,89,159,248,65,21,52,57,115,248
4565,NYK,2015,Pablo Prigioni,37,43,3,795,68,161,.422,43,115,.374,25,46,.543,.556,22,26,.846,18,62,80,104,52,1,47,53,201
4566,NYK,2015,Andrea Bargnani,29,29,22,785,164,361,.454,15,41,.366,149,320,.466,.475,87,107,.813,32,95,127,46,2,27,42,53,430
4567,NYK,2015,Travis Wear,24,51,1,672,84,209,.402,11,30,.367,73,179,.408,.428,20,26,.769,31,75,106,40,15,11,35,55,199
4568,NYK,2015,Cleanthony Early,23,39,7,647,76,214,.355,22,84,.262,54,130,.415,.407,36,48,.750,22,75,97,36,24,12,40,57,210
4569,NYK,2015,Iman Shumpert,24,24,24,625,88,215,.409,23,66,.348,65,149,.436,.463,25,37,.676,22,59,81,78,30,3,42,67,224
4570,NYK,2015,J.R. Smith,29,24,6,619,101,251,.402,32,90,.356,69,161,.429,.466,27,39,.692,4,54,58,81,18,4,45,44,261
4571,NYK,2015,Samuel Dalembert,33,32,21,544,57,130,.438,0,0,,57,130,.438,.438,14,20,.700,53,115,168,29,14,41,39,70,128
4572,NYK,2015,Alexey Shved,26,16,9,423,73,181,.403,26,70,.371,47,111,.423,.475,64,82,.780,14,59,73,57,15,5,25,25,236
4573,NYK,2015,Ricky Ledo,22,12,0,233,32,90,.356,10,24,.417,22,66,.333,.411,15,20,.750,15,19,34,18,6,1,24,20,89
4574,NYK,2014,Carmelo Anthony,29,77,77,2982,743,1643,.452,167,415,.402,576,1228,.469,.503,459,541,.848,145,477,622,242,95,51,198,224,2112
4575,NYK,2014,J.R. Smith,28,74,37,2421,396,955,.415,189,480,.394,207,475,.436,.514,90,138,.652,35,261,296,219,65,20,108,196,1071
4576,NYK,2014,Raymond Felton,29,65,65,2017,240,608,.395,62,195,.318,178,413,.431,.446,88,122,.721,54,143,197,365,78,27,129,157,630
4577,NYK,2014,Iman Shumpert,23,74,58,1962,183,484,.378,76,228,.333,107,256,.418,.457,53,71,.746,81,227,308,129,92,13,79,209,495
4578,NYK,2014,Tim Hardaway Jr.,21,81,1,1875,294,687,.428,130,358,.363,164,329,.498,.523,106,128,.828,19,102,121,66,44,7,47,144,824
4579,NYK,2014,Tyson Chandler,31,55,55,1662,191,322,.593,0,1,.000,191,321,.595,.593,98,155,.632,159,370,529,59,36,63,71,145,480
4580,NYK,2014,Amar'e Stoudemire,31,65,21,1466,311,558,.557,0,0,,311,558,.557,.557,150,203,.739,112,208,320,34,23,37,91,159,772
4581,NYK,2014,Pablo Prigioni,36,66,27,1283,88,191,.461,65,140,.464,23,51,.451,.631,11,12,.917,36,93,129,228,67,2,60,132,252
4582,NYK,2014,Andrea Bargnani,28,42,39,1257,222,502,.442,30,108,.278,192,394,.487,.472,84,102,.824,69,153,222,45,14,52,58,100,558
4583,NYK,2014,Kenyon Martin,36,32,15,633,63,123,.512,0,1,.000,63,122,.516,.512,11,19,.579,36,98,134,50,25,27,26,85,137
4584,NYK,2014,Beno Udrih,31,31,12,588,68,160,.425,17,40,.425,51,120,.425,.478,20,24,.833,10,47,57,110,22,3,42,46,173
4585,NYK,2014,Jeremy Tyler,22,41,0,398,60,116,.517,0,0,,60,116,.517,.517,26,48,.542,38,71,109,8,6,20,26,70,146
4586,NYK,2014,Metta World Peace,34,29,1,388,56,141,.397,17,54,.315,39,87,.448,.457,10,16,.625,18,41,59,17,24,8,19,44,139
4587,NYK,2014,Toure' Murry,24,51,0,373,56,129,.434,5,12,.417,51,117,.436,.453,23,39,.590,13,31,44,49,19,1,34,46,140
4588,NYK,2014,Cole Aldrich,25,46,2,330,33,61,.541,0,0,,33,61,.541,.541,26,30,.867,37,92,129,14,8,30,18,40,92
4589,NYK,2014,Shannon Brown,28,19,0,148,16,38,.421,0,0,,16,38,.421,.421,8,12,.667,6,9,15,4,12,0,10,12,40
4590,NYK,2014,Earl Clark,26,9,0,70,7,21,.333,1,6,.167,6,15,.400,.357,8,10,.800,2,14,16,2,1,6,1,6,23
4591,NYK,2014,Chris Smith,26,2,0,2,0,0,,0,0,,0,0,,,0,0,,0,0,0,0,0,0,0,0,0
4592,NYK,2013,J.R. Smith,27,80,0,2678,527,1249,.422,155,436,.356,372,813,.458,.484,237,311,.762,64,361,425,218,100,24,134,226,1446
4593,NYK,2013,Carmelo Anthony,28,67,67,2482,669,1489,.449,157,414,.379,512,1075,.476,.502,425,512,.830,134,326,460,171,52,32,175,205,1920
4594,NYK,2013,Raymond Felton,28,68,68,2313,377,882,.427,93,258,.360,284,624,.455,.480,101,128,.789,51,143,194,372,94,14,155,130,948
4595,NYK,2013,Tyson Chandler,30,66,66,2164,255,400,.638,0,0,,255,400,.638,.638,179,258,.694,269,434,703,62,42,75,87,188,689
4596,NYK,2013,Jason Kidd,39,76,48,2043,152,409,.372,114,325,.351,38,84,.452,.511,40,48,.833,50,273,323,249,125,25,76,125,458
4597,NYK,2013,Steve Novak,29,81,1,1641,178,430,.414,149,351,.425,29,79,.367,.587,30,33,.909,17,135,152,35,28,8,12,97,535
4598,NYK,2013,Pablo Prigioni,35,78,18,1263,100,220,.455,53,134,.396,47,86,.547,.575,22,25,.880,41,102,143,236,69,2,86,127,275
4599,NYK,2013,Iman Shumpert,22,45,45,996,109,275,.396,51,127,.402,58,148,.392,.489,36,47,.766,31,105,136,75,43,7,37,99,305
4600,NYK,2013,Chris Copeland,28,56,13,862,182,380,.479,59,140,.421,123,240,.513,.557,63,83,.759,34,85,119,27,16,12,50,104,486
4601,NYK,2013,Ronnie Brewer,27,46,34,711,64,175,.366,22,71,.310,42,104,.404,.429,16,39,.410,29,71,100,40,34,6,14,27,166
4602,NYK,2013,Amar'e Stoudemire,30,29,0,682,154,267,.577,0,0,,154,267,.577,.577,105,130,.808,60,85,145,13,10,21,50,89,413
4603,NYK,2013,James White,30,57,16,435,50,116,.431,14,41,.341,36,75,.480,.491,11,19,.579,5,43,48,29,13,4,17,44,125
4604,NYK,2013,Kenyon Martin,35,18,11,431,56,93,.602,0,0,,56,93,.602,.602,17,40,.425,34,61,95,8,16,17,16,64,129
4605,NYK,2013,Kurt Thomas,40,39,17,392,45,83,.542,1,1,1.000,44,82,.537,.548,6,13,.462,24,65,89,21,10,16,8,52,97
4606,NYK,2013,Rasheed Wallace,38,21,0,296,55,142,.387,22,69,.319,33,73,.452,.465,14,20,.700,11,72,83,6,13,15,10,40,146
4607,NYK,2013,Marcus Camby,38,24,4,250,17,53,.321,0,0,,17,53,.321,.321,8,19,.421,24,56,80,14,7,14,15,28,42
4608,NYK,2013,Earl Barron,31,1,1,37,5,14,.357,0,0,,5,14,.357,.357,1,2,.500,6,12,18,2,0,1,1,1,11
4609,NYK,2013,Quentin Richardson,32,1,0,29,1,11,.091,1,4,.250,0,7,.000,.136,2,2,1.000,5,5,10,1,0,0,2,1,5
4610,NYK,2013,Solomon Jones,28,2,1,26,0,1,.000,0,0,,0,1,.000,.000,0,0,,1,2,3,0,0,1,3,3,0
4611,NYK,2012,Tyson Chandler,29,62,62,2061,241,355,.679,0,2,.000,241,353,.683,.679,217,315,.689,212,400,612,56,56,89,102,186,699
4612,NYK,2012,Landry Fields,23,66,62,1894,236,513,.460,31,121,.256,205,392,.523,.490,77,137,.562,59,219,278,169,79,17,102,99,580
4613,NYK,2012,Carmelo Anthony,27,55,55,1876,441,1025,.430,68,203,.335,373,822,.454,.463,295,367,.804,88,256,344,200,62,24,144,156,1245
4614,NYK,2012,Iman Shumpert,21,59,35,1705,214,534,.401,48,157,.306,166,377,.440,.446,87,109,.798,42,144,186,164,101,8,111,173,563
4615,NYK,2012,Amar'e Stoudemire,29,47,47,1543,316,654,.483,5,21,.238,311,633,.491,.487,186,243,.765,106,261,367,52,38,45,112,138,823
4616,NYK,2012,Steve Novak,28,54,0,1020,161,337,.478,133,282,.472,28,55,.509,.675,22,26,.846,9,95,104,12,16,9,21,59,477
4617,NYK,2012,J.R. Smith,26,35,1,967,165,405,.407,67,193,.347,98,212,.462,.490,39,55,.709,29,107,136,84,54,6,46,87,436
4618,NYK,2012,Jeremy Lin,23,35,25,940,171,383,.446,24,75,.320,147,308,.477,.478,146,183,.798,18,89,107,216,55,9,126,78,512
4619,NYK,2012,Jared Jeffries,30,39,4,729,59,144,.410,3,16,.188,56,128,.438,.420,49,72,.681,69,83,152,26,29,25,29,89,170
4620,NYK,2012,Toney Douglas,25,38,9,656,94,290,.324,27,117,.231,67,173,.387,.371,22,26,.846,16,56,72,77,29,1,56,55,237
4621,NYK,2012,Henry Walker,24,32,8,620,68,171,.398,36,113,.319,32,58,.552,.503,17,20,.850,9,71,80,37,19,7,35,84,189
4622,NYK,2012,Baron Davis,32,29,14,595,68,184,.370,26,85,.306,42,99,.424,.440,16,24,.667,13,43,56,135,34,3,76,61,178
4623,NYK,2012,Mike Bibby,33,39,4,557,35,124,.282,27,85,.318,8,39,.205,.391,6,8,.750,5,54,59,80,21,3,20,45,103
4624,NYK,2012,Josh Harrellson,22,37,4,540,63,149,.423,20,59,.339,43,90,.478,.490,16,26,.615,47,97,144,11,23,20,20,48,162
4625,NYK,2012,Renaldo Balkman,27,14,0,115,16,32,.500,2,9,.222,14,23,.609,.531,8,11,.727,6,20,26,5,4,3,6,14,42
4626,NYK,2012,Jerome Jordan,25,21,0,108,17,33,.515,0,0,,17,33,.515,.515,8,10,.800,14,13,27,4,1,6,2,15,42
4627,NYK,2012,Dan Gadzuric,33,2,0,13,0,2,.000,0,0,,0,2,.000,.000,0,2,.000,1,4,5,0,1,1,1,4,0
4628,NYK,2011,Amar'e Stoudemire,28,78,78,2870,744,1482,.502,10,23,.435,734,1459,.503,.505,473,597,.792,198,438,636,202,71,150,250,274,1971
4629,NYK,2011,Landry Fields,22,82,81,2541,299,602,.497,86,219,.393,213,383,.556,.568,113,147,.769,105,416,521,155,80,17,107,114,797
4630,NYK,2011,Raymond Felton,26,54,54,2074,339,801,.423,88,268,.328,251,533,.471,.478,157,181,.867,40,154,194,488,97,11,176,113,923
4631,NYK,2011,Toney Douglas,24,81,9,1971,314,755,.416,143,383,.373,171,372,.460,.511,85,107,.794,65,179,244,244,89,4,89,177,856
4632,NYK,2011,Wilson Chandler,23,51,30,1759,328,712,.461,86,245,.351,242,467,.518,.521,96,119,.807,62,241,303,86,34,70,67,152,838
4633,NYK,2011,Danilo Gallinari,22,48,48,1671,211,509,.415,83,239,.347,128,270,.474,.496,259,290,.893,48,181,229,82,38,18,58,117,764
4634,NYK,2011,Shawne Williams,24,64,11,1323,164,385,.426,85,212,.401,79,173,.457,.536,41,49,.837,60,179,239,47,39,51,46,164,454
4635,NYK,2011,Ronny Turiaf,28,64,21,1141,103,163,.632,0,0,,103,163,.632,.632,61,98,.622,64,143,207,92,35,73,41,160,267
4636,NYK,2011,Carmelo Anthony,26,27,27,977,247,536,.461,53,125,.424,194,411,.472,.510,164,188,.872,41,140,181,81,25,15,64,90,711
4637,NYK,2011,Henry Walker,23,61,1,784,104,236,.441,59,153,.386,45,83,.542,.566,31,44,.705,16,106,122,34,21,6,37,81,298
4638,NYK,2011,Chauncey Billups,34,21,21,664,104,258,.403,41,125,.328,63,133,.474,.483,119,132,.902,13,52,65,116,19,2,48,52,368
4639,NYK,2011,Jared Jeffries,29,24,9,463,19,50,.380,1,3,.333,18,47,.383,.390,8,19,.421,42,39,81,25,24,14,17,54,47
4640,NYK,2011,Timofey Mozgov,24,34,14,458,52,112,.464,0,0,,52,112,.464,.464,31,44,.705,41,63,104,15,14,23,32,76,135
4641,NYK,2011,Roger Mason,30,26,0,319,26,77,.338,16,44,.364,10,33,.303,.442,7,10,.700,5,38,43,20,6,2,6,25,75
4642,NYK,2011,Anthony Carter,35,19,0,310,35,76,.461,8,28,.286,27,48,.563,.513,6,6,1.000,7,32,39,43,18,5,25,30,84
4643,NYK,2011,Shelden Williams,27,17,6,198,21,39,.538,0,0,,21,39,.538,.538,24,29,.828,19,31,50,13,5,4,6,34,66
4644,NYK,2011,Anthony Randolph,21,17,0,127,14,45,.311,1,4,.250,13,41,.317,.322,6,12,.500,11,29,40,7,4,8,10,15,35
4645,NYK,2011,Derrick Brown,23,8,0,88,12,18,.667,3,4,.750,9,14,.643,.750,7,13,.538,9,6,15,4,4,2,7,11,34
4646,NYK,2011,Andy Rautins,24,5,0,24,3,7,.429,1,4,.250,2,3,.667,.500,1,2,.500,0,1,1,3,1,0,7,0,8
4647,NYK,2011,Renaldo Balkman,26,3,0,18,1,4,.250,1,2,.500,0,2,.000,.375,0,0,,1,2,3,0,1,0,1,4,3
4648,NYK,2010,David Lee,26,81,81,3019,686,1258,.545,0,8,.000,686,1250,.549,.545,268,330,.812,228,721,949,295,85,40,189,257,1640
4649,NYK,2010,Danilo Gallinari,21,81,74,2747,392,927,.423,186,488,.381,206,439,.469,.523,251,307,.818,65,333,398,135,75,58,110,191,1221
4650,NYK,2010,Wilson Chandler,22,65,64,2320,412,860,.479,40,150,.267,372,710,.524,.502,129,160,.806,93,255,348,138,46,49,108,184,993
4651,NYK,2010,Al Harrington,29,72,15,2195,448,1030,.435,140,409,.342,308,621,.496,.503,240,317,.757,88,317,405,110,62,26,132,209,1276
4652,NYK,2010,Chris Duhon,27,67,59,2072,168,451,.373,90,258,.349,78,193,.404,.472,68,95,.716,28,150,178,378,59,3,110,83,494
4653,NYK,2010,Jared Jeffries,28,52,37,1462,102,230,.443,20,62,.323,82,168,.488,.487,60,93,.645,99,124,223,83,53,58,62,157,284
4654,NYK,2010,Toney Douglas,23,56,12,1087,179,391,.458,68,175,.389,111,216,.514,.545,55,68,.809,40,68,108,112,42,3,55,116,481
4655,NYK,2010,Larry Hughes,31,31,14,820,102,279,.366,28,97,.289,74,182,.407,.416,65,79,.823,16,94,110,109,40,11,56,53,297
4656,NYK,2010,Henry Walker,22,27,13,739,117,226,.518,50,116,.431,67,110,.609,.628,37,47,.787,15,68,83,37,23,3,26,79,321
4657,NYK,2010,Nate Robinson,25,30,2,733,152,336,.452,51,136,.375,101,200,.505,.528,42,54,.778,23,49,72,112,27,5,53,66,397
4658,NYK,2010,Tracy McGrady,30,24,24,627,84,216,.389,15,62,.242,69,154,.448,.424,43,57,.754,22,67,89,93,15,12,43,38,226
4659,NYK,2010,Sergio Rodríguez,23,27,8,531,79,161,.491,17,49,.347,62,112,.554,.543,25,31,.806,9,30,39,91,21,2,55,38,200
4660,NYK,2010,Eddie House,31,18,0,371,44,133,.331,15,60,.250,29,73,.397,.387,12,12,1.000,6,34,40,37,12,0,20,20,115
4661,NYK,2010,Jonathan Bender,29,25,1,292,40,100,.400,14,39,.359,26,61,.426,.470,24,26,.923,15,37,52,16,2,17,28,33,118
4662,NYK,2010,Jordan Hill,22,24,0,252,41,92,.446,0,2,.000,41,90,.456,.446,15,21,.714,32,29,61,7,10,9,12,37,97
4663,NYK,2010,Earl Barron,28,7,6,232,30,68,.441,0,0,,30,68,.441,.441,22,29,.759,31,46,77,8,4,4,11,24,82
4664,NYK,2010,J.R. Giddens,24,11,0,140,19,39,.487,0,8,.000,19,31,.613,.487,7,11,.636,12,19,31,7,5,1,10,19,45
4665,NYK,2010,Marcus Landry,24,17,0,108,16,41,.390,9,26,.346,7,15,.467,.500,3,5,.600,5,14,19,0,1,2,6,14,44
4666,NYK,2010,Darko Miličić,24,8,0,71,8,17,.471,0,0,,8,17,.471,.471,0,0,,5,13,18,4,4,1,2,7,16
4667,NYK,2010,Eddy Curry,27,7,0,62,8,21,.381,0,0,,8,21,.381,.381,10,17,.588,4,9,13,0,0,1,13,13,26
4668,NYK,2009,Chris Duhon,26,79,78,2906,287,681,.421,127,325,.391,160,356,.449,.515,179,209,.856,45,201,246,566,72,7,221,126,880
4669,NYK,2009,David Lee,25,81,74,2824,522,951,.549,0,3,.000,522,948,.551,.549,249,330,.755,256,695,951,174,80,22,150,260,1293
4670,NYK,2009,Wilson Chandler,21,82,70,2735,455,1054,.432,103,314,.328,352,740,.476,.481,171,215,.795,91,354,445,170,71,75,139,250,1184
4671,NYK,2009,Al Harrington,28,68,51,2380,509,1142,.446,160,442,.362,349,700,.499,.516,229,285,.804,89,338,427,92,81,22,154,213,1407
4672,NYK,2009,Nate Robinson,24,74,11,2209,449,1028,.437,125,385,.325,324,643,.504,.498,249,296,.841,98,192,290,301,95,6,139,206,1272
4673,NYK,2009,Quentin Richardson,28,72,51,1894,262,667,.393,120,329,.365,142,338,.420,.483,89,117,.761,71,248,319,117,47,7,74,132,733
4674,NYK,2009,Jared Jeffries,27,56,36,1310,120,273,.440,1,12,.083,119,261,.456,.441,55,90,.611,128,103,231,80,47,33,65,153,296
4675,NYK,2009,Tim Thomas,31,36,1,773,119,258,.461,53,126,.421,66,132,.500,.564,54,67,.806,20,93,113,46,22,10,46,91,345
4676,NYK,2009,Larry Hughes,30,25,14,687,97,249,.390,35,91,.385,62,158,.392,.460,50,63,.794,10,55,65,60,36,5,35,45,279
4677,NYK,2009,Danilo Gallinari,20,28,2,412,56,125,.448,32,72,.444,24,53,.453,.576,26,27,.963,13,42,55,15,14,4,15,48,170
4678,NYK,2009,Jamal Crawford,28,11,11,392,73,169,.432,35,77,.455,38,92,.413,.536,35,46,.761,2,15,17,48,9,0,26,13,216
4679,NYK,2009,Zach Randolph,27,11,11,388,82,189,.434,7,24,.292,75,165,.455,.452,55,67,.821,40,97,137,15,13,3,23,28,226
4680,NYK,2009,Chris Wilcox,26,25,0,330,54,102,.529,0,1,.000,54,101,.535,.529,27,53,.509,31,51,82,14,8,5,20,48,135
4681,NYK,2009,Anthony Roberson,25,23,0,253,39,103,.379,24,71,.338,15,32,.469,.495,5,5,1.000,4,11,15,19,10,1,7,18,107
4682,NYK,2009,Malik Rose,34,18,0,160,11,41,.268,0,4,.000,11,37,.297,.268,8,11,.727,4,27,31,10,1,1,17,24,30
4683,NYK,2009,Mardy Collins,24,9,0,75,8,23,.348,0,3,.000,8,20,.400,.348,4,9,.444,2,6,8,10,2,0,5,7,20
4684,NYK,2009,Joe Crawford,22,2,0,23,3,10,.300,1,4,.250,2,6,.333,.350,2,2,1.000,1,3,4,1,1,0,0,2,9
4685,NYK,2009,Eddy Curry,26,3,0,12,2,2,1.000,0,0,,2,2,1.000,1.000,1,3,.333,0,4,4,0,0,0,2,5,5
4686,NYK,2009,Courtney Sims,25,1,0,11,3,6,.500,0,0,,3,6,.500,.500,0,0,,2,2,4,0,0,0,0,1,6
4687,NYK,2009,Jerome James,33,2,0,10,3,8,.375,0,0,,3,8,.375,.375,0,0,,1,2,3,0,1,1,1,2,6
4688,NYK,2009,Demetris Nichols,24,2,0,9,2,5,.400,0,1,.000,2,4,.500,.400,1,2,.500,0,2,2,0,0,1,0,0,5
4689,NYK,2009,Cheikh Samb,24,2,0,8,0,3,.000,0,0,,0,3,.000,.000,0,2,.000,1,1,2,0,0,0,0,0,0
4690,NYK,2009,Mouhamed Sene,22,1,0,6,1,2,.500,0,0,,1,2,.500,.500,1,1,1.000,2,3,5,0,0,1,1,0,3
4691,NYK,2008,Jamal Crawford,27,80,80,3190,570,1391,.410,176,494,.356,394,897,.439,.473,329,381,.864,37,170,207,398,81,17,192,144,1645
4692,NYK,2008,David Lee,24,81,29,2356,341,618,.552,0,2,.000,341,616,.554,.552,194,237,.819,242,482,724,95,55,29,97,210,876
4693,NYK,2008,Zach Randolph,26,69,68,2244,486,1058,.459,22,80,.275,464,978,.474,.470,223,289,.772,184,526,710,140,59,16,186,194,1217
4694,NYK,2008,Nate Robinson,23,72,17,1883,331,782,.423,97,292,.332,234,490,.478,.485,154,196,.786,51,171,222,212,60,1,103,186,913
4695,NYK,2008,Quentin Richardson,27,65,65,1841,199,555,.359,69,214,.322,130,341,.381,.421,60,88,.682,56,259,315,116,44,15,69,153,527
4696,NYK,2008,Fred Jones,28,70,26,1757,182,432,.421,74,192,.385,108,240,.450,.507,94,126,.746,30,140,170,166,48,18,78,140,532
4697,NYK,2008,Eddy Curry,25,59,58,1530,297,544,.546,0,0,,297,544,.546,.546,187,300,.623,111,164,275,32,14,29,126,157,781
4698,NYK,2008,Jared Jeffries,26,73,19,1325,108,270,.400,4,25,.160,104,245,.424,.407,49,93,.527,118,125,243,66,36,23,64,132,269
4699,NYK,2008,Renaldo Balkman,23,65,0,952,91,186,.489,1,12,.083,90,174,.517,.492,41,95,.432,83,133,216,40,44,30,37,132,224
4700,NYK,2008,Stephon Marbury,30,24,19,805,111,265,.419,28,74,.378,83,191,.435,.472,83,116,.716,17,42,59,113,21,2,48,57,333
4701,NYK,2008,Wilson Chandler,20,35,16,685,106,242,.438,9,30,.300,97,212,.458,.457,34,54,.630,38,89,127,33,15,16,27,83,255
4702,NYK,2008,Mardy Collins,23,46,8,634,57,175,.326,8,32,.250,49,143,.343,.349,23,38,.605,19,56,75,89,24,8,56,56,145
4703,NYK,2008,Malik Rose,33,49,3,494,66,180,.367,2,7,.286,64,173,.370,.372,37,51,.725,31,72,103,28,16,7,40,80,171
4704,NYK,2008,Randolph Morris,22,18,2,181,21,58,.362,0,0,,21,58,.362,.362,14,29,.483,12,25,37,2,4,2,9,37,56
4705,NYK,2008,Jerome James,32,2,0,5,1,1,1.000,0,0,,1,1,1.000,1.000,2,2,1.000,0,3,3,0,0,0,0,0,4
4706,NYK,2007,Eddy Curry,24,81,81,2849,585,1016,.576,1,1,1.000,584,1015,.575,.576,405,659,.615,195,376,571,68,34,40,295,265,1576
4707,NYK,2007,Stephon Marbury,29,74,74,2748,395,952,.415,123,345,.357,272,607,.448,.480,297,386,.769,36,177,213,403,71,10,179,185,1210
4708,NYK,2007,Jamal Crawford,26,59,36,2198,354,886,.400,103,322,.320,251,564,.445,.458,228,272,.838,44,145,189,259,57,8,162,114,1039
4709,NYK,2007,Channing Frye,23,72,59,1896,298,689,.433,3,18,.167,295,671,.440,.435,85,108,.787,91,304,395,67,36,42,100,216,684
4710,NYK,2007,David Lee,23,58,12,1731,240,400,.600,0,0,,240,400,.600,.600,141,173,.815,196,406,602,104,48,23,92,155,621
4711,NYK,2007,Quentin Richardson,26,49,47,1621,228,545,.418,97,258,.376,131,287,.456,.507,83,120,.692,65,287,352,108,36,7,70,133,636
4712,NYK,2007,Nate Robinson,22,64,5,1356,227,523,.434,83,213,.390,144,310,.465,.513,108,139,.777,55,97,152,90,50,6,72,160,645
4713,NYK,2007,Jared Jeffries,25,55,43,1307,95,206,.461,2,20,.100,93,186,.500,.466,31,68,.456,111,127,238,67,44,30,61,150,223
4714,NYK,2007,Steve Francis,29,44,30,1237,140,343,.408,42,111,.378,98,232,.422,.469,175,211,.829,33,124,157,170,41,12,100,126,497
4715,NYK,2007,Renaldo Balkman,22,68,1,1064,139,275,.505,5,27,.185,134,248,.540,.515,51,90,.567,97,197,294,44,57,44,49,146,334
4716,NYK,2007,Malik Rose,32,65,2,810,74,186,.398,2,8,.250,72,178,.404,.403,42,52,.808,47,128,175,65,26,9,65,120,192
4717,NYK,2007,Mardy Collins,22,52,9,777,87,228,.382,13,47,.277,74,181,.409,.410,48,82,.585,28,76,104,83,32,3,57,75,235
4718,NYK,2007,Jerome James,31,41,11,273,33,79,.418,0,0,,33,79,.418,.418,10,18,.556,21,45,66,3,6,15,23,73,76
4719,NYK,2007,Kelvin Cato,32,18,0,95,7,22,.318,0,0,,7,22,.318,.318,8,12,.667,12,19,31,0,3,10,6,10,22
4720,NYK,2007,Randolph Morris,21,5,0,44,1,6,.167,0,0,,1,6,.167,.167,2,6,.333,1,8,9,1,2,1,2,4,4
4721,NYK,2006,Jamal Crawford,25,79,27,2555,366,879,.416,101,293,.345,265,586,.452,.474,295,357,.826,36,212,248,301,87,15,175,150,1128
4722,NYK,2006,Stephon Marbury,28,60,60,2193,349,774,.451,33,104,.317,316,670,.472,.472,246,326,.755,25,150,175,382,63,4,157,143,977
4723,NYK,2006,Eddy Curry,23,72,69,1865,336,597,.563,0,0,,336,597,.563,.563,307,486,.632,145,287,432,19,28,56,179,239,979
4724,NYK,2006,Channing Frye,22,65,14,1572,305,640,.477,3,9,.333,302,631,.479,.479,189,229,.825,138,236,374,53,30,47,97,200,802
4725,NYK,2006,Nate Robinson,21,72,26,1544,230,565,.407,58,146,.397,172,419,.411,.458,152,202,.752,56,111,167,147,59,1,114,201,670
4726,NYK,2006,Quentin Richardson,25,55,43,1442,163,459,.355,64,188,.340,99,271,.365,.425,61,91,.670,65,165,230,88,39,6,56,134,451
4727,NYK,2006,Maurice Taylor,29,67,13,1210,182,389,.468,0,1,.000,182,388,.469,.468,58,83,.699,65,164,229,53,21,14,103,177,422
4728,NYK,2006,David Lee,22,67,14,1129,137,230,.596,0,0,,137,230,.596,.596,71,123,.577,109,194,303,43,30,20,51,124,345
4729,NYK,2006,Malik Rose,31,72,35,1119,105,281,.374,1,1,1.000,104,280,.371,.375,107,137,.781,84,175,259,67,43,14,80,145,318
4730,NYK,2006,Qyntel Woods,24,49,16,1013,129,254,.508,22,60,.367,107,194,.552,.551,49,76,.645,44,146,190,47,32,13,61,96,329
4731,NYK,2006,Antonio Davis,37,36,31,749,68,159,.428,0,1,.000,68,158,.430,.428,45,61,.738,75,97,172,14,20,9,43,99,181
4732,NYK,2006,Jalen Rose,33,26,23,747,110,239,.460,28,57,.491,82,182,.451,.519,82,101,.812,13,69,82,68,10,3,50,55,330
4733,NYK,2006,Jackie Butler,20,55,0,740,117,215,.544,0,0,,117,215,.544,.544,58,77,.753,67,116,183,25,17,31,62,127,292
4734,NYK,2006,Trevor Ariza,20,36,10,709,61,146,.418,1,3,.333,60,143,.420,.421,42,77,.545,49,88,137,46,43,9,46,78,165
4735,NYK,2006,Steve Francis,28,24,15,659,84,190,.442,7,13,.538,77,177,.435,.461,83,109,.761,14,57,71,83,23,6,58,62,258
4736,NYK,2006,Jerome James,30,45,9,406,56,121,.463,0,0,,56,121,.463,.463,25,40,.625,39,52,91,12,3,23,51,104,137
4737,NYK,2006,Ime Udoka,28,8,0,114,9,24,.375,1,3,.333,8,21,.381,.396,3,6,.500,3,14,17,6,1,0,2,8,22
4738,NYK,2006,Matt Barnes,25,6,5,93,11,30,.367,1,4,.250,10,26,.385,.383,3,4,.750,7,17,24,6,4,0,6,8,26
4739,NYK,2006,Anfernee Hardaway,34,4,0,72,4,14,.286,0,1,.000,4,13,.308,.286,2,2,1.000,0,10,10,8,2,0,6,7,10
4740,NYK,2005,Stephon Marbury,27,82,82,3281,604,1308,.462,115,325,.354,489,983,.497,.506,458,549,.834,50,198,248,668,122,6,233,186,1781
4741,NYK,2005,Kurt Thomas,32,80,80,2855,424,901,.471,2,4,.500,422,897,.470,.472,66,84,.786,170,661,831,160,70,79,99,310,916
4742,NYK,2005,Jamal Crawford,24,70,67,2688,437,1097,.398,185,512,.361,252,585,.431,.483,182,216,.843,33,170,203,302,92,19,148,135,1241
4743,NYK,2005,Tim Thomas,27,71,68,1940,315,718,.439,85,208,.409,230,510,.451,.498,136,173,.786,45,192,237,110,41,17,113,222,851
4744,NYK,2005,Nazr Mohammed,27,54,54,1519,234,460,.509,0,1,.000,234,459,.510,.509,121,171,.708,169,270,439,26,53,53,81,172,589
4745,NYK,2005,Mike Sweetney,22,77,28,1509,237,446,.531,0,1,.000,237,445,.533,.531,176,235,.749,169,249,418,44,27,28,108,224,650
4746,NYK,2005,Trevor Ariza,19,80,12,1382,172,389,.442,3,13,.231,169,376,.449,.446,121,174,.695,89,153,242,85,70,18,73,150,468
4747,NYK,2005,Jerome Williams,31,79,4,1211,122,243,.502,0,5,.000,122,238,.513,.502,115,172,.669,115,168,283,41,55,10,65,155,359
4748,NYK,2005,Anfernee Hardaway,33,37,0,894,110,260,.423,15,50,.300,95,210,.452,.452,34,46,.739,19,70,89,74,28,3,50,79,269
4749,NYK,2005,Malik Rose,30,26,4,613,74,174,.425,1,6,.167,73,168,.435,.428,68,87,.782,34,80,114,18,15,7,46,84,217
4750,NYK,2005,Allan Houston,33,20,11,532,85,205,.415,31,80,.388,54,125,.432,.490,36,43,.837,4,19,23,42,8,2,21,40,237
4751,NYK,2005,Maurice Taylor,28,27,0,431,76,154,.494,0,1,.000,76,153,.497,.494,24,43,.558,26,67,93,14,11,8,31,57,176
4752,NYK,2005,Moochie Norris,31,32,0,321,32,93,.344,0,12,.000,32,81,.395,.344,18,22,.818,9,33,42,34,17,2,25,42,82
4753,NYK,2005,Jermaine Jackson,28,21,0,230,17,33,.515,0,2,.000,17,31,.548,.515,8,13,.615,3,20,23,24,7,1,10,26,42
4754,NYK,2005,Vin Baker,33,24,0,191,13,38,.342,0,1,.000,13,37,.351,.342,7,15,.467,17,20,37,9,2,4,15,31,33
4755,NYK,2005,Jamison Brewer,24,18,0,185,11,37,.297,3,15,.200,8,22,.364,.338,6,13,.462,6,16,22,12,8,1,13,11,31
4756,NYK,2005,Bruno Šundov,24,21,0,73,11,37,.297,1,3,.333,10,34,.294,.311,2,2,1.000,6,7,13,2,2,2,6,16,25
4757,NYK,2005,Shandon Anderson,31,1,0,20,0,2,.000,0,1,.000,0,1,.000,.000,0,0,,1,0,1,0,0,0,1,2,0
4758,NYK,2005,Jackie Butler,19,3,0,5,4,4,1.000,0,0,,4,4,1.000,1.000,2,2,1.000,0,0,0,0,1,0,1,0,10
4759,NYK,2004,Kurt Thomas,31,80,75,2548,392,829,.473,0,3,.000,392,826,.475,.473,106,127,.835,145,517,662,149,56,80,132,298,890
4760,NYK,2004,Shandon Anderson,30,80,37,1974,238,564,.422,36,128,.281,202,436,.463,.454,123,161,.764,53,169,222,122,68,17,118,182,635
4761,NYK,2004,Stephon Marbury,26,47,47,1839,336,780,.431,50,156,.321,286,624,.458,.463,209,251,.833,39,107,146,438,65,4,152,98,931
4762,NYK,2004,Allan Houston,32,50,50,1799,340,781,.435,87,202,.431,253,579,.437,.491,157,172,.913,20,101,121,99,38,2,102,105,924
4763,NYK,2004,Keith Van Horn,28,47,47,1574,273,613,.445,60,161,.373,213,452,.471,.494,163,199,.819,98,245,343,83,52,18,119,151,769
4764,NYK,2004,Dikembe Mutombo,37,65,56,1494,141,295,.478,0,0,,141,295,.478,.478,81,119,.681,145,292,437,25,17,123,54,141,363
4765,NYK,2004,Anfernee Hardaway,32,42,4,1219,159,408,.390,16,44,.364,143,364,.393,.409,69,89,.775,42,147,189,79,42,12,65,81,403
4766,NYK,2004,Othella Harrington,30,56,3,872,100,202,.495,0,0,,100,202,.495,.495,58,78,.744,58,119,177,29,12,14,65,134,258
4767,NYK,2004,Charlie Ward,33,35,10,827,115,260,.442,59,138,.428,56,122,.459,.556,16,21,.762,10,86,96,170,47,8,69,74,305
4768,NYK,2004,Tim Thomas,26,24,23,746,137,303,.452,26,64,.406,111,239,.464,.495,78,96,.813,26,89,115,34,24,5,43,69,378
4769,NYK,2004,Howard Eisley,31,33,23,730,80,202,.396,28,85,.329,52,117,.444,.465,32,36,.889,7,59,66,156,30,3,50,85,220
4770,NYK,2004,Frank Williams,23,56,3,714,80,208,.385,18,60,.300,62,148,.419,.428,41,48,.854,8,45,53,121,25,6,63,58,219
4771,NYK,2004,Michael Doleac,26,46,0,685,100,225,.444,0,0,,100,225,.444,.444,31,36,.861,60,129,189,30,17,30,37,84,231
4772,NYK,2004,Nazr Mohammed,26,27,23,673,108,192,.563,0,0,,108,192,.563,.563,31,59,.525,77,130,207,16,33,25,41,82,247
4773,NYK,2004,Mike Sweetney,21,42,1,494,69,140,.493,0,1,.000,69,139,.496,.493,42,58,.724,68,89,157,14,18,12,32,57,180
4774,NYK,2004,Moochie Norris,30,36,0,446,53,130,.408,12,35,.343,41,95,.432,.454,36,47,.766,8,27,35,73,28,3,34,35,154
4775,NYK,2004,Antonio McDyess,29,18,6,421,65,142,.458,0,0,,65,142,.458,.458,22,38,.579,31,88,119,20,12,11,27,46,152
4776,NYK,2004,Vin Baker,32,17,0,313,40,99,.404,1,2,.500,39,97,.402,.409,32,45,.711,36,34,70,12,7,9,25,62,113
4777,NYK,2004,DerMarr Johnson,23,21,1,287,36,97,.371,13,36,.361,23,61,.377,.438,28,31,.903,5,34,39,11,8,7,16,32,113
4778,NYK,2004,Clarence Weatherspoon,33,15,1,216,18,40,.450,0,0,,18,40,.450,.450,18,19,.947,14,36,50,13,8,2,9,19,54
4779,NYK,2004,Cezary Trybański,24,3,0,5,0,2,.000,0,0,,0,2,.000,.000,1,2,.500,0,0,0,0,1,0,0,2,1
4780,NYK,2004,Bruno Šundov,23,1,0,4,1,1,1.000,0,0,,1,1,1.000,1.000,0,0,,0,0,0,1,0,0,0,2,2
4781,NYK,2003,Allan Houston,31,82,82,3108,652,1465,.445,178,450,.396,474,1015,.467,.506,363,395,.919,26,205,231,220,54,7,178,191,1845
4782,NYK,2003,Latrell Sprewell,32,74,73,2859,454,1127,.403,134,360,.372,320,767,.417,.462,173,218,.794,45,240,285,332,102,22,172,134,1215
4783,NYK,2003,Kurt Thomas,30,81,81,2577,497,1028,.483,2,3,.667,495,1025,.483,.484,138,184,.750,160,477,637,162,81,97,138,344,1134
4784,NYK,2003,Howard Eisley,30,82,76,2243,262,628,.417,131,337,.389,131,291,.450,.521,89,105,.848,24,162,186,444,71,9,149,222,744
4785,NYK,2003,Clarence Weatherspoon,32,79,19,2024,186,414,.449,0,0,,186,414,.449,.449,149,194,.768,214,385,599,68,69,36,63,174,521
4786,NYK,2003,Othella Harrington,29,74,64,1850,225,443,.508,0,0,,225,443,.508,.508,123,150,.820,165,311,476,62,12,23,90,231,573
4787,NYK,2003,Shandon Anderson,29,82,9,1731,248,537,.462,52,140,.371,196,397,.494,.510,139,190,.732,64,190,254,87,73,20,114,177,687
4788,NYK,2003,Charlie Ward,32,66,6,1465,165,414,.399,101,267,.378,64,147,.435,.521,41,53,.774,25,152,177,306,78,11,95,146,472
4789,NYK,2003,Michael Doleac,25,75,0,1041,146,343,.426,0,0,,146,343,.426,.426,36,46,.783,65,154,219,42,16,16,49,150,328
4790,NYK,2003,Lee Nailon,27,38,0,405,84,190,.442,0,1,.000,84,189,.444,.442,42,51,.824,32,38,70,26,6,3,32,46,210
4791,NYK,2003,Travis Knight,28,32,0,287,25,65,.385,0,1,.000,25,64,.391,.385,10,13,.769,18,44,62,14,8,9,10,44,60
4792,NYK,2003,Frank Williams,22,21,0,167,9,33,.273,6,16,.375,3,17,.176,.364,4,6,.667,3,15,18,34,7,2,17,20,28
4793,NYK,2003,Lavor Postell,24,12,0,98,14,38,.368,2,7,.286,12,31,.387,.395,13,15,.867,1,3,4,3,2,0,7,9,43
4794,NYK,2002,Latrell Sprewell,31,81,81,3326,573,1419,.404,145,403,.360,428,1016,.421,.455,284,346,.821,59,239,298,313,94,14,223,161,1575
4795,NYK,2002,Allan Houston,30,77,77,2914,568,1301,.437,136,346,.393,432,955,.452,.489,295,339,.870,37,215,252,190,54,10,170,182,1567
4796,NYK,2002,Kurt Thomas,29,82,82,2771,463,938,.494,1,6,.167,462,932,.496,.494,216,265,.815,214,533,747,87,71,79,153,341,1143
4797,NYK,2002,Mark Jackson,36,82,82,2367,260,592,.439,79,195,.405,181,397,.456,.506,87,110,.791,56,253,309,605,74,1,150,162,686
4798,NYK,2002,Clarence Weatherspoon,31,56,41,1728,189,452,.418,0,0,,189,452,.418,.418,116,146,.795,149,311,460,60,37,48,47,132,494
4799,NYK,2002,Shandon Anderson,28,82,6,1596,149,373,.399,39,141,.277,110,232,.474,.452,74,107,.692,57,192,249,76,48,15,97,134,411
4800,NYK,2002,Othella Harrington,28,77,4,1563,237,450,.527,0,2,.000,237,448,.529,.527,122,172,.709,125,224,349,37,30,36,95,250,596
4801,NYK,2002,Charlie Ward,31,63,0,1058,113,303,.373,53,164,.323,60,139,.432,.460,47,58,.810,15,112,127,203,68,14,75,100,326
4802,NYK,2002,Marcus Camby,27,29,29,1007,130,290,.448,0,1,.000,130,289,.450,.448,62,99,.626,89,233,322,33,34,50,42,107,322
4803,NYK,2002,Howard Eisley,29,39,0,609,59,175,.337,14,58,.241,45,117,.385,.377,39,49,.796,9,40,49,100,24,3,53,55,171
4804,NYK,2002,Travis Knight,27,49,0,429,41,113,.363,0,0,,41,113,.363,.363,16,21,.762,48,56,104,8,11,10,27,95,98
4805,NYK,2002,Felton Spencer,34,32,8,248,6,26,.231,0,0,,6,26,.231,.231,17,33,.515,16,34,50,3,7,8,12,73,29
4806,NYK,2002,Lavor Postell,23,23,0,179,28,84,.333,6,26,.231,22,58,.379,.369,31,41,.756,2,14,16,5,6,0,11,7,93
4807,NYK,2002,Larry Robinson,34,2,0,10,1,4,.250,1,2,.500,0,2,.000,.375,0,0,,0,2,2,0,0,0,0,1,3
4808,NYK,2001,Latrell Sprewell,30,77,77,3017,524,1219,.430,41,135,.304,483,1084,.446,.447,275,351,.783,49,298,347,269,106,28,218,159,1364
4809,NYK,2001,Allan Houston,29,78,78,2858,542,1208,.449,96,252,.381,446,956,.467,.488,279,307,.909,20,263,283,173,52,10,161,190,1459
4810,NYK,2001,Glen Rice,33,75,25,2212,331,752,.440,82,211,.389,249,541,.460,.495,155,182,.852,61,246,307,89,41,13,96,179,899
4811,NYK,2001,Marcus Camby,26,63,63,2127,304,580,.524,1,8,.125,303,572,.530,.525,150,225,.667,196,527,723,52,66,136,63,205,759
4812,NYK,2001,Kurt Thomas,28,77,29,2125,314,614,.511,1,3,.333,313,611,.512,.512,171,210,.814,172,343,515,63,61,69,99,287,800
4813,NYK,2001,Larry Johnson,31,65,65,2105,246,598,.411,51,163,.313,195,435,.448,.454,102,128,.797,90,273,363,127,39,29,97,209,645
4814,NYK,2001,Charlie Ward,30,61,33,1492,155,373,.416,67,175,.383,88,198,.444,.505,56,70,.800,32,127,159,273,70,10,112,132,433
4815,NYK,2001,Chris Childs,33,51,5,1309,93,222,.419,20,64,.313,73,158,.462,.464,39,46,.848,14,124,138,236,37,7,98,160,245
4816,NYK,2001,Mark Jackson,35,29,28,786,74,180,.411,13,42,.310,61,138,.442,.447,9,17,.529,21,99,120,163,21,0,58,56,170
4817,NYK,2001,Othella Harrington,27,30,5,548,67,121,.554,0,0,,67,121,.554,.554,51,70,.729,37,62,99,20,15,19,41,101,185
4818,NYK,2001,Erick Strickland,27,28,0,421,40,131,.305,16,47,.340,24,84,.286,.366,24,28,.857,9,43,52,29,22,1,21,46,120
4819,NYK,2001,Luc Longley,32,25,2,301,18,54,.333,0,0,,18,54,.333,.333,13,17,.765,26,40,66,7,3,9,22,51,49
4820,NYK,2001,Travis Knight,26,45,0,256,10,53,.189,0,1,.000,10,52,.192,.189,9,18,.500,19,34,53,5,5,11,10,47,29
4821,NYK,2001,Lavor Postell,22,26,0,169,17,54,.315,3,11,.273,14,43,.326,.343,22,27,.815,8,17,25,5,4,2,17,12,59
4822,NYK,2001,Felton Spencer,33,18,0,113,12,20,.600,0,0,,12,20,.600,.600,15,25,.600,16,19,35,2,2,2,11,24,39
4823,NYK,2001,Rick Brunson,28,15,0,66,8,19,.421,0,3,.000,8,16,.500,.421,4,6,.667,3,9,12,7,1,0,8,5,20
4824,NYK,2000,Latrell Sprewell,29,82,82,3276,568,1305,.435,44,127,.346,524,1178,.445,.452,344,397,.866,49,300,349,332,109,22,226,184,1524
4825,NYK,2000,Allan Houston,28,82,82,3169,614,1271,.483,106,243,.436,508,1028,.494,.525,280,334,.838,38,233,271,224,65,14,186,219,1614
4826,NYK,2000,Larry Johnson,30,70,68,2281,282,652,.433,58,174,.333,224,478,.469,.477,128,167,.766,87,293,380,175,42,7,94,205,750
4827,NYK,2000,Patrick Ewing,37,62,62,2035,361,775,.466,0,2,.000,361,773,.467,.466,207,283,.731,140,464,604,58,36,84,142,196,929
4828,NYK,2000,Charlie Ward,29,72,69,1986,189,447,.423,102,264,.386,87,183,.475,.537,48,58,.828,22,206,228,300,95,16,102,176,528
4829,NYK,2000,Kurt Thomas,27,80,21,1971,270,535,.505,1,3,.333,269,532,.506,.506,100,128,.781,144,361,505,82,51,42,105,278,641
4830,NYK,2000,Chris Childs,32,71,2,1675,146,357,.409,37,104,.356,109,253,.431,.461,47,59,.797,17,130,147,285,36,4,105,240,376
4831,NYK,2000,Marcus Camby,25,59,11,1548,226,471,.480,1,2,.500,225,469,.480,.481,148,221,.670,174,287,461,49,43,116,72,204,601
4832,NYK,2000,John Wallace,25,60,0,798,155,332,.467,0,3,.000,155,329,.471,.467,82,102,.804,42,93,135,22,10,14,63,103,392
4833,NYK,2000,Chris Dudley,34,47,3,459,23,67,.343,0,0,,23,67,.343,.343,9,27,.333,63,73,136,5,7,21,18,95,55
4834,NYK,2000,Rick Brunson,27,37,0,289,29,70,.414,2,13,.154,27,57,.474,.429,11,18,.611,3,24,27,49,9,1,31,35,71
4835,NYK,2000,Andrew Lang,33,19,10,244,28,64,.438,0,0,,28,64,.438,.438,3,7,.429,16,44,60,3,8,6,5,31,59
4836,NYK,2000,DeMarco Johnson,24,5,0,37,3,9,.333,0,0,,3,9,.333,.333,0,0,,3,4,7,0,1,0,3,5,6
4837,NYK,2000,David Wingate,36,7,0,32,1,9,.111,0,0,,1,9,.111,.111,0,0,,1,1,2,3,1,2,2,7,2
4838,NYK,2000,Mirsad Türkcan,23,7,0,25,2,10,.200,0,2,.000,2,8,.250,.200,0,0,,2,8,10,1,2,0,1,4,4
4839,NYK,2000,Etdrick Bohannon,26,2,0,5,0,0,,0,0,,0,0,,,3,4,.750,1,0,1,0,0,0,2,1,3
4840,NYK,1999,Allan Houston,27,50,50,1815,294,703,.418,57,140,.407,237,563,.421,.459,168,195,.862,20,132,152,137,35,9,130,115,813
4841,NYK,1999,Larry Johnson,29,49,48,1639,210,458,.459,33,92,.359,177,366,.484,.495,134,164,.817,91,193,284,119,34,10,89,147,587
4842,NYK,1999,Charlie Ward,28,50,50,1556,135,334,.404,53,149,.356,82,185,.443,.484,55,78,.705,23,149,172,271,103,8,131,105,378
4843,NYK,1999,Patrick Ewing,36,38,38,1300,247,568,.435,0,2,.000,247,566,.436,.435,163,231,.706,74,303,377,43,30,100,99,105,657
4844,NYK,1999,Chris Childs,31,48,0,1297,114,267,.427,36,94,.383,78,173,.451,.494,64,78,.821,18,115,133,193,44,1,85,156,328
4845,NYK,1999,Latrell Sprewell,28,37,4,1233,215,518,.415,21,77,.273,194,441,.440,.435,155,191,.812,41,115,156,91,46,2,79,65,606
4846,NYK,1999,Kurt Thomas,26,50,44,1182,170,368,.462,0,1,.000,170,367,.463,.462,66,108,.611,82,204,286,55,45,17,73,159,406
4847,NYK,1999,Marcus Camby,24,46,0,945,136,261,.521,0,0,,136,261,.521,.521,57,103,.553,102,151,253,12,29,74,39,131,329
4848,NYK,1999,Chris Dudley,33,46,16,685,48,109,.440,0,0,,48,109,.440,.440,19,40,.475,79,114,193,7,13,38,24,116,115
4849,NYK,1999,Dennis Scott,30,15,0,206,17,56,.304,8,29,.276,9,27,.333,.375,1,4,.250,3,17,20,8,3,1,5,17,43
4850,NYK,1999,Rick Brunson,26,17,0,95,6,21,.286,0,5,.000,6,16,.375,.286,5,18,.278,3,7,10,19,9,0,12,8,17
4851,NYK,1999,David Wingate,35,20,0,92,7,16,.438,0,0,,7,16,.438,.438,0,0,,3,5,8,5,4,0,6,10,14
4852,NYK,1999,Herb Williams,40,6,0,34,4,8,.500,0,0,,4,8,.500,.500,2,2,1.000,3,3,6,0,0,2,2,2,10
4853,NYK,1999,Ben Davis,26,8,0,21,7,17,.412,0,0,,7,17,.412,.412,3,6,.500,9,2,11,3,0,0,1,4,17
4854,NYK,1998,Allan Houston,26,82,82,2848,571,1277,.447,82,213,.385,489,1064,.460,.479,285,335,.851,43,231,274,212,63,24,200,207,1509
4855,NYK,1998,Charles Oakley,34,79,79,2734,307,698,.440,0,6,.000,307,692,.444,.440,97,114,.851,218,506,724,201,123,22,126,280,711
4856,NYK,1998,Larry Johnson,28,70,70,2412,429,884,.485,15,63,.238,414,821,.504,.494,214,283,.756,175,226,401,150,40,13,127,193,1087
4857,NYK,1998,Charlie Ward,27,82,82,2317,235,516,.455,81,215,.377,154,301,.512,.534,91,113,.805,32,242,274,466,144,37,175,195,642
4858,NYK,1998,John Starks,32,82,10,2188,372,947,.393,130,398,.327,242,549,.441,.461,185,235,.787,48,182,230,219,78,5,143,205,1059
4859,NYK,1998,Chris Mills,28,80,29,2183,292,675,.433,40,137,.292,252,538,.468,.462,152,189,.804,120,288,408,133,45,30,107,218,776
4860,NYK,1998,Chris Childs,30,68,0,1599,149,354,.421,27,87,.310,122,267,.457,.459,104,126,.825,29,133,162,268,56,6,103,179,429
4861,NYK,1998,Chris Dudley,32,51,22,858,58,143,.406,0,0,,58,143,.406,.406,41,92,.446,108,167,275,21,13,51,44,139,157
4862,NYK,1998,Patrick Ewing,35,26,26,848,203,403,.504,0,2,.000,203,401,.506,.504,134,186,.720,59,206,265,28,16,58,77,74,540
4863,NYK,1998,Buck Williams,37,41,6,738,75,149,.503,0,0,,75,149,.503,.503,52,71,.732,78,105,183,21,17,15,38,93,202
4864,NYK,1998,Terry Cummings,36,30,1,529,103,216,.477,0,0,,103,216,.477,.477,28,40,.700,42,93,135,26,16,5,34,79,234
4865,NYK,1998,Anthony Bowie,34,27,3,224,32,59,.542,3,4,.750,29,55,.527,.568,8,9,.889,9,17,26,11,6,2,7,25,75
4866,NYK,1998,Herb Williams,39,27,0,178,18,43,.419,0,0,,18,43,.419,.419,1,8,.125,6,23,29,4,6,9,5,34,37
4867,NYK,1998,Brooks Thompson,27,17,0,121,13,29,.448,4,14,.286,9,15,.600,.517,3,5,.600,0,10,10,24,6,1,11,16,33
4868,NYK,1998,Pete Myers,34,9,0,40,5,10,.500,0,0,,5,10,.500,.500,4,6,.667,5,5,10,3,4,0,4,7,14
4869,NYK,1998,Ben Davis,25,7,0,13,2,10,.200,0,0,,2,10,.200,.200,0,0,,6,0,6,0,1,0,0,3,4
4870,NYK,1997,Patrick Ewing,34,78,78,2887,655,1342,.488,2,9,.222,653,1333,.490,.489,439,582,.754,175,659,834,156,69,189,269,250,1751
4871,NYK,1997,Charles Oakley,33,80,80,2873,339,694,.488,5,19,.263,334,675,.495,.492,181,224,.808,246,535,781,221,111,21,171,305,864
4872,NYK,1997,Allan Houston,25,81,81,2681,437,1032,.423,148,384,.385,289,648,.446,.495,175,218,.803,43,197,240,179,41,18,167,233,1197
4873,NYK,1997,Larry Johnson,27,76,76,2613,376,735,.512,34,105,.324,342,630,.543,.535,190,274,.693,165,228,393,174,64,36,136,249,976
4874,NYK,1997,Chris Childs,29,65,61,2076,211,510,.414,70,181,.387,141,329,.429,.482,113,149,.758,22,169,191,398,78,11,180,213,605
4875,NYK,1997,John Starks,31,77,1,2042,369,856,.431,150,407,.369,219,449,.488,.519,173,225,.769,36,169,205,217,90,11,158,196,1061
4876,NYK,1997,Charlie Ward,26,79,21,1763,133,337,.395,48,154,.312,85,183,.464,.466,95,125,.760,45,175,220,326,83,15,147,188,409
4877,NYK,1997,Buck Williams,36,74,4,1496,175,326,.537,0,1,.000,175,325,.538,.537,115,179,.642,166,231,397,53,40,38,79,204,465
4878,NYK,1997,John Wallace,22,68,6,787,122,236,.517,2,4,.500,120,232,.517,.521,79,110,.718,51,104,155,37,21,25,76,102,325
4879,NYK,1997,Scott Brooks,31,38,0,251,19,39,.487,5,12,.417,14,27,.519,.551,14,15,.933,6,12,18,29,21,0,17,35,57
4880,NYK,1997,Walter McCarty,22,35,0,192,26,68,.382,4,14,.286,22,54,.407,.412,8,14,.571,8,15,23,13,7,9,17,38,64
4881,NYK,1997,Herb Williams,38,21,2,184,18,46,.391,0,1,.000,18,45,.400,.391,3,4,.750,9,22,31,5,4,5,5,18,39
4882,NYK,1997,Chris Jent,27,3,0,10,2,6,.333,2,3,.667,0,3,.000,.500,0,0,,1,0,1,1,0,0,0,2,6
4883,NYK,1996,Anthony Mason,29,82,82,3457,449,798,.563,0,0,,449,798,.563,.563,298,414,.720,220,544,764,363,69,34,211,246,1196
4884,NYK,1996,Derek Harper,34,82,82,2893,436,939,.464,121,325,.372,315,614,.513,.529,156,206,.757,32,170,202,352,131,5,178,201,1149
4885,NYK,1996,Patrick Ewing,33,76,76,2783,678,1456,.466,4,28,.143,674,1428,.472,.467,351,461,.761,157,649,806,160,68,184,221,247,1711
4886,NYK,1996,John Starks,30,81,71,2491,375,846,.443,143,396,.361,232,450,.516,.528,131,174,.753,31,206,237,315,103,11,156,226,1024
4887,NYK,1996,Charles Oakley,32,53,51,1775,211,448,.471,7,26,.269,204,422,.483,.479,175,210,.833,162,298,460,137,58,14,104,195,604
4888,NYK,1996,Hubert Davis,25,74,14,1773,275,566,.486,127,267,.476,148,299,.495,.598,112,129,.868,35,88,123,103,31,8,63,120,789
4889,NYK,1996,Charles Smith,30,41,4,890,114,294,.388,2,15,.133,112,279,.401,.391,73,103,.709,59,101,160,29,18,51,61,124,303
4890,NYK,1996,Charlie Ward,25,62,1,787,87,218,.399,33,99,.333,54,119,.454,.475,37,54,.685,29,73,102,132,54,6,79,98,244
4891,NYK,1996,J.R. Reid,27,33,16,670,88,160,.550,0,0,,88,160,.550,.550,43,55,.782,38,94,132,28,18,7,30,89,219
4892,NYK,1996,Gary Grant,30,47,1,596,88,181,.486,8,24,.333,80,157,.510,.508,48,58,.828,12,40,52,69,39,3,45,91,232
4893,NYK,1996,Herb Williams,37,43,2,540,59,144,.410,1,4,.250,58,140,.414,.413,13,20,.650,14,68,82,27,13,31,22,75,132
4894,NYK,1996,Willie Anderson,29,27,2,496,56,133,.421,5,25,.200,51,108,.472,.440,19,31,.613,13,47,60,48,17,8,24,59,136
4895,NYK,1996,Brad Lohaus,31,23,7,325,32,79,.405,24,57,.421,8,22,.364,.557,2,2,1.000,2,29,31,27,8,10,11,36,90
4896,NYK,1996,Doug Christie,25,23,0,218,35,73,.479,10,19,.526,25,54,.463,.548,13,22,.591,8,26,34,25,12,3,19,41,93
4897,NYK,1996,Monty Williams,24,14,0,62,7,22,.318,0,0,,7,22,.318,.318,5,8,.625,9,8,17,4,2,0,5,9,19
4898,NYK,1996,Ron Grandison,31,6,0,57,7,15,.467,0,0,,7,15,.467,.467,4,6,.667,5,8,13,2,4,1,1,4,18
4899,NYK,1996,Matt Fish,26,2,1,17,6,10,.600,0,0,,6,10,.600,.600,0,1,.000,3,0,3,1,0,1,0,3,12
4900,NYK,1995,Patrick Ewing,32,79,79,2920,730,1452,.503,6,21,.286,724,1431,.506,.505,420,560,.750,157,710,867,212,68,159,256,272,1886
4901,NYK,1995,John Starks,29,80,78,2725,419,1062,.395,217,611,.355,202,451,.448,.497,168,228,.737,34,185,219,411,92,4,160,257,1223
4902,NYK,1995,Derek Harper,33,80,80,2716,337,756,.446,106,292,.363,231,464,.498,.516,139,192,.724,31,163,194,458,79,10,151,219,919
4903,NYK,1995,Anthony Mason,28,77,11,2496,287,507,.566,0,1,.000,287,506,.567,.566,191,298,.641,182,468,650,240,69,21,123,253,765
4904,NYK,1995,Charles Smith,29,76,58,2150,352,747,.471,7,31,.226,345,716,.482,.476,255,322,.792,144,180,324,120,49,95,147,286,966
4905,NYK,1995,Hubert Davis,24,82,4,1697,296,617,.480,131,288,.455,165,329,.502,.586,97,120,.808,30,80,110,150,35,11,87,146,820
4906,NYK,1995,Charles Oakley,31,50,49,1567,192,393,.489,3,12,.250,189,381,.496,.492,119,150,.793,155,290,445,126,60,7,103,179,506
4907,NYK,1995,Anthony Bonner,26,58,23,1126,88,193,.456,1,5,.200,87,188,.463,.459,44,67,.657,113,149,262,80,48,23,79,159,221
4908,NYK,1995,Greg Anthony,27,61,2,943,128,293,.437,56,155,.361,72,138,.522,.532,60,76,.789,7,57,64,160,50,7,57,99,372
4909,NYK,1995,Herb Williams,36,56,3,743,82,180,.456,0,0,,82,180,.456,.456,23,37,.622,23,109,132,27,13,45,40,108,187
4910,NYK,1995,Monty Williams,23,41,23,503,60,133,.451,0,8,.000,60,125,.480,.451,17,38,.447,42,56,98,49,20,4,41,87,137
4911,NYK,1995,Doug Christie,24,12,0,79,5,22,.227,1,7,.143,4,15,.267,.250,4,5,.800,3,10,13,8,2,1,13,18,15
4912,NYK,1995,Doc Rivers,33,3,0,47,4,13,.308,3,5,.600,1,8,.125,.423,8,11,.727,2,7,9,8,4,0,4,8,19
4913,NYK,1995,Charlie Ward,24,10,0,44,4,19,.211,1,10,.100,3,9,.333,.237,7,10,.700,1,5,6,4,2,0,8,7,16
4914,NYK,1995,Greg Kite,33,2,0,16,0,3,.000,0,0,,0,3,.000,.000,0,0,,2,2,4,0,0,0,1,2,0
4915,NYK,1995,Ron Grandison,30,2,0,8,1,4,.250,0,0,,1,4,.250,.250,0,0,,3,2,5,2,0,0,0,2,2
4916,NYK,1994,Patrick Ewing,31,79,79,2972,745,1503,.496,4,14,.286,741,1489,.498,.497,445,582,.765,219,666,885,179,90,217,260,275,1939
4917,NYK,1994,Charles Oakley,30,82,82,2932,363,760,.478,0,3,.000,363,757,.480,.478,243,313,.776,349,616,965,218,110,18,193,293,969
4918,NYK,1994,John Starks,28,59,54,2057,410,977,.420,113,337,.335,297,640,.464,.477,187,248,.754,37,148,185,348,95,6,184,191,1120
4919,NYK,1994,Greg Anthony,26,80,36,1994,225,571,.394,48,160,.300,177,411,.431,.436,130,168,.774,43,146,189,365,114,13,127,163,628
4920,NYK,1994,Anthony Mason,27,73,12,1903,206,433,.476,0,1,.000,206,432,.477,.476,116,161,.720,158,269,427,151,31,9,107,190,528
4921,NYK,1994,Anthony Bonner,25,73,38,1402,162,288,.563,0,0,,162,288,.563,.563,50,105,.476,150,194,344,88,76,13,89,175,374
4922,NYK,1994,Hubert Davis,23,56,27,1333,238,505,.471,53,132,.402,185,373,.496,.524,85,103,.825,23,44,67,165,40,4,76,118,614
4923,NYK,1994,Derek Harper,32,54,27,1311,173,402,.430,36,98,.367,137,304,.451,.475,84,113,.743,10,76,86,236,80,4,81,117,466
4924,NYK,1994,Charles Smith,28,43,21,1105,176,397,.443,8,16,.500,168,381,.441,.453,87,121,.719,66,99,165,50,26,45,64,144,447
4925,NYK,1994,Rolando Blackman,34,55,1,969,161,369,.436,30,84,.357,131,285,.460,.477,48,53,.906,23,70,93,76,25,6,44,100,400
4926,NYK,1994,Herb Williams,35,70,3,774,103,233,.442,0,1,.000,103,232,.444,.442,27,42,.643,56,126,182,28,18,43,39,108,233
4927,NYK,1994,Doc Rivers,32,19,19,499,55,127,.433,19,52,.365,36,75,.480,.508,14,22,.636,4,35,39,100,25,5,29,44,143
4928,NYK,1994,Tony Campbell,31,22,11,379,63,128,.492,1,3,.333,62,125,.496,.496,30,37,.811,28,32,60,31,20,1,29,59,157
4929,NYK,1994,Corey Gaines,28,18,0,78,9,20,.450,2,5,.400,7,15,.467,.500,13,15,.867,3,10,13,30,2,0,5,12,33
4930,NYK,1994,Eric Anderson,23,11,0,39,7,17,.412,2,2,1.000,5,15,.333,.471,5,14,.357,6,11,17,2,0,1,2,9,21
4931,NYK,1994,Gerald Paddio,28,3,0,8,2,5,.400,0,0,,2,5,.400,.400,0,0,,0,0,0,0,0,0,0,3,4
4932,NYK,1993,Patrick Ewing,30,81,81,3003,779,1550,.503,1,7,.143,778,1543,.504,.503,400,556,.719,191,789,980,151,74,161,265,286,1959
4933,NYK,1993,Anthony Mason,26,81,0,2482,316,629,.502,0,0,,316,629,.502,.502,199,292,.682,231,409,640,170,43,19,137,240,831
4934,NYK,1993,John Starks,27,80,51,2477,513,1199,.428,108,336,.321,405,863,.469,.473,263,331,.795,54,150,204,404,91,12,173,234,1397
4935,NYK,1993,Charles Oakley,29,82,82,2230,219,431,.508,0,1,.000,219,430,.509,.508,127,176,.722,288,420,708,126,85,15,124,289,565
4936,NYK,1993,Charles Smith,27,81,68,2172,358,764,.469,0,2,.000,358,762,.470,.469,287,367,.782,170,262,432,142,48,96,155,254,1003
4937,NYK,1993,Doc Rivers,31,77,45,1886,216,494,.437,39,123,.317,177,371,.477,.477,133,162,.821,26,166,192,405,123,9,114,215,604
4938,NYK,1993,Greg Anthony,25,70,35,1699,174,419,.415,4,30,.133,170,389,.437,.420,107,159,.673,42,128,170,398,113,12,104,141,459
4939,NYK,1993,Rolando Blackman,33,60,33,1434,239,539,.443,31,73,.425,208,466,.446,.472,71,90,.789,23,79,102,157,22,10,65,129,580
4940,NYK,1993,Tony Campbell,30,58,13,1062,194,396,.490,2,5,.400,192,391,.491,.492,59,87,.678,59,96,155,62,34,5,51,150,449
4941,NYK,1993,Hubert Davis,22,50,2,815,110,251,.438,6,19,.316,104,232,.448,.450,43,54,.796,13,43,56,83,22,4,45,71,269
4942,NYK,1993,Herb Williams,34,55,0,571,72,175,.411,0,0,,72,175,.411,.411,14,21,.667,44,102,146,19,21,28,22,78,158
4943,NYK,1993,Bo Kimble,26,9,0,55,14,33,.424,2,8,.250,12,25,.480,.455,3,8,.375,3,8,11,5,1,0,6,10,33
4944,NYK,1993,Eric Anderson,22,16,0,44,5,18,.278,0,0,,5,18,.278,.278,11,13,.846,6,8,14,3,3,1,5,14,21
4945,NYK,1992,Patrick Ewing,29,82,82,3150,796,1525,.522,1,6,.167,795,1519,.523,.522,377,511,.738,228,693,921,156,88,245,209,277,1970
4946,NYK,1992,Mark Jackson,26,81,81,2461,367,747,.491,11,43,.256,356,704,.506,.499,171,222,.770,95,210,305,694,112,13,211,153,916
4947,NYK,1992,Xavier McDaniel,28,82,82,2344,488,1021,.478,12,39,.308,476,982,.485,.484,137,192,.714,176,284,460,149,57,24,147,241,1125
4948,NYK,1992,Gerald Wilkins,28,82,82,2344,431,964,.447,38,108,.352,393,856,.459,.467,116,159,.730,74,132,206,219,76,17,113,195,1016
4949,NYK,1992,Charles Oakley,28,82,82,2309,210,402,.522,0,3,.000,210,399,.526,.522,86,117,.735,256,444,700,133,67,15,123,258,506
4950,NYK,1992,Anthony Mason,25,82,0,2198,203,399,.509,0,0,,203,399,.509,.509,167,260,.642,216,357,573,106,46,20,101,229,573
4951,NYK,1992,John Starks,26,82,0,2118,405,902,.449,94,270,.348,311,632,.492,.501,235,302,.778,45,146,191,276,103,18,150,231,1139
4952,NYK,1992,Greg Anthony,24,82,1,1510,161,435,.370,8,55,.145,153,380,.403,.379,117,158,.741,33,103,136,314,59,9,98,170,447
4953,NYK,1992,Kiki Vandeweghe,33,67,0,956,188,383,.491,26,66,.394,162,317,.511,.525,65,81,.802,31,57,88,57,15,8,27,87,467
4954,NYK,1992,Brian Quinnett,25,24,0,190,28,73,.384,10,26,.385,18,47,.383,.452,8,14,.571,9,15,24,7,7,6,8,21,74
4955,NYK,1992,Tim McCormick,29,22,0,108,14,33,.424,0,0,,14,33,.424,.424,14,21,.667,14,20,34,9,2,0,8,18,42
4956,NYK,1992,James Donaldson,34,14,0,81,5,18,.278,0,0,,5,18,.278,.278,2,2,1.000,2,17,19,2,0,5,7,17,12
4957,NYK,1992,Kennard Winchester,25,15,0,64,12,27,.444,1,2,.500,11,25,.440,.463,8,10,.800,6,9,15,8,2,2,2,4,33
4958,NYK,1992,Patrick Eddie,24,4,0,13,2,9,.222,0,0,,2,9,.222,.222,0,0,,0,1,1,0,0,0,0,3,4
4959,NYK,1992,Carlton McKinney,27,2,0,9,2,9,.222,0,0,,2,9,.222,.222,0,0,,0,1,1,0,0,0,0,1,4
4960,NYK,1991,Patrick Ewing,28,81,81,3104,845,1645,.514,0,6,.000,845,1639,.516,.514,464,623,.745,194,711,905,244,80,258,291,287,2154
4961,NYK,1991,Charles Oakley,27,76,74,2739,307,595,.516,0,2,.000,307,593,.518,.516,239,305,.784,305,615,920,204,62,17,215,288,853
4962,NYK,1991,Kiki Vandeweghe,32,75,72,2420,458,927,.494,51,141,.362,407,786,.518,.522,259,288,.899,78,102,180,110,42,10,108,122,1226
4963,NYK,1991,Gerald Wilkins,27,68,56,2164,380,804,.473,9,43,.209,371,761,.488,.478,169,206,.820,78,129,207,275,82,23,161,181,938
4964,NYK,1991,Maurice Cheeks,34,76,64,2147,241,483,.499,5,20,.250,236,463,.510,.504,105,129,.814,22,151,173,435,128,10,108,138,592
4965,NYK,1991,Mark Jackson,25,72,21,1595,250,508,.492,13,51,.255,237,457,.519,.505,117,160,.731,62,135,197,452,60,9,135,81,630
4966,NYK,1991,Trent Tucker,31,65,13,1194,191,434,.440,64,153,.418,127,281,.452,.514,17,27,.630,33,72,105,111,44,9,46,120,463
4967,NYK,1991,John Starks,25,61,10,1173,180,410,.439,27,93,.290,153,317,.483,.472,79,105,.752,30,101,131,204,59,17,74,137,466
4968,NYK,1991,Brian Quinnett,24,68,5,1011,139,303,.459,15,43,.349,124,260,.477,.483,26,36,.722,65,80,145,53,22,13,52,100,319
4969,NYK,1991,Jerrod Mustaf,21,62,5,825,106,228,.465,0,1,.000,106,227,.467,.465,56,87,.644,51,118,169,36,15,14,61,109,268
4970,NYK,1991,Kenny Walker,26,54,8,771,83,191,.435,0,1,.000,83,190,.437,.435,64,82,.780,63,94,157,13,18,30,30,92,230
4971,NYK,1991,Eddie Lee Wilkins,28,68,1,668,114,255,.447,0,1,.000,114,254,.449,.447,51,90,.567,69,111,180,15,17,7,50,91,279
4972,NYK,1991,Greg Grant,24,22,0,107,10,27,.370,1,3,.333,9,24,.375,.389,5,6,.833,1,9,10,20,9,0,10,12,26
4973,NYK,1991,Stuart Gray,27,8,0,37,4,12,.333,0,0,,4,12,.333,.333,3,3,1.000,2,8,10,0,0,1,2,6,11
4974,NYK,1990,Patrick Ewing,27,82,82,3165,922,1673,.551,1,4,.250,921,1669,.552,.551,502,648,.775,235,658,893,182,78,327,278,325,2347
4975,NYK,1990,Gerald Wilkins,26,82,80,2609,472,1032,.457,39,125,.312,433,907,.477,.476,208,259,.803,133,238,371,330,95,21,194,188,1191
4976,NYK,1990,Mark Jackson,24,82,69,2428,327,749,.437,35,131,.267,292,618,.472,.460,120,165,.727,106,212,318,604,109,4,211,121,809
4977,NYK,1990,Johnny Newman,26,80,69,2277,374,786,.476,45,142,.317,329,644,.511,.504,239,299,.799,60,131,191,180,95,22,143,254,1032
4978,NYK,1990,Charles Oakley,26,61,61,2196,336,641,.524,0,3,.000,336,638,.527,.524,217,285,.761,258,469,727,146,64,16,165,220,889
4979,NYK,1990,Trent Tucker,30,81,2,1725,253,606,.417,95,245,.388,158,361,.438,.496,66,86,.767,57,117,174,173,74,8,73,159,667
4980,NYK,1990,Kenny Walker,25,68,21,1595,204,384,.531,2,5,.400,202,379,.533,.534,125,173,.723,131,212,343,49,33,52,60,178,535
4981,NYK,1990,Rod Strickland,23,51,0,1019,170,386,.440,6,21,.286,164,365,.449,.448,83,130,.638,43,83,126,219,70,8,85,71,429
4982,NYK,1990,Eddie Lee Wilkins,27,79,0,972,141,310,.455,0,2,.000,141,308,.458,.455,89,147,.605,114,151,265,16,18,18,73,152,371
4983,NYK,1990,Maurice Cheeks,33,31,13,753,92,159,.579,3,7,.429,89,152,.586,.588,57,65,.877,11,62,73,151,42,5,36,32,244
4984,NYK,1990,Kiki Vandeweghe,31,22,13,563,102,231,.442,10,19,.526,92,212,.434,.463,44,48,.917,15,38,53,41,15,3,26,28,258
4985,NYK,1990,Pete Myers,26,24,0,208,15,45,.333,0,1,.000,15,44,.341,.333,16,31,.516,10,18,28,35,15,2,18,39,46
4986,NYK,1990,Brian Quinnett,23,31,0,193,19,58,.328,0,2,.000,19,56,.339,.328,2,3,.667,9,19,28,11,3,4,4,27,40
4987,NYK,1990,Stuart Gray,26,19,0,94,4,17,.235,0,3,.000,4,14,.286,.235,7,8,.875,2,12,14,2,3,2,5,26,15
4988,NYK,1990,Greg Butler,23,13,0,33,3,12,.250,0,0,,3,12,.250,.250,0,2,.000,3,6,9,1,0,0,3,8,6
4989,NYK,1989,Patrick Ewing,26,80,80,2896,727,1282,.567,0,6,.000,727,1276,.570,.567,361,484,.746,213,527,740,188,117,281,266,311,1815
4990,NYK,1989,Charles Oakley,25,82,82,2604,426,835,.510,12,48,.250,414,787,.526,.517,197,255,.773,343,518,861,187,104,14,248,270,1061
4991,NYK,1989,Mark Jackson,23,72,72,2477,479,1025,.467,81,240,.338,398,785,.507,.507,180,258,.698,106,235,341,619,139,7,226,163,1219
4992,NYK,1989,Gerald Wilkins,25,81,58,2414,462,1025,.451,51,172,.297,411,853,.482,.476,186,246,.756,95,149,244,274,115,22,169,166,1161
4993,NYK,1989,Johnny Newman,25,81,80,2336,455,957,.475,97,287,.338,358,670,.534,.526,286,351,.815,93,113,206,162,111,23,153,259,1293
4994,NYK,1989,Trent Tucker,29,81,24,1824,263,579,.454,118,296,.399,145,283,.512,.556,43,55,.782,55,121,176,132,88,6,59,163,687
4995,NYK,1989,Rod Strickland,22,81,10,1358,265,567,.467,19,59,.322,246,508,.484,.484,172,231,.745,51,109,160,319,98,3,148,142,721
4996,NYK,1989,Sidney Green,28,82,0,1277,194,422,.460,0,3,.000,194,419,.463,.460,129,170,.759,157,237,394,76,47,18,125,172,517
4997,NYK,1989,Kenny Walker,24,79,2,1163,174,356,.489,5,20,.250,169,336,.503,.496,66,85,.776,101,129,230,36,41,45,44,190,419
4998,NYK,1989,Eddie Lee Wilkins,26,71,2,584,114,245,.465,0,1,.000,114,244,.467,.465,61,111,.550,72,76,148,7,10,16,56,110,289
4999,NYK,1989,Kiki Vandeweghe,30,27,0,502,97,209,.464,3,10,.300,94,199,.472,.471,51,56,.911,15,21,36,35,12,7,23,38,248
5000,NYK,1989,Pete Myers,25,29,0,230,25,61,.410,0,2,.000,25,59,.424,.410,31,44,.705,12,11,23,46,17,2,19,41,81
5001,NYK,1989,Greg Butler,22,33,0,140,20,48,.417,0,3,.000,20,45,.444,.417,16,20,.800,9,19,28,2,1,2,17,28,56
5002,NYK,1988,Mark Jackson,22,82,80,3249,438,1013,.432,32,126,.254,406,887,.458,.448,206,266,.774,120,276,396,868,205,6,258,244,1114
5003,NYK,1988,Gerald Wilkins,24,81,78,2703,591,1324,.446,39,129,.302,552,1195,.462,.461,191,243,.786,106,164,270,326,90,22,212,183,1412
5004,NYK,1988,Patrick Ewing,25,82,82,2546,656,1183,.555,0,3,.000,656,1180,.556,.555,341,476,.716,245,431,676,125,104,245,287,332,1653
5005,NYK,1988,Kenny Walker,23,82,61,2139,344,728,.473,0,1,.000,344,727,.473,.473,138,178,.775,192,197,389,86,63,59,83,290,826
5006,NYK,1988,Sidney Green,27,82,65,2049,258,585,.441,0,2,.000,258,583,.443,.441,126,190,.663,221,421,642,93,65,32,148,318,642
5007,NYK,1988,Bill Cartwright,30,82,4,1676,287,528,.544,0,0,,287,528,.544,.544,340,426,.798,127,257,384,85,43,43,135,234,914
5008,NYK,1988,Johnny Newman,24,77,25,1589,270,620,.435,26,93,.280,244,527,.463,.456,207,246,.841,87,72,159,62,72,11,103,204,773
5009,NYK,1988,Trent Tucker,28,71,4,1248,193,455,.424,69,167,.413,124,288,.431,.500,51,71,.718,32,87,119,117,53,6,47,158,506
5010,NYK,1988,Pat Cummings,31,62,9,946,140,307,.456,0,1,.000,140,306,.458,.456,59,80,.738,82,153,235,37,20,10,65,143,339
5011,NYK,1988,Billy Donovan,22,44,0,364,44,109,.404,0,7,.000,44,102,.431,.404,17,21,.810,5,20,25,87,16,1,42,33,105
5012,NYK,1988,Chris McNealy,26,19,0,265,23,74,.311,0,0,,23,74,.311,.311,21,31,.677,24,40,64,23,16,2,17,50,67
5013,NYK,1988,Rick Carlisle,28,26,0,204,29,67,.433,6,17,.353,23,50,.460,.478,10,11,.909,6,7,13,32,11,4,22,39,74
5014,NYK,1988,Louis Orr,29,29,0,180,16,50,.320,0,1,.000,16,49,.327,.320,8,16,.500,13,21,34,9,6,0,14,27,40
5015,NYK,1988,Ray Tolbert,29,11,0,177,19,41,.463,0,0,,19,41,.463,.463,9,17,.529,14,21,35,5,5,2,10,25,47
5016,NYK,1988,Sedric Toney,25,21,0,139,21,48,.438,5,14,.357,16,34,.471,.490,10,11,.909,3,5,8,24,9,1,12,20,57
5017,NYK,1988,Tony White,22,12,0,117,17,46,.370,0,1,.000,17,45,.378,.370,9,13,.692,1,2,3,10,1,0,13,14,43
5018,NYK,1988,Bob Thornton,25,7,0,85,6,19,.316,0,0,,6,19,.316,.316,5,8,.625,5,8,13,4,2,0,8,23,17
5019,NYK,1988,Gerald Henderson,32,6,2,69,5,14,.357,2,4,.500,3,10,.300,.429,2,2,1.000,1,9,10,13,2,0,8,14,14
5020,NYK,1988,Rory Sparrow,29,3,0,52,5,19,.263,0,1,.000,5,18,.278,.263,0,0,,1,1,2,5,4,0,6,7,10
5021,NYK,1988,Carey Scurry,25,4,0,8,1,2,.500,0,0,,1,2,.500,.500,0,0,,1,2,3,1,2,1,2,3,2
5022,NYK,1987,Gerald Wilkins,23,80,73,2758,633,1302,.486,26,74,.351,607,1228,.494,.496,235,335,.701,120,174,294,354,88,18,214,165,1527
5023,NYK,1987,Patrick Ewing,24,63,63,2206,530,1053,.503,0,7,.000,530,1046,.507,.503,296,415,.713,157,398,555,104,89,147,229,248,1356
5024,NYK,1987,Bill Cartwright,29,58,50,1989,335,631,.531,0,0,,335,631,.531,.531,346,438,.790,132,313,445,96,40,26,128,188,1016
5025,NYK,1987,Rory Sparrow,28,80,30,1951,263,590,.446,11,42,.262,252,548,.460,.455,71,89,.798,29,86,115,432,67,6,140,160,608
5026,NYK,1987,Gerald Henderson,31,68,53,1890,273,624,.438,19,74,.257,254,550,.462,.453,173,212,.816,44,122,166,439,95,11,157,191,738
5027,NYK,1987,Kenny Walker,22,68,64,1719,285,581,.491,0,4,.000,285,577,.494,.491,140,185,.757,118,220,338,75,49,49,75,236,710
5028,NYK,1987,Trent Tucker,27,70,15,1691,325,691,.470,68,161,.422,257,530,.485,.520,77,101,.762,49,86,135,166,116,13,78,169,795
5029,NYK,1987,Louis Orr,28,65,8,1440,166,389,.427,1,5,.200,165,384,.430,.428,125,172,.727,102,130,232,110,47,18,70,123,458
5030,NYK,1987,Pat Cummings,30,49,11,1056,172,382,.450,0,0,,172,382,.450,.450,79,110,.718,123,189,312,38,26,7,85,145,423
5031,NYK,1987,Chris McNealy,25,59,16,972,88,179,.492,0,0,,88,179,.492,.492,52,80,.650,74,153,227,46,36,16,64,136,228
5032,NYK,1987,Jawann Oldham,29,44,9,776,71,174,.408,0,1,.000,71,173,.410,.408,31,57,.544,51,128,179,19,22,71,48,95,173
5033,NYK,1987,Eddie Lee Wilkins,24,24,10,454,56,127,.441,0,1,.000,56,126,.444,.441,27,58,.466,45,62,107,6,9,2,28,67,139
5034,NYK,1987,Bob Thornton,24,33,4,282,29,67,.433,0,1,.000,29,66,.439,.433,13,20,.650,18,38,56,8,4,3,24,48,71
5035,NYK,1987,Bernard King,30,6,4,214,52,105,.495,0,0,,52,105,.495,.495,32,43,.744,13,19,32,19,2,0,15,14,136
5036,NYK,1987,Stewart Granger,25,15,0,166,20,54,.370,0,3,.000,20,51,.392,.370,9,11,.818,6,11,17,27,7,1,22,17,49
5037,NYK,1987,Brad Wright,24,14,0,138,20,46,.435,0,1,.000,20,45,.444,.435,12,28,.429,25,28,53,1,3,6,13,20,52
5038,NYK,1987,Bill Martin,24,8,0,68,9,25,.360,0,0,,9,25,.360,.360,7,8,.875,2,5,7,0,4,2,7,5,25
5039,NYK,1987,McKinley Singleton,25,2,0,10,2,3,.667,0,1,.000,2,2,1.000,.667,0,0,,0,0,0,1,0,0,0,1,4
5040,NYK,1986,Rory Sparrow,27,74,74,2344,345,723,.477,5,20,.250,340,703,.484,.481,101,127,.795,50,120,170,472,85,14,154,182,796
5041,NYK,1986,Louis Orr,27,74,64,2237,330,741,.445,0,4,.000,330,737,.448,.445,218,278,.784,123,189,312,179,61,26,118,177,878
5042,NYK,1986,Gerald Wilkins,22,81,53,2025,437,934,.468,7,25,.280,430,909,.473,.472,132,237,.557,92,116,208,161,68,9,157,155,1013
5043,NYK,1986,Darrell Walker,24,81,35,2023,324,753,.430,0,10,.000,324,743,.436,.430,190,277,.686,100,120,220,337,146,36,192,216,838
5044,NYK,1986,Trent Tucker,26,77,23,1788,349,740,.472,41,91,.451,308,649,.475,.499,79,100,.790,70,99,169,192,65,8,70,167,818
5045,NYK,1986,Patrick Ewing,23,50,50,1771,386,814,.474,0,5,.000,386,809,.477,.474,226,306,.739,124,327,451,102,54,103,172,191,998
5046,NYK,1986,Ken Bannister,25,70,15,1405,235,479,.491,0,1,.000,235,478,.492,.491,131,249,.526,89,233,322,42,42,24,129,208,601
5047,NYK,1986,Ernie Grunfeld,30,76,0,1402,148,355,.417,26,61,.426,122,294,.415,.454,90,108,.833,42,164,206,119,39,13,50,192,412
5048,NYK,1986,Bob Thornton,23,71,23,1323,125,274,.456,0,0,,125,274,.456,.456,86,162,.531,113,177,290,43,30,7,83,209,336
5049,NYK,1986,James Bailey,28,48,36,1245,202,443,.456,0,4,.000,202,439,.460,.456,129,167,.772,102,232,334,50,33,40,99,207,533
5050,NYK,1986,Pat Cummings,29,31,30,1007,195,408,.478,0,2,.000,195,406,.480,.478,97,139,.698,92,188,280,47,27,12,87,136,487
5051,NYK,1986,Chris McNealy,24,30,6,627,70,144,.486,0,0,,70,144,.486,.486,31,47,.660,62,141,203,41,38,12,35,88,171
5052,NYK,1986,Fred Cofield,24,45,1,469,75,184,.408,3,15,.200,72,169,.426,.416,12,20,.600,6,40,46,82,20,3,49,65,165
5053,NYK,1986,Ken Green,26,7,0,72,13,27,.481,0,0,,13,27,.481,.481,5,9,.556,12,15,27,2,4,0,1,8,31
5054,NYK,1986,Bill Cartwright,28,2,0,36,3,7,.429,0,0,,3,7,.429,.429,6,10,.600,2,8,10,5,1,1,6,6,12
5055,NYK,1986,Butch Carter,27,5,0,31,2,8,.250,0,1,.000,2,7,.286,.250,1,1,1.000,2,1,3,3,1,0,6,6,5
5056,NYK,1985,Darrell Walker,23,82,66,2489,430,989,.435,0,17,.000,430,972,.442,.435,243,347,.700,128,150,278,408,167,21,204,244,1103
5057,NYK,1985,Louis Orr,26,79,31,2452,372,766,.486,1,10,.100,371,756,.491,.486,262,334,.784,171,220,391,134,100,27,138,195,1007
5058,NYK,1985,Rory Sparrow,26,79,41,2292,326,662,.492,7,31,.226,319,631,.506,.498,122,141,.865,38,131,169,557,81,9,150,200,781
5059,NYK,1985,Pat Cummings,28,63,63,2069,410,797,.514,0,4,.000,410,793,.517,.514,177,227,.780,139,379,518,109,50,17,166,247,997
5060,NYK,1985,Bernard King,28,55,55,2063,691,1303,.530,1,10,.100,690,1293,.534,.531,426,552,.772,114,203,317,204,71,15,204,191,1809
5061,NYK,1985,Trent Tucker,25,77,46,1819,293,606,.483,29,72,.403,264,534,.494,.507,38,48,.792,74,114,188,199,75,15,64,195,653
5062,NYK,1985,Ken Bannister,24,75,50,1404,209,445,.470,0,0,,209,445,.470,.470,91,192,.474,108,222,330,39,38,40,141,279,509
5063,NYK,1985,James Bailey,27,74,28,1297,156,349,.447,0,1,.000,156,348,.448,.447,73,108,.676,122,222,344,39,30,50,100,286,385
5064,NYK,1985,Butch Carter,26,69,11,1279,214,476,.450,11,43,.256,203,433,.469,.461,109,134,.813,36,59,95,167,57,5,109,151,548
5065,NYK,1985,Ernie Grunfeld,29,69,0,1061,188,384,.490,2,8,.250,186,376,.495,.492,77,104,.740,41,110,151,105,50,7,40,129,455
5066,NYK,1985,Eddie Lee Wilkins,22,54,16,917,116,233,.498,0,2,.000,116,231,.502,.498,66,122,.541,86,176,262,16,21,16,64,155,298
5067,NYK,1985,Ron Cavenall,25,53,2,653,28,86,.326,0,0,,28,86,.326,.326,22,39,.564,53,113,166,19,12,42,45,123,78
5068,NYK,1985,Truck Robinson,33,2,1,35,2,5,.400,0,0,,2,5,.400,.400,0,2,.000,6,3,9,3,2,3,5,3,4
5069,NYK,1984,Bernard King,27,77,76,2667,795,1391,.572,0,4,.000,795,1387,.573,.572,437,561,.779,123,271,394,164,75,17,197,273,2027
5070,NYK,1984,Bill Cartwright,26,77,77,2487,453,808,.561,0,1,.000,453,807,.561,.561,404,502,.805,195,454,649,107,44,97,200,262,1310
5071,NYK,1984,Rory Sparrow,25,79,74,2436,350,738,.474,10,39,.256,340,699,.486,.481,108,131,.824,48,141,189,539,100,8,210,230,818
5072,NYK,1984,Ray Williams,29,76,63,2230,418,939,.445,25,81,.309,393,858,.458,.458,263,318,.827,67,200,267,449,162,26,219,274,1124
5073,NYK,1984,Truck Robinson,32,65,63,2135,284,581,.489,0,0,,284,581,.489,.489,133,206,.646,171,374,545,94,43,27,160,217,701
5074,NYK,1984,Louis Orr,25,78,20,1640,262,572,.458,0,0,,262,572,.458,.458,173,211,.820,101,127,228,61,66,17,95,142,697
5075,NYK,1984,Darrell Walker,22,82,0,1324,216,518,.417,4,15,.267,212,503,.421,.421,208,263,.791,74,93,167,284,127,15,194,202,644
5076,NYK,1984,Marvin Webster,31,76,5,1290,112,239,.469,0,0,,112,239,.469,.469,66,117,.564,146,220,366,53,34,100,85,187,290
5077,NYK,1984,Trent Tucker,24,63,21,1228,225,450,.500,6,16,.375,219,434,.505,.507,25,33,.758,43,87,130,138,63,8,54,124,481
5078,NYK,1984,Ernie Grunfeld,28,76,6,1119,166,362,.459,2,9,.222,164,353,.465,.461,64,83,.771,24,97,121,108,43,7,71,151,398
5079,NYK,1984,Len Elmore,31,65,5,832,64,157,.408,0,0,,64,157,.408,.408,27,38,.711,62,103,165,30,29,30,46,153,155
5080,NYK,1984,Eric Fernsten,30,32,0,402,29,52,.558,0,0,,29,52,.558,.558,25,34,.735,29,57,86,11,16,8,19,49,83
5081,NYK,1984,Rudy Macklin,25,8,0,65,12,30,.400,0,0,,12,30,.400,.400,11,13,.846,5,6,11,3,1,0,6,17,35
5082,NYK,1983,Bill Cartwright,25,82,82,2468,455,804,.566,0,0,,455,804,.566,.566,380,511,.744,185,405,590,136,41,127,204,315,1290
5083,NYK,1983,Truck Robinson,31,81,76,2426,326,706,.462,0,0,,326,706,.462,.462,118,201,.587,199,458,657,145,57,24,190,241,770
5084,NYK,1983,Bernard King,26,68,68,2207,603,1142,.528,0,6,.000,603,1136,.531,.528,280,388,.722,99,227,326,195,90,13,197,233,1486
5085,NYK,1983,Paul Westphal,32,80,59,1978,318,693,.459,14,48,.292,304,645,.471,.469,148,184,.804,19,96,115,439,87,16,196,180,798
5086,NYK,1983,Trent Tucker,23,78,59,1830,299,647,.462,14,30,.467,285,617,.462,.473,43,64,.672,75,141,216,195,56,6,70,235,655
5087,NYK,1983,Louis Orr,24,82,14,1666,274,593,.462,0,2,.000,274,591,.464,.462,140,175,.800,94,134,228,94,64,24,93,134,688
5088,NYK,1983,Ed Sherod,23,64,37,1624,171,421,.406,1,13,.077,170,408,.417,.407,52,80,.650,43,106,149,311,96,14,104,112,395
5089,NYK,1983,Marvin Webster,30,82,0,1472,168,331,.508,0,1,.000,168,330,.509,.508,106,180,.589,176,267,443,49,35,131,102,210,442
5090,NYK,1983,Ernie Grunfeld,27,77,0,1422,167,377,.443,0,4,.000,167,373,.448,.443,81,98,.827,42,121,163,136,40,10,84,172,415
5091,NYK,1983,Sly Williams,25,68,6,1385,314,647,.485,2,19,.105,312,628,.497,.487,176,259,.680,94,196,290,133,73,3,133,166,806
5092,NYK,1983,Rory Sparrow,24,32,9,880,128,298,.430,2,7,.286,126,291,.433,.433,63,86,.733,22,67,89,159,37,4,71,93,321
5093,NYK,1983,Vince Taylor,22,31,0,321,37,102,.363,0,0,,37,102,.363,.363,21,32,.656,19,17,36,41,20,2,30,54,95
5094,NYK,1983,Scott Hastings,22,21,0,98,8,22,.364,0,1,.000,8,21,.381,.364,7,14,.500,10,21,31,1,5,0,6,31,23
5095,NYK,1983,Mike Davis,26,8,0,28,4,10,.400,0,0,,4,10,.400,.400,6,10,.600,3,7,10,0,0,4,0,4,14
5096,NYK,1982,Micheal Ray Richardson,26,82,79,3044,619,1343,.461,19,101,.188,600,1242,.483,.468,212,303,.700,177,388,565,572,213,41,291,317,1469
5097,NYK,1982,Maurice Lucas,29,80,74,2671,505,1001,.504,0,3,.000,505,998,.506,.504,253,349,.725,274,629,903,179,68,70,173,309,1263
5098,NYK,1982,Campy Russell,30,77,63,2358,410,858,.478,25,57,.439,385,801,.481,.492,228,294,.776,86,150,236,284,77,12,195,221,1073
5099,NYK,1982,Bill Cartwright,24,72,50,2060,390,694,.562,0,0,,390,694,.562,.562,257,337,.763,116,305,421,87,48,65,166,208,1037
5100,NYK,1982,Randy Smith,33,82,40,2033,348,748,.465,3,11,.273,345,737,.468,.467,122,151,.808,53,102,155,255,91,1,124,199,821
5101,NYK,1982,Marvin Webster,29,82,32,1883,199,405,.491,0,0,,199,405,.491,.491,108,170,.635,184,306,490,99,22,91,90,211,506
5102,NYK,1982,Sly Williams,24,60,27,1521,349,628,.556,2,9,.222,347,619,.561,.557,131,173,.757,100,127,227,142,77,16,114,153,831
5103,NYK,1982,Mike Newlin,33,76,32,1507,286,615,.465,7,23,.304,279,592,.471,.471,126,147,.857,36,55,91,170,33,3,104,194,705
5104,NYK,1982,Reggie Carter,24,75,1,923,119,280,.425,0,0,,119,280,.425,.425,64,80,.800,35,60,95,130,36,6,78,124,302
5105,NYK,1982,Toby Knight,26,40,0,550,102,183,.557,0,0,,102,183,.557,.557,17,25,.680,33,49,82,23,14,11,21,74,221
5106,NYK,1982,Paul Westphal,31,18,12,451,86,194,.443,2,8,.250,84,186,.452,.448,36,47,.766,9,13,22,100,19,8,47,61,210
5107,NYK,1982,Larry Demic,24,48,0,356,39,83,.470,0,1,.000,39,82,.476,.470,14,39,.359,29,50,79,14,4,6,26,65,92
5108,NYK,1982,Alex Bradley,22,39,0,331,54,103,.524,0,1,.000,54,102,.529,.524,29,48,.604,31,34,65,11,12,5,28,37,137
5109,NYK,1982,Hollis Copeland,26,18,0,118,16,38,.421,0,0,,16,38,.421,.421,5,6,.833,3,2,5,9,4,2,4,19,37
5110,NYK,1982,DeWayne Scales,23,3,0,24,1,5,.200,0,0,,1,5,.200,.200,1,2,.500,2,3,5,0,1,1,2,3,3
5111,NYK,1981,Micheal Ray Richardson,25,79,79,3175,523,1116,.469,23,102,.225,500,1014,.493,.479,224,338,.663,173,372,545,627,232,35,302,258,1293
5112,NYK,1981,Bill Cartwright,23,82,81,2925,619,1118,.554,0,1,.000,619,1117,.554,.554,408,518,.788,161,452,613,111,48,83,200,259,1646
5113,NYK,1981,Campy Russell,29,79,79,2865,508,1095,.464,8,26,.308,500,1069,.468,.468,268,343,.781,109,244,353,257,99,8,212,248,1292
5114,NYK,1981,Ray Williams,26,79,79,2742,616,1335,.461,16,68,.235,600,1267,.474,.467,312,382,.817,122,199,321,432,185,37,235,270,1560
5115,NYK,1981,Sly Williams,23,67,57,1976,349,708,.493,2,8,.250,347,700,.496,.494,185,268,.690,159,257,416,180,116,18,141,199,885
5116,NYK,1981,Marvin Webster,28,82,3,1708,159,341,.466,1,4,.250,158,337,.469,.468,104,163,.638,162,303,465,72,27,97,103,187,423
5117,NYK,1981,Mike Glenn,25,82,6,1506,285,511,.558,4,11,.364,281,500,.562,.562,98,110,.891,27,61,88,108,72,5,62,126,672
5118,NYK,1981,Larry Demic,23,76,17,964,128,254,.504,0,2,.000,128,252,.508,.504,58,92,.630,114,129,243,28,12,13,58,153,314
5119,NYK,1981,Mike Woodson,22,81,2,949,165,373,.442,1,5,.200,164,368,.446,.444,49,64,.766,33,64,97,75,36,12,54,95,380
5120,NYK,1981,Reggie Carter,23,60,0,536,59,179,.330,0,3,.000,59,176,.335,.330,51,69,.739,30,39,69,76,22,2,38,68,169
5121,NYK,1981,DeWayne Scales,22,44,7,484,94,225,.418,1,6,.167,93,219,.425,.420,26,39,.667,47,85,132,10,12,4,30,54,215
5122,NYK,1980,Bill Cartwright,22,82,82,3150,665,1215,.547,0,0,,665,1215,.547,.547,451,566,.797,194,532,726,165,48,101,222,279,1781
5123,NYK,1980,Micheal Ray Richardson,24,82,82,3060,502,1063,.472,27,110,.245,475,953,.498,.485,223,338,.660,151,388,539,832,265,35,359,260,1254
5124,NYK,1980,Toby Knight,24,81,81,2945,669,1265,.529,0,2,.000,669,1263,.530,.529,211,261,.808,201,292,493,150,117,86,163,302,1549
5125,NYK,1980,Ray Williams,25,82,82,2582,687,1384,.496,7,37,.189,680,1347,.505,.499,333,423,.787,149,263,412,512,167,24,256,295,1714
5126,NYK,1980,Larry Demic,22,82,51,1872,230,528,.436,0,0,,230,528,.436,.436,110,183,.601,195,288,483,64,56,30,168,306,570
5127,NYK,1980,Joe Meriweather,26,65,30,1565,252,477,.528,0,1,.000,252,476,.529,.528,78,121,.645,122,228,350,66,37,120,112,239,582
5128,NYK,1980,Hollis Copeland,24,75,1,1142,182,368,.495,0,2,.000,182,366,.497,.495,63,86,.733,70,86,156,80,61,25,84,154,427
5129,NYK,1980,Geoff Huston,22,71,0,923,94,241,.390,3,17,.176,91,224,.406,.396,28,38,.737,14,44,58,159,39,5,73,83,219
5130,NYK,1980,Mike Glenn,24,75,0,800,188,364,.516,2,10,.200,186,354,.525,.519,63,73,.863,21,45,66,85,35,7,38,79,441
5131,NYK,1980,Earl Monroe,35,51,0,633,161,352,.457,0,0,,161,352,.457,.457,56,64,.875,16,20,36,67,21,3,28,46,378
5132,NYK,1980,Sly Williams,22,57,0,556,104,267,.390,0,4,.000,104,263,.395,.390,58,90,.644,65,56,121,36,19,8,49,73,266
5133,NYK,1980,Marvin Webster,27,20,1,298,38,79,.481,0,0,,38,79,.481,.481,12,16,.750,28,52,80,9,3,11,20,39,88
5134,NYK,1980,Jim Cleamons,30,22,0,254,30,69,.435,3,8,.375,27,61,.443,.457,12,15,.800,10,9,19,40,13,2,17,13,75
5135,MIL,2024,Damian Lillard,33,73,73,2579,541,1277,.424,220,622,.354,321,655,.490,.510,473,514,.920,36,284,320,508,72,18,193,134,1775
5136,MIL,2024,Giannis Antetokounmpo,29,73,73,2567,837,1369,.611,34,124,.274,803,1245,.645,.624,514,782,.657,196,645,841,476,87,79,250,210,2222
5137,MIL,2024,Brook Lopez,35,79,79,2411,366,755,.485,148,404,.366,218,351,.621,.583,110,134,.821,117,292,409,127,43,189,79,191,990
5138,MIL,2024,Malik Beasley,27,79,77,2337,320,722,.443,224,542,.413,96,180,.533,.598,25,35,.714,41,249,290,108,59,9,54,158,889
5139,MIL,2024,Bobby Portis,28,82,4,2008,466,918,.508,100,246,.407,366,672,.545,.562,98,124,.790,142,465,607,104,68,34,91,189,1130
5140,MIL,2024,Pat Connaughton,31,76,3,1676,151,347,.435,82,238,.345,69,109,.633,.553,44,58,.759,51,188,239,161,40,19,49,99,428
5141,MIL,2024,Khris Middleton,32,55,55,1487,317,643,.493,94,247,.381,223,396,.563,.566,100,120,.833,40,217,257,292,51,15,127,141,828
5142,MIL,2024,Jae Crowder,33,50,25,1156,114,270,.422,58,166,.349,56,104,.538,.530,26,36,.722,31,130,161,66,38,9,23,74,312
5143,MIL,2024,Cameron Payne,29,47,2,702,101,222,.455,52,131,.397,49,91,.538,.572,37,44,.841,5,57,62,109,22,3,31,73,291
5144,MIL,2024,A.J. Green,24,56,0,614,83,196,.423,69,169,.408,14,27,.519,.599,17,19,.895,9,55,64,30,9,4,12,49,252
5145,MIL,2024,MarJon Beauchamp,23,48,1,608,81,166,.488,30,75,.400,51,91,.560,.578,19,28,.679,22,77,99,31,13,7,27,54,211
5146,MIL,2024,Andre Jackson Jr.,22,57,8,572,50,100,.500,17,46,.370,33,54,.611,.585,8,11,.727,43,70,113,50,16,6,28,92,125
5147,MIL,2024,Patrick Beverley,35,26,8,543,54,138,.391,26,72,.361,28,66,.424,.486,23,27,.852,19,75,94,68,19,13,16,45,157
5148,MIL,2024,Thanasis Antetokounmpo,31,34,0,155,16,30,.533,0,1,.000,16,29,.552,.533,0,2,.000,7,6,13,17,7,4,14,24,32
5149,MIL,2024,Danilo Gallinari,35,17,0,155,14,37,.378,3,17,.176,11,20,.550,.419,16,18,.889,6,12,18,12,6,1,10,15,47
5150,MIL,2024,Chris Livingston,20,21,0,90,11,22,.500,1,5,.200,10,17,.588,.523,3,4,.750,3,18,21,5,2,0,5,15,26
5151,MIL,2024,Robin Lopez,35,16,2,65,7,19,.368,2,8,.250,5,11,.455,.421,2,2,1.000,3,2,5,4,1,3,2,7,18
5152,MIL,2024,TyTy Washington Jr.,22,11,0,56,6,20,.300,2,6,.333,4,14,.286,.350,0,0,,1,4,5,5,3,0,2,1,14
5153,MIL,2024,Ryan Rollins,21,3,0,12,1,2,.500,1,1,1.000,0,1,.000,.750,0,0,,0,2,2,3,2,0,1,1,3
5154,MIL,2024,Lindell Wigginton,25,3,0,8,2,5,.400,0,2,.000,2,3,.667,.400,2,2,1.000,0,0,0,0,0,0,1,1,6
5155,MIL,2024,Marques Bolden,25,2,0,3,0,0,,0,0,,0,0,,,0,0,,0,2,2,0,0,0,0,1,0
5156,MIL,2023,Brook Lopez,34,78,78,2373,477,899,.531,136,364,.374,341,535,.637,.606,149,190,.784,157,363,520,99,37,193,107,203,1239
5157,MIL,2023,Jrue Holiday,32,67,65,2183,490,1023,.479,158,411,.384,332,612,.542,.556,152,177,.859,79,262,341,495,79,25,197,116,1290
5158,MIL,2023,Giannis Antetokounmpo,28,63,63,2024,707,1278,.553,47,171,.275,660,1107,.596,.572,498,772,.645,137,605,742,359,52,51,246,197,1959
5159,MIL,2023,Grayson Allen,27,72,70,1972,245,557,.440,146,366,.399,99,191,.518,.571,114,126,.905,61,176,237,163,62,14,72,117,750
5160,MIL,2023,Bobby Portis,27,70,22,1818,398,803,.496,95,257,.370,303,546,.555,.555,96,125,.768,154,518,672,105,29,16,81,115,987
5161,MIL,2023,Jevon Carter,27,81,39,1810,239,565,.423,142,337,.421,97,228,.425,.549,31,38,.816,35,167,202,197,66,29,78,158,651
5162,MIL,2023,Pat Connaughton,30,61,33,1443,165,421,.392,109,322,.339,56,99,.566,.521,27,41,.659,50,233,283,77,37,11,33,69,466
5163,MIL,2023,Joe Ingles,35,46,0,1044,108,248,.435,83,203,.409,25,45,.556,.603,18,21,.857,13,115,128,150,33,6,55,74,317
5164,MIL,2023,Wesley Matthews,36,52,0,820,58,160,.363,39,124,.315,19,36,.528,.484,24,28,.857,34,79,113,34,20,13,18,71,179
5165,MIL,2023,Khris Middleton,31,33,19,801,177,406,.436,51,162,.315,126,244,.516,.499,92,102,.902,28,112,140,163,23,5,71,68,497
5166,MIL,2023,MarJon Beauchamp,22,52,11,701,96,243,.395,47,142,.331,49,101,.485,.492,27,37,.730,38,77,115,35,21,7,45,71,266
5167,MIL,2023,George Hill,36,35,0,668,59,132,.447,23,74,.311,36,58,.621,.534,34,46,.739,13,54,67,89,19,3,27,41,175
5168,MIL,2023,Jordan Nwora,24,38,3,597,76,197,.386,40,102,.392,36,95,.379,.487,37,43,.860,29,88,117,38,12,7,34,34,229
5169,MIL,2023,A.J. Green,23,35,1,345,53,125,.424,44,105,.419,9,20,.450,.600,4,4,1.000,6,39,45,22,6,0,9,31,154
5170,MIL,2023,Jae Crowder,32,18,3,340,45,94,.479,24,55,.436,21,39,.538,.606,10,12,.833,17,52,69,27,12,6,7,27,124
5171,MIL,2023,Sandro Mamukelashvili,23,24,0,217,19,58,.328,7,32,.219,12,26,.462,.388,12,18,.667,18,38,56,16,4,5,9,19,57
5172,MIL,2023,Thanasis Antetokounmpo,30,37,0,206,20,46,.435,0,8,.000,20,38,.526,.435,11,22,.500,15,29,44,15,3,3,12,22,51
5173,MIL,2023,Serge Ibaka,33,16,0,185,26,54,.481,6,18,.333,20,36,.556,.537,8,13,.615,15,29,44,4,2,7,11,23,66
5174,MIL,2023,Meyers Leonard,30,9,2,114,14,29,.483,7,18,.389,7,11,.636,.603,8,9,.889,12,22,34,1,2,0,6,16,43
5175,MIL,2023,Lindell Wigginton,24,7,1,87,18,37,.486,6,18,.333,12,19,.632,.568,8,9,.889,0,7,7,14,0,2,12,7,50
5176,MIL,2023,Goran Dragić,36,7,0,83,14,36,.389,7,17,.412,7,19,.368,.486,4,4,1.000,3,9,12,12,2,0,7,2,39
5177,MIL,2022,Jrue Holiday,31,67,64,2208,478,954,.501,132,321,.411,346,633,.547,.570,137,180,.761,69,232,301,457,108,29,183,133,1225
5178,MIL,2022,Giannis Antetokounmpo,27,67,67,2204,689,1245,.553,71,242,.293,618,1003,.616,.582,553,766,.722,134,644,778,388,72,91,219,212,2002
5179,MIL,2022,Khris Middleton,30,66,66,2141,452,1021,.443,162,434,.373,290,587,.494,.522,259,291,.890,41,315,356,358,76,18,190,160,1325
5180,MIL,2022,Bobby Portis,26,72,59,2028,417,871,.479,133,338,.393,284,533,.533,.555,85,113,.752,180,477,657,86,53,51,90,174,1052
5181,MIL,2022,Grayson Allen,26,66,61,1805,255,569,.448,159,389,.409,96,180,.533,.588,64,74,.865,32,190,222,100,46,18,43,96,733
5182,MIL,2022,Pat Connaughton,29,65,19,1691,227,496,.458,146,370,.395,81,126,.643,.605,45,54,.833,45,228,273,82,59,15,35,86,645
5183,MIL,2022,George Hill,35,54,17,1253,118,275,.429,41,134,.306,77,141,.546,.504,57,62,.919,38,117,155,120,42,6,41,70,334
5184,MIL,2022,Jordan Nwora,23,62,13,1185,186,462,.403,79,227,.348,107,235,.455,.488,36,43,.837,37,184,221,59,25,17,57,78,487
5185,MIL,2022,Wesley Matthews,35,49,14,1002,87,220,.395,53,157,.338,34,63,.540,.516,22,28,.786,30,62,92,36,23,8,18,87,249
5186,MIL,2022,Rodney Hood,29,39,0,581,46,131,.351,24,80,.300,22,51,.431,.443,13,14,.929,13,54,67,30,12,4,7,27,129
5187,MIL,2022,Thanasis Antetokounmpo,29,48,6,473,70,128,.547,2,14,.143,68,114,.596,.555,29,46,.630,40,61,101,22,16,12,26,68,171
5188,MIL,2022,Sandro Mamukelashvili,22,41,3,407,57,115,.496,22,52,.423,35,63,.556,.591,18,22,.818,35,47,82,22,9,9,15,28,154
5189,MIL,2022,Jevon Carter,26,20,2,353,40,79,.506,24,43,.558,16,36,.444,.658,8,8,1.000,5,38,43,50,10,4,8,22,112
5190,MIL,2022,Donte DiVincenzo,25,17,0,341,39,118,.331,21,74,.284,18,44,.409,.419,23,27,.852,18,42,60,29,11,3,28,26,122
5191,MIL,2022,Serge Ibaka,32,19,2,339,54,104,.519,13,37,.351,41,67,.612,.582,12,15,.800,22,78,100,13,4,7,10,46,133
5192,MIL,2022,Semi Ojeleye,27,20,0,308,18,70,.257,11,41,.268,7,29,.241,.336,10,13,.769,25,33,58,5,5,5,5,26,57
5193,MIL,2022,Brook Lopez,33,13,11,298,61,131,.466,19,53,.358,42,78,.538,.538,20,23,.870,19,34,53,6,8,15,12,34,161
5194,MIL,2022,DeMarcus Cousins,31,17,5,287,55,118,.466,13,48,.271,42,70,.600,.521,31,38,.816,24,74,98,18,16,8,16,46,154
5195,MIL,2022,Lindell Wigginton,23,19,0,199,26,61,.426,9,26,.346,17,35,.486,.500,19,35,.543,3,22,25,23,5,1,12,17,80
5196,MIL,2022,Justin Robinson,24,17,0,198,18,57,.316,10,37,.270,8,20,.400,.404,2,2,1.000,2,11,13,21,8,0,11,17,48
5197,MIL,2022,Javonte Smart,22,13,1,160,11,43,.256,4,18,.222,7,25,.280,.302,5,6,.833,4,15,19,14,4,2,9,11,31
5198,MIL,2022,DeAndre' Bembry,27,8,0,77,3,8,.375,0,0,,3,8,.375,.375,0,0,,4,7,11,6,2,0,1,9,6
5199,MIL,2022,Greg Monroe,31,5,0,70,11,22,.500,0,0,,11,22,.500,.500,5,9,.556,11,10,21,2,3,2,3,7,27
5200,MIL,2022,Langston Galloway,30,3,0,49,1,13,.077,0,8,.000,1,5,.200,.077,0,0,,2,8,10,7,1,0,1,2,2
5201,MIL,2022,Georgios Kalaitzakis,23,9,0,48,5,11,.455,2,4,.500,3,7,.429,.545,4,9,.444,4,4,8,0,1,1,4,8,16
5202,MIL,2022,Rayjon Tucker,24,2,0,42,5,7,.714,3,3,1.000,2,4,.500,.929,2,3,.667,2,2,4,6,3,0,1,2,15
5203,MIL,2022,Luke Kornet,26,1,0,3,0,1,.000,0,0,,0,1,.000,.000,0,0,,1,0,1,0,0,0,0,1,0
5204,MIL,2022,Jeff Dowtin,24,1,0,3,0,1,.000,0,1,.000,0,0,,.000,0,0,,0,0,0,0,0,0,0,0,0
5205,MIL,2022,Javin DeLaurier,23,1,0,3,0,0,,0,0,,0,0,,,0,0,,0,1,1,0,1,0,0,1,0
5206,MIL,2021,Khris Middleton,29,68,68,2269,511,1074,.476,151,365,.414,360,709,.508,.546,212,236,.898,54,352,406,370,74,9,178,160,1385
5207,MIL,2021,Giannis Antetokounmpo,26,61,61,2013,626,1100,.569,67,221,.303,559,879,.636,.600,398,581,.685,97,574,671,357,72,73,207,168,1717
5208,MIL,2021,Jrue Holiday,30,59,56,1907,414,823,.503,111,283,.392,303,540,.561,.570,107,136,.787,73,195,268,357,96,37,127,98,1046
5209,MIL,2021,Brook Lopez,32,70,70,1902,322,640,.503,95,281,.338,227,359,.632,.577,120,142,.845,104,243,347,50,40,103,64,149,859
5210,MIL,2021,Donte DiVincenzo,24,66,66,1814,253,603,.420,131,346,.379,122,257,.475,.528,51,71,.718,81,299,380,203,72,15,91,112,688
5211,MIL,2021,Pat Connaughton,28,69,4,1575,168,387,.434,101,272,.371,67,115,.583,.565,31,40,.775,63,269,332,81,49,23,33,99,468
5212,MIL,2021,Bobby Portis,25,66,7,1372,313,598,.523,74,157,.471,239,441,.542,.585,54,73,.740,124,342,466,71,52,26,56,115,754
5213,MIL,2021,Bryn Forbes,27,70,10,1354,250,529,.473,154,341,.452,96,188,.511,.618,47,61,.770,11,101,112,45,24,1,44,77,701
5214,MIL,2021,D.J. Augustin,33,37,6,713,71,192,.370,49,129,.380,22,63,.349,.497,36,40,.900,11,39,50,110,20,1,34,33,227
5215,MIL,2021,Thanasis Antetokounmpo,28,57,3,551,67,137,.489,7,29,.241,60,108,.556,.515,25,49,.510,54,70,124,46,22,10,43,74,166
5216,MIL,2021,P.J. Tucker,35,20,1,397,18,46,.391,13,33,.394,5,13,.385,.533,3,5,.600,18,38,56,16,10,2,7,34,52
5217,MIL,2021,Jeff Teague,32,21,2,334,45,96,.469,10,26,.385,35,70,.500,.521,38,44,.864,5,26,31,59,8,5,25,13,138
5218,MIL,2021,Jordan Nwora,22,30,2,274,62,135,.459,28,62,.452,34,73,.466,.563,19,25,.760,9,51,60,7,16,7,24,22,171
5219,MIL,2021,Sam Merrill,24,30,2,233,32,72,.444,21,47,.447,11,25,.440,.590,4,4,1.000,6,24,30,21,8,1,10,17,89
5220,MIL,2021,Torrey Craig,30,18,0,201,18,46,.391,8,22,.364,10,24,.417,.478,1,2,.500,13,30,43,16,9,7,5,24,45
5221,MIL,2021,Mamadi Diakite,24,14,1,141,16,40,.400,1,8,.125,15,32,.469,.413,11,14,.786,8,26,34,8,7,6,3,16,44
5222,MIL,2021,D.J. Wilson,24,12,0,105,16,43,.372,10,28,.357,6,15,.400,.488,1,2,.500,3,22,25,3,1,4,4,13,43
5223,MIL,2021,Axel Toupane,28,8,1,61,4,11,.364,1,2,.500,3,9,.333,.409,5,7,.714,0,6,6,4,2,3,0,6,14
5224,MIL,2021,Rodions Kurucs,22,5,0,34,5,8,.625,3,4,.750,2,4,.500,.813,2,2,1.000,3,6,9,4,3,0,4,8,15
5225,MIL,2021,Justin Jackson,25,1,0,33,3,9,.333,2,6,.333,1,3,.333,.444,1,2,.500,2,4,6,1,0,0,1,1,9
5226,MIL,2021,Elijah Bryant,25,1,0,32,6,13,.462,1,5,.200,5,8,.625,.500,3,3,1.000,2,4,6,3,0,1,4,4,16
5227,MIL,2021,Jaylen Adams,24,7,0,18,1,8,.125,0,2,.000,1,6,.167,.125,0,0,,0,3,3,2,0,0,0,1,2
5228,MIL,2020,Giannis Antetokounmpo,25,63,63,1917,685,1238,.553,89,293,.304,596,945,.631,.589,398,629,.633,140,716,856,354,61,66,230,195,1857
5229,MIL,2020,Khris Middleton,28,62,59,1853,471,947,.497,147,354,.415,324,593,.546,.575,208,227,.916,44,338,382,265,53,7,137,142,1297
5230,MIL,2020,Brook Lopez,31,68,67,1817,292,671,.435,102,325,.314,190,346,.549,.511,127,152,.836,58,254,312,99,46,163,70,163,813
5231,MIL,2020,Eric Bledsoe,30,61,61,1646,334,703,.475,74,215,.344,260,488,.533,.528,169,214,.790,43,239,282,328,57,26,148,128,911
5232,MIL,2020,Wesley Matthews,33,67,67,1635,167,422,.396,108,297,.364,59,125,.472,.524,52,68,.765,22,144,166,92,38,9,43,103,494
5233,MIL,2020,Donte DiVincenzo,23,66,24,1520,232,510,.455,83,247,.336,149,263,.567,.536,63,86,.733,66,252,318,154,85,20,90,113,610
5234,MIL,2020,George Hill,33,59,2,1271,194,376,.516,81,176,.460,113,200,.565,.624,85,101,.842,50,127,177,180,47,5,57,84,554
5235,MIL,2020,Pat Connaughton,27,67,4,1243,137,301,.455,55,166,.331,82,135,.607,.547,31,40,.775,60,224,284,107,25,31,52,70,360
5236,MIL,2020,Ersan İlyasova,32,63,8,986,146,313,.466,50,137,.365,96,176,.545,.546,72,87,.828,62,240,302,49,24,17,34,95,414
5237,MIL,2020,Kyle Korver,38,58,1,960,126,293,.430,99,237,.418,27,56,.482,.599,35,41,.854,15,107,122,68,26,12,48,78,386
5238,MIL,2020,Robin Lopez,31,66,5,958,147,299,.492,35,105,.333,112,194,.577,.550,28,53,.528,56,105,161,45,10,45,63,96,357
5239,MIL,2020,Sterling Brown,24,52,1,767,95,256,.371,44,136,.324,51,120,.425,.457,32,40,.800,31,152,183,51,29,7,42,54,266
5240,MIL,2020,D.J. Wilson,23,37,1,363,52,132,.394,18,73,.247,34,59,.576,.462,11,18,.611,12,80,92,25,3,5,19,33,133
5241,MIL,2020,Marvin Williams,33,17,0,321,25,57,.439,12,39,.308,13,18,.722,.544,6,7,.857,15,59,74,19,10,8,8,32,68
5242,MIL,2020,Thanasis Antetokounmpo,27,20,2,129,24,48,.500,0,10,.000,24,38,.632,.500,7,17,.412,12,12,24,15,7,2,12,18,55
5243,MIL,2020,Frank Mason III,25,9,0,118,23,51,.451,6,21,.286,17,30,.567,.510,10,17,.588,5,14,19,29,5,1,11,11,62
5244,MIL,2020,Dragan Bender,22,7,0,91,10,21,.476,4,9,.444,6,12,.500,.571,2,3,.667,0,20,20,9,0,5,5,16,26
5245,MIL,2019,Khris Middleton,27,77,77,2393,506,1148,.441,179,474,.378,327,674,.485,.519,216,258,.837,50,411,461,331,80,7,174,172,1407
5246,MIL,2019,Giannis Antetokounmpo,24,72,72,2358,721,1247,.578,52,203,.256,669,1044,.641,.599,500,686,.729,159,739,898,424,92,110,268,232,1994
5247,MIL,2019,Brook Lopez,30,81,81,2322,355,786,.452,187,512,.365,168,274,.613,.571,112,133,.842,33,363,396,98,51,179,82,189,1009
5248,MIL,2019,Eric Bledsoe,29,78,78,2272,470,971,.484,124,377,.329,346,594,.582,.548,177,236,.750,82,280,362,430,116,29,165,156,1241
5249,MIL,2019,Malcolm Brogdon,26,64,64,1832,378,748,.505,104,244,.426,274,504,.544,.575,141,152,.928,65,223,288,205,46,13,91,102,1001
5250,MIL,2019,Tony Snell,27,74,12,1304,163,361,.452,81,204,.397,82,157,.522,.564,37,42,.881,29,128,157,68,26,18,23,90,444
5251,MIL,2019,Pat Connaughton,26,61,2,1261,163,350,.466,66,200,.330,97,150,.647,.560,29,40,.725,61,197,258,122,33,25,33,81,421
5252,MIL,2019,Ersan İlyasova,31,67,7,1231,167,381,.438,58,160,.363,109,221,.493,.514,61,74,.824,94,208,302,52,32,20,48,172,453
5253,MIL,2019,Sterling Brown,23,58,7,1034,145,312,.465,53,147,.361,92,165,.558,.550,29,42,.690,29,155,184,84,25,8,46,88,372
5254,MIL,2019,George Hill,32,47,0,958,115,269,.428,35,125,.280,80,144,.556,.493,53,65,.815,27,94,121,99,40,7,31,67,318
5255,MIL,2019,D.J. Wilson,22,48,3,882,104,251,.414,46,127,.362,58,124,.468,.506,26,47,.553,45,177,222,52,18,20,32,85,280
5256,MIL,2019,Donte DiVincenzo,22,27,0,411,50,124,.403,22,83,.265,28,41,.683,.492,9,12,.750,16,49,65,31,13,6,19,38,131
5257,MIL,2019,Thon Maker,21,35,0,409,59,134,.440,26,78,.333,33,56,.589,.537,20,37,.541,17,79,96,18,10,18,9,55,164
5258,MIL,2019,Nikola Mirotić,27,14,3,320,56,135,.415,31,87,.356,25,48,.521,.530,20,23,.870,14,61,75,20,10,9,11,21,163
5259,MIL,2019,Tim Frazier,28,12,2,211,28,66,.424,10,24,.417,18,42,.429,.500,9,13,.692,9,22,31,42,5,1,16,19,75
5260,MIL,2019,John Henson,28,14,0,188,31,67,.463,11,31,.355,20,36,.556,.545,6,10,.600,16,55,71,14,7,11,12,16,79
5261,MIL,2019,Bonzie Colson,23,8,2,98,13,39,.333,5,21,.238,8,18,.444,.397,8,9,.889,8,22,30,3,5,1,3,3,39
5262,MIL,2019,Matthew Dellavedova,28,12,0,97,6,19,.316,4,11,.364,2,8,.250,.421,4,4,1.000,0,10,10,29,2,0,11,9,20
5263,MIL,2019,Christian Wood,23,13,0,62,12,25,.480,3,5,.600,9,20,.450,.540,10,15,.667,4,16,20,2,0,0,3,3,37
5264,MIL,2019,Jason Smith,32,6,0,40,4,13,.308,3,9,.333,1,4,.250,.423,2,2,1.000,3,8,11,1,2,2,5,6,13
5265,MIL,2019,Isaiah Canaan,27,4,0,31,2,6,.333,2,5,.400,0,1,.000,.500,0,0,,1,3,4,3,0,1,2,2,6
5266,MIL,2019,Pau Gasol,38,3,0,30,1,6,.167,1,3,.333,0,3,.000,.250,1,2,.500,0,10,10,2,0,1,2,1,4
5267,MIL,2019,Jaylen Morris,23,4,0,29,4,10,.400,1,3,.333,3,7,.429,.450,1,2,.500,0,5,5,4,2,0,1,1,10
5268,MIL,2019,Trevon Duval,20,3,0,6,2,3,.667,1,1,1.000,1,2,.500,.833,0,0,,0,1,1,2,0,0,0,0,5
5269,MIL,2018,Khris Middleton,26,82,82,2982,593,1272,.466,146,407,.359,447,865,.517,.524,320,362,.884,45,384,429,328,119,21,191,270,1652
5270,MIL,2018,Giannis Antetokounmpo,23,75,75,2756,742,1402,.529,43,140,.307,699,1262,.554,.545,487,641,.760,156,597,753,361,109,106,223,231,2014
5271,MIL,2018,Eric Bledsoe,28,71,71,2239,452,949,.476,121,347,.349,331,602,.550,.540,241,303,.795,48,229,277,361,145,40,206,179,1266
5272,MIL,2018,Tony Snell,26,75,59,2053,185,425,.435,108,268,.403,77,157,.490,.562,38,48,.792,9,132,141,98,47,28,36,115,516
5273,MIL,2018,John Henson,27,76,69,1970,287,502,.572,1,7,.143,286,495,.578,.573,90,158,.570,150,363,513,114,45,109,84,202,665
5274,MIL,2018,Malcolm Brogdon,25,48,20,1436,244,503,.485,62,161,.385,182,342,.532,.547,75,85,.882,23,133,156,152,41,13,66,128,625
5275,MIL,2018,Thon Maker,20,74,12,1238,130,316,.411,31,104,.298,99,212,.467,.460,65,93,.699,75,150,225,46,38,53,44,162,356
5276,MIL,2018,Jason Terry,40,51,4,814,59,154,.383,40,115,.348,19,39,.487,.513,8,9,.889,5,43,48,59,42,13,25,52,166
5277,MIL,2018,Sterling Brown,22,54,4,776,82,205,.400,32,91,.352,50,114,.439,.478,21,24,.875,27,116,143,25,31,13,25,80,217
5278,MIL,2018,Jabari Parker,22,31,3,743,160,332,.482,31,81,.383,129,251,.514,.529,40,54,.741,42,109,151,59,25,10,45,50,391
5279,MIL,2018,Matthew Dellavedova,27,38,3,712,55,152,.362,29,78,.372,26,74,.351,.457,25,27,.926,14,50,64,145,14,0,49,67,164
5280,MIL,2018,DeAndre Liggins,29,31,1,480,22,65,.338,11,36,.306,11,29,.379,.423,2,5,.400,5,44,49,27,27,10,13,61,57
5281,MIL,2018,Tyler Zeller,28,24,1,406,62,105,.590,0,2,.000,62,103,.602,.590,17,19,.895,47,64,111,19,7,14,12,48,141
5282,MIL,2018,Sean Kilpatrick,28,23,0,205,31,82,.378,13,46,.283,18,36,.500,.457,18,19,.947,1,24,25,15,5,1,9,15,93
5283,MIL,2018,Brandon Jennings,28,14,0,205,27,72,.375,9,33,.273,18,39,.462,.438,10,10,1.000,5,26,31,44,6,4,18,11,73
5284,MIL,2018,Rashad Vaughn,21,22,0,173,21,50,.420,13,35,.371,8,15,.533,.550,4,6,.667,2,15,17,12,4,3,4,12,59
5285,MIL,2018,Mirza Teletović,32,10,0,159,25,57,.439,21,45,.467,4,12,.333,.623,0,0,,3,20,23,10,4,1,7,14,71
5286,MIL,2018,Shabazz Muhammad,25,11,0,117,37,67,.552,3,8,.375,34,59,.576,.575,17,19,.895,8,23,31,7,4,1,1,7,94
5287,MIL,2018,Gary Payton II,25,12,6,106,13,33,.394,2,12,.167,11,21,.524,.424,2,3,.667,4,13,17,9,3,1,3,17,30
5288,MIL,2018,Greg Monroe,27,5,0,79,16,33,.485,0,0,,16,33,.485,.485,2,4,.500,6,19,25,5,0,0,6,7,34
5289,MIL,2018,D.J. Wilson,21,22,0,71,9,16,.563,2,5,.400,7,11,.636,.625,1,2,.500,2,8,10,3,3,1,4,7,21
5290,MIL,2018,Marshall Plumlee,25,8,0,52,1,3,.333,0,0,,1,3,.333,.333,12,16,.750,4,13,17,2,0,1,3,10,14
5291,MIL,2018,Joel Bolomboy,24,6,0,38,3,6,.500,0,1,.000,3,5,.600,.500,3,6,.500,6,4,10,0,2,0,2,3,9
5292,MIL,2018,Xavier Munford,25,6,0,21,1,6,.167,0,2,.000,1,4,.250,.167,1,2,.500,1,0,1,4,1,0,2,4,3
5293,MIL,2017,Giannis Antetokounmpo,22,80,80,2845,656,1259,.521,49,180,.272,607,1079,.563,.541,471,612,.770,142,558,700,434,131,151,234,246,1832
5294,MIL,2017,Tony Snell,25,80,80,2336,246,541,.455,144,355,.406,102,186,.548,.588,47,58,.810,22,226,248,96,55,14,55,125,683
5295,MIL,2017,Matthew Dellavedova,26,76,54,1986,208,534,.390,79,215,.367,129,319,.404,.463,82,96,.854,24,123,147,357,53,0,133,153,577
5296,MIL,2017,Malcolm Brogdon,24,75,28,1982,290,635,.457,78,193,.404,212,442,.480,.518,109,126,.865,47,166,213,317,84,12,113,140,767
5297,MIL,2017,Greg Monroe,26,81,0,1823,387,726,.533,0,4,.000,387,722,.536,.533,177,239,.741,167,365,532,187,92,38,140,168,951
5298,MIL,2017,Jabari Parker,21,51,50,1728,399,814,.490,65,178,.365,334,636,.525,.530,162,218,.743,79,235,314,142,50,22,93,111,1025
5299,MIL,2017,Jason Terry,39,74,0,1365,105,243,.432,73,171,.427,32,72,.444,.582,24,29,.828,15,91,106,98,46,20,36,95,307
5300,MIL,2017,Mirza Teletović,31,70,2,1133,156,418,.373,104,305,.341,52,113,.460,.498,35,45,.778,11,151,162,48,12,13,37,109,451
5301,MIL,2017,John Henson,26,58,39,1123,159,309,.515,0,1,.000,159,308,.516,.515,74,107,.692,92,203,295,57,29,78,52,151,392
5302,MIL,2017,Michael Beasley,28,56,6,935,216,406,.532,18,43,.419,198,363,.545,.554,78,105,.743,40,153,193,53,27,27,66,92,528
5303,MIL,2017,Khris Middleton,25,29,23,889,150,333,.450,45,104,.433,105,229,.459,.518,81,92,.880,11,112,123,99,41,7,65,79,426
5304,MIL,2017,Thon Maker,19,57,34,562,83,181,.459,28,74,.378,55,107,.514,.536,32,49,.653,40,74,114,23,10,26,17,84,226
5305,MIL,2017,Rashad Vaughn,20,41,2,458,57,156,.365,26,81,.321,31,75,.413,.449,2,5,.400,4,45,49,23,19,10,14,32,142
5306,MIL,2017,Miles Plumlee,28,32,12,310,30,68,.441,0,0,,30,68,.441,.441,22,35,.629,23,30,53,18,11,9,22,48,82
5307,MIL,2017,Spencer Hawes,28,19,0,171,30,59,.508,9,26,.346,21,33,.636,.585,14,18,.778,6,39,45,19,2,4,9,16,83
5308,MIL,2017,Gary Payton II,24,6,0,99,8,22,.364,1,9,.111,7,13,.538,.386,3,5,.600,0,12,12,13,3,4,10,9,20
5309,MIL,2017,Steve Novak,33,8,0,22,2,7,.286,1,6,.167,1,1,1.000,.357,0,0,,0,3,3,0,0,0,0,1,5
5310,MIL,2017,Terrence Jones,25,3,0,6,0,3,.000,0,0,,0,3,.000,.000,0,0,,0,3,3,0,1,1,0,0,0
5311,MIL,2017,Axel Toupane,24,2,0,6,0,1,.000,0,1,.000,0,0,,.000,0,0,,0,0,0,0,0,0,0,1,0
5312,MIL,2016,Khris Middleton,24,79,79,2852,507,1142,.444,143,361,.396,364,781,.466,.507,277,312,.888,44,258,302,331,131,19,180,204,1434
5313,MIL,2016,Giannis Antetokounmpo,21,80,79,2823,513,1013,.506,28,109,.257,485,904,.537,.520,296,409,.724,113,499,612,345,94,113,208,258,1350
5314,MIL,2016,Jabari Parker,20,76,72,2408,443,899,.493,9,35,.257,434,864,.502,.498,175,228,.768,123,272,395,130,69,29,116,154,1070
5315,MIL,2016,Greg Monroe,25,79,67,2314,491,941,.522,0,1,.000,491,940,.522,.522,228,308,.740,218,478,696,178,72,67,129,163,1210
5316,MIL,2016,Michael Carter-Williams,24,54,37,1649,251,555,.452,15,55,.273,236,500,.472,.466,106,162,.654,48,228,276,281,80,41,153,162,623
5317,MIL,2016,Jerryd Bayless,27,52,18,1505,185,437,.423,101,231,.437,84,206,.408,.539,70,90,.778,21,120,141,163,47,11,73,111,541
5318,MIL,2016,O.J. Mayo,28,41,24,1090,119,321,.371,52,162,.321,67,159,.421,.452,31,40,.775,13,92,105,118,48,8,72,126,321
5319,MIL,2016,Rashad Vaughn,19,70,6,1001,81,266,.305,43,147,.293,38,119,.319,.385,12,15,.800,11,77,88,39,29,16,28,73,217
5320,MIL,2016,John Henson,25,57,1,960,164,291,.564,0,1,.000,164,290,.566,.564,69,117,.590,87,134,221,54,18,109,64,131,397
5321,MIL,2016,Miles Plumlee,27,61,14,870,140,233,.601,0,0,,140,233,.601,.601,34,59,.576,94,138,232,16,21,50,40,73,314
5322,MIL,2016,Johnny O'Bryant,22,66,4,857,86,209,.411,1,1,1.000,85,208,.409,.414,27,40,.675,65,111,176,32,18,8,31,100,200
5323,MIL,2016,Tyler Ennis,21,46,7,654,84,187,.449,13,39,.333,71,148,.480,.484,25,34,.735,13,62,75,95,25,1,46,64,206
5324,MIL,2016,Greivis Vásquez,29,23,0,460,45,138,.326,18,73,.247,27,65,.415,.391,22,26,.846,5,42,47,91,10,0,40,42,130
5325,MIL,2016,Damien Inglis,20,20,1,156,13,37,.351,3,13,.231,10,24,.417,.392,7,8,.875,2,29,31,10,6,3,11,11,36
5326,MIL,2016,Chris Copeland,31,24,1,156,17,51,.333,10,36,.278,7,15,.467,.431,6,7,.857,1,9,10,11,2,0,6,17,50
5327,MIL,2016,Jared Cunningham,24,4,0,55,4,14,.286,2,7,.286,2,7,.286,.357,6,7,.857,0,9,9,1,2,0,3,4,16
5328,MIL,2016,Steve Novak,32,3,0,20,2,6,.333,2,6,.333,0,0,,.500,1,1,1.000,0,1,1,0,0,0,0,2,7
5329,MIL,2015,Giannis Antetokounmpo,20,81,71,2541,383,780,.491,7,44,.159,376,736,.511,.496,257,347,.741,100,442,542,207,73,85,173,254,1030
5330,MIL,2015,Khris Middleton,23,79,58,2378,406,869,.467,109,268,.407,297,601,.494,.530,134,156,.859,48,299,347,182,122,11,113,183,1055
5331,MIL,2015,Zaza Pachulia,30,73,45,1730,240,529,.454,0,3,.000,240,526,.456,.454,126,160,.788,197,303,500,178,80,21,133,170,606
5332,MIL,2015,Jerryd Bayless,26,77,4,1717,220,516,.426,37,120,.308,183,396,.462,.462,121,137,.883,22,189,211,233,59,12,133,163,598
5333,MIL,2015,Jared Dudley,29,72,22,1717,198,423,.468,74,192,.385,124,231,.537,.556,48,67,.716,45,175,220,130,72,11,62,113,518
5334,MIL,2015,O.J. Mayo,27,71,15,1697,296,701,.422,99,277,.357,197,424,.465,.493,115,139,.827,30,157,187,197,57,18,128,165,806
5335,MIL,2015,Brandon Knight,23,52,52,1688,324,745,.435,104,254,.409,220,491,.448,.505,171,194,.881,26,195,221,281,84,9,166,93,923
5336,MIL,2015,Ersan İlyasova,27,58,36,1319,263,557,.472,74,190,.389,189,367,.515,.539,69,107,.645,80,197,277,56,36,19,45,149,669
5337,MIL,2015,John Henson,24,67,11,1228,196,346,.566,0,0,,196,346,.566,.566,78,137,.569,124,188,312,59,28,135,87,152,470
5338,MIL,2015,Michael Carter-Williams,23,25,25,758,132,308,.429,4,28,.143,128,280,.457,.435,85,109,.780,21,78,99,140,51,12,79,64,353
5339,MIL,2015,Jabari Parker,19,25,25,738,129,263,.490,4,16,.250,125,247,.506,.498,46,66,.697,50,88,138,42,31,5,47,42,308
5340,MIL,2015,Larry Sanders,26,27,26,586,86,172,.500,0,0,,86,172,.500,.500,24,48,.500,67,99,166,23,26,39,28,104,196
5341,MIL,2015,Kendall Marshall,23,28,3,417,46,101,.455,18,46,.391,28,55,.509,.545,8,9,.889,2,26,28,86,21,0,35,26,118
5342,MIL,2015,Johnny O'Bryant,21,34,15,368,44,120,.367,0,0,,44,120,.367,.367,12,27,.444,26,38,64,17,5,4,25,44,100
5343,MIL,2015,Tyler Ennis,20,25,1,353,43,123,.350,10,37,.270,33,86,.384,.390,3,5,.600,6,22,28,59,18,3,34,33,99
5344,MIL,2015,Miles Plumlee,26,19,0,189,29,59,.492,0,0,,29,59,.492,.492,3,8,.375,17,29,46,7,6,11,6,12,61
5345,MIL,2015,Nate Wolters,23,11,0,142,12,31,.387,0,5,.000,12,26,.462,.387,1,4,.250,2,14,16,10,5,0,3,11,25
5346,MIL,2015,Jorge Gutiérrez,26,10,1,131,15,27,.556,0,2,.000,15,25,.600,.556,7,10,.700,5,13,18,15,5,0,9,16,37
5347,MIL,2015,Chris Johnson,24,8,0,128,12,30,.400,5,18,.278,7,12,.583,.483,2,2,1.000,2,9,11,5,5,2,0,7,31
5348,MIL,2015,Kenyon Martin,37,11,0,104,9,22,.409,0,0,,9,22,.409,.409,2,2,1.000,6,13,19,5,5,6,3,13,20
5349,MIL,2014,Khris Middleton,22,82,64,2460,376,854,.440,120,290,.414,256,564,.454,.511,118,137,.861,60,250,310,169,83,20,123,243,990
5350,MIL,2014,Brandon Knight,22,72,69,2400,461,1092,.422,110,338,.325,351,754,.466,.473,259,323,.802,46,209,255,352,69,17,188,146,1291
5351,MIL,2014,Giannis Antetokounmpo,19,77,23,1897,173,418,.414,41,118,.347,132,300,.440,.463,138,202,.683,78,261,339,150,60,61,122,173,525
5352,MIL,2014,John Henson,23,70,23,1856,344,639,.538,0,1,.000,344,638,.539,.538,91,177,.514,171,326,497,113,41,116,114,185,779
5353,MIL,2014,Ersan İlyasova,26,55,47,1478,237,579,.409,37,131,.282,200,448,.446,.441,107,130,.823,107,235,342,72,46,8,61,135,618
5354,MIL,2014,O.J. Mayo,26,52,23,1346,224,550,.407,84,227,.370,140,323,.433,.484,76,88,.864,24,100,124,113,28,13,95,111,608
5355,MIL,2014,Zaza Pachulia,29,53,43,1325,149,349,.427,0,1,.000,149,348,.428,.427,110,130,.846,141,192,333,136,45,14,92,124,408
5356,MIL,2014,Nate Wolters,22,58,31,1309,170,389,.437,18,62,.290,152,327,.465,.460,59,90,.656,33,116,149,187,35,15,57,67,417
5357,MIL,2014,Ramon Sessions,27,28,12,909,140,304,.461,20,56,.357,120,248,.484,.493,143,170,.841,16,70,86,134,16,3,55,40,443
5358,MIL,2014,Caron Butler,33,34,13,821,137,354,.387,53,147,.361,84,207,.406,.462,47,56,.839,16,142,158,56,23,11,52,64,374
5359,MIL,2014,Ekpe Udoh,26,42,14,804,57,143,.399,0,0,,57,143,.399,.399,30,47,.638,61,87,148,31,15,44,38,96,144
5360,MIL,2014,Luke Ridnour,32,36,12,763,84,219,.384,25,68,.368,59,151,.391,.441,13,19,.684,15,47,62,122,23,2,46,55,206
5361,MIL,2014,Jeff Adrien,27,28,12,705,121,235,.515,0,0,,121,235,.515,.515,63,94,.670,69,149,218,31,17,21,31,73,305
5362,MIL,2014,Gary Neal,29,30,2,607,108,277,.390,40,111,.360,68,166,.410,.462,45,54,.833,8,42,50,46,7,0,39,26,301
5363,MIL,2014,Larry Sanders,25,23,20,584,76,162,.469,0,1,.000,76,161,.472,.469,26,55,.473,60,105,165,19,18,40,26,74,178
5364,MIL,2014,Miroslav Raduljica,26,48,2,465,68,126,.540,0,0,,68,126,.540,.540,45,55,.818,54,54,108,23,7,13,28,84,181
5365,MIL,2014,Chris Wright,25,8,0,126,21,35,.600,0,1,.000,21,34,.618,.600,6,15,.400,10,10,20,5,7,5,5,17,48
5366,MIL,2014,D.J. Stephens,23,3,0,15,3,7,.429,0,0,,3,7,.429,.429,1,1,1.000,1,4,5,0,0,0,0,0,7
5367,MIL,2014,Tony Mitchell,24,3,0,10,3,5,.600,0,1,.000,3,4,.750,.600,0,0,,1,0,1,1,1,0,0,0,6
5368,MIL,2013,Monta Ellis,27,82,82,3076,597,1436,.416,94,328,.287,503,1108,.454,.448,289,374,.773,45,271,316,496,169,36,254,164,1577
5369,MIL,2013,Brandon Jennings,23,80,80,2897,497,1247,.399,173,461,.375,324,786,.412,.468,230,281,.819,59,187,246,521,125,10,203,155,1397
5370,MIL,2013,Ersan İlyasova,25,73,54,2012,371,803,.462,95,214,.444,276,589,.469,.521,125,157,.796,154,366,520,117,68,36,75,185,962
5371,MIL,2013,Mike Dunleavy,32,75,3,1943,276,624,.442,128,299,.428,148,325,.455,.545,105,128,.820,31,260,291,145,39,35,90,135,785
5372,MIL,2013,Larry Sanders,24,71,55,1937,306,605,.506,0,2,.000,306,603,.507,.506,84,136,.618,224,448,672,83,53,201,87,233,696
5373,MIL,2013,Luc Mbah a Moute,26,58,45,1326,151,377,.401,13,37,.351,138,340,.406,.418,72,126,.571,89,167,256,55,42,14,70,82,387
5374,MIL,2013,Ekpe Udoh,25,76,9,1312,117,269,.435,0,1,.000,117,268,.437,.435,89,119,.748,113,138,251,43,39,85,43,139,323
5375,MIL,2013,Marquis Daniels,32,59,33,1085,132,351,.376,20,72,.278,112,279,.401,.405,40,54,.741,48,102,150,65,51,10,45,77,324
5376,MIL,2013,John Henson,22,63,9,827,162,336,.482,0,3,.000,162,333,.486,.482,56,105,.533,116,181,297,31,19,42,47,83,380
5377,MIL,2013,JJ Redick,28,28,2,804,120,298,.403,48,151,.318,72,147,.490,.483,56,61,.918,8,44,52,76,9,4,33,47,344
5378,MIL,2013,Samuel Dalembert,31,47,23,765,137,253,.542,1,1,1.000,136,252,.540,.543,38,55,.691,105,171,276,21,17,53,51,90,313
5379,MIL,2013,Beno Udrih,30,39,0,719,113,238,.475,13,49,.265,100,189,.529,.502,24,33,.727,17,61,78,138,16,2,53,39,263
5380,MIL,2013,Tobias Harris,20,28,14,325,53,115,.461,7,21,.333,46,94,.489,.491,23,26,.885,17,40,57,13,8,7,18,31,136
5381,MIL,2013,Doron Lamb,21,23,0,280,33,95,.347,4,16,.250,29,79,.367,.368,8,15,.533,3,14,17,20,7,0,16,27,78
5382,MIL,2013,Gustavo Ayón,27,12,0,163,25,42,.595,0,0,,25,42,.595,.595,1,12,.083,20,39,59,12,9,4,9,24,51
5383,MIL,2013,Drew Gooden,31,16,0,151,20,61,.328,1,5,.200,19,56,.339,.336,11,16,.688,13,18,31,6,5,6,9,21,52
5384,MIL,2013,Ish Smith,24,16,0,138,17,43,.395,4,10,.400,13,33,.394,.442,0,0,,1,14,15,30,8,3,10,12,38
5385,MIL,2013,Joel Przybilla,33,12,1,68,1,4,.250,0,0,,1,4,.250,.250,0,2,.000,5,16,21,4,1,2,4,10,2
5386,MIL,2012,Brandon Jennings,22,66,66,2331,469,1121,.418,129,388,.332,340,733,.464,.476,193,239,.808,49,177,226,365,104,22,146,114,1260
5387,MIL,2012,Ersan İlyasova,24,60,41,1655,294,597,.492,51,112,.455,243,485,.501,.535,143,183,.781,196,333,529,71,42,44,76,133,782
5388,MIL,2012,Carlos Delfino,29,54,53,1537,182,453,.402,86,239,.360,96,214,.449,.497,38,48,.792,20,188,208,123,79,10,66,99,488
5389,MIL,2012,Drew Gooden,30,56,46,1469,287,657,.437,16,55,.291,271,602,.450,.449,176,208,.846,130,233,363,144,46,34,109,112,766
5390,MIL,2012,Mike Dunleavy,31,55,3,1445,239,504,.474,83,208,.399,156,296,.527,.557,116,143,.811,29,175,204,117,28,8,58,87,677
5391,MIL,2012,Shaun Livingston,26,58,27,1092,127,271,.469,2,3,.667,125,268,.466,.472,62,79,.785,39,84,123,122,27,20,66,79,318
5392,MIL,2012,Beno Udrih,29,59,0,1080,146,332,.440,17,59,.288,129,273,.473,.465,39,55,.709,26,76,102,227,37,1,77,69,348
5393,MIL,2012,Luc Mbah a Moute,25,43,22,1009,133,261,.510,1,4,.250,132,257,.514,.511,66,103,.641,77,150,227,29,40,22,39,93,333
5394,MIL,2012,Monta Ellis,26,21,21,755,145,336,.432,12,45,.267,133,291,.457,.449,68,89,.764,4,69,73,123,29,6,54,52,370
5395,MIL,2012,Stephen Jackson,33,26,13,712,97,272,.357,30,108,.278,67,164,.409,.412,50,60,.833,16,66,82,77,26,6,66,61,274
5396,MIL,2012,Larry Sanders,23,52,0,643,84,184,.457,0,2,.000,84,182,.462,.457,18,38,.474,62,98,160,33,32,76,43,133,186
5397,MIL,2012,Jon Leuer,22,46,12,555,97,191,.508,3,9,.333,94,182,.516,.516,21,28,.750,45,75,120,25,14,17,18,67,218
5398,MIL,2012,Tobias Harris,19,42,9,479,79,169,.467,6,23,.261,73,146,.500,.485,44,54,.815,30,71,101,22,13,7,31,45,208
5399,MIL,2012,Ekpe Udoh,24,23,5,463,45,110,.409,0,2,.000,45,108,.417,.409,40,50,.800,42,65,107,26,15,37,18,59,130
5400,MIL,2012,Andrew Bogut,27,12,12,364,61,136,.449,0,1,.000,61,135,.452,.449,14,23,.609,22,78,100,31,12,24,24,36,136
5401,MIL,2012,Jon Brockman,24,35,0,239,15,45,.333,0,1,.000,15,44,.341,.333,7,15,.467,33,42,75,9,4,1,10,33,37
5402,MIL,2012,Darington Hobson,24,5,0,39,2,13,.154,0,6,.000,2,7,.286,.154,0,0,,0,3,3,6,0,0,2,1,4
5403,MIL,2011,John Salmons,31,73,70,2554,373,898,.415,83,219,.379,290,679,.427,.462,195,240,.813,27,239,266,252,72,28,137,157,1024
5404,MIL,2011,Andrew Bogut,26,65,65,2297,367,742,.495,0,4,.000,367,738,.497,.495,96,217,.442,199,521,720,131,47,168,125,217,830
5405,MIL,2011,Brandon Jennings,21,63,61,2169,361,926,.390,98,303,.323,263,623,.422,.443,199,246,.809,42,192,234,305,95,21,146,131,1019
5406,MIL,2011,Luc Mbah a Moute,24,79,52,2093,198,428,.463,0,7,.000,198,421,.470,.463,133,188,.707,169,251,420,68,72,28,77,180,529
5407,MIL,2011,Keyon Dooling,30,80,22,1757,206,519,.397,81,234,.346,125,285,.439,.475,78,94,.830,12,105,117,243,54,4,91,119,571
5408,MIL,2011,Carlos Delfino,28,49,40,1590,200,513,.390,105,284,.370,95,229,.415,.492,60,75,.800,24,176,200,112,76,8,57,72,565
5409,MIL,2011,Ersan İlyasova,23,60,34,1505,221,507,.436,36,121,.298,185,386,.479,.471,93,104,.894,105,260,365,56,51,24,63,159,571
5410,MIL,2011,Corey Maggette,31,67,18,1401,253,559,.453,28,78,.359,225,481,.468,.478,271,325,.834,44,197,241,84,21,5,127,175,805
5411,MIL,2011,Chris Douglas-Roberts,24,44,12,884,117,273,.429,15,46,.326,102,227,.449,.456,74,89,.831,7,81,88,50,29,13,35,73,323
5412,MIL,2011,Larry Sanders,22,60,12,872,116,268,.433,0,0,,116,268,.433,.433,28,50,.560,59,119,178,16,22,72,38,117,260
5413,MIL,2011,Earl Boykins,34,57,0,862,156,352,.443,27,71,.380,129,281,.459,.482,69,82,.841,15,40,55,141,38,3,52,43,408
5414,MIL,2011,Drew Gooden,29,35,18,860,156,362,.431,3,20,.150,153,342,.447,.435,81,102,.794,73,165,238,47,21,18,46,98,396
5415,MIL,2011,Jon Brockman,23,63,6,677,48,94,.511,0,0,,48,94,.511,.511,40,59,.678,74,110,184,18,14,3,24,119,136
5416,MIL,2011,Michael Redd,31,10,0,134,18,45,.400,4,17,.235,14,28,.500,.444,4,4,1.000,0,8,8,12,2,1,4,4,44
5417,MIL,2011,Earl Barron,29,7,0,85,17,37,.459,0,0,,17,37,.459,.459,2,2,1.000,12,10,22,4,2,2,2,10,36
5418,MIL,2011,Garrett Temple,24,9,0,83,7,21,.333,3,10,.300,4,11,.364,.405,0,4,.000,0,6,6,6,1,1,2,8,17
5419,MIL,2011,Brian Skinner,34,2,0,6,0,0,,0,0,,0,0,,,0,0,,0,0,0,0,0,0,0,0,0
5420,MIL,2010,Brandon Jennings,20,82,82,2671,451,1216,.371,145,388,.374,306,828,.370,.431,223,273,.817,49,233,282,470,105,18,200,191,1270
5421,MIL,2010,Carlos Delfino,27,75,66,2279,299,732,.408,134,365,.367,165,367,.450,.500,93,119,.782,51,343,394,202,80,21,119,138,825
5422,MIL,2010,Andrew Bogut,25,69,69,2229,473,910,.520,0,2,.000,473,908,.521,.520,149,237,.629,208,493,701,127,39,175,131,222,1095
5423,MIL,2010,Ersan İlyasova,22,81,31,1898,323,729,.443,81,241,.336,242,488,.496,.499,113,158,.715,157,360,517,84,53,23,71,251,840
5424,MIL,2010,Luc Mbah a Moute,23,73,62,1866,177,369,.480,6,17,.353,171,352,.486,.488,93,133,.699,171,229,400,81,60,39,70,181,453
5425,MIL,2010,Luke Ridnour,28,82,0,1759,328,686,.478,69,181,.381,259,505,.513,.528,127,140,.907,24,119,143,324,54,7,106,182,852
5426,MIL,2010,Charlie Bell,30,71,39,1611,169,443,.381,73,200,.365,96,243,.395,.464,48,67,.716,31,101,132,104,39,12,54,136,459
5427,MIL,2010,John Salmons,30,30,28,1129,207,443,.467,45,117,.385,162,326,.497,.518,137,158,.867,17,79,96,98,34,4,53,65,596
5428,MIL,2010,Kurt Thomas,37,70,9,1049,99,208,.476,0,0,,99,208,.476,.476,12,15,.800,84,207,291,47,26,46,48,159,210
5429,MIL,2010,Hakim Warrick,27,48,6,1024,182,378,.481,1,6,.167,181,372,.487,.483,125,172,.727,87,125,212,35,17,10,57,83,490
5430,MIL,2010,Jerry Stackhouse,35,42,0,855,129,316,.408,45,130,.346,84,186,.452,.479,55,69,.797,19,81,100,70,21,9,66,56,358
5431,MIL,2010,Michael Redd,30,18,12,492,75,213,.352,18,60,.300,57,153,.373,.394,47,66,.712,11,43,54,39,19,2,15,24,215
5432,MIL,2010,Jodie Meeks,22,41,0,486,64,177,.362,23,82,.280,41,95,.432,.427,18,21,.857,5,67,72,22,13,4,20,33,169
5433,MIL,2010,Dan Gadzuric,31,32,6,314,39,89,.438,0,0,,39,89,.438,.438,10,25,.400,38,54,92,12,9,13,15,63,88
5434,MIL,2010,Roko Ukić,25,13,0,97,14,30,.467,3,12,.250,11,18,.611,.517,9,11,.818,0,3,3,12,1,0,6,6,40
5435,MIL,2010,Royal Ivey,28,18,0,90,9,28,.321,2,11,.182,7,17,.412,.357,3,5,.600,1,7,8,10,9,0,6,14,23
5436,MIL,2010,Francisco Elson,33,11,0,62,4,13,.308,0,0,,4,13,.308,.308,2,2,1.000,5,8,13,2,1,0,1,7,10
5437,MIL,2010,Primož Brezec,30,14,0,59,7,13,.538,0,0,,7,13,.538,.538,0,4,.000,6,7,13,1,0,2,2,10,14
5438,MIL,2010,Darnell Jackson,24,1,0,9,1,5,.200,0,1,.000,1,4,.250,.200,0,0,,1,1,2,0,0,0,0,2,2
5439,MIL,2009,Richard Jefferson,28,82,82,2939,537,1222,.439,116,292,.397,421,930,.453,.487,417,518,.805,57,317,374,199,66,14,165,252,1607
5440,MIL,2009,Ramon Sessions,22,79,39,2173,345,775,.445,6,34,.176,339,741,.457,.449,281,354,.794,64,205,269,452,83,7,152,158,977
5441,MIL,2009,Luc Mbah a Moute,22,82,52,2114,227,491,.462,0,4,.000,227,487,.466,.462,140,192,.729,189,298,487,87,87,45,100,204,594
5442,MIL,2009,Charlie Villanueva,24,78,47,2095,487,1089,.447,89,258,.345,398,831,.479,.488,201,240,.838,154,366,520,137,50,56,138,254,1264
5443,MIL,2009,Luke Ridnour,27,72,50,2033,250,621,.403,55,157,.350,195,464,.420,.447,133,153,.869,33,185,218,365,92,16,128,200,688
5444,MIL,2009,Charlie Bell,29,70,23,1783,217,524,.414,87,240,.363,130,284,.458,.497,66,80,.825,32,102,134,151,50,7,76,138,587
5445,MIL,2009,Michael Redd,29,33,32,1203,249,547,.455,70,191,.366,179,356,.503,.519,131,161,.814,24,83,107,88,35,2,53,45,699
5446,MIL,2009,Andrew Bogut,24,36,33,1124,183,317,.577,0,0,,183,317,.577,.577,56,98,.571,117,252,369,72,23,37,86,130,422
5447,MIL,2009,Francisco Elson,32,59,23,977,83,169,.491,1,4,.250,82,165,.497,.494,33,39,.846,100,129,229,32,36,36,48,144,200
5448,MIL,2009,Dan Gadzuric,30,67,26,941,117,244,.480,0,2,.000,117,242,.483,.480,37,68,.544,95,160,255,39,32,43,41,162,271
5449,MIL,2009,Joe Alexander,22,59,0,716,102,245,.416,16,46,.348,86,199,.432,.449,58,83,.699,44,71,115,42,15,29,52,107,278
5450,MIL,2009,Malik Allen,30,49,3,579,73,170,.429,0,1,.000,73,169,.432,.429,10,21,.476,35,68,103,35,7,12,20,89,156
5451,MIL,2009,Keith Bogans,28,29,0,485,56,149,.376,32,92,.348,24,57,.421,.483,31,33,.939,16,75,91,33,20,2,22,44,175
5452,MIL,2009,Tyronn Lue,31,30,0,392,54,119,.454,21,45,.467,33,74,.446,.542,12,16,.750,6,29,35,46,6,0,21,41,141
5453,MIL,2009,Damon Jones,32,18,0,108,11,34,.324,11,28,.393,0,6,.000,.485,0,0,,0,6,6,7,3,0,6,4,33
5454,MIL,2009,Austin Croshere,33,11,0,77,12,30,.400,5,11,.455,7,19,.368,.483,7,11,.636,7,17,24,6,1,1,4,4,36
5455,MIL,2009,Eddie Gill,30,6,0,43,6,9,.667,2,3,.667,4,6,.667,.778,0,0,,0,4,4,11,3,1,5,10,14
5456,MIL,2008,Andrew Bogut,23,78,78,2720,465,910,.511,0,7,.000,465,903,.515,.511,189,322,.587,245,518,763,199,64,135,172,254,1119
5457,MIL,2008,Michael Redd,28,72,71,2702,550,1243,.442,130,359,.362,420,884,.475,.495,402,490,.820,85,224,309,247,65,13,181,120,1632
5458,MIL,2008,Mo Williams,25,66,66,2410,441,919,.480,89,231,.385,352,688,.512,.528,166,194,.856,37,193,230,419,78,10,182,188,1137
5459,MIL,2008,Charlie Villanueva,23,76,31,1829,354,814,.435,55,185,.297,299,629,.475,.469,123,157,.783,145,321,466,78,30,35,107,174,886
5460,MIL,2008,Desmond Mason,30,59,56,1702,230,477,.482,0,0,,230,477,.482,.482,114,173,.659,75,181,256,121,40,30,83,106,574
5461,MIL,2008,Yi Jianlian,20,66,49,1647,219,520,.421,6,21,.286,213,499,.427,.427,122,145,.841,106,238,344,55,36,56,90,153,566
5462,MIL,2008,Charlie Bell,28,68,5,1628,185,486,.381,74,217,.341,111,269,.413,.457,70,87,.805,31,136,167,210,52,2,76,121,514
5463,MIL,2008,Bobby Simmons,27,70,21,1521,209,496,.421,60,171,.351,149,325,.458,.482,53,70,.757,67,159,226,80,50,5,78,140,531
5464,MIL,2008,Royal Ivey,26,75,20,1437,149,378,.394,35,107,.327,114,271,.421,.440,85,117,.726,38,80,118,160,45,7,75,166,418
5465,MIL,2008,Michael Ruffin,31,46,2,632,33,62,.532,0,0,,33,62,.532,.532,25,63,.397,90,96,186,24,31,19,19,93,91
5466,MIL,2008,Dan Gadzuric,29,51,4,534,64,154,.416,0,1,.000,64,153,.418,.416,33,63,.524,67,77,144,11,20,24,34,83,161
5467,MIL,2008,Ramon Sessions,21,17,7,450,51,117,.436,3,7,.429,48,110,.436,.449,32,41,.780,8,50,58,127,17,3,36,26,137
5468,MIL,2008,Jake Voskuhl,30,44,0,386,37,80,.463,0,0,,37,80,.463,.463,24,29,.828,30,67,97,13,9,21,29,83,98
5469,MIL,2008,Awvee Storey,30,26,0,259,39,89,.438,0,7,.000,39,82,.476,.438,14,29,.483,31,23,54,16,7,1,10,41,92
5470,MIL,2007,Charlie Bell,27,82,64,2848,426,974,.437,127,361,.352,299,613,.488,.503,131,168,.780,57,181,238,247,97,4,104,213,1110
5471,MIL,2007,Ruben Patterson,31,81,53,2508,475,867,.548,3,19,.158,472,848,.557,.550,241,376,.641,190,250,440,232,110,25,199,232,1194
5472,MIL,2007,Mo Williams,24,68,68,2472,468,1049,.446,79,228,.346,389,821,.474,.484,159,186,.855,54,275,329,416,85,6,203,201,1174
5473,MIL,2007,Andrew Bogut,22,66,66,2258,348,629,.553,1,5,.200,347,624,.556,.554,112,194,.577,168,416,584,198,49,35,150,216,809
5474,MIL,2007,Michael Redd,27,53,53,2036,477,1025,.465,117,306,.382,360,719,.501,.522,345,416,.829,42,154,196,124,63,9,122,78,1416
5475,MIL,2007,Brian Skinner,30,67,44,1523,124,253,.490,0,0,,124,253,.490,.490,46,79,.582,106,279,385,58,18,64,75,195,294
5476,MIL,2007,Earl Boykins,30,35,19,1154,167,391,.427,54,129,.419,113,262,.431,.496,101,114,.886,26,50,76,159,31,0,68,61,489
5477,MIL,2007,Charlie Villanueva,22,39,17,984,180,383,.470,29,86,.337,151,297,.508,.508,73,89,.820,62,166,228,36,24,12,54,108,462
5478,MIL,2007,Ersan İlyasova,19,66,14,973,139,363,.383,54,148,.365,85,215,.395,.457,70,89,.787,58,131,189,49,27,17,51,147,402
5479,MIL,2007,Dan Gadzuric,28,54,8,840,108,228,.474,0,1,.000,108,227,.476,.474,42,90,.467,94,152,246,29,22,32,49,141,258
5480,MIL,2007,David Noel,22,68,0,792,65,177,.367,17,53,.321,48,124,.387,.415,37,43,.860,42,81,123,65,25,9,40,77,184
5481,MIL,2007,Steve Blake,26,33,2,583,45,129,.349,19,68,.279,26,61,.426,.422,11,20,.550,7,38,45,84,10,3,28,49,120
5482,MIL,2007,Lynn Greer,27,41,0,432,61,141,.433,18,52,.346,43,89,.483,.496,27,32,.844,2,25,27,53,17,1,18,32,167
5483,MIL,2007,Jared Reiner,24,27,2,244,15,43,.349,0,0,,15,43,.349,.349,3,10,.300,21,50,71,13,5,6,14,45,33
5484,MIL,2007,Damir Markota,21,30,0,170,19,52,.365,6,16,.375,13,36,.361,.423,7,11,.636,11,20,31,6,3,1,15,22,51
5485,MIL,2007,Julius Hodge,23,5,0,28,4,7,.571,0,0,,4,7,.571,.571,1,2,.500,1,4,5,2,1,0,2,3,9
5486,MIL,2007,Chris McCray,22,5,0,12,0,3,.000,0,0,,0,3,.000,.000,0,0,,0,0,0,0,0,0,2,1,0
5487,MIL,2006,Michael Redd,26,80,80,3130,682,1516,.450,163,413,.395,519,1103,.471,.504,501,571,.877,78,264,342,229,95,5,170,157,2028
5488,MIL,2006,T.J. Ford,22,72,70,2557,328,789,.416,35,104,.337,293,685,.428,.438,187,248,.754,63,248,311,473,104,7,219,196,878
5489,MIL,2006,Bobby Simmons,25,75,74,2538,366,808,.453,105,250,.420,261,558,.468,.518,165,200,.825,91,242,333,172,86,21,123,254,1002
5490,MIL,2006,Jamaal Magloire,27,82,82,2465,287,615,.467,0,0,,287,615,.467,.467,178,333,.535,220,558,778,56,29,80,166,276,752
5491,MIL,2006,Andrew Bogut,21,82,77,2348,323,606,.533,0,3,.000,323,603,.536,.533,122,194,.629,189,384,573,192,49,68,125,259,768
5492,MIL,2006,Mo Williams,23,58,12,1531,267,629,.424,73,191,.382,194,438,.443,.483,96,113,.850,30,113,143,230,52,7,105,146,703
5493,MIL,2006,Charlie Bell,26,59,6,1283,180,410,.439,71,168,.423,109,242,.450,.526,63,89,.708,21,99,120,130,59,5,41,126,494
5494,MIL,2006,Toni Kukoč,37,65,0,1018,116,298,.389,45,147,.306,71,151,.470,.465,40,56,.714,26,124,150,139,33,17,66,87,317
5495,MIL,2006,Joe Smith,30,44,5,887,145,305,.475,0,2,.000,145,303,.479,.475,89,115,.774,83,147,230,31,24,13,40,120,379
5496,MIL,2006,Dan Gadzuric,27,74,0,885,171,309,.553,0,1,.000,171,308,.555,.553,41,89,.461,91,141,232,24,25,43,35,171,383
5497,MIL,2006,Jiří Welsch,26,58,2,866,86,222,.387,14,49,.286,72,173,.416,.419,65,87,.747,22,89,111,62,34,1,41,65,251
5498,MIL,2006,Jermaine Jackson,29,30,2,202,11,26,.423,1,4,.250,10,22,.455,.442,12,14,.857,8,19,27,25,4,1,13,19,35
5499,MIL,2006,Ervin Johnson,38,18,0,81,7,17,.412,0,0,,7,17,.412,.412,1,2,.500,5,19,24,2,1,2,5,23,15
5500,MIL,2006,Reece Gaines,25,12,0,54,6,12,.500,0,2,.000,6,10,.600,.500,1,4,.250,0,0,0,3,1,0,1,1,13
5501,MIL,2006,Josh Davis,25,4,0,12,1,4,.250,0,1,.000,1,3,.333,.250,0,0,,2,1,3,1,1,0,1,2,2
5502,MIL,2005,Desmond Mason,27,80,71,2893,478,1079,.443,1,8,.125,477,1071,.445,.443,420,524,.802,85,227,312,217,58,27,164,198,1377
5503,MIL,2005,Michael Redd,25,75,75,2848,625,1418,.441,104,293,.355,521,1125,.463,.477,369,432,.854,72,240,312,172,63,8,133,152,1723
5504,MIL,2005,Joe Smith,29,74,73,2265,319,621,.514,0,1,.000,319,620,.515,.514,175,228,.768,179,362,541,67,43,38,79,222,813
5505,MIL,2005,Mo Williams,22,80,80,2254,323,737,.438,32,99,.323,291,638,.456,.460,136,160,.850,50,194,244,484,74,11,196,221,814
5506,MIL,2005,Dan Gadzuric,26,81,81,1783,243,451,.539,0,0,,243,451,.539,.539,107,199,.538,261,413,674,30,47,106,81,224,593
5507,MIL,2005,Zaza Pachulia,20,74,4,1397,160,354,.452,0,1,.000,160,353,.453,.452,138,185,.746,131,247,378,60,44,34,70,166,458
5508,MIL,2005,Mike James,29,47,0,1167,205,460,.446,58,152,.382,147,308,.477,.509,67,90,.744,23,99,122,185,40,4,80,114,535
5509,MIL,2005,Toni Kukoč,36,53,6,1099,105,256,.410,42,116,.362,63,140,.450,.492,44,61,.721,31,129,160,160,39,13,64,70,296
5510,MIL,2005,Erick Strickland,31,62,5,1014,114,304,.375,21,83,.253,93,221,.421,.410,52,64,.813,11,92,103,115,30,1,64,103,301
5511,MIL,2005,Marcus Fizer,26,54,0,903,133,292,.455,0,6,.000,133,286,.465,.455,70,103,.680,29,146,175,64,25,13,63,96,336
5512,MIL,2005,Keith Van Horn,29,33,13,818,128,285,.449,30,78,.385,98,207,.473,.502,56,65,.862,55,110,165,41,21,11,47,82,342
5513,MIL,2005,Anthony Goldwire,33,24,2,482,53,121,.438,29,71,.408,24,50,.480,.558,19,23,.826,9,42,51,78,15,0,14,27,154
5514,MIL,2005,Kendall Gill,36,14,0,284,32,80,.400,3,9,.333,29,71,.408,.419,18,20,.900,11,26,37,27,14,4,9,37,85
5515,MIL,2005,Calvin Booth,28,17,0,189,15,29,.517,0,0,,15,29,.517,.517,12,16,.750,13,36,49,4,4,12,8,23,42
5516,MIL,2005,Zendon Hamilton,29,16,0,159,11,32,.344,0,0,,11,32,.344,.344,29,48,.604,18,24,42,6,5,2,12,26,51
5517,MIL,2005,Daniel Santiago,28,11,0,105,7,21,.333,0,0,,7,21,.333,.333,8,11,.727,6,13,19,1,3,4,4,28,22
5518,MIL,2005,Reece Gaines,24,11,0,79,7,23,.304,1,2,.500,6,21,.286,.326,0,0,,1,2,3,4,2,1,3,5,15
5519,MIL,2005,Eddie House,26,5,0,41,6,17,.353,4,6,.667,2,11,.182,.471,0,0,,0,3,3,5,2,0,0,3,16
5520,MIL,2004,Michael Redd,24,82,82,3021,633,1439,.440,127,363,.350,506,1076,.470,.484,383,441,.868,118,289,407,185,81,6,116,152,1776
5521,MIL,2004,Desmond Mason,26,82,31,2534,409,867,.472,9,39,.231,400,828,.483,.477,356,463,.769,93,266,359,152,60,24,148,191,1183
5522,MIL,2004,Joe Smith,28,76,76,2254,311,708,.439,1,5,.200,310,703,.441,.440,207,241,.859,230,413,643,78,47,94,82,209,830
5523,MIL,2004,Damon Jones,27,82,26,2016,210,524,.401,98,273,.359,112,251,.446,.494,55,72,.764,15,155,170,478,30,4,103,92,573
5524,MIL,2004,Brian Skinner,27,56,54,1577,255,513,.497,0,0,,255,513,.497,.497,79,138,.572,119,292,411,49,30,61,78,165,589
5525,MIL,2004,Toni Kukoč,35,73,0,1522,211,506,.417,49,168,.292,162,338,.479,.465,145,199,.729,60,211,271,200,59,21,110,110,616
5526,MIL,2004,T.J. Ford,20,55,55,1472,153,398,.384,5,21,.238,148,377,.393,.391,80,98,.816,37,140,177,356,60,3,139,123,391
5527,MIL,2004,Tim Thomas,26,42,42,1343,226,510,.443,47,130,.362,179,380,.471,.489,93,122,.762,38,167,205,90,40,15,73,127,592
5528,MIL,2004,Dan Gadzuric,25,75,0,1260,183,349,.524,0,1,.000,183,348,.526,.524,58,118,.492,126,220,346,28,51,105,45,186,424
5529,MIL,2004,Keith Van Horn,28,25,15,766,137,290,.472,33,72,.458,104,218,.477,.529,86,91,.945,51,107,158,37,16,15,50,64,393
5530,MIL,2004,Daniel Santiago,27,54,28,708,78,163,.479,0,0,,78,163,.479,.479,61,90,.678,35,97,132,24,19,21,32,98,217
5531,MIL,2004,Erick Strickland,30,43,0,571,79,196,.403,29,66,.439,50,130,.385,.477,44,51,.863,13,58,71,90,26,2,54,63,231
5532,MIL,2004,Brevin Knight,28,21,1,420,46,105,.438,1,3,.333,45,102,.441,.443,30,38,.789,3,45,48,98,29,0,25,56,123
5533,MIL,2004,Marcus Haislip,23,31,0,263,36,74,.486,1,2,.500,35,72,.486,.493,20,28,.714,21,32,53,4,6,12,9,25,93
5534,MIL,2004,Joel Przybilla,24,5,0,33,0,0,,0,0,,0,0,,,1,2,.500,1,9,10,3,0,0,2,5,1
5535,MIL,2004,Dan Langhi,26,2,0,20,3,8,.375,1,2,.500,2,6,.333,.438,0,0,,0,1,1,0,0,0,0,2,7
5536,MIL,2003,Sam Cassell,33,78,77,2700,546,1162,.470,59,163,.362,487,999,.487,.495,385,447,.861,57,285,342,450,88,14,177,216,1536
5537,MIL,2003,Tim Thomas,25,80,70,2358,412,930,.443,97,265,.366,315,665,.474,.495,145,186,.780,97,292,389,102,70,49,133,257,1066
5538,MIL,2003,Michael Redd,23,82,14,2316,455,971,.469,182,416,.438,273,555,.492,.562,149,185,.805,98,273,371,117,100,13,74,143,1241
5539,MIL,2003,Anthony Mason,36,65,58,2119,191,393,.486,0,1,.000,191,392,.487,.486,84,117,.718,90,326,416,209,32,12,79,147,466
5540,MIL,2003,Toni Kukoč,34,63,0,1704,249,577,.432,95,263,.361,154,314,.490,.514,137,194,.706,67,199,266,230,81,29,122,134,730
5541,MIL,2003,Ray Allen,27,47,46,1683,351,803,.437,123,311,.395,228,492,.463,.514,178,195,.913,45,173,218,164,57,11,117,149,1003
5542,MIL,2003,Ervin Johnson,35,69,17,1170,61,135,.452,0,0,,61,135,.452,.452,30,44,.682,117,177,294,24,34,63,34,178,152
5543,MIL,2003,Kevin Ollie,30,53,4,1127,117,255,.459,1,5,.200,116,250,.464,.461,68,91,.747,12,87,99,181,37,4,36,71,303
5544,MIL,2003,Gary Payton,34,28,28,1085,221,474,.466,20,68,.294,201,406,.495,.487,88,118,.746,23,63,86,206,40,8,56,64,550
5545,MIL,2003,Desmond Mason,25,28,25,952,166,350,.474,5,17,.294,161,333,.483,.481,78,102,.765,66,122,188,68,20,11,41,74,415
5546,MIL,2003,Jason Caffey,29,51,16,894,113,248,.456,0,0,,113,248,.456,.456,69,106,.651,68,108,176,38,19,15,56,122,295
5547,MIL,2003,Dan Gadzuric,24,49,30,760,70,145,.483,0,1,.000,70,144,.486,.483,29,56,.518,66,131,197,9,22,52,27,125,169
5548,MIL,2003,Joel Przybilla,23,32,17,546,18,46,.391,0,0,,18,46,.391,.391,12,24,.500,48,97,145,12,10,45,19,85,48
5549,MIL,2003,Marcus Haislip,22,39,8,441,66,153,.431,3,12,.250,63,141,.447,.441,26,38,.684,21,32,53,9,7,18,21,55,161
5550,MIL,2003,Ronald Murray,23,12,0,42,9,26,.346,0,4,.000,9,22,.409,.346,5,8,.625,0,1,1,3,4,0,4,0,23
5551,MIL,2003,Jamal Sampson,19,5,0,8,0,2,.000,0,0,,0,2,.000,.000,0,0,,1,1,2,1,1,0,0,0,0
5552,MIL,2002,Anthony Mason,35,82,82,3143,316,626,.505,1,1,1.000,315,625,.504,.506,154,221,.697,124,522,646,346,57,22,130,187,787
5553,MIL,2002,Sam Cassell,32,74,73,2605,554,1197,.463,71,204,.348,483,993,.486,.492,282,328,.860,54,258,312,493,90,12,177,208,1461
5554,MIL,2002,Ray Allen,26,69,67,2525,530,1148,.462,229,528,.434,301,620,.485,.561,214,245,.873,81,231,312,271,88,18,159,157,1503
5555,MIL,2002,Glenn Robinson,29,66,63,2346,536,1147,.467,58,178,.326,478,969,.493,.493,236,282,.837,70,336,406,168,97,41,174,173,1366
5556,MIL,2002,Tim Thomas,24,74,22,1987,316,753,.420,95,291,.326,221,462,.478,.483,142,179,.793,64,236,300,105,65,32,127,200,869
5557,MIL,2002,Ervin Johnson,34,81,9,1660,89,193,.461,0,1,.000,89,192,.464,.461,30,66,.455,142,324,466,27,37,82,52,219,208
5558,MIL,2002,Michael Redd,22,67,8,1417,294,609,.483,88,198,.444,206,411,.501,.555,91,115,.791,77,147,224,91,42,7,57,96,767
5559,MIL,2002,Darvin Ham,28,70,2,1208,120,211,.569,1,7,.143,119,204,.583,.571,62,123,.504,91,111,202,73,25,37,83,175,303
5560,MIL,2002,Joel Przybilla,22,71,62,1128,76,142,.535,0,1,.000,76,141,.539,.535,38,90,.422,78,205,283,21,20,118,43,199,190
5561,MIL,2002,Rafer Alston,25,50,7,600,66,191,.346,27,71,.380,39,120,.325,.416,18,29,.621,10,62,72,143,32,2,40,42,177
5562,MIL,2002,Greg Anthony,34,24,3,553,70,188,.372,19,73,.260,51,115,.443,.423,13,21,.619,6,38,44,79,28,1,36,42,172
5563,MIL,2002,Mark Pope,29,45,12,426,36,91,.396,4,25,.160,32,66,.485,.418,11,21,.524,20,53,73,17,11,11,15,47,87
5564,MIL,2002,Jason Caffey,28,23,0,283,36,72,.500,0,1,.000,36,71,.507,.500,27,43,.628,24,26,50,12,4,5,19,39,99
5565,MIL,2002,Greg Foster,33,6,0,24,2,9,.222,0,4,.000,2,5,.400,.222,3,4,.750,0,8,8,1,0,0,0,4,7
5566,MIL,2001,Ray Allen,25,82,82,3129,628,1309,.480,202,467,.433,426,842,.506,.557,348,392,.888,101,327,428,374,124,20,204,192,1806
5567,MIL,2001,Glenn Robinson,28,76,74,2813,684,1460,.468,55,184,.299,629,1276,.493,.487,251,306,.820,124,402,526,252,86,62,219,191,1674
5568,MIL,2001,Sam Cassell,31,76,75,2709,537,1132,.474,30,98,.306,507,1034,.490,.488,277,323,.858,46,244,290,580,88,8,220,214,1381
5569,MIL,2001,Tim Thomas,23,76,16,2086,326,758,.430,107,260,.412,219,498,.440,.501,195,253,.771,79,234,313,138,78,45,114,194,954
5570,MIL,2001,Lindsey Hunter,30,82,5,2002,298,783,.381,152,407,.373,146,376,.388,.478,77,96,.802,32,137,169,222,102,12,68,172,825
5571,MIL,2001,Ervin Johnson,33,82,19,1981,108,198,.545,0,0,,108,198,.545,.545,50,93,.538,205,408,613,40,44,97,47,257,266
5572,MIL,2001,Jason Caffey,27,70,33,1460,179,367,.488,0,0,,179,367,.488,.488,142,211,.673,135,218,353,53,38,25,77,184,500
5573,MIL,2001,Scott Williams,32,66,31,1272,171,361,.474,1,4,.250,170,357,.476,.475,60,70,.857,97,267,364,35,48,32,41,178,403
5574,MIL,2001,Mark Pope,28,63,45,942,62,142,.437,5,24,.208,57,118,.483,.454,22,35,.629,56,91,147,38,16,26,17,140,151
5575,MIL,2001,Darvin Ham,27,29,13,540,39,80,.488,2,3,.667,37,77,.481,.500,29,49,.592,56,65,121,25,17,21,33,85,109
5576,MIL,2001,Rafer Alston,24,37,2,288,30,84,.357,8,30,.267,22,54,.407,.405,9,13,.692,4,27,31,68,13,0,20,27,77
5577,MIL,2001,Joel Przybilla,21,33,13,270,12,35,.343,0,0,,12,35,.343,.343,3,11,.273,29,42,71,2,3,30,13,56,27
5578,MIL,2001,Jerome Kersey,38,22,2,243,32,69,.464,0,1,.000,32,68,.471,.464,8,16,.500,8,37,45,15,14,8,6,36,72
5579,MIL,2001,Michael Redd,21,6,0,35,5,19,.263,0,3,.000,5,16,.313,.263,3,6,.500,3,1,4,1,1,0,1,2,13
5580,MIL,2001,Jason Hart,22,1,0,10,1,1,1.000,0,0,,1,1,1.000,1.000,0,0,,0,0,0,1,0,0,2,0,2
5581,MIL,2000,Ray Allen,24,82,82,3070,642,1411,.455,172,407,.423,470,1004,.468,.516,353,398,.887,83,276,359,308,110,19,183,187,1809
5582,MIL,2000,Glenn Robinson,27,81,81,2909,690,1461,.472,86,237,.363,604,1224,.493,.502,227,283,.802,107,378,485,193,78,41,223,212,1693
5583,MIL,2000,Sam Cassell,30,81,81,2899,545,1170,.466,26,90,.289,519,1080,.481,.477,390,445,.876,69,232,301,729,102,8,267,255,1506
5584,MIL,2000,Ervin Johnson,32,80,74,2129,144,279,.516,0,1,.000,144,278,.518,.516,95,157,.605,233,415,648,44,81,127,80,298,383
5585,MIL,2000,Tim Thomas,22,80,1,2093,347,753,.461,63,182,.346,284,571,.497,.503,188,243,.774,100,232,332,113,59,31,129,227,945
5586,MIL,2000,Scott Williams,31,68,46,1488,213,426,.500,0,0,,213,426,.500,.500,94,129,.729,177,271,448,28,40,66,65,230,520
5587,MIL,2000,Danny Manning,33,72,0,1217,149,339,.440,1,4,.250,148,335,.442,.441,34,52,.654,50,158,208,73,62,29,55,183,333
5588,MIL,2000,Vinny Del Negro,33,67,0,1211,153,325,.471,8,24,.333,145,301,.482,.483,35,39,.897,9,98,107,160,36,0,48,81,349
5589,MIL,2000,Darvin Ham,26,35,21,792,71,128,.555,0,1,.000,71,127,.559,.555,35,78,.449,85,87,172,42,29,29,29,102,177
5590,MIL,2000,J.R. Reid,31,34,7,602,53,127,.417,1,7,.143,52,120,.433,.421,43,56,.768,29,88,117,18,19,5,20,81,150
5591,MIL,2000,Robert Traylor,22,44,16,447,58,122,.475,0,4,.000,58,118,.492,.475,41,68,.603,50,65,115,20,25,25,27,79,157
5592,MIL,2000,Rafer Alston,23,27,0,361,27,95,.284,3,14,.214,24,81,.296,.300,3,4,.750,5,18,23,70,12,0,29,29,60
5593,MIL,2000,Dale Ellis,39,18,0,324,47,101,.465,23,65,.354,24,36,.667,.579,6,9,.667,7,27,34,6,6,0,7,23,123
5594,MIL,2000,Haywoode Workman,34,23,1,248,23,62,.371,11,29,.379,12,33,.364,.460,9,13,.692,1,16,17,44,11,0,14,23,66
5595,MIL,2000,Mirsad Türkcan,23,10,0,65,12,28,.429,0,4,.000,12,24,.500,.429,5,8,.625,11,12,23,4,1,1,7,10,29
5596,MIL,1999,Ray Allen,23,50,50,1719,303,673,.450,74,208,.356,229,465,.492,.505,176,195,.903,57,155,212,178,53,7,122,117,856
5597,MIL,1999,Glenn Robinson,26,47,47,1579,347,756,.459,31,79,.392,316,677,.467,.479,140,161,.870,73,203,276,100,46,41,106,114,865
5598,MIL,1999,Michael Curry,30,50,4,1146,90,206,.437,1,15,.067,89,191,.466,.439,63,79,.797,19,89,108,78,42,7,37,135,244
5599,MIL,1999,Vinny Del Negro,32,48,7,1093,114,270,.422,13,30,.433,101,240,.421,.446,40,50,.800,14,88,102,174,33,3,55,62,281
5600,MIL,1999,Ervin Johnson,31,50,7,1027,96,189,.508,0,0,,96,189,.508,.508,64,105,.610,120,200,320,19,29,57,47,151,256
5601,MIL,1999,Dell Curry,34,42,0,864,163,336,.485,69,145,.476,94,191,.492,.588,28,34,.824,18,67,85,48,36,3,45,42,423
5602,MIL,1999,Haywoode Workman,33,29,29,815,73,170,.429,17,47,.362,56,123,.455,.479,37,47,.787,14,88,102,172,32,1,63,53,200
5603,MIL,1999,Robert Traylor,21,49,43,786,108,201,.537,0,1,.000,108,200,.540,.537,43,80,.538,80,102,182,38,44,44,42,140,259
5604,MIL,1999,Armen Gilliam,34,34,5,668,101,223,.453,0,1,.000,101,222,.455,.453,79,101,.782,33,93,126,19,22,12,36,48,281
5605,MIL,1999,Tim Thomas,21,33,26,624,105,212,.495,16,49,.327,89,163,.546,.533,54,88,.614,42,51,93,31,23,9,31,86,280
5606,MIL,1999,Tyrone Hill,30,17,17,517,50,118,.424,0,0,,50,118,.424,.424,46,81,.568,51,83,134,17,18,8,24,68,146
5607,MIL,1999,Terrell Brandon,28,15,14,505,85,208,.409,7,28,.250,78,180,.433,.425,26,31,.839,11,42,53,104,24,3,36,25,203
5608,MIL,1999,Chris Gatling,31,30,1,494,81,168,.482,1,7,.143,80,161,.497,.485,25,69,.362,31,83,114,20,24,6,33,78,188
5609,MIL,1999,Sam Cassell,29,4,0,99,18,44,.409,1,3,.333,17,41,.415,.420,18,19,.947,4,5,9,17,6,0,8,9,55
5610,MIL,1999,Elliot Perry,29,5,0,47,9,17,.529,1,1,1.000,8,16,.500,.559,1,2,.500,1,7,8,12,4,0,2,3,20
5611,MIL,1999,Scott Williams,30,5,0,29,5,15,.333,0,0,,5,15,.333,.333,4,7,.571,2,10,12,0,1,1,2,5,14
5612,MIL,1999,Adonis Jordan,28,4,0,18,2,4,.500,0,2,.000,2,2,1.000,.500,2,4,.500,0,0,0,3,3,0,2,0,6
5613,MIL,1999,Jerald Honeycutt,24,3,0,12,2,5,.400,0,3,.000,2,2,1.000,.400,1,2,.500,0,1,1,0,1,0,1,6,5
5614,MIL,1999,Paul Grant,25,2,0,5,1,2,.500,0,0,,1,2,.500,.500,0,0,,0,0,0,0,1,0,1,0,2
5615,MIL,1999,Jamie Feick,24,2,0,3,0,1,.000,0,0,,0,1,.000,.000,0,0,,0,2,2,0,0,0,0,0,0
5616,MIL,1998,Ray Allen,22,82,82,3287,563,1315,.428,134,368,.364,429,947,.453,.479,342,391,.875,127,278,405,356,111,12,263,244,1602
5617,MIL,1998,Glenn Robinson,25,56,56,2294,534,1136,.470,25,65,.385,509,1071,.475,.481,215,266,.808,82,225,307,158,69,34,200,164,1308
5618,MIL,1998,Ervin Johnson,30,81,81,2261,253,471,.537,0,0,,253,471,.537,.537,143,238,.601,242,443,685,59,79,158,117,321,649
5619,MIL,1998,Armen Gilliam,33,82,25,2114,327,676,.484,0,4,.000,327,672,.487,.484,267,333,.802,146,293,439,104,65,37,148,177,921
5620,MIL,1998,Tyrone Hill,29,57,56,2064,208,418,.498,0,1,.000,208,417,.499,.498,155,255,.608,212,396,608,88,67,30,106,230,571
5621,MIL,1998,Michael Curry,29,82,27,1978,196,418,.469,4,9,.444,192,409,.469,.474,147,176,.835,26,72,98,137,56,14,77,218,543
5622,MIL,1998,Terrell Brandon,27,50,48,1784,339,731,.464,31,93,.333,308,638,.483,.485,132,156,.846,23,153,176,387,111,17,145,120,841
5623,MIL,1998,Elliot Perry,28,81,33,1752,241,561,.430,17,50,.340,224,511,.438,.445,92,109,.844,21,87,108,230,90,2,128,129,591
5624,MIL,1998,Andrew Lang,31,57,0,692,54,143,.378,0,1,.000,54,142,.380,.378,44,57,.772,56,97,153,16,18,27,33,101,152
5625,MIL,1998,Jerald Honeycutt,23,38,0,530,90,221,.407,29,77,.377,61,144,.424,.473,36,58,.621,27,66,93,33,20,6,49,83,245
5626,MIL,1998,Jamie Feick,23,45,2,450,39,90,.433,4,13,.308,35,77,.455,.456,20,41,.488,45,79,124,16,25,17,21,67,102
5627,MIL,1998,Ricky Pierce,38,39,0,442,52,143,.364,4,13,.308,48,130,.369,.378,43,52,.827,19,26,45,34,9,0,21,35,151
5628,MIL,1998,Litterial Green,27,21,0,124,5,23,.217,0,2,.000,5,21,.238,.217,15,20,.750,1,6,7,16,4,0,8,11,25
5629,MIL,1998,Tony Smith,29,7,0,80,8,24,.333,0,4,.000,8,20,.400,.333,3,4,.750,4,3,7,10,5,2,9,7,19
5630,MIL,1998,Jeff Nordgaard,24,13,0,48,5,18,.278,0,0,,5,18,.278,.278,8,9,.889,4,10,14,3,2,0,3,7,18
5631,MIL,1998,Tim Breaux,27,6,0,30,4,11,.364,1,3,.333,3,8,.375,.409,1,2,.500,0,2,2,2,2,1,1,1,10
5632,MIL,1997,Vin Baker,25,78,78,3159,632,1251,.505,15,54,.278,617,1197,.515,.511,358,521,.687,267,537,804,211,81,112,245,275,1637
5633,MIL,1997,Glenn Robinson,24,80,79,3114,669,1438,.465,63,180,.350,606,1258,.482,.487,288,364,.791,130,372,502,248,103,68,269,225,1689
5634,MIL,1997,Ray Allen,21,82,81,2532,390,908,.430,117,298,.393,273,610,.448,.494,205,249,.823,97,229,326,210,75,10,149,218,1102
5635,MIL,1997,Sherman Douglas,30,79,79,2316,306,610,.502,38,114,.333,268,496,.540,.533,114,171,.667,57,136,193,427,78,10,153,191,764
5636,MIL,1997,Johnny Newman,33,82,4,2060,246,547,.450,34,98,.347,212,449,.472,.481,189,247,.765,66,120,186,116,73,17,115,257,715
5637,MIL,1997,Armen Gilliam,32,80,25,2050,246,522,.471,0,0,,246,522,.471,.471,199,259,.768,136,361,497,53,61,40,105,206,691
5638,MIL,1997,Elliot Perry,27,82,3,1595,217,458,.474,49,137,.358,168,321,.523,.527,79,106,.745,24,100,124,247,98,3,111,117,562
5639,MIL,1997,Andrew Lang,30,52,52,1194,115,248,.464,0,0,,115,248,.464,.464,44,61,.721,94,184,278,25,26,47,39,140,274
5640,MIL,1997,Chucky Brown,28,60,1,674,65,128,.508,1,6,.167,64,122,.525,.512,39,59,.661,38,94,132,24,9,20,15,86,170
5641,MIL,1997,Joe Wolf,32,56,7,525,40,89,.449,1,7,.143,39,82,.476,.455,14,19,.737,32,80,112,20,14,11,14,105,95
5642,MIL,1997,David Wood,32,46,0,240,20,38,.526,5,15,.333,15,23,.652,.592,12,18,.667,5,22,27,13,7,6,6,36,57
5643,MIL,1997,Shawn Respert,24,14,0,83,6,19,.316,1,9,.111,5,10,.500,.342,7,7,1.000,3,4,7,8,0,0,8,5,20
5644,MIL,1997,Keith Tower,26,5,1,72,3,8,.375,0,0,,3,8,.375,.375,1,8,.125,2,7,9,1,2,1,2,12,7
5645,MIL,1997,Acie Earl,26,9,0,43,8,23,.348,0,0,,8,23,.348,.348,10,14,.714,2,9,11,2,3,1,2,7,26
5646,MIL,1997,Darrin Hancock,25,9,0,39,2,6,.333,0,0,,2,6,.333,.333,0,0,,1,4,5,4,2,0,4,7,4
5647,MIL,1997,Jimmy Carruth,27,4,0,21,2,3,.667,0,0,,2,3,.667,.667,1,1,1.000,0,4,4,0,0,2,1,4,5
5648,MIL,1997,Cuonzo Martin,25,3,0,13,0,7,.000,0,2,.000,0,5,.000,.000,0,0,,1,0,1,1,0,0,1,1,0
5649,MIL,1996,Vin Baker,24,82,82,3319,699,1429,.489,10,48,.208,689,1381,.499,.493,321,479,.670,263,545,808,212,68,91,216,272,1729
5650,MIL,1996,Glenn Robinson,23,82,82,3249,627,1382,.454,90,263,.342,537,1119,.480,.486,316,389,.812,136,368,504,293,95,42,282,236,1660
5651,MIL,1996,Johnny Newman,32,82,82,2690,321,649,.495,61,162,.377,260,487,.534,.542,186,232,.802,66,134,200,154,90,15,108,257,889
5652,MIL,1996,Sherman Douglas,29,69,62,2101,309,601,.514,39,103,.379,270,498,.542,.547,135,179,.754,49,108,157,397,61,5,165,147,792
5653,MIL,1996,Terry Cummings,34,81,13,1777,270,584,.462,1,7,.143,269,577,.466,.463,104,160,.650,162,283,445,89,56,30,69,263,645
5654,MIL,1996,Lee Mayberry,25,82,20,1705,153,364,.420,75,189,.397,78,175,.446,.523,41,68,.603,21,69,90,302,64,10,89,144,422
5655,MIL,1996,Benoit Benjamin,31,70,58,1492,223,429,.520,0,3,.000,223,426,.523,.520,101,138,.732,110,326,436,48,35,70,110,184,547
5656,MIL,1996,Marty Conlon,28,74,1,958,153,327,.468,5,30,.167,148,297,.498,.476,84,110,.764,58,119,177,68,20,11,79,126,395
5657,MIL,1996,Shawn Respert,23,62,0,845,113,292,.387,42,122,.344,71,170,.418,.459,35,42,.833,28,46,74,68,32,4,42,67,303
5658,MIL,1996,Randolph Keys,29,69,1,816,87,208,.418,22,71,.310,65,137,.474,.471,36,43,.837,41,84,125,65,32,14,33,139,232
5659,MIL,1996,Eric Murdock,27,9,0,193,24,66,.364,6,23,.261,18,43,.419,.409,8,12,.667,5,9,14,35,6,0,12,16,62
5660,MIL,1996,Jerry Reynolds,33,19,0,191,21,53,.396,1,10,.100,20,43,.465,.406,13,21,.619,13,20,33,12,15,6,16,20,56
5661,MIL,1996,Todd Day,26,8,0,171,22,71,.310,5,25,.200,17,46,.370,.345,24,26,.923,8,14,22,5,4,3,11,27,73
5662,MIL,1996,Alton Lister,37,7,5,88,4,9,.444,0,0,,4,9,.444,.444,2,2,1.000,7,22,29,4,0,3,4,15,10
5663,MIL,1996,Eric Mobley,25,5,3,65,2,7,.286,0,0,,2,7,.286,.286,2,4,.500,3,9,12,0,1,1,1,5,6
5664,MIL,1996,Kevin Duckworth,31,8,1,58,3,14,.214,0,0,,3,14,.214,.214,3,6,.500,2,5,7,2,2,0,2,19,9
5665,MIL,1996,Mike Peplowski,25,5,0,12,3,5,.600,0,0,,3,5,.600,.600,1,3,.333,1,3,4,1,1,2,2,6,7
5666,MIL,1995,Vin Baker,23,82,82,3361,594,1229,.483,7,24,.292,587,1205,.487,.486,256,432,.593,289,557,846,296,86,116,221,277,1451
5667,MIL,1995,Glenn Robinson,22,80,76,2958,636,1410,.451,86,268,.321,550,1142,.482,.482,397,499,.796,169,344,513,197,115,22,313,234,1755
5668,MIL,1995,Todd Day,25,82,81,2717,445,1049,.424,163,418,.390,282,631,.447,.502,257,341,.754,95,227,322,134,104,63,157,283,1310
5669,MIL,1995,Eric Murdock,26,75,32,2158,338,814,.415,90,240,.375,248,574,.432,.471,211,267,.790,48,166,214,482,113,12,194,139,977
5670,MIL,1995,Marty Conlon,27,82,3,2064,344,647,.532,8,29,.276,336,618,.544,.538,119,194,.613,160,266,426,110,42,18,123,218,815
5671,MIL,1995,Johnny Newman,31,82,11,1896,226,488,.463,45,128,.352,181,360,.503,.509,137,171,.801,72,101,173,91,69,13,86,234,634
5672,MIL,1995,Lee Mayberry,24,82,50,1744,172,408,.422,72,177,.407,100,231,.433,.510,58,83,.699,21,61,82,276,51,4,106,123,474
5673,MIL,1995,Ed Pinckney,31,62,17,835,48,97,.495,0,0,,48,97,.495,.495,44,62,.710,65,146,211,21,34,17,26,64,140
5674,MIL,1995,Alton Lister,36,60,32,776,66,134,.493,0,1,.000,66,133,.496,.493,35,70,.500,67,169,236,12,16,57,38,146,167
5675,MIL,1995,Jon Barry,25,52,0,602,57,134,.425,16,48,.333,41,86,.477,.485,61,80,.763,15,34,49,85,30,4,41,54,191
5676,MIL,1995,Eric Mobley,24,46,26,587,78,132,.591,2,2,1.000,76,130,.585,.598,22,45,.489,55,98,153,21,8,27,24,63,180
5677,MIL,1995,Danny Young,32,7,0,77,9,17,.529,5,12,.417,4,5,.800,.676,1,1,1.000,1,4,5,12,4,0,4,8,24
5678,MIL,1995,Aaron Williams,23,15,0,72,8,24,.333,0,1,.000,8,23,.348,.333,8,12,.667,5,14,19,0,2,6,7,14,24
5679,MIL,1995,Tate George,26,3,0,8,1,3,.333,0,1,.000,1,2,.500,.333,2,2,1.000,1,0,1,0,0,0,2,1,4
5680,MIL,1994,Vin Baker,22,82,63,2560,435,869,.501,1,5,.200,434,864,.502,.501,234,411,.569,277,344,621,163,60,114,162,231,1105
5681,MIL,1994,Ken Norman,29,82,75,2539,412,919,.448,63,189,.333,349,730,.478,.483,92,183,.503,169,331,500,222,58,46,150,209,979
5682,MIL,1994,Eric Murdock,25,82,76,2533,477,1019,.468,69,168,.411,408,851,.479,.502,234,288,.813,91,170,261,546,197,12,206,189,1257
5683,MIL,1994,Blue Edwards,28,82,64,2322,382,800,.478,38,106,.358,344,694,.496,.501,151,189,.799,104,225,329,171,83,27,146,235,953
5684,MIL,1994,Todd Day,24,76,39,2127,351,845,.415,33,148,.223,318,697,.456,.435,231,331,.698,115,195,310,138,103,52,129,221,966
5685,MIL,1994,Lee Mayberry,23,82,6,1472,167,402,.415,41,119,.345,126,283,.445,.466,58,84,.690,26,75,101,215,46,4,97,114,433
5686,MIL,1994,Frank Brickowski,34,43,40,1441,251,521,.482,3,18,.167,248,503,.493,.485,148,191,.775,53,226,279,165,52,16,125,165,653
5687,MIL,1994,Jon Barry,24,72,7,1242,158,382,.414,32,115,.278,126,267,.472,.455,97,122,.795,36,110,146,168,102,17,83,110,445
5688,MIL,1994,Derek Strong,25,67,11,1131,141,341,.413,3,13,.231,138,328,.421,.418,159,206,.772,109,172,281,48,38,14,61,69,444
5689,MIL,1994,Brad Lohaus,29,67,2,962,102,281,.363,46,134,.343,56,147,.381,.445,20,29,.690,33,117,150,62,30,55,58,142,270
5690,MIL,1994,Anthony Avent,24,33,20,695,92,228,.404,0,0,,92,228,.404,.404,61,79,.772,60,94,154,33,16,20,43,60,245
5691,MIL,1994,Danny Schayes,34,23,6,230,14,46,.304,0,0,,14,46,.304,.304,21,22,.955,16,29,45,5,5,8,14,27,49
5692,MIL,1994,Anthony Cook,26,23,0,201,26,53,.491,0,1,.000,26,52,.500,.491,10,25,.400,20,36,56,4,3,12,11,22,62
5693,MIL,1994,Joe Courtney,24,19,0,177,27,70,.386,2,3,.667,25,67,.373,.400,9,15,.600,14,15,29,6,7,6,11,21,65
5694,MIL,1994,Mike Gminski,34,8,1,54,5,24,.208,0,0,,5,24,.208,.208,3,4,.750,3,12,15,0,0,3,2,3,13
5695,MIL,1994,Greg Foster,25,3,0,19,4,7,.571,0,0,,4,7,.571,.571,2,2,1.000,0,3,3,0,0,1,1,3,10
5696,MIL,1993,Blue Edwards,27,82,81,2729,554,1083,.512,37,106,.349,517,977,.529,.529,237,300,.790,123,259,382,214,129,45,175,242,1382
5697,MIL,1993,Eric Murdock,24,79,78,2437,438,936,.468,31,119,.261,407,817,.498,.485,231,296,.780,95,189,284,603,174,7,207,177,1138
5698,MIL,1993,Anthony Avent,23,82,78,2285,347,802,.433,0,2,.000,347,800,.434,.433,112,172,.651,180,332,512,91,57,73,140,237,806
5699,MIL,1993,Frank Brickowski,33,66,64,2075,456,836,.545,8,26,.308,448,810,.553,.550,195,268,.728,120,285,405,196,80,44,202,235,1115
5700,MIL,1993,Todd Day,23,71,37,1931,358,828,.432,54,184,.293,304,644,.472,.465,213,297,.717,144,147,291,117,75,48,118,222,983
5701,MIL,1993,Brad Lohaus,28,80,24,1766,283,614,.461,85,230,.370,198,384,.516,.530,73,101,.723,59,217,276,127,47,74,93,178,724
5702,MIL,1993,Lee Mayberry,22,82,4,1503,171,375,.456,43,110,.391,128,265,.483,.513,39,68,.574,26,92,118,273,59,7,85,148,424
5703,MIL,1993,Fred Roberts,32,79,5,1488,226,428,.528,12,29,.414,214,399,.536,.542,135,169,.799,91,146,237,118,57,27,67,138,599
5704,MIL,1993,Danny Schayes,33,70,7,1124,105,263,.399,0,3,.000,105,260,.404,.399,112,137,.818,72,177,249,78,36,36,65,148,322
5705,MIL,1993,Alvin Robertson,30,39,32,1065,139,290,.479,17,55,.309,122,235,.519,.509,44,70,.629,47,90,137,156,90,9,77,120,339
5706,MIL,1993,Jon Barry,23,47,0,552,76,206,.369,21,63,.333,55,143,.385,.420,33,49,.673,10,33,43,68,35,3,42,57,206
5707,MIL,1993,Derek Strong,24,23,0,339,42,92,.457,4,8,.500,38,84,.452,.478,68,85,.800,40,75,115,14,11,1,13,20,156
5708,MIL,1993,Alaa Abdelnaby,24,12,0,159,26,56,.464,0,1,.000,26,55,.473,.464,12,16,.750,12,25,37,10,6,4,13,24,64
5709,MIL,1993,Moses Malone,37,11,0,104,13,42,.310,0,0,,13,42,.310,.310,24,31,.774,22,24,46,7,1,8,10,6,50
5710,MIL,1993,Orlando Woolridge,33,8,0,78,18,33,.545,0,0,,18,33,.545,.545,7,9,.778,3,6,9,3,1,2,6,8,43
5711,MIL,1993,Anthony Pullard,26,8,0,37,8,18,.444,0,0,,8,18,.444,.444,1,3,.333,2,6,8,2,2,2,5,5,17
5712,MIL,1993,Alan Ogg,25,3,0,26,3,9,.333,0,0,,3,9,.333,.333,2,2,1.000,1,5,6,4,1,3,3,6,8
5713,MIL,1993,Alex Stivrins,30,3,0,25,4,11,.364,0,0,,4,11,.364,.364,3,4,.750,3,3,6,2,1,0,2,4,11
5714,MIL,1993,Dan O'Sullivan,24,3,0,7,1,2,.500,0,0,,1,2,.500,.500,3,4,.750,0,2,2,1,1,0,0,3,5
5715,MIL,1992,Moses Malone,36,82,77,2511,440,929,.474,3,8,.375,437,921,.474,.475,396,504,.786,320,424,744,93,74,64,150,136,1279
5716,MIL,1992,Alvin Robertson,29,82,79,2463,396,922,.430,67,210,.319,329,712,.462,.466,151,198,.763,175,175,350,360,210,32,223,263,1010
5717,MIL,1992,Jay Humphries,29,71,71,2261,377,803,.469,42,144,.292,335,659,.508,.496,195,249,.783,44,140,184,466,119,13,148,210,991
5718,MIL,1992,Dale Ellis,31,81,11,2191,485,1034,.469,138,329,.419,347,705,.492,.536,164,212,.774,92,161,253,104,57,18,119,151,1272
5719,MIL,1992,Larry Krystkowiak,27,79,16,1848,293,660,.444,0,5,.000,293,655,.447,.444,128,169,.757,131,298,429,114,54,12,115,218,714
5720,MIL,1992,Fred Roberts,31,80,63,1746,311,645,.482,19,37,.514,292,608,.480,.497,128,171,.749,103,154,257,122,52,40,122,177,769
5721,MIL,1992,Jeff Grayer,26,82,11,1659,309,689,.448,19,66,.288,290,623,.465,.462,102,153,.667,129,128,257,150,64,13,105,142,739
5722,MIL,1992,Frank Brickowski,32,65,60,1556,306,584,.524,3,6,.500,303,578,.524,.527,125,163,.767,97,247,344,122,60,23,112,223,740
5723,MIL,1992,Lester Conner,32,81,9,1420,103,239,.431,0,7,.000,103,232,.444,.431,81,115,.704,63,121,184,294,97,10,79,86,287
5724,MIL,1992,Brad Lohaus,27,70,8,1081,162,360,.450,57,144,.396,105,216,.486,.529,27,41,.659,65,184,249,74,40,71,46,144,408
5725,MIL,1992,Danny Schayes,32,43,4,726,83,199,.417,0,0,,83,199,.417,.417,74,96,.771,58,110,168,34,19,19,41,98,240
5726,MIL,1992,Steve Henson,23,50,1,386,52,144,.361,23,48,.479,29,96,.302,.441,23,29,.793,17,24,41,82,15,1,40,50,150
5727,MIL,1992,Dave Popson,27,5,0,26,3,7,.429,0,1,.000,3,6,.500,.429,1,2,.500,2,3,5,3,2,1,4,5,7
5728,MIL,1992,Jerome Lane,25,2,0,6,1,1,1.000,0,0,,1,1,1.000,1.000,1,2,.500,1,3,4,0,0,0,1,1,3
5729,MIL,1991,Jay Humphries,28,80,80,2726,482,960,.502,60,161,.373,422,799,.528,.533,191,239,.799,57,163,220,538,129,7,151,237,1215
5730,MIL,1991,Alvin Robertson,28,81,81,2598,438,904,.485,23,63,.365,415,841,.493,.497,199,263,.757,191,268,459,444,246,16,212,273,1098
5731,MIL,1991,Danny Schayes,31,82,38,2228,298,597,.499,0,5,.000,298,592,.503,.499,274,328,.835,174,361,535,98,55,61,106,264,870
5732,MIL,1991,Fred Roberts,30,82,82,2114,357,670,.533,4,25,.160,353,645,.547,.536,170,209,.813,107,174,281,135,63,29,135,190,888
5733,MIL,1991,Jack Sikma,35,77,44,1940,295,691,.427,46,135,.341,249,556,.448,.460,166,197,.843,108,333,441,143,65,64,130,218,802
5734,MIL,1991,Frank Brickowski,31,75,73,1912,372,706,.527,0,2,.000,372,704,.528,.527,198,248,.798,129,297,426,131,86,43,160,255,942
5735,MIL,1991,Jeff Grayer,25,82,7,1422,210,485,.433,0,3,.000,210,482,.436,.433,101,147,.687,111,135,246,123,48,9,86,98,521
5736,MIL,1991,Ricky Pierce,31,46,0,1327,359,720,.499,37,93,.398,322,627,.514,.524,282,311,.907,37,80,117,96,38,11,93,90,1037
5737,MIL,1991,Brad Lohaus,26,81,3,1219,179,415,.431,33,119,.277,146,296,.493,.471,37,54,.685,59,158,217,75,50,74,60,170,428
5738,MIL,1991,Steve Henson,22,68,0,690,79,189,.418,18,54,.333,61,135,.452,.466,38,42,.905,14,37,51,131,32,0,43,83,214
5739,MIL,1991,Dale Ellis,30,21,0,624,159,327,.486,30,68,.441,129,259,.498,.532,58,82,.707,38,43,81,31,16,5,32,53,406
5740,MIL,1991,Lester Conner,31,39,2,519,38,96,.396,0,3,.000,38,93,.409,.396,39,52,.750,10,45,55,107,48,1,31,37,115
5741,MIL,1991,Greg Anderson,26,26,0,247,27,73,.370,0,1,.000,27,72,.375,.370,16,28,.571,26,49,75,3,8,9,22,29,70
5742,MIL,1991,Frank Kornet,24,32,0,157,23,62,.371,5,18,.278,18,44,.409,.411,7,13,.538,10,14,24,9,5,1,11,28,58
5743,MIL,1991,Adrian Dantley,35,10,0,126,19,50,.380,1,3,.333,18,47,.383,.390,18,26,.692,8,5,13,9,5,0,6,8,57
5744,MIL,1991,Everette Stephens,24,3,0,6,2,3,.667,0,0,,2,3,.667,.667,2,2,1.000,0,0,0,2,0,0,0,0,6
5745,MIL,1990,Jay Humphries,27,81,81,2818,496,1005,.494,21,70,.300,475,935,.508,.504,224,285,.786,80,189,269,472,156,11,151,253,1237
5746,MIL,1990,Alvin Robertson,27,81,81,2599,476,946,.503,4,26,.154,472,920,.513,.505,197,266,.741,230,329,559,445,207,17,217,280,1153
5747,MIL,1990,Jack Sikma,34,71,70,2250,344,827,.416,68,199,.342,276,628,.439,.457,230,260,.885,109,383,492,229,76,48,139,244,986
5748,MIL,1990,Fred Roberts,29,82,66,2235,330,666,.495,2,11,.182,328,655,.501,.497,195,249,.783,107,204,311,147,56,25,130,210,857
5749,MIL,1990,Ricky Pierce,30,59,0,1709,503,987,.510,46,133,.346,457,854,.535,.533,307,366,.839,64,103,167,133,50,7,129,158,1359
5750,MIL,1990,Jeff Grayer,24,71,40,1427,224,487,.460,1,8,.125,223,479,.466,.461,99,152,.651,94,123,217,107,48,10,82,125,548
5751,MIL,1990,Paul Pressey,31,57,2,1400,239,506,.472,6,43,.140,233,463,.503,.478,144,190,.758,59,113,172,244,71,23,109,149,628
5752,MIL,1990,Brad Lohaus,25,52,17,1353,211,461,.458,46,121,.380,165,340,.485,.508,54,77,.701,77,211,288,106,44,66,64,145,522
5753,MIL,1990,Greg Anderson,25,60,28,1291,219,432,.507,0,0,,219,432,.507,.507,91,170,.535,112,261,373,24,32,54,80,176,529
5754,MIL,1990,Tony Brown,29,61,10,635,88,206,.427,5,20,.250,83,186,.446,.439,38,56,.679,39,33,72,41,32,4,51,79,219
5755,MIL,1990,Randy Breuer,29,30,8,554,86,186,.462,0,0,,86,186,.462,.462,32,51,.627,43,84,127,13,9,33,28,63,204
5756,MIL,1990,Frank Kornet,23,57,0,438,42,114,.368,5,20,.250,37,94,.394,.390,24,39,.615,25,46,71,21,14,3,23,54,113
5757,MIL,1990,Larry Krystkowiak,25,16,7,381,43,118,.364,0,2,.000,43,116,.371,.364,26,33,.788,16,60,76,25,10,2,19,41,112
5758,MIL,1990,Ben Coleman,28,22,0,305,46,97,.474,0,1,.000,46,96,.479,.474,34,41,.829,31,56,87,12,7,7,26,54,126
5759,MIL,1990,Tito Horford,24,35,0,236,18,62,.290,0,0,,18,62,.290,.290,15,24,.625,19,40,59,2,5,16,14,33,51
5760,MIL,1990,Gerald Henderson,34,11,0,129,11,26,.423,3,7,.429,8,19,.421,.481,2,2,1.000,3,9,12,13,8,0,8,14,27
5761,MIL,1990,Mike Dunleavy,35,5,0,43,4,14,.286,2,9,.222,2,5,.400,.357,7,8,.875,0,2,2,10,1,0,8,7,17
5762,MIL,1990,Jerry Sichting,33,1,0,27,0,6,.000,0,0,,0,6,.000,.000,3,4,.750,0,0,0,2,0,0,0,1,3
5763,MIL,1989,Terry Cummings,27,80,78,2824,730,1563,.467,7,15,.467,723,1548,.467,.469,362,460,.787,281,369,650,198,106,72,201,265,1829
5764,MIL,1989,Jack Sikma,33,80,80,2587,360,835,.431,82,216,.380,278,619,.449,.480,266,294,.905,141,482,623,289,85,61,145,300,1068
5765,MIL,1989,Larry Krystkowiak,24,80,77,2472,362,766,.473,4,12,.333,358,754,.475,.475,289,351,.823,198,412,610,107,93,9,147,219,1017
5766,MIL,1989,Jay Humphries,26,73,50,2220,345,714,.483,25,94,.266,320,620,.516,.501,129,158,.816,70,119,189,405,142,5,160,187,844
5767,MIL,1989,Paul Pressey,30,67,62,2170,307,648,.474,12,55,.218,295,593,.497,.483,187,241,.776,73,189,262,439,119,44,184,221,813
5768,MIL,1989,Ricky Pierce,29,75,4,2078,527,1018,.518,8,36,.222,519,982,.529,.522,255,297,.859,82,115,197,156,77,19,112,193,1317
5769,MIL,1989,Sidney Moncrief,31,62,50,1594,261,532,.491,25,73,.342,236,459,.514,.514,205,237,.865,46,126,172,188,65,13,94,114,752
5770,MIL,1989,Fred Roberts,28,71,3,1251,155,319,.486,3,14,.214,152,305,.498,.491,104,129,.806,68,141,209,66,36,23,80,126,417
5771,MIL,1989,Paul Mokeski,32,74,0,690,59,164,.360,7,26,.269,52,138,.377,.381,40,51,.784,63,124,187,36,29,21,35,153,165
5772,MIL,1989,Randy Breuer,28,48,4,513,86,179,.480,0,0,,86,179,.480,.480,28,51,.549,51,84,135,22,9,37,29,59,200
5773,MIL,1989,Rickey Green,34,30,0,501,72,132,.545,2,6,.333,70,126,.556,.553,17,19,.895,7,39,46,105,22,2,33,19,163
5774,MIL,1989,Tony Brown,28,29,0,274,36,73,.493,2,7,.286,34,66,.515,.507,18,23,.783,15,14,29,21,12,4,10,28,92
5775,MIL,1989,Mark Davis,25,31,0,251,48,97,.495,1,9,.111,47,88,.534,.500,26,32,.813,15,21,36,14,13,5,12,38,123
5776,MIL,1989,Jeff Grayer,23,11,2,200,32,73,.438,0,2,.000,32,71,.451,.438,17,20,.850,14,21,35,22,10,1,19,15,81
5777,MIL,1989,Tito Horford,23,25,0,112,15,46,.326,0,0,,15,46,.326,.326,12,19,.632,9,13,22,3,1,7,15,14,42
5778,MIL,1989,Andre Turner,24,4,0,13,3,6,.500,0,0,,3,6,.500,.500,0,0,,0,3,3,0,2,0,4,2,6
5779,MIL,1989,Mike Dunleavy,34,2,0,5,1,2,.500,1,2,.500,0,0,,.750,0,0,,0,0,0,0,0,0,0,0,3
5780,MIL,1988,Jack Sikma,32,82,82,2923,514,1058,.486,3,14,.214,511,1044,.489,.487,321,348,.922,195,514,709,279,93,80,157,316,1352
5781,MIL,1988,Terry Cummings,26,76,76,2629,675,1392,.485,1,3,.333,674,1389,.485,.485,270,406,.665,184,369,553,181,78,46,170,274,1621
5782,MIL,1988,Paul Pressey,29,75,75,2484,345,702,.491,8,39,.205,337,663,.508,.497,285,357,.798,130,245,375,523,112,34,198,233,983
5783,MIL,1988,Randy Breuer,27,81,73,2258,390,788,.495,0,0,,390,788,.495,.495,188,286,.657,191,360,551,103,46,107,107,198,968
5784,MIL,1988,John Lucas,34,81,22,1766,281,631,.445,51,151,.338,230,480,.479,.486,130,162,.802,29,130,159,392,88,3,125,102,743
5785,MIL,1988,Sidney Moncrief,30,56,51,1428,217,444,.489,5,31,.161,212,413,.513,.494,164,196,.837,58,122,180,204,41,14,86,109,603
5786,MIL,1988,Jerry Reynolds,25,62,21,1161,188,419,.449,3,7,.429,185,412,.449,.452,119,154,.773,70,90,160,104,74,32,104,97,498
5787,MIL,1988,Larry Krystkowiak,23,50,7,1050,128,266,.481,0,3,.000,128,263,.487,.481,103,127,.811,88,143,231,50,18,8,57,137,359
5788,MIL,1988,Craig Hodges,27,43,0,983,155,345,.449,55,118,.466,100,227,.441,.529,32,39,.821,12,34,46,109,30,0,49,80,397
5789,MIL,1988,Ricky Pierce,28,37,0,965,248,486,.510,3,14,.214,245,472,.519,.513,107,122,.877,30,53,83,73,21,7,57,94,606
5790,MIL,1988,Paul Mokeski,31,60,0,848,100,210,.476,0,4,.000,100,206,.485,.476,51,72,.708,70,151,221,22,27,27,49,194,251
5791,MIL,1988,Pace Mannion,27,35,1,477,48,118,.407,2,12,.167,46,106,.434,.415,25,37,.676,17,34,51,55,13,7,24,53,123
5792,MIL,1988,John Stroeder,29,41,0,271,29,79,.367,0,2,.000,29,77,.377,.367,20,30,.667,24,47,71,20,3,12,24,48,78
5793,MIL,1988,Jay Humphries,25,18,0,252,20,54,.370,0,2,.000,20,52,.385,.370,9,14,.643,5,18,23,41,20,1,19,23,49
5794,MIL,1988,Conner Henry,24,14,2,145,13,41,.317,2,6,.333,11,35,.314,.341,4,7,.571,5,14,19,29,4,1,14,11,32
5795,MIL,1988,Rickie Winslow,23,7,0,45,3,13,.231,0,1,.000,3,12,.250,.231,1,2,.500,3,4,7,2,1,0,4,9,7
5796,MIL,1988,Charles Davis,29,5,0,39,6,18,.333,0,2,.000,6,16,.375,.333,0,0,,1,2,3,3,2,1,5,4,12
5797,MIL,1988,Dave Hoppen,23,3,0,35,4,11,.364,0,0,,4,11,.364,.364,3,3,1.000,4,3,7,2,0,0,2,3,11
5798,MIL,1988,Andre Moore,23,3,0,16,2,3,.667,0,0,,2,3,.667,.667,0,2,.000,1,1,2,1,0,0,1,2,4
5799,MIL,1988,Dudley Bradley,30,2,0,5,0,1,.000,0,1,.000,0,0,,.000,0,0,,0,1,1,1,0,0,0,2,0
5800,MIL,1987,Terry Cummings,25,82,77,2770,729,1426,.511,0,3,.000,729,1423,.512,.511,249,376,.662,214,486,700,229,129,81,172,296,1707
5801,MIL,1987,Jack Sikma,31,82,82,2536,390,842,.463,0,2,.000,390,840,.464,.463,265,313,.847,208,614,822,203,88,90,160,328,1045
5802,MIL,1987,Ricky Pierce,27,79,31,2505,575,1077,.534,3,28,.107,572,1049,.545,.535,387,440,.880,117,149,266,144,64,24,120,222,1540
5803,MIL,1987,Craig Hodges,26,78,43,2147,315,682,.462,85,228,.373,230,454,.507,.524,131,147,.891,48,92,140,240,76,7,124,189,846
5804,MIL,1987,Paul Pressey,28,61,60,2057,294,616,.477,16,55,.291,278,561,.496,.490,242,328,.738,98,198,296,441,110,47,186,213,846
5805,MIL,1987,Randy Breuer,26,76,10,1467,241,497,.485,0,0,,241,497,.485,.485,118,202,.584,129,221,350,47,56,61,100,229,600
5806,MIL,1987,John Lucas,33,43,40,1358,285,624,.457,46,126,.365,239,498,.480,.494,137,174,.787,29,96,125,290,71,6,89,82,753
5807,MIL,1987,Sidney Moncrief,29,39,30,992,158,324,.488,8,31,.258,150,293,.512,.500,136,162,.840,57,70,127,121,27,10,63,73,460
5808,MIL,1987,Jerry Reynolds,24,58,24,963,140,356,.393,6,18,.333,134,338,.396,.402,118,184,.641,72,101,173,106,50,30,82,91,404
5809,MIL,1987,Dudley Bradley,29,68,2,900,76,213,.357,13,50,.260,63,163,.387,.387,47,58,.810,31,71,102,66,105,8,34,118,212
5810,MIL,1987,Paul Mokeski,30,62,3,626,52,129,.403,0,1,.000,52,128,.406,.403,46,64,.719,45,93,138,22,18,13,22,126,150
5811,MIL,1987,Keith Smith,22,42,4,461,57,150,.380,3,9,.333,54,141,.383,.390,21,28,.750,13,19,32,43,25,3,30,74,138
5812,MIL,1987,Junior Bridgeman,33,34,4,418,79,171,.462,1,6,.167,78,165,.473,.465,16,20,.800,14,38,52,35,10,2,15,50,175
5813,MIL,1987,Scott Skiles,22,13,0,205,18,62,.290,3,14,.214,15,48,.313,.315,10,12,.833,6,20,26,45,5,1,21,18,49
5814,MIL,1987,Marvin Webster,34,15,0,102,10,19,.526,1,1,1.000,9,18,.500,.553,6,8,.750,12,14,26,3,3,7,8,17,27
5815,MIL,1987,Hank McDowell,27,7,0,70,8,17,.471,0,0,,8,17,.471,.471,6,7,.857,9,10,19,2,2,0,3,14,22
5816,MIL,1987,Don Collins,28,6,0,57,10,28,.357,0,0,,10,28,.357,.357,5,7,.714,11,4,15,2,2,1,5,11,25
5817,MIL,1987,Chris Engler,27,5,0,48,3,12,.250,0,0,,3,12,.250,.250,1,1,1.000,3,13,16,3,1,1,0,10,7
5818,MIL,1987,Jerome Henderson,27,6,0,36,4,13,.308,0,0,,4,13,.308,.308,4,4,1.000,2,5,7,0,1,1,6,12,12
5819,MIL,1987,Mike Glenn,31,4,0,34,5,13,.385,0,0,,5,13,.385,.385,5,7,.714,0,2,2,1,1,0,0,3,15
5820,MIL,1987,Kenny Fields,24,4,0,22,6,8,.750,0,0,,6,8,.750,.750,1,5,.200,0,2,2,1,1,0,1,3,13
5821,MIL,1987,Cedric Henderson,21,2,0,6,2,3,.667,0,0,,2,3,.667,.667,2,2,1.000,1,4,5,0,0,0,3,1,6
5822,MIL,1986,Paul Pressey,27,80,80,2704,411,843,.488,8,44,.182,403,799,.504,.492,316,392,.806,127,272,399,623,168,71,240,247,1146
5823,MIL,1986,Terry Cummings,24,82,82,2669,681,1438,.474,0,2,.000,681,1436,.474,.474,265,404,.656,222,472,694,193,121,51,191,283,1627
5824,MIL,1986,Sidney Moncrief,28,73,72,2567,470,962,.489,33,103,.320,437,859,.509,.506,498,580,.859,115,219,334,357,103,18,174,178,1471
5825,MIL,1986,Ricky Pierce,26,81,8,2147,429,798,.538,3,23,.130,426,775,.550,.539,266,310,.858,94,137,231,177,83,6,107,252,1127
5826,MIL,1986,Alton Lister,27,81,19,1812,318,577,.551,0,2,.000,318,575,.553,.551,160,266,.602,199,393,592,101,49,142,161,300,796
5827,MIL,1986,Randy Breuer,25,82,63,1792,272,570,.477,0,1,.000,272,569,.478,.477,141,198,.712,159,299,458,114,50,116,122,214,685
5828,MIL,1986,Craig Hodges,25,66,66,1739,284,568,.500,73,162,.451,211,406,.520,.564,75,86,.872,39,78,117,229,74,2,89,157,716
5829,MIL,1986,Kenny Fields,23,78,3,1120,204,398,.513,0,4,.000,204,394,.518,.513,91,132,.689,59,144,203,79,51,15,77,170,499
5830,MIL,1986,Charles Davis,27,57,7,873,188,397,.474,3,24,.125,185,373,.496,.477,61,75,.813,60,110,170,55,26,7,50,113,440
5831,MIL,1986,Jeff Lamp,26,44,1,701,109,243,.449,3,13,.231,106,230,.461,.455,55,64,.859,34,87,121,64,20,3,30,88,276
5832,MIL,1986,Mike Glenn,30,38,1,573,94,190,.495,0,0,,94,190,.495,.495,47,49,.959,4,53,57,39,9,3,18,42,235
5833,MIL,1986,Paul Mokeski,29,45,0,521,59,139,.424,0,0,,59,139,.424,.424,25,34,.735,36,103,139,30,6,6,25,92,143
5834,MIL,1986,Jerry Reynolds,23,55,8,508,72,162,.444,1,2,.500,71,160,.444,.448,58,104,.558,37,43,80,86,43,19,52,57,203
5835,MIL,1986,Earl Jones,25,12,0,43,5,12,.417,0,0,,5,12,.417,.417,3,4,.750,4,6,10,4,0,1,7,13,13
5836,MIL,1986,Bryan Warrick,26,5,0,27,4,10,.400,1,2,.500,3,8,.375,.450,1,1,1.000,0,3,3,6,2,0,5,3,10
5837,MIL,1986,Derrick Rowland,26,2,0,9,1,3,.333,0,0,,1,3,.333,.333,1,2,.500,0,1,1,1,0,0,0,1,3
5838,MIL,1985,Paul Pressey,26,80,80,2876,480,928,.517,7,20,.350,473,908,.521,.521,317,418,.758,149,280,429,543,129,56,247,258,1284
5839,MIL,1985,Sidney Moncrief,27,73,72,2734,561,1162,.483,9,33,.273,552,1129,.489,.487,454,548,.828,149,242,391,382,117,39,184,197,1585
5840,MIL,1985,Terry Cummings,23,79,78,2722,759,1532,.495,0,1,.000,759,1531,.496,.495,343,463,.741,244,472,716,228,117,67,190,264,1861
5841,MIL,1985,Craig Hodges,24,82,63,2496,359,732,.490,47,135,.348,312,597,.523,.523,106,130,.815,74,112,186,349,96,1,135,262,871
5842,MIL,1985,Alton Lister,26,81,80,2091,322,598,.538,0,1,.000,322,597,.539,.538,154,262,.588,219,428,647,127,49,167,183,287,798
5843,MIL,1985,Paul Mokeski,28,79,6,1586,205,429,.478,0,2,.000,205,427,.480,.478,81,116,.698,107,303,410,99,28,35,85,266,491
5844,MIL,1985,Kevin Grevey,31,78,6,1182,190,424,.448,8,33,.242,182,391,.465,.458,88,107,.822,27,76,103,94,30,2,55,85,476
5845,MIL,1985,Randy Breuer,24,78,0,1083,162,317,.511,0,0,,162,317,.511,.511,89,127,.701,92,164,256,40,21,82,63,179,413
5846,MIL,1985,Ricky Pierce,25,44,3,882,165,307,.537,1,4,.250,164,303,.541,.539,102,124,.823,49,68,117,94,34,5,63,117,433
5847,MIL,1985,Charles Davis,26,57,2,746,151,346,.436,1,10,.100,150,336,.446,.438,48,58,.828,57,92,149,50,21,5,52,110,351
5848,MIL,1985,Kenny Fields,22,51,1,535,84,191,.440,0,0,,84,191,.440,.440,27,36,.750,41,43,84,38,9,10,32,84,195
5849,MIL,1985,Mike Dunleavy,30,19,19,433,64,135,.474,16,47,.340,48,88,.545,.533,25,29,.862,6,25,31,85,15,3,40,55,169
5850,MIL,1985,Paul Thompson,23,16,0,227,41,105,.390,0,7,.000,41,98,.418,.390,24,34,.706,21,21,42,20,15,5,15,42,106
5851,MIL,1985,Larry Micheaux,24,18,0,171,17,35,.486,0,0,,17,35,.486,.486,12,17,.706,18,26,44,13,8,7,8,26,46
5852,MIL,1985,Lorenzo Romar,26,4,0,16,1,8,.125,0,1,.000,1,7,.143,.125,0,0,,0,0,0,2,0,0,0,2,2
5853,MIL,1985,David Thirdkill,24,6,0,16,3,4,.750,0,0,,3,4,.750,.750,1,2,.500,1,1,2,0,0,0,0,1,7
5854,MIL,1985,Mark West,24,1,0,6,0,1,.000,0,0,,0,1,.000,.000,2,2,1.000,1,0,1,0,0,1,2,4,2
5855,MIL,1985,Chris Engler,25,1,0,3,0,2,.000,0,0,,0,2,.000,.000,0,0,,1,0,1,0,0,1,0,0,0
5856,MIL,1984,Sidney Moncrief,26,79,79,3075,560,1125,.498,5,18,.278,555,1107,.501,.500,529,624,.848,215,313,528,358,108,27,217,204,1654
5857,MIL,1984,Marques Johnson,27,74,74,2715,646,1288,.502,2,13,.154,644,1275,.505,.502,241,340,.709,173,307,480,315,115,45,180,194,1535
5858,MIL,1984,Junior Bridgeman,30,81,10,2431,509,1094,.465,6,31,.194,503,1063,.473,.468,196,243,.807,80,252,332,265,53,14,148,224,1220
5859,MIL,1984,Bob Lanier,35,72,72,2007,392,685,.572,0,3,.000,392,682,.575,.572,194,274,.708,141,314,455,186,58,51,163,228,978
5860,MIL,1984,Alton Lister,25,82,72,1955,256,512,.500,0,0,,256,512,.500,.500,114,182,.626,156,447,603,110,41,140,153,327,626
5861,MIL,1984,Paul Pressey,25,81,18,1730,276,528,.523,2,9,.222,274,519,.528,.525,120,200,.600,102,180,282,252,86,50,157,241,674
5862,MIL,1984,Harvey Catchings,32,69,3,1156,61,153,.399,0,1,.000,61,152,.401,.399,22,42,.524,89,182,271,43,25,81,57,172,144
5863,MIL,1984,Tiny Archibald,35,46,46,1038,136,279,.487,4,18,.222,132,261,.506,.495,64,101,.634,16,60,76,160,33,0,78,78,340
5864,MIL,1984,Lorenzo Romar,25,65,9,1007,159,346,.460,4,32,.125,155,314,.494,.465,65,90,.722,21,71,92,192,55,8,63,76,387
5865,MIL,1984,Kevin Grevey,30,64,3,923,178,395,.451,15,53,.283,163,342,.477,.470,75,84,.893,30,51,81,75,27,4,45,95,446
5866,MIL,1984,Paul Mokeski,27,68,4,838,102,213,.479,1,3,.333,101,210,.481,.481,50,72,.694,51,115,166,44,11,29,44,168,255
5867,MIL,1984,Randy Breuer,23,57,8,472,68,177,.384,0,0,,68,177,.384,.384,32,46,.696,48,61,109,17,11,38,35,98,168
5868,MIL,1984,Mike Dunleavy,29,17,12,404,70,127,.551,19,45,.422,51,82,.622,.626,32,40,.800,6,22,28,78,12,1,36,51,191
5869,MIL,1984,Charlie Criss,35,6,0,107,11,30,.367,1,6,.167,10,24,.417,.383,7,11,.636,2,7,9,17,5,0,4,7,30
5870,MIL,1984,Rory White,24,8,0,45,7,17,.412,0,0,,7,17,.412,.412,2,5,.400,5,3,8,1,2,1,5,3,16
5871,MIL,1984,Linton Townes,24,2,0,2,1,1,1.000,0,0,,1,1,1.000,1.000,0,0,,0,0,0,0,0,0,0,1,2
5872,MIL,1983,Marques Johnson,26,80,80,2853,723,1420,.509,4,20,.200,719,1400,.514,.511,264,359,.735,196,366,562,363,100,56,196,211,1714
5873,MIL,1983,Sidney Moncrief,25,76,76,2710,606,1156,.524,1,10,.100,605,1146,.528,.525,499,604,.826,192,245,437,300,113,23,197,180,1712
5874,MIL,1983,Alton Lister,24,80,37,1885,272,514,.529,0,0,,272,514,.529,.529,130,242,.537,168,400,568,111,50,177,186,328,674
5875,MIL,1983,Junior Bridgeman,29,70,5,1855,421,856,.492,1,13,.077,420,843,.498,.492,164,196,.837,44,202,246,207,40,9,122,155,1007
5876,MIL,1983,Harvey Catchings,31,74,33,1554,90,197,.457,0,0,,90,197,.457,.457,62,92,.674,132,276,408,77,26,148,83,224,242
5877,MIL,1983,Paul Pressey,24,79,18,1528,213,466,.457,1,9,.111,212,457,.464,.458,105,176,.597,83,198,281,207,99,47,162,174,532
5878,MIL,1983,Phil Ford,26,70,56,1447,193,410,.471,1,8,.125,192,402,.478,.472,90,113,.796,18,78,96,252,46,3,113,168,477
5879,MIL,1983,Brian Winters,30,57,12,1361,255,587,.434,22,68,.324,233,519,.449,.453,73,85,.859,35,75,110,156,45,4,81,132,605
5880,MIL,1983,Dave Cowens,34,40,34,1014,136,306,.444,0,2,.000,136,304,.447,.444,52,63,.825,73,201,274,82,30,15,44,137,324
5881,MIL,1983,Bob Lanier,34,39,35,978,163,332,.491,0,1,.000,163,331,.492,.491,91,133,.684,58,142,200,105,34,24,82,125,417
5882,MIL,1983,Charlie Criss,34,66,0,922,169,375,.451,6,31,.194,163,344,.474,.459,68,76,.895,14,65,79,127,27,0,44,44,412
5883,MIL,1983,Steve Mix,35,57,20,792,133,273,.487,1,4,.250,132,269,.491,.489,74,87,.851,37,99,136,68,33,3,45,70,341
5884,MIL,1983,Paul Mokeski,26,50,1,589,64,139,.460,0,1,.000,64,138,.464,.460,34,42,.810,29,93,122,23,9,21,40,138,162
5885,MIL,1983,Armond Hill,29,14,3,169,14,26,.538,0,0,,14,26,.538,.538,18,22,.818,5,15,20,27,9,0,13,20,46
5886,MIL,1983,Mickey Johnson,30,6,0,153,30,66,.455,0,2,.000,30,64,.469,.455,7,9,.778,9,16,25,11,1,2,12,22,67
5887,MIL,1983,Sam Pellom,31,4,0,20,4,10,.400,0,0,,4,10,.400,.400,0,0,,2,6,8,0,0,0,2,3,8
5888,MIL,1982,Sidney Moncrief,24,80,80,2980,556,1063,.523,1,14,.071,555,1049,.529,.524,468,573,.817,221,313,534,382,138,22,208,206,1581
5889,MIL,1982,Quinn Buckner,27,70,70,2156,396,822,.482,4,15,.267,392,807,.486,.484,110,168,.655,77,173,250,328,174,3,180,218,906
5890,MIL,1982,Bob Lanier,33,74,72,1986,407,729,.558,0,2,.000,407,727,.560,.558,182,242,.752,92,296,388,219,72,56,166,211,996
5891,MIL,1982,Mickey Johnson,29,76,71,1934,372,757,.491,1,7,.143,371,750,.495,.492,233,291,.801,133,321,454,215,72,45,191,240,978
5892,MIL,1982,Marques Johnson,25,60,52,1900,404,760,.532,0,4,.000,404,756,.534,.532,182,260,.700,153,211,364,213,59,35,145,142,990
5893,MIL,1982,Brian Winters,29,61,13,1829,404,806,.501,36,93,.387,368,713,.516,.524,123,156,.788,51,119,170,253,57,9,118,187,967
5894,MIL,1982,Harvey Catchings,30,80,9,1603,94,224,.420,0,0,,94,224,.420,.420,41,69,.594,129,227,356,97,42,134,94,237,229
5895,MIL,1982,Scott May,27,65,7,1187,212,417,.508,0,4,.000,212,413,.513,.508,159,193,.824,85,133,218,133,50,6,92,151,583
5896,MIL,1982,Alton Lister,23,80,23,1186,149,287,.519,0,0,,149,287,.519,.519,64,123,.520,108,279,387,84,18,118,129,239,362
5897,MIL,1982,Pat Cummings,25,78,7,1132,219,430,.509,0,2,.000,219,428,.512,.509,67,91,.736,61,184,245,99,22,9,108,227,505
5898,MIL,1982,Junior Bridgeman,28,41,4,924,209,433,.483,4,9,.444,205,424,.483,.487,89,103,.864,37,88,125,109,28,3,64,91,511
5899,MIL,1982,Robert Smith,26,17,1,316,52,110,.473,2,10,.200,50,100,.500,.482,10,12,.833,1,13,14,44,10,1,14,35,116
5900,MIL,1982,Geoff Crompton,26,35,1,203,11,32,.344,0,0,,11,32,.344,.344,6,15,.400,10,31,41,13,6,12,17,39,28
5901,MIL,1982,Mike Evans,26,14,0,196,24,51,.471,0,2,.000,24,49,.490,.471,8,12,.667,3,9,12,22,9,0,15,26,56
5902,MIL,1982,Bob Dandridge,34,11,0,174,21,55,.382,0,0,,21,55,.382,.382,10,17,.588,4,13,17,13,5,2,11,25,52
5903,MIL,1982,Kevin Stacom,30,7,0,90,14,34,.412,1,2,.500,13,32,.406,.426,1,2,.500,2,5,7,7,1,0,9,6,30
5904,MIL,1982,Brad Holland,25,1,0,9,0,5,.000,0,0,,0,5,.000,.000,0,2,.000,0,0,0,2,0,0,1,1,0
5905,MIL,1981,Marques Johnson,24,76,,2542,636,1153,.552,0,9,.000,636,1144,.556,.552,269,381,.706,225,293,518,346,115,41,190,196,1541
5906,MIL,1981,Sidney Moncrief,23,80,,2417,400,739,.541,2,9,.222,398,730,.545,.543,320,398,.804,186,220,406,264,90,37,145,156,1122
5907,MIL,1981,Quinn Buckner,26,82,82,2384,471,956,.493,1,6,.167,470,950,.495,.493,149,203,.734,88,210,298,384,197,3,236,271,1092
5908,MIL,1981,Junior Bridgeman,27,77,,2215,537,1102,.487,3,21,.143,534,1081,.494,.489,213,241,.884,78,211,289,234,88,28,150,182,1290
5909,MIL,1981,Mickey Johnson,28,82,82,2118,379,846,.448,3,18,.167,376,828,.454,.450,262,332,.789,183,362,545,286,94,71,230,256,1023
5910,MIL,1981,Brian Winters,28,69,,1771,331,697,.475,18,51,.353,313,646,.485,.488,119,137,.869,32,108,140,229,70,10,136,185,799
5911,MIL,1981,Bob Lanier,32,67,,1753,376,716,.525,1,1,1.000,375,715,.524,.526,208,277,.751,128,285,413,179,73,81,139,184,961
5912,MIL,1981,Harvey Catchings,29,77,,1635,134,300,.447,0,0,,134,300,.447,.447,59,92,.641,154,319,473,99,33,184,105,284,327
5913,MIL,1981,Pat Cummings,24,74,,1084,248,460,.539,0,2,.000,248,458,.541,.539,99,140,.707,97,195,292,62,31,19,114,192,595
5914,MIL,1981,Len Elmore,28,72,,925,76,212,.358,0,0,,76,212,.358,.358,54,75,.720,68,140,208,69,37,52,44,178,206
5915,MIL,1981,Mike Evans,25,71,,911,134,291,.460,2,14,.143,132,277,.477,.464,50,64,.781,22,65,87,167,34,4,72,114,320
5916,MIL,1980,Marques Johnson,23,77,,2686,689,1267,.544,2,9,.222,687,1258,.546,.545,291,368,.791,217,349,566,273,100,70,185,173,1671
5917,MIL,1980,Brian Winters,27,80,,2623,535,1116,.479,38,102,.373,497,1014,.490,.496,184,214,.860,48,175,223,362,101,28,186,208,1292
5918,MIL,1980,Junior Bridgeman,26,81,,2316,594,1243,.478,5,27,.185,589,1216,.484,.480,230,266,.865,104,197,301,237,94,20,172,216,1423
5919,MIL,1980,Dave Meyers,26,79,,2204,399,830,.481,1,5,.200,398,825,.482,.481,156,246,.634,140,308,448,225,72,40,182,218,955
5920,MIL,1980,Quinn Buckner,25,67,,1690,306,655,.467,2,5,.400,304,650,.468,.469,105,143,.734,69,169,238,383,135,4,149,202,719
5921,MIL,1980,Sidney Moncrief,22,77,,1557,211,451,.468,0,1,.000,211,450,.469,.468,232,292,.795,154,184,338,133,72,16,117,106,654
5922,MIL,1980,Kent Benson,25,56,,1389,213,431,.494,0,1,.000,213,430,.495,.494,66,97,.680,96,237,333,127,54,74,106,178,492
5923,MIL,1980,Harvey Catchings,28,72,,1366,97,244,.398,0,1,.000,97,243,.399,.398,39,62,.629,164,246,410,82,23,162,68,191,233
5924,MIL,1980,Lloyd Walton,26,76,,1243,110,242,.455,1,3,.333,109,239,.456,.457,49,71,.690,33,58,91,285,43,2,112,68,270
5925,MIL,1980,Richard Washington,24,75,,1092,197,421,.468,0,0,,197,421,.468,.468,46,76,.605,95,181,276,55,26,48,63,166,440
5926,MIL,1980,Pat Cummings,23,71,,900,187,370,.505,0,0,,187,370,.505,.505,94,123,.764,81,157,238,53,22,17,74,141,468
5927,MIL,1980,Bob Lanier,31,26,,739,147,283,.519,1,1,1.000,146,282,.518,.521,113,144,.785,44,135,179,62,36,29,49,70,408
5928,ATL,2024,Dejounte Murray,27,78,78,2783,672,1463,.459,201,554,.363,471,909,.518,.528,208,262,.794,62,354,416,502,111,24,201,138,1753
5929,ATL,2024,Bogdan Bogdanović,31,79,33,2401,471,1100,.428,240,641,.374,231,459,.503,.537,151,164,.921,53,219,272,247,96,26,112,179,1333
5930,ATL,2024,Saddiq Bey,24,63,51,2062,290,697,.416,113,358,.316,177,339,.522,.497,170,203,.837,167,244,411,92,51,11,54,88,863
5931,ATL,2024,Trae Young,25,54,54,1942,433,1008,.430,175,469,.373,258,539,.479,.516,348,407,.855,23,126,149,583,72,11,235,109,1389
5932,ATL,2024,Jalen Johnson,22,56,52,1889,359,702,.511,71,200,.355,288,502,.574,.562,107,147,.728,74,414,488,203,67,47,101,133,896
5933,ATL,2024,Clint Capela,29,73,73,1883,353,618,.571,0,1,.000,353,617,.572,.571,130,206,.631,335,441,776,91,43,106,74,164,836
5934,ATL,2024,De'Andre Hunter,26,57,37,1681,304,663,.459,117,304,.385,187,359,.521,.547,166,196,.847,31,191,222,87,40,16,83,146,891
5935,ATL,2024,Onyeka Okongwu,23,55,8,1405,223,365,.611,23,69,.333,200,296,.676,.642,92,116,.793,145,231,376,74,26,60,45,162,561
5936,ATL,2024,Garrison Mathews,27,66,5,992,103,226,.456,85,193,.440,18,33,.545,.644,34,42,.810,17,75,92,37,20,8,19,115,325
5937,ATL,2024,Bruno Fernando,25,45,2,682,109,187,.583,0,4,.000,109,183,.596,.583,64,96,.667,59,134,193,46,25,28,44,107,282
5938,ATL,2024,Vit Krejci,23,22,14,541,51,104,.490,28,68,.412,23,36,.639,.625,5,6,.833,11,41,52,50,13,6,20,48,135
5939,ATL,2024,Trent Forrest,25,38,0,414,34,90,.378,2,10,.200,32,80,.400,.389,13,17,.765,11,40,51,92,11,3,20,25,83
5940,ATL,2024,Wesley Matthews,37,36,3,413,34,97,.351,24,69,.348,10,28,.357,.474,18,24,.750,9,44,53,23,16,11,8,43,110
5941,ATL,2024,Patty Mills,35,19,0,202,19,51,.373,13,34,.382,6,17,.353,.500,0,0,,5,15,20,14,9,1,8,17,51
5942,ATL,2024,Kobe Bufkin,20,17,0,196,34,92,.370,9,40,.225,25,52,.481,.418,4,8,.500,6,27,33,27,7,5,10,20,81
5943,ATL,2024,AJ Griffin,20,20,0,171,18,62,.290,10,39,.256,8,23,.348,.371,2,2,1.000,2,16,18,5,1,2,8,6,48
5944,ATL,2024,Mouhamed Gueye,21,6,0,73,8,23,.348,3,9,.333,5,14,.357,.413,5,6,.833,10,12,22,4,5,4,1,13,24
5945,ATL,2024,Dylan Windler,27,6,0,73,10,19,.526,8,17,.471,2,2,1.000,.737,0,0,,3,9,12,3,2,0,2,3,28
5946,ATL,2024,Seth Lundy,23,9,0,52,4,17,.235,3,13,.231,1,4,.250,.324,3,4,.750,1,6,7,0,0,0,1,6,14
5947,ATL,2023,Dejounte Murray,26,74,74,2693,612,1319,.464,133,387,.344,479,932,.514,.514,158,190,.832,53,336,389,448,112,19,160,106,1515
5948,ATL,2023,Trae Young,24,73,73,2541,597,1390,.429,154,460,.335,443,930,.476,.485,566,639,.886,56,161,217,741,80,9,300,104,1914
5949,ATL,2023,John Collins,25,71,71,2130,359,707,.508,70,240,.292,289,467,.619,.557,143,178,.803,77,385,462,85,42,73,79,220,931
5950,ATL,2023,De'Andre Hunter,25,67,67,2126,379,822,.461,100,286,.350,279,536,.521,.522,171,207,.826,46,238,284,94,35,17,82,199,1029
5951,ATL,2023,Onyeka Okongwu,22,80,18,1849,317,497,.638,4,13,.308,313,484,.647,.642,153,196,.781,217,359,576,81,56,107,81,251,791
5952,ATL,2023,Clint Capela,28,65,63,1730,350,536,.653,0,1,.000,350,535,.654,.653,79,131,.603,258,459,717,58,45,79,54,139,779
5953,ATL,2023,Bogdan Bogdanović,30,54,9,1508,273,611,.447,146,360,.406,127,251,.506,.566,64,77,.831,23,142,165,150,43,18,65,86,756
5954,ATL,2023,AJ Griffin,19,72,12,1401,248,533,.465,101,259,.390,147,274,.536,.560,42,47,.894,37,116,153,73,42,12,42,87,639
5955,ATL,2023,Jalen Johnson,21,70,6,1042,158,322,.491,30,104,.288,128,218,.587,.537,49,78,.628,51,231,282,83,38,34,41,113,395
5956,ATL,2023,Aaron Holiday,26,63,6,845,92,220,.418,36,88,.409,56,132,.424,.500,27,32,.844,25,49,74,89,37,12,36,79,247
5957,ATL,2023,Saddiq Bey,23,25,7,629,108,230,.470,50,125,.400,58,105,.552,.578,25,29,.862,39,81,120,34,20,1,17,37,291
5958,ATL,2023,Justin Holiday,33,28,0,411,48,125,.384,30,87,.345,18,38,.474,.504,0,0,,2,21,23,25,5,10,12,37,126
5959,ATL,2023,Trent Forrest,24,23,3,277,25,60,.417,0,2,.000,25,58,.431,.417,2,3,.667,5,32,37,38,7,2,15,17,52
5960,ATL,2023,Frank Kaminsky,29,26,0,176,25,44,.568,11,23,.478,14,21,.667,.693,10,12,.833,3,33,36,21,5,1,9,21,71
5961,ATL,2023,Vit Krejci,22,29,0,165,15,37,.405,5,21,.238,10,16,.625,.473,1,2,.500,6,20,26,17,5,1,5,17,36
5962,ATL,2023,Jarrett Culver,23,10,1,137,17,43,.395,1,12,.083,16,31,.516,.407,9,13,.692,10,28,38,6,6,2,7,14,44
5963,ATL,2023,Garrison Mathews,26,9,0,84,13,31,.419,10,25,.400,3,6,.500,.581,7,8,.875,1,10,11,3,1,1,1,6,43
5964,ATL,2023,Tyrese Martin,23,16,0,66,9,23,.391,1,7,.143,8,16,.500,.413,2,2,1.000,5,7,12,2,1,0,2,2,21
5965,ATL,2023,Bruno Fernando,24,8,0,41,11,19,.579,0,3,.000,11,16,.688,.579,5,6,.833,6,9,15,1,0,3,5,6,27
5966,ATL,2023,Donovan Williams,21,2,0,4,2,5,.400,0,2,.000,2,3,.667,.400,0,0,,0,2,2,0,0,0,0,0,4
5967,ATL,2022,Trae Young,23,76,76,2652,711,1544,.460,233,610,.382,478,934,.512,.536,500,553,.904,50,234,284,737,72,7,303,128,2155
5968,ATL,2022,Kevin Huerter,23,74,60,2188,345,760,.454,160,411,.389,185,349,.530,.559,42,52,.808,32,222,254,203,55,26,91,185,892
5969,ATL,2022,Clint Capela,27,74,73,2042,370,604,.613,0,1,.000,370,603,.614,.613,80,169,.473,279,598,877,92,55,93,44,166,820
5970,ATL,2022,Bogdan Bogdanović,29,63,27,1848,342,794,.431,169,459,.368,173,335,.516,.537,97,115,.843,29,221,250,194,68,14,70,132,950
5971,ATL,2022,Danilo Gallinari,33,66,18,1672,259,597,.434,112,294,.381,147,303,.485,.528,141,156,.904,35,273,308,101,28,12,38,93,771
5972,ATL,2022,John Collins,24,54,53,1663,339,644,.526,64,176,.364,275,468,.588,.576,134,169,.793,93,329,422,98,33,56,60,164,876
5973,ATL,2022,De'Andre Hunter,24,53,52,1577,254,575,.442,74,195,.379,180,380,.474,.506,127,166,.765,26,150,176,68,36,21,69,155,709
5974,ATL,2022,Delon Wright,29,77,8,1452,122,269,.454,44,116,.379,78,153,.510,.535,54,63,.857,50,170,220,188,93,19,45,56,342
5975,ATL,2022,Onyeka Okongwu,21,48,6,992,156,226,.690,0,0,,156,226,.690,.690,80,110,.727,115,168,283,53,31,60,44,149,392
5976,ATL,2022,Lou Williams,35,56,0,799,125,320,.391,37,102,.363,88,218,.404,.448,67,78,.859,16,71,87,105,28,3,43,48,354
5977,ATL,2022,Cam Reddish,22,34,7,797,138,343,.402,58,153,.379,80,190,.421,.487,72,80,.900,20,64,84,38,35,11,44,45,406
5978,ATL,2022,Timothé Luwawu-Cabarrot,26,52,18,685,74,186,.398,44,122,.361,30,64,.469,.516,35,41,.854,17,65,82,40,18,6,20,76,227
5979,ATL,2022,Gorgui Dieng,32,44,3,371,53,112,.473,29,68,.426,24,44,.545,.603,19,26,.731,32,89,121,34,11,13,20,52,154
5980,ATL,2022,Skylar Mays,24,28,5,220,32,64,.500,8,25,.320,24,39,.615,.563,8,9,.889,5,20,25,17,7,0,10,9,80
5981,ATL,2022,Solomon Hill,30,13,1,139,3,20,.150,2,13,.154,1,7,.143,.200,0,0,,6,17,23,12,4,2,1,16,8
5982,ATL,2022,Jalen Johnson,20,22,0,120,22,41,.537,3,13,.231,19,28,.679,.573,5,7,.714,2,24,26,3,3,2,9,9,52
5983,ATL,2022,Kevin Knox,22,17,0,111,16,45,.356,5,26,.192,11,19,.579,.411,9,12,.750,6,16,22,7,2,1,2,14,46
5984,ATL,2022,Chaundee Brown Jr.,23,3,2,83,9,25,.360,6,15,.400,3,10,.300,.480,5,6,.833,1,13,14,4,2,0,0,7,29
5985,ATL,2022,Wes Iwundu,27,3,1,82,8,18,.444,3,5,.600,5,13,.385,.528,3,4,.750,3,10,13,0,1,0,1,8,22
5986,ATL,2022,Lance Stephenson,31,6,0,70,5,13,.385,0,3,.000,5,10,.500,.385,1,2,.500,1,14,15,11,0,0,4,8,11
5987,ATL,2022,Malcolm Hill,26,3,0,46,5,8,.625,3,5,.600,2,3,.667,.813,4,4,1.000,2,4,6,1,4,1,0,7,17
5988,ATL,2022,Cameron Oliver,25,2,0,43,10,15,.667,1,3,.333,9,12,.750,.700,2,3,.667,2,4,6,3,1,1,0,5,23
5989,ATL,2022,Sharife Cooper,20,13,0,39,3,14,.214,1,6,.167,2,8,.250,.250,0,0,,0,5,5,5,0,0,5,1,7
5990,ATL,2022,Cat Barber,27,3,0,13,0,4,.000,0,0,,0,4,.000,.000,0,4,.000,1,2,3,3,0,0,1,1,0
5991,ATL,2021,Kevin Huerter,22,69,49,2126,316,731,.432,140,386,.363,176,345,.510,.528,50,64,.781,38,193,231,241,82,18,79,165,822
5992,ATL,2021,Trae Young,22,63,63,2125,487,1112,.438,136,397,.343,351,715,.491,.499,484,546,.886,38,207,245,594,53,12,261,111,1594
5993,ATL,2021,Clint Capela,26,63,63,1898,413,695,.594,0,0,,413,695,.594,.594,130,227,.573,297,606,903,49,44,129,73,145,956
5994,ATL,2021,John Collins,23,63,63,1848,429,771,.556,83,208,.399,346,563,.615,.610,170,204,.833,118,349,467,78,34,63,84,193,1111
5995,ATL,2021,Solomon Hill,29,71,16,1513,107,298,.359,68,212,.321,39,86,.453,.473,35,46,.761,42,172,214,75,50,11,42,116,317
5996,ATL,2021,Bogdan Bogdanović,28,44,27,1305,267,565,.473,146,333,.438,121,232,.522,.602,40,44,.909,20,140,160,147,49,13,54,99,720
5997,ATL,2021,Danilo Gallinari,32,51,4,1222,206,475,.434,103,254,.406,103,221,.466,.542,161,174,.925,17,194,211,76,30,10,43,105,676
5998,ATL,2021,Tony Snell,29,47,23,992,88,171,.515,62,109,.569,26,62,.419,.696,11,11,1.000,18,94,112,59,13,11,21,75,249
5999,ATL,2021,Cam Reddish,21,26,21,750,96,263,.365,33,126,.262,63,137,.460,.428,67,82,.817,22,82,104,35,33,9,34,68,292
6000,ATL,2021,De'Andre Hunter,23,23,19,678,120,248,.484,31,95,.326,89,153,.582,.546,73,85,.859,17,93,110,44,19,12,29,59,344
6001,ATL,2021,Brandon Goodwin,25,47,5,620,84,223,.377,32,103,.311,52,120,.433,.448,28,43,.651,8,61,69,95,17,0,36,41,228
6002,ATL,2021,Onyeka Okongwu,20,50,4,601,96,149,.644,0,3,.000,96,146,.658,.644,36,57,.632,62,101,163,18,23,33,29,100,228
6003,ATL,2021,Lou Williams,34,24,1,505,84,216,.389,24,54,.444,60,162,.370,.444,47,54,.870,6,44,50,81,8,2,42,20,239
6004,ATL,2021,Rajon Rondo,34,27,2,402,44,110,.400,17,45,.378,27,65,.415,.477,1,2,.500,4,51,55,95,19,2,39,25,106
6005,ATL,2021,Nathan Knight,23,33,0,279,37,100,.370,6,33,.182,31,67,.463,.400,44,55,.800,27,45,72,8,9,10,15,22,124
6006,ATL,2021,Skylar Mays,23,33,0,269,44,98,.449,14,40,.350,30,58,.517,.520,22,25,.880,10,25,35,30,14,2,9,15,124
6007,ATL,2021,Bruno Fernando,22,33,0,226,18,44,.409,0,2,.000,18,42,.429,.409,15,22,.682,16,62,78,10,4,3,21,23,51
6008,ATL,2021,Kris Dunn,26,4,0,45,1,12,.083,0,2,.000,1,10,.100,.083,3,4,.750,0,6,6,2,2,2,3,10,5
6009,ATL,2020,Trae Young,21,60,60,2120,546,1249,.437,205,568,.361,341,681,.501,.519,481,559,.860,32,223,255,560,65,8,289,104,1778
6010,ATL,2020,De'Andre Hunter,22,63,62,2018,280,683,.410,108,304,.355,172,379,.454,.489,110,144,.764,44,242,286,112,44,18,103,182,778
6011,ATL,2020,Kevin Huerter,21,56,48,1760,252,610,.413,127,334,.380,125,276,.453,.517,53,64,.828,35,193,228,213,51,27,87,139,684
6012,ATL,2020,Cam Reddish,20,58,34,1551,213,554,.384,83,250,.332,130,304,.428,.459,101,126,.802,35,181,216,87,62,28,96,132,610
6013,ATL,2020,John Collins,22,41,41,1363,353,605,.583,59,147,.401,294,458,.642,.632,120,150,.800,116,300,416,60,31,66,75,138,885
6014,ATL,2020,DeAndre' Bembry,25,43,4,915,104,228,.456,15,65,.231,89,163,.546,.489,26,48,.542,34,118,152,81,55,19,60,84,249
6015,ATL,2020,Damian Jones,24,55,27,887,121,178,.680,2,9,.222,119,169,.704,.685,62,84,.738,74,132,206,35,26,40,28,149,306
6016,ATL,2020,Vince Carter,43,60,0,876,107,304,.352,61,202,.302,46,102,.451,.452,23,29,.793,18,106,124,48,23,25,33,90,298
6017,ATL,2020,Jabari Parker,24,32,23,837,198,393,.504,31,115,.270,167,278,.601,.543,53,72,.736,54,137,191,58,42,15,60,93,480
6018,ATL,2020,Alex Len,26,40,9,745,142,260,.546,14,56,.250,128,204,.627,.573,51,81,.630,69,161,230,42,20,33,39,93,349
6019,ATL,2020,Bruno Fernando,21,56,13,713,103,199,.518,5,37,.135,98,162,.605,.530,29,51,.569,67,131,198,49,18,17,42,107,240
6020,ATL,2020,Allen Crabbe,27,28,1,522,52,143,.364,30,93,.323,22,50,.440,.469,9,12,.750,10,55,65,28,15,4,12,36,143
6021,ATL,2020,Jeff Teague,31,25,4,519,68,165,.412,10,30,.333,58,135,.430,.442,47,53,.887,12,42,54,100,19,6,40,36,193
6022,ATL,2020,Brandon Goodwin,24,34,1,430,76,190,.400,26,87,.299,50,103,.485,.468,28,30,.933,11,61,72,51,12,4,29,43,206
6023,ATL,2020,Treveon Graham,26,22,0,266,25,67,.373,13,37,.351,12,30,.400,.470,9,19,.474,22,28,50,15,7,4,10,36,72
6024,ATL,2020,Evan Turner,31,19,0,251,25,67,.373,0,5,.000,25,62,.403,.373,12,14,.857,8,30,38,38,9,8,26,20,62
6025,ATL,2020,Dewayne Dedmon,30,10,8,233,33,84,.393,8,36,.222,25,48,.521,.440,7,8,.875,14,68,82,7,10,15,10,40,81
6026,ATL,2020,Tyrone Wallace,25,14,0,160,14,44,.318,1,15,.067,13,29,.448,.330,11,17,.647,3,19,22,13,7,1,10,19,40
6027,ATL,2020,Chandler Parsons,31,5,0,54,5,18,.278,4,14,.286,1,4,.250,.389,0,0,,1,6,7,3,4,1,3,3,14
6028,ATL,2020,Charlie Brown Jr.,22,10,0,40,6,19,.316,3,9,.333,3,10,.300,.395,5,5,1.000,2,2,4,2,2,2,3,3,20
6029,ATL,2020,Paul Watson,25,2,0,17,0,7,.000,0,3,.000,0,4,.000,.000,0,0,,0,2,2,3,1,0,0,1,0
6030,ATL,2019,Trae Young,20,81,81,2503,525,1256,.418,156,482,.324,369,774,.477,.480,343,414,.829,64,237,301,653,72,15,308,140,1549
6031,ATL,2019,Kevin Huerter,20,75,59,2048,275,657,.419,136,353,.385,139,304,.457,.522,41,56,.732,60,185,245,214,65,25,109,155,727
6032,ATL,2019,DeAndre' Bembry,24,82,15,1931,275,616,.446,50,173,.289,225,443,.508,.487,87,136,.640,54,304,358,202,105,41,142,190,687
6033,ATL,2019,John Collins,21,61,59,1829,465,831,.560,55,158,.348,410,673,.609,.593,203,266,.763,219,376,595,121,22,39,120,199,1188
6034,ATL,2019,Kent Bazemore,29,67,35,1643,278,691,.402,96,300,.320,182,391,.465,.472,127,175,.726,37,224,261,152,89,42,121,170,779
6035,ATL,2019,Dewayne Dedmon,29,64,52,1609,259,526,.492,83,217,.382,176,309,.570,.571,92,113,.814,105,375,480,90,69,71,84,214,693
6036,ATL,2019,Taurean Prince,24,55,47,1552,262,594,.441,123,315,.390,139,279,.498,.545,95,116,.819,22,177,199,118,53,19,100,141,742
6037,ATL,2019,Alex Len,25,77,31,1544,320,648,.494,74,204,.363,246,444,.554,.551,140,216,.648,158,266,424,86,27,69,97,200,854
6038,ATL,2019,Vince Carter,42,76,9,1330,196,468,.419,123,316,.389,73,152,.480,.550,47,66,.712,31,163,194,87,44,27,48,141,562
6039,ATL,2019,Jeremy Lin,30,51,1,1003,180,386,.466,44,132,.333,136,254,.535,.523,142,168,.845,16,103,119,181,38,7,98,96,546
6040,ATL,2019,Omari Spellman,21,46,11,805,98,244,.402,44,128,.344,54,116,.466,.492,32,45,.711,72,122,194,47,26,25,31,67,272
6041,ATL,2019,Justin Anderson,25,48,4,463,64,157,.408,24,77,.312,40,80,.500,.484,26,35,.743,24,60,84,23,22,13,23,48,178
6042,ATL,2019,Jaylen Adams,22,34,1,428,38,110,.345,25,74,.338,13,36,.361,.459,7,9,.778,11,49,60,65,14,5,28,45,108
6043,ATL,2019,Alex Poythress,25,21,1,305,40,81,.494,9,23,.391,31,58,.534,.549,18,29,.621,29,47,76,17,4,10,13,47,107
6044,ATL,2019,Tyler Dorsey,22,27,0,251,32,89,.360,10,39,.256,22,50,.440,.416,16,26,.615,9,34,43,17,7,1,10,20,90
6045,ATL,2019,Daniel Hamilton,23,19,3,204,23,60,.383,8,23,.348,15,37,.405,.450,3,6,.500,10,37,47,22,6,1,16,19,57
6046,ATL,2019,Miles Plumlee,30,18,0,173,32,48,.667,0,0,,32,48,.667,.667,16,30,.533,16,23,39,17,6,4,10,14,80
6047,ATL,2019,Deyonta Davis,22,9,0,118,15,22,.682,0,1,.000,15,21,.714,.682,6,10,.600,10,26,36,5,3,5,3,12,36
6048,ATL,2019,Isaac Humphries,21,5,1,56,6,21,.286,3,11,.273,3,10,.300,.357,0,0,,4,7,11,0,1,0,0,7,15
6049,ATL,2019,B.J. Johnson,23,6,0,43,8,16,.500,3,6,.500,5,10,.500,.594,2,2,1.000,2,6,8,0,2,0,2,3,21
6050,ATL,2019,Tyler Zeller,29,2,0,11,0,2,.000,0,1,.000,0,1,.000,.000,0,0,,2,4,6,1,0,0,0,4,0
6051,ATL,2019,Jordan Sibert,26,1,0,4,1,1,1.000,1,1,1.000,0,0,,1.500,0,0,,0,0,0,0,0,0,0,0,3
6052,ATL,2018,Taurean Prince,23,82,82,2464,415,975,.426,176,457,.385,239,518,.461,.516,152,180,.844,50,339,389,214,85,42,191,168,1158
6053,ATL,2018,Dennis Schröder,24,67,67,2078,500,1146,.436,76,262,.290,424,884,.480,.469,225,265,.849,44,164,208,417,72,6,183,147,1301
6054,ATL,2018,Kent Bazemore,28,65,65,1789,284,676,.420,108,274,.394,176,402,.438,.500,160,201,.796,25,223,248,228,100,45,157,147,836
6055,ATL,2018,John Collins,20,74,26,1785,314,545,.576,16,47,.340,298,498,.598,.591,133,186,.715,176,365,541,98,47,80,105,215,777
6056,ATL,2018,Dewayne Dedmon,28,62,46,1542,250,477,.524,50,141,.355,200,336,.595,.577,67,86,.779,100,389,489,90,40,51,86,162,617
6057,ATL,2018,Marco Belinelli,31,52,1,1210,199,485,.410,92,247,.372,107,238,.450,.505,101,109,.927,14,86,100,103,46,3,54,41,591
6058,ATL,2018,Ersan İlyasova,30,46,40,1175,184,401,.459,61,170,.359,123,231,.532,.535,72,90,.800,74,177,251,51,44,17,43,92,501
6059,ATL,2018,Isaiah Taylor,23,67,9,1167,163,390,.418,20,80,.250,143,310,.461,.444,99,141,.702,22,72,94,206,34,10,84,116,445
6060,ATL,2018,Mike Muscala,26,53,7,1060,143,312,.458,62,167,.371,81,145,.559,.558,57,62,.919,56,174,230,51,31,27,42,80,405
6061,ATL,2018,Malcolm Delaney,28,54,3,1014,109,285,.382,46,124,.371,63,161,.391,.463,74,92,.804,9,91,100,163,35,6,66,82,338
6062,ATL,2018,Tyler Dorsey,21,56,5,974,144,382,.377,72,199,.362,72,183,.393,.471,45,63,.714,17,113,130,79,17,5,37,63,405
6063,ATL,2018,Miles Plumlee,29,55,35,918,105,180,.583,0,0,,105,180,.583,.583,27,60,.450,77,151,228,45,17,30,63,79,237
6064,ATL,2018,Luke Babbitt,28,37,9,570,80,168,.476,49,111,.441,31,57,.544,.622,17,22,.773,5,76,81,26,7,5,15,47,226
6065,ATL,2018,Tyler Cavanaugh,23,39,1,518,67,152,.441,32,89,.360,35,63,.556,.546,17,21,.810,45,82,127,27,9,4,14,61,183
6066,ATL,2018,DeAndre' Bembry,23,26,3,455,53,128,.414,11,30,.367,42,98,.429,.457,19,33,.576,8,64,72,49,21,12,47,38,136
6067,ATL,2018,Damion Lee,25,15,11,404,62,152,.408,15,60,.250,47,92,.511,.457,22,29,.759,11,60,71,29,19,1,14,25,161
6068,ATL,2018,Josh Magette,28,18,0,216,15,46,.326,8,22,.364,7,24,.292,.413,8,8,1.000,2,17,19,57,8,1,9,16,46
6069,ATL,2018,Andrew White,24,15,0,209,25,73,.342,18,49,.367,7,24,.292,.466,1,4,.250,4,30,34,6,3,1,8,12,69
6070,ATL,2018,Jaylen Morris,22,6,0,98,13,32,.406,2,10,.200,11,22,.500,.438,0,0,,2,14,16,7,2,1,6,2,28
6071,ATL,2018,Antonius Cleveland,23,4,0,42,4,7,.571,3,3,1.000,1,4,.250,.786,2,2,1.000,1,3,4,0,1,1,5,12,13
6072,ATL,2018,Nicolás Brussino,24,4,0,10,0,2,.000,0,2,.000,0,0,,.000,0,0,,0,3,3,0,0,0,0,0,0
6073,ATL,2018,Jeremy Evans,30,1,0,5,1,1,1.000,0,0,,1,1,1.000,1.000,0,0,,1,0,1,0,0,0,1,1,2
6074,ATL,2017,Dennis Schröder,23,79,78,2485,548,1214,.451,100,294,.340,448,920,.487,.493,218,255,.855,42,206,248,499,74,16,258,149,1414
6075,ATL,2017,Paul Millsap,31,69,67,2343,430,972,.442,75,241,.311,355,731,.486,.481,311,405,.768,111,422,533,252,90,62,158,186,1246
6076,ATL,2017,Dwight Howard,31,74,74,2199,388,613,.633,0,2,.000,388,611,.635,.633,226,424,.533,296,644,940,104,64,92,170,203,1002
6077,ATL,2017,Tim Hardaway Jr.,24,79,30,2154,415,912,.455,149,417,.357,266,495,.537,.537,164,214,.766,35,189,224,182,55,15,106,103,1143
6078,ATL,2017,Kent Bazemore,27,73,64,1963,295,721,.409,92,266,.346,203,455,.446,.473,119,168,.708,45,186,231,177,91,52,125,165,801
6079,ATL,2017,Thabo Sefolosha,32,62,42,1596,174,395,.441,41,120,.342,133,275,.484,.492,55,75,.733,54,216,270,107,96,31,58,97,444
6080,ATL,2017,Malcolm Delaney,27,73,2,1248,145,388,.374,26,110,.236,119,278,.428,.407,75,93,.806,10,113,123,193,39,1,95,112,391
6081,ATL,2017,Mike Muscala,25,70,3,1237,170,337,.504,46,110,.418,124,227,.546,.573,49,64,.766,76,164,240,95,30,41,55,97,435
6082,ATL,2017,Taurean Prince,22,59,10,981,114,285,.400,33,102,.324,81,183,.443,.458,74,94,.787,25,132,157,55,43,27,61,96,335
6083,ATL,2017,Kyle Korver,35,32,21,894,108,246,.439,65,159,.409,43,87,.494,.571,24,27,.889,0,89,89,75,23,13,40,47,305
6084,ATL,2017,Kris Humphries,31,56,4,689,87,214,.407,19,54,.352,68,160,.425,.451,64,82,.780,60,146,206,29,15,21,28,69,257
6085,ATL,2017,Ersan İlyasova,29,26,12,633,93,226,.412,32,92,.348,61,134,.455,.482,52,65,.800,42,109,151,43,22,8,34,73,270
6086,ATL,2017,Mike Dunleavy,36,30,0,475,57,130,.438,33,77,.429,24,53,.453,.565,22,26,.846,13,55,68,30,9,5,14,35,169
6087,ATL,2017,DeAndre' Bembry,22,38,1,371,47,98,.480,1,18,.056,46,80,.575,.485,6,16,.375,14,45,59,28,8,5,16,21,101
6088,ATL,2017,José Calderón,35,17,2,247,23,57,.404,8,30,.267,15,27,.556,.474,7,8,.875,7,25,32,37,4,0,15,14,61
6089,ATL,2017,Mike Scott,28,18,0,195,17,59,.288,4,27,.148,13,32,.406,.322,7,8,.875,10,27,37,17,4,3,8,12,45
6090,ATL,2017,Ryan Kelly,25,16,0,110,8,28,.286,4,10,.400,4,18,.222,.357,5,6,.833,1,17,18,8,4,5,4,5,25
6091,ATL,2017,Lamar Patterson,25,5,0,40,3,15,.200,1,6,.167,2,9,.222,.233,2,3,.667,1,6,7,6,1,0,4,6,9
6092,ATL,2017,Gary Neal,32,2,0,18,0,7,.000,0,2,.000,0,5,.000,.000,4,4,1.000,0,1,1,1,0,0,0,1,4
6093,ATL,2017,Edy Tavares,24,1,0,4,1,1,1.000,0,0,,1,1,1.000,1.000,0,2,.000,0,1,1,0,0,0,0,0,2
6094,ATL,2016,Paul Millsap,30,81,81,2647,501,1066,.470,74,232,.319,427,834,.512,.505,309,408,.757,198,534,732,265,147,139,191,237,1385
6095,ATL,2016,Al Horford,29,82,82,2631,529,1048,.505,88,256,.344,441,792,.557,.547,103,129,.798,148,448,596,263,68,121,107,163,1249
6096,ATL,2016,Kyle Korver,34,80,80,2401,268,616,.435,158,397,.398,110,219,.502,.563,45,54,.833,14,246,260,164,60,35,98,161,739
6097,ATL,2016,Jeff Teague,27,79,78,2255,434,988,.439,110,275,.400,324,713,.454,.495,261,312,.837,33,181,214,470,97,24,218,167,1239
6098,ATL,2016,Kent Bazemore,26,75,68,2083,320,725,.441,109,305,.357,211,420,.502,.517,123,151,.815,28,351,379,171,98,38,138,176,872
6099,ATL,2016,Thabo Sefolosha,31,75,11,1758,188,372,.505,42,124,.339,146,248,.589,.562,62,99,.626,52,282,334,107,85,37,68,109,480
6100,ATL,2016,Dennis Schröder,22,80,6,1621,329,781,.421,77,239,.322,252,542,.465,.471,144,182,.791,25,179,204,349,70,9,183,138,879
6101,ATL,2016,Mike Scott,27,75,0,1146,176,376,.468,62,158,.392,114,218,.523,.551,50,63,.794,53,153,206,78,25,17,42,102,464
6102,ATL,2016,Tim Hardaway Jr.,23,51,1,864,114,265,.430,48,142,.338,66,123,.537,.521,50,56,.893,7,79,86,51,21,7,23,48,326
6103,ATL,2016,Tiago Splitter,31,36,2,579,81,155,.523,0,2,.000,81,153,.529,.523,39,48,.813,45,75,120,30,20,12,24,71,201
6104,ATL,2016,Mike Muscala,24,60,0,565,76,152,.500,12,39,.308,64,113,.566,.539,31,39,.795,38,79,117,34,13,27,27,72,195
6105,ATL,2016,Lamar Patterson,24,35,0,395,28,80,.350,12,49,.245,16,31,.516,.425,16,22,.727,4,46,50,39,9,2,23,45,84
6106,ATL,2016,Kris Humphries,30,21,0,295,47,101,.465,8,31,.258,39,70,.557,.505,32,45,.711,20,51,71,13,10,7,14,44,134
6107,ATL,2016,Justin Holiday,26,26,1,263,24,73,.329,10,45,.222,14,28,.500,.397,5,10,.500,4,23,27,11,13,4,13,21,63
6108,ATL,2016,Shelvin Mack,25,24,0,179,40,95,.421,4,27,.148,36,68,.529,.442,9,12,.750,2,20,22,38,8,0,14,7,93
6109,ATL,2016,Kirk Hinrich,35,11,0,76,2,11,.182,1,6,.167,1,5,.200,.227,0,0,,1,11,12,14,2,1,3,1,5
6110,ATL,2016,Edy Tavares,23,11,0,73,11,19,.579,0,0,,11,19,.579,.579,3,8,.375,7,14,21,3,1,6,5,8,25
6111,ATL,2015,Kyle Korver,33,75,75,2418,292,600,.487,221,449,.492,71,151,.470,.671,106,118,.898,15,289,304,196,52,42,107,140,911
6112,ATL,2015,Paul Millsap,29,73,73,2390,443,930,.476,77,216,.356,366,714,.513,.518,255,337,.757,139,431,570,223,130,69,166,201,1218
6113,ATL,2015,Al Horford,28,76,76,2318,519,965,.538,11,36,.306,508,929,.547,.544,107,141,.759,131,413,544,244,68,98,100,121,1156
6114,ATL,2015,Jeff Teague,26,73,72,2228,408,887,.460,71,207,.343,337,680,.496,.500,275,319,.862,30,154,184,513,125,31,205,139,1162
6115,ATL,2015,DeMarre Carroll,28,70,69,2189,318,653,.487,120,304,.395,198,349,.567,.579,127,181,.702,99,273,372,118,94,17,75,154,883
6116,ATL,2015,Dennis Schröder,21,77,10,1516,284,665,.427,52,148,.351,232,517,.449,.466,148,179,.827,29,135,164,317,49,4,150,127,768
6117,ATL,2015,Kent Bazemore,25,75,10,1324,141,331,.426,48,132,.364,93,199,.467,.498,60,100,.600,21,201,222,78,52,33,73,127,390
6118,ATL,2015,Mike Scott,26,68,0,1123,201,453,.444,66,192,.344,135,261,.517,.517,61,77,.792,45,154,199,75,25,3,39,83,529
6119,ATL,2015,Pero Antić,32,63,3,1037,108,296,.365,52,173,.301,56,123,.455,.453,88,123,.715,58,131,189,49,18,14,49,132,356
6120,ATL,2015,Thabo Sefolosha,30,52,7,976,104,249,.418,25,78,.321,79,171,.462,.468,45,58,.776,53,170,223,75,53,21,38,67,278
6121,ATL,2015,Shelvin Mack,24,55,0,833,117,292,.401,40,127,.315,77,165,.467,.469,25,31,.806,8,71,79,155,30,2,49,32,299
6122,ATL,2015,Mike Muscala,23,40,8,502,83,151,.550,9,22,.409,74,129,.574,.579,22,25,.880,52,67,119,25,16,19,21,52,197
6123,ATL,2015,Elton Brand,35,36,4,486,42,95,.442,0,1,.000,42,94,.447,.442,12,23,.522,28,72,100,22,17,25,18,54,96
6124,ATL,2015,John Jenkins,23,24,3,297,49,99,.495,21,52,.404,28,47,.596,.601,16,19,.842,2,37,39,13,10,0,8,15,135
6125,ATL,2015,Austin Daye,26,8,0,76,10,26,.385,5,14,.357,5,12,.417,.481,1,2,.500,4,10,14,8,4,2,5,9,26
6126,ATL,2015,Adreian Payne,23,3,0,19,2,7,.286,0,1,.000,2,6,.333,.286,1,2,.500,1,3,4,0,1,0,0,4,5
6127,ATL,2014,Jeff Teague,25,79,79,2542,456,1040,.438,74,225,.329,382,815,.469,.474,318,376,.846,34,174,208,528,89,17,232,158,1304
6128,ATL,2014,Paul Millsap,28,74,73,2482,483,1047,.461,76,212,.358,407,835,.487,.498,286,391,.731,154,473,627,232,129,78,185,210,1328
6129,ATL,2014,Kyle Korver,32,71,71,2408,289,609,.475,185,392,.472,104,217,.479,.626,87,94,.926,22,260,282,208,70,24,102,147,850
6130,ATL,2014,DeMarre Carroll,27,73,73,2341,302,642,.470,97,268,.362,205,374,.548,.546,109,141,.773,107,296,403,134,108,21,79,188,810
6131,ATL,2014,Shelvin Mack,23,73,11,1490,209,501,.417,62,184,.337,147,317,.464,.479,64,74,.865,21,139,160,271,50,2,89,100,544
6132,ATL,2014,Mike Scott,25,80,6,1482,301,628,.479,62,200,.310,239,428,.558,.529,103,132,.780,62,222,284,75,30,7,79,121,767
6133,ATL,2014,Lou Williams,27,60,7,1445,197,493,.400,79,231,.342,118,262,.450,.480,152,179,.849,10,114,124,210,45,4,92,65,625
6134,ATL,2014,Elton Brand,34,73,15,1414,179,332,.539,0,2,.000,179,330,.542,.539,61,94,.649,97,264,361,74,40,88,60,192,419
6135,ATL,2014,Al Horford,27,29,29,958,238,420,.567,4,11,.364,234,409,.572,.571,58,85,.682,66,178,244,76,27,44,64,56,538
6136,ATL,2014,Pero Antić,31,50,26,925,123,294,.418,56,171,.327,67,123,.545,.514,50,66,.758,57,152,209,58,19,12,55,126,352
6137,ATL,2014,Cartier Martin,29,53,6,822,106,256,.414,56,146,.384,50,110,.455,.523,46,61,.754,12,93,105,31,26,7,33,68,314
6138,ATL,2014,Dennis Schröder,20,49,0,641,72,188,.383,10,42,.238,62,146,.425,.410,29,43,.674,5,55,60,93,17,0,61,54,183
6139,ATL,2014,Gustavo Ayón,28,26,14,429,52,102,.510,0,0,,52,102,.510,.510,8,20,.400,42,83,125,28,25,10,29,47,112
6140,ATL,2014,Mike Muscala,22,20,0,215,31,73,.425,0,3,.000,31,70,.443,.425,14,14,1.000,17,35,52,7,3,10,12,29,76
6141,ATL,2014,John Jenkins,22,13,0,158,16,42,.381,4,18,.222,12,24,.500,.429,4,4,1.000,3,19,22,11,1,1,11,11,40
6142,ATL,2014,James Nunnally,23,4,0,54,6,18,.333,3,10,.300,3,8,.375,.417,3,4,.750,1,7,8,2,1,1,4,2,18
6143,ATL,2014,Jared Cunningham,22,5,0,22,1,2,.500,0,1,.000,1,1,1.000,.500,0,2,.000,0,1,1,3,0,0,2,3,2
6144,ATL,2014,Dexter Pittman,25,2,0,3,0,1,.000,0,0,,0,1,.000,.000,0,2,.000,3,0,3,0,0,0,0,0,0
6145,ATL,2013,Al Horford,26,74,74,2756,576,1060,.543,3,6,.500,573,1054,.544,.545,134,208,.644,195,562,757,240,78,78,147,163,1289
6146,ATL,2013,Josh Smith,27,76,76,2683,550,1182,.465,61,201,.303,489,981,.498,.491,166,321,.517,133,506,639,321,94,136,226,175,1327
6147,ATL,2013,Jeff Teague,24,80,78,2628,439,974,.451,89,248,.359,350,726,.482,.496,199,226,.881,25,155,180,579,117,28,230,181,1166
6148,ATL,2013,Kyle Korver,31,74,60,2259,277,601,.461,189,414,.457,88,187,.471,.618,67,78,.859,23,270,293,146,70,37,70,170,810
6149,ATL,2013,Devin Harris,29,58,34,1421,194,443,.438,77,230,.335,117,213,.549,.525,112,154,.727,6,110,116,197,64,13,88,103,577
6150,ATL,2013,DeShawn Stevenson,31,56,31,1158,98,262,.374,76,209,.364,22,53,.415,.519,12,23,.522,18,104,122,52,29,6,23,69,284
6151,ATL,2013,Zaza Pachulia,28,52,15,1134,114,241,.473,0,3,.000,114,238,.479,.473,78,103,.757,132,204,336,79,35,12,70,128,306
6152,ATL,2013,Lou Williams,26,39,9,1119,187,443,.422,72,196,.367,115,247,.466,.503,105,121,.868,8,72,80,139,44,10,74,55,551
6153,ATL,2013,Ivan Johnson,28,69,5,1035,185,356,.520,1,13,.077,184,343,.536,.521,81,131,.618,76,190,266,46,56,14,71,131,452
6154,ATL,2013,Anthony Tolliver,27,62,11,963,82,216,.380,45,133,.338,37,83,.446,.484,44,51,.863,31,124,155,32,15,12,36,66,253
6155,ATL,2013,John Jenkins,21,61,2,902,131,294,.446,53,138,.384,78,156,.500,.536,59,70,.843,17,77,94,56,12,10,40,37,374
6156,ATL,2013,Dahntay Jones,32,28,4,381,32,82,.390,3,12,.250,29,70,.414,.409,21,31,.677,11,20,31,20,12,1,16,46,88
6157,ATL,2013,Mike Scott,24,40,1,376,70,147,.476,0,1,.000,70,146,.479,.476,43,56,.768,39,71,110,12,4,2,21,32,183
6158,ATL,2013,Johan Petro,27,31,8,352,48,110,.436,1,4,.250,47,106,.443,.441,11,12,.917,33,79,112,16,10,9,24,48,108
6159,ATL,2013,Anthony Morrow,27,24,1,301,47,111,.423,15,38,.395,32,73,.438,.491,16,18,.889,10,16,26,9,12,1,4,33,125
6160,ATL,2013,Shelvin Mack,22,20,1,268,41,84,.488,14,35,.400,27,49,.551,.571,8,14,.571,0,24,24,44,9,0,24,28,104
6161,ATL,2013,Jannero Pargo,33,7,0,113,13,38,.342,7,20,.350,6,18,.333,.434,2,2,1.000,1,6,7,19,3,0,5,8,35
6162,ATL,2013,Jeremy Tyler,21,1,0,5,0,0,,0,0,,0,0,,,0,0,,0,3,3,0,0,0,0,0,0
6163,ATL,2012,Josh Smith,26,66,66,2329,504,1101,.458,28,109,.257,476,992,.480,.470,203,322,.630,136,496,632,257,93,115,164,172,1239
6164,ATL,2012,Jeff Teague,23,66,66,2183,320,672,.476,51,149,.342,269,523,.514,.514,140,185,.757,21,138,159,321,106,37,134,145,831
6165,ATL,2012,Joe Johnson,30,60,60,2127,423,931,.454,125,322,.388,298,609,.489,.521,158,186,.849,53,168,221,232,48,13,116,75,1129
6166,ATL,2012,Zaza Pachulia,27,58,44,1640,169,339,.499,0,0,,169,339,.499,.499,117,158,.741,154,303,457,79,55,29,81,172,455
6167,ATL,2012,Marvin Williams,25,57,37,1500,203,470,.432,58,149,.389,145,321,.452,.494,115,146,.788,76,218,294,71,47,18,39,84,579
6168,ATL,2012,Kirk Hinrich,31,48,31,1237,122,295,.414,47,136,.346,75,159,.472,.493,25,32,.781,11,90,101,132,38,11,58,100,316
6169,ATL,2012,Ivan Johnson,27,56,0,934,141,275,.513,2,6,.333,139,269,.517,.516,72,100,.720,65,161,226,32,43,18,69,116,356
6170,ATL,2012,Willie Green,30,53,2,922,153,325,.471,50,113,.442,103,212,.486,.548,48,56,.857,15,65,80,40,23,6,33,74,404
6171,ATL,2012,Tracy McGrady,32,52,0,837,101,231,.437,15,33,.455,86,198,.434,.470,56,83,.675,23,131,154,110,16,15,53,35,273
6172,ATL,2012,Vladimir Radmanović,31,49,3,755,74,197,.376,50,135,.370,24,62,.387,.503,22,29,.759,34,109,143,54,21,15,35,62,220
6173,ATL,2012,Jannero Pargo,32,50,0,671,105,253,.415,53,138,.384,52,115,.452,.520,19,20,.950,9,64,73,96,20,2,49,64,282
6174,ATL,2012,Al Horford,25,11,11,348,57,103,.553,0,1,.000,57,102,.559,.553,22,30,.733,26,51,77,24,10,14,16,21,136
6175,ATL,2012,Jason Collins,33,30,10,308,16,40,.400,0,0,,16,40,.400,.400,7,15,.467,12,36,48,10,4,3,10,34,39
6176,ATL,2012,Jerry Stackhouse,37,30,0,273,37,100,.370,13,38,.342,24,62,.387,.435,21,23,.913,6,17,23,14,10,3,13,12,108
6177,ATL,2012,Erick Dampier,36,15,0,83,1,8,.125,0,0,,1,8,.125,.125,0,0,,10,15,25,4,1,4,3,9,2
6178,ATL,2012,Donald Sloan,24,5,0,20,3,8,.375,0,1,.000,3,7,.429,.375,0,0,,1,4,5,5,1,0,2,3,6
6179,ATL,2011,Al Horford,24,77,77,2704,513,921,.557,2,4,.500,511,917,.557,.558,150,188,.798,182,536,718,266,59,80,119,193,1178
6180,ATL,2011,Josh Smith,25,77,77,2645,497,1041,.477,51,154,.331,446,887,.503,.502,229,316,.725,134,523,657,255,99,120,197,217,1274
6181,ATL,2011,Joe Johnson,29,72,72,2554,514,1161,.443,89,300,.297,425,861,.494,.481,195,243,.802,59,232,291,338,47,7,146,131,1312
6182,ATL,2011,Jamal Crawford,30,76,0,2297,368,874,.421,119,349,.341,249,525,.474,.489,222,260,.854,22,108,130,241,57,14,145,97,1077
6183,ATL,2011,Marvin Williams,24,65,52,1865,246,537,.458,37,110,.336,209,427,.489,.493,147,174,.845,68,245,313,88,34,23,62,104,676
6184,ATL,2011,Mike Bibby,32,56,56,1674,192,441,.435,113,256,.441,79,185,.427,.563,29,46,.630,15,128,143,202,38,6,68,125,526
6185,ATL,2011,Zaza Pachulia,26,79,7,1244,107,232,.461,0,0,,107,232,.461,.461,135,179,.754,119,214,333,58,34,22,69,184,349
6186,ATL,2011,Jeff Teague,22,70,7,963,133,304,.438,18,48,.375,115,256,.449,.467,77,97,.794,11,91,102,138,45,25,64,82,361
6187,ATL,2011,Maurice Evans,32,47,12,837,79,201,.393,28,89,.315,51,112,.455,.463,24,28,.857,23,61,84,30,16,5,15,74,210
6188,ATL,2011,Kirk Hinrich,30,24,22,686,80,185,.432,32,76,.421,48,109,.440,.519,14,21,.667,7,46,53,78,19,7,37,66,206
6189,ATL,2011,Damien Wilkins,31,52,0,676,69,137,.504,2,10,.200,67,127,.528,.511,40,56,.714,23,67,90,41,27,9,21,72,180
6190,ATL,2011,Josh Powell,28,54,0,653,94,208,.452,0,1,.000,94,207,.454,.452,36,45,.800,49,86,135,22,5,5,53,78,224
6191,ATL,2011,Jason Collins,32,49,28,593,34,71,.479,1,1,1.000,33,70,.471,.486,27,41,.659,30,72,102,22,9,9,26,97,96
6192,ATL,2011,Jordan Crawford,22,16,0,160,27,77,.351,9,27,.333,18,50,.360,.409,4,6,.667,9,19,28,15,3,0,15,13,67
6193,ATL,2011,Etan Thomas,32,13,0,82,10,21,.476,0,0,,10,21,.476,.476,12,15,.800,6,17,23,2,1,4,5,11,32
6194,ATL,2011,Hilton Armstrong,26,12,0,76,6,12,.500,1,1,1.000,5,11,.455,.542,2,10,.200,3,14,17,4,3,5,3,9,15
6195,ATL,2011,Pape Sy,22,3,0,21,2,6,.333,0,1,.000,2,5,.400,.333,3,3,1.000,2,1,3,2,1,0,3,1,7
6196,ATL,2010,Joe Johnson,28,76,76,2886,635,1386,.458,129,350,.369,506,1036,.488,.505,220,269,.818,74,279,353,369,82,5,145,145,1619
6197,ATL,2010,Josh Smith,24,81,81,2871,504,999,.505,0,7,.000,504,992,.508,.505,261,422,.618,223,482,705,342,130,172,198,240,1269
6198,ATL,2010,Al Horford,23,81,81,2845,467,847,.551,1,1,1.000,466,846,.551,.552,213,270,.789,236,563,799,189,59,91,122,225,1148
6199,ATL,2010,Marvin Williams,23,81,81,2468,302,664,.455,40,132,.303,262,532,.492,.485,176,215,.819,106,310,416,93,66,46,72,160,820
6200,ATL,2010,Jamal Crawford,29,79,0,2460,496,1105,.449,163,427,.382,333,678,.491,.523,270,315,.857,34,167,201,238,61,12,137,132,1425
6201,ATL,2010,Mike Bibby,31,80,80,2195,268,644,.416,126,324,.389,142,320,.444,.514,68,79,.861,20,164,184,310,67,3,90,157,730
6202,ATL,2010,Maurice Evans,31,79,5,1317,175,393,.445,57,169,.337,118,224,.527,.518,46,61,.754,59,95,154,48,34,17,20,125,453
6203,ATL,2010,Zaza Pachulia,25,78,1,1089,120,246,.488,0,4,.000,120,242,.496,.488,93,143,.650,117,176,293,42,37,31,58,186,333
6204,ATL,2010,Jeff Teague,21,71,3,719,90,227,.396,7,32,.219,83,195,.426,.412,41,49,.837,5,62,67,122,34,11,50,82,228
6205,ATL,2010,Joe Smith,34,64,1,592,77,193,.399,1,7,.143,76,186,.409,.402,39,48,.813,66,91,157,21,6,19,22,95,194
6206,ATL,2010,Mario West,25,39,1,142,12,21,.571,0,1,.000,12,20,.600,.571,6,10,.600,8,19,27,9,8,0,7,25,30
6207,ATL,2010,Randolph Morris,24,28,0,124,23,41,.561,0,0,,23,41,.561,.561,16,27,.593,10,28,38,2,5,3,12,34,62
6208,ATL,2010,Jason Collins,31,24,0,115,8,23,.348,0,1,.000,8,22,.364,.348,0,2,.000,5,9,14,4,3,2,5,21,16
6209,ATL,2010,Othello Hunter,23,7,0,33,4,12,.333,0,0,,4,12,.333,.333,3,4,.750,6,6,12,0,0,1,3,5,11
6210,ATL,2009,Joe Johnson,27,79,79,3124,620,1420,.437,149,414,.360,471,1006,.468,.489,299,362,.826,65,281,346,455,84,19,195,176,1688
6211,ATL,2009,Mike Bibby,30,79,79,2740,437,1005,.435,167,428,.390,270,577,.468,.518,135,171,.789,38,240,278,392,98,11,128,145,1176
6212,ATL,2009,Josh Smith,23,69,69,2421,418,849,.492,26,87,.299,392,762,.514,.508,211,359,.588,134,364,498,169,94,111,161,184,1073
6213,ATL,2009,Al Horford,22,67,67,2242,312,594,.525,0,1,.000,312,593,.526,.525,149,205,.727,145,479,624,163,53,95,103,190,773
6214,ATL,2009,Marvin Williams,22,61,59,2093,285,622,.458,55,155,.355,230,467,.493,.502,220,273,.806,110,272,382,81,57,39,70,127,845
6215,ATL,2009,Ronald Murray,29,80,2,1975,355,795,.447,87,242,.360,268,553,.485,.501,177,233,.760,22,146,168,158,88,17,128,173,974
6216,ATL,2009,Maurice Evans,30,80,25,1840,208,482,.432,98,248,.395,110,234,.470,.533,60,73,.822,88,155,243,54,50,10,43,163,574
6217,ATL,2009,Zaza Pachulia,24,77,26,1473,159,320,.497,0,3,.000,159,317,.502,.497,163,230,.709,173,263,436,57,35,26,91,208,481
6218,ATL,2009,Solomon Jones,24,63,0,675,67,111,.604,1,2,.500,66,109,.606,.608,53,74,.716,52,90,142,15,7,34,27,125,188
6219,ATL,2009,Acie Law,24,55,1,560,52,139,.374,9,29,.310,43,110,.391,.406,49,60,.817,6,52,58,86,11,3,29,43,162
6220,ATL,2009,Mario West,24,53,3,269,14,34,.412,1,1,1.000,13,33,.394,.426,14,30,.467,24,32,56,19,18,4,13,35,43
6221,ATL,2009,Thomas Gardner,23,16,0,98,9,36,.250,4,23,.174,5,13,.385,.306,2,4,.500,0,7,7,2,4,1,3,4,24
6222,ATL,2009,Othello Hunter,22,16,0,92,11,20,.550,0,0,,11,20,.550,.550,0,5,.000,9,15,24,1,2,5,2,11,22
6223,ATL,2009,Randolph Morris,23,23,0,89,7,17,.412,0,0,,7,17,.412,.412,4,4,1.000,4,16,20,2,2,1,7,25,18
6224,ATL,2009,Speedy Claxton,30,2,0,15,2,7,.286,0,0,,2,7,.286,.286,1,2,.500,0,0,0,3,0,0,0,1,5
6225,ATL,2008,Joe Johnson,26,82,82,3343,647,1497,.432,169,444,.381,478,1053,.454,.489,316,379,.834,83,284,367,474,84,18,223,168,1779
6226,ATL,2008,Josh Smith,22,81,81,2873,518,1133,.457,25,99,.253,493,1034,.477,.468,333,469,.710,161,506,667,272,123,227,245,269,1394
6227,ATL,2008,Marvin Williams,21,80,80,2765,424,918,.462,1,10,.100,423,908,.466,.462,336,409,.822,119,338,457,137,81,33,127,225,1185
6228,ATL,2008,Al Horford,21,81,77,2540,333,668,.499,0,5,.000,333,663,.502,.499,155,212,.731,248,537,785,124,60,76,137,267,821
6229,ATL,2008,Josh Childress,24,76,0,2274,327,573,.571,22,60,.367,305,513,.595,.590,222,275,.807,174,199,373,117,71,43,98,129,898
6230,ATL,2008,Anthony Johnson,33,42,41,1121,115,267,.431,27,63,.429,88,204,.431,.481,26,32,.813,17,81,98,202,42,8,50,86,283
6231,ATL,2008,Mike Bibby,29,33,32,1100,170,411,.414,69,187,.369,101,224,.451,.498,55,69,.797,5,99,104,215,35,2,81,63,464
6232,ATL,2008,Zaza Pachulia,23,62,5,944,107,245,.437,0,3,.000,107,242,.442,.437,108,153,.706,89,159,248,36,24,13,69,140,322
6233,ATL,2008,Acie Law,23,56,6,865,95,237,.401,7,34,.206,88,203,.433,.416,38,48,.792,12,45,57,113,29,0,56,73,235
6234,ATL,2008,Tyronn Lue,30,33,3,564,86,196,.439,30,69,.435,56,127,.441,.515,24,28,.857,9,32,41,59,11,0,22,38,226
6235,ATL,2008,Shelden Williams,24,36,0,414,37,100,.370,0,1,.000,37,99,.374,.370,35,51,.686,34,73,107,11,13,11,14,60,109
6236,ATL,2008,Salim Stoudamire,25,35,0,402,65,180,.361,29,85,.341,36,95,.379,.442,41,50,.820,4,20,24,28,7,5,21,34,200
6237,ATL,2008,Mario West,23,64,2,269,21,49,.429,0,4,.000,21,45,.467,.429,17,26,.654,26,22,48,13,12,4,9,61,59
6238,ATL,2008,Lorenzen Wright,32,13,1,148,5,17,.294,0,0,,5,17,.294,.294,3,6,.500,7,30,37,3,3,3,2,26,13
6239,ATL,2008,Solomon Jones,23,35,0,145,12,30,.400,0,2,.000,12,28,.429,.400,11,20,.550,19,23,42,0,3,5,11,28,35
6240,ATL,2008,Jeremy Richardson,23,19,0,88,13,31,.419,5,12,.417,8,19,.421,.500,0,0,,1,6,7,0,2,0,5,6,31
6241,ATL,2007,Josh Smith,21,72,72,2647,436,993,.439,38,152,.250,398,841,.473,.458,268,387,.693,165,456,621,236,101,207,227,241,1178
6242,ATL,2007,Joe Johnson,25,57,57,2359,536,1139,.471,119,312,.381,417,827,.504,.523,235,314,.748,53,186,239,249,60,11,176,115,1426
6243,ATL,2007,Marvin Williams,20,64,63,2179,306,706,.433,11,45,.244,295,661,.446,.441,216,265,.815,84,253,337,121,52,30,127,191,839
6244,ATL,2007,Zaza Pachulia,22,72,47,2026,291,614,.474,0,1,.000,291,613,.475,.474,293,373,.786,199,301,500,106,77,36,162,267,875
6245,ATL,2007,Josh Childress,23,55,13,2024,261,518,.504,26,77,.338,235,441,.533,.529,167,210,.795,123,217,340,127,58,36,80,118,715
6246,ATL,2007,Shelden Williams,23,81,31,1514,166,365,.455,2,4,.500,164,361,.454,.458,110,144,.764,131,304,435,44,52,39,96,199,444
6247,ATL,2007,Tyronn Lue,29,56,17,1488,218,524,.416,56,161,.348,162,363,.446,.469,144,163,.883,19,85,104,201,24,0,85,101,636
6248,ATL,2007,Speedy Claxton,28,42,31,1054,91,278,.327,6,28,.214,85,250,.340,.338,33,60,.550,12,69,81,185,72,4,75,131,221
6249,ATL,2007,Lorenzen Wright,31,67,31,1035,82,183,.448,0,0,,82,183,.448,.448,9,32,.281,85,131,216,40,28,28,39,204,173
6250,ATL,2007,Salim Stoudamire,24,61,0,1034,177,425,.416,56,155,.361,121,270,.448,.482,61,68,.897,6,68,74,61,21,2,55,88,471
6251,ATL,2007,Anthony Johnson,32,27,17,739,82,197,.416,14,44,.318,68,153,.444,.452,25,32,.781,9,44,53,123,17,2,45,51,203
6252,ATL,2007,Solomon Jones,22,58,8,666,65,128,.508,0,1,.000,65,127,.512,.508,59,75,.787,49,87,136,11,11,42,25,124,189
6253,ATL,2007,Royal Ivey,25,53,18,539,64,143,.448,5,16,.313,59,127,.465,.465,24,35,.686,15,36,51,45,24,4,31,62,157
6254,ATL,2007,Cedric Bozeman,23,23,5,199,11,39,.282,2,13,.154,9,26,.346,.308,2,6,.333,3,20,23,9,5,2,9,32,26
6255,ATL,2007,Matt Freije,25,19,0,147,16,54,.296,3,22,.136,13,32,.406,.324,5,6,.833,8,16,24,7,3,1,3,13,40
6256,ATL,2007,Stanislav Medvedenko,27,14,0,81,12,29,.414,1,2,.500,11,27,.407,.431,17,20,.850,4,10,14,2,0,2,5,16,42
6257,ATL,2007,Esteban Batista,23,13,0,81,8,16,.500,0,0,,8,16,.500,.500,4,7,.571,7,23,30,4,3,0,4,13,20
6258,ATL,2007,Dijon Thompson,23,6,0,50,6,15,.400,0,2,.000,6,13,.462,.400,5,6,.833,3,5,8,2,0,0,1,2,17
6259,ATL,2007,Jeremy Richardson,22,5,0,19,3,6,.500,2,3,.667,1,3,.333,.667,0,0,,1,1,2,0,1,0,1,2,8
6260,ATL,2006,Joe Johnson,24,82,82,3340,632,1395,.453,128,360,.356,504,1035,.487,.499,261,330,.791,98,237,335,536,103,31,267,187,1653
6261,ATL,2006,Al Harrington,25,76,76,2782,551,1220,.452,66,191,.346,485,1029,.471,.479,243,350,.694,132,391,523,238,85,14,195,301,1411
6262,ATL,2006,Josh Smith,20,80,73,2559,329,774,.425,34,110,.309,295,664,.444,.447,210,292,.719,176,355,531,191,64,208,162,260,902
6263,ATL,2006,Zaza Pachulia,21,78,78,2452,307,681,.451,0,2,.000,307,679,.452,.451,297,404,.735,264,349,613,129,89,39,180,286,911
6264,ATL,2006,Josh Childress,22,74,10,2249,278,504,.552,32,65,.492,246,439,.560,.583,154,201,.766,134,253,387,131,86,39,101,184,742
6265,ATL,2006,Marvin Williams,19,79,7,1952,235,531,.443,13,53,.245,222,478,.464,.455,189,253,.747,122,261,383,63,48,24,83,227,672
6266,ATL,2006,Salim Stoudamire,23,61,1,1236,204,492,.415,82,216,.380,122,276,.442,.498,99,110,.900,12,104,116,75,27,3,82,118,589
6267,ATL,2006,Tyronn Lue,28,51,10,1234,192,418,.459,58,127,.457,134,291,.460,.529,118,138,.855,13,69,82,157,26,3,75,113,560
6268,ATL,2006,Royal Ivey,24,73,66,978,116,264,.439,4,10,.400,112,254,.441,.447,24,33,.727,31,65,96,74,24,7,23,147,260
6269,ATL,2006,Esteban Batista,22,57,3,495,34,80,.425,0,1,.000,34,79,.430,.425,33,53,.623,61,83,144,7,15,11,38,111,101
6270,ATL,2006,John Edwards,24,40,4,296,31,64,.484,0,0,,31,64,.484,.484,8,11,.727,18,30,48,5,3,15,12,76,70
6271,ATL,2006,Donta Smith,22,23,0,127,15,27,.556,2,4,.500,13,23,.565,.593,6,12,.500,3,11,14,9,8,0,4,20,38
6272,ATL,2006,Anthony Grundy,26,12,0,108,19,38,.500,5,15,.333,14,23,.609,.566,9,14,.643,1,16,17,9,7,0,9,14,52
6273,ATL,2006,John Thomas,30,11,0,66,3,7,.429,0,0,,3,7,.429,.429,3,4,.750,3,7,10,1,2,0,4,10,9
6274,ATL,2006,Tony Delk,32,1,0,7,0,1,.000,0,0,,0,1,.000,.000,2,2,1.000,1,1,2,0,0,0,0,0,2
6275,ATL,2005,Al Harrington,24,66,66,2550,453,986,.459,16,74,.216,437,912,.479,.468,236,351,.672,145,316,461,208,85,16,204,249,1158
6276,ATL,2005,Josh Childress,21,80,44,2376,302,642,.470,13,56,.232,289,586,.493,.481,190,231,.823,195,287,482,151,74,35,106,184,807
6277,ATL,2005,Antoine Walker,28,53,53,2128,420,1013,.415,85,268,.317,335,745,.450,.457,157,294,.534,126,371,497,194,64,32,183,147,1082
6278,ATL,2005,Josh Smith,19,74,59,2050,274,602,.455,4,23,.174,270,579,.466,.458,163,237,.688,147,310,457,127,59,144,135,157,715
6279,ATL,2005,Tyronn Lue,27,49,46,1528,247,532,.464,40,110,.364,207,422,.491,.502,128,147,.871,14,95,109,264,25,0,81,120,662
6280,ATL,2005,Predrag Drobnjak,29,71,1,1435,238,543,.438,25,71,.352,213,472,.451,.461,96,120,.800,73,165,238,49,42,24,78,138,597
6281,ATL,2005,Tony Delk,31,56,1,1340,246,591,.416,72,202,.356,174,389,.447,.477,103,136,.757,28,102,130,104,47,3,54,123,667
6282,ATL,2005,Boris Diaw,22,66,25,1201,124,294,.422,9,50,.180,115,244,.471,.437,57,77,.740,54,116,170,149,37,18,87,123,314
6283,ATL,2005,Jason Collier,27,70,44,942,174,376,.463,6,14,.429,168,362,.464,.471,48,71,.676,84,100,184,18,15,13,63,147,402
6284,ATL,2005,Royal Ivey,23,62,5,809,85,198,.429,3,9,.333,82,189,.434,.437,47,67,.701,19,65,84,103,39,7,58,140,220
6285,ATL,2005,Tom Gugliotta,35,27,9,748,88,204,.431,8,26,.308,80,178,.449,.451,29,37,.784,41,107,148,56,32,13,48,81,213
6286,ATL,2005,Obinna Ekezie,29,42,31,732,79,182,.434,0,1,.000,79,181,.436,.434,72,93,.774,69,110,179,11,22,12,45,129,230
6287,ATL,2005,Kenny Anderson,34,39,20,717,81,190,.426,6,13,.462,75,177,.424,.442,27,37,.730,23,60,83,98,33,0,46,81,195
6288,ATL,2005,Donta Smith,21,38,0,433,44,113,.389,6,22,.273,38,91,.418,.416,33,48,.688,19,33,52,39,23,5,25,50,127
6289,ATL,2005,Kevin Willis,42,29,5,344,35,90,.389,0,2,.000,35,88,.398,.389,17,23,.739,29,47,76,9,8,7,15,53,87
6290,ATL,2005,Jon Barry,35,16,0,275,31,77,.403,11,32,.344,20,45,.444,.474,10,13,.769,4,17,21,28,14,2,14,28,83
6291,ATL,2005,Michael Stewart,29,12,1,145,11,21,.524,0,0,,11,21,.524,.524,3,7,.429,21,19,40,5,6,5,6,32,25
6292,ATL,2005,Jelani McCoy,27,10,0,88,7,13,.538,0,0,,7,13,.538,.538,1,5,.200,7,14,21,0,3,8,6,24,15
6293,ATL,2005,Anthony Miller,33,2,0,9,2,3,.667,0,0,,2,3,.667,.667,0,0,,0,1,1,1,1,0,1,2,4
6294,ATL,2005,James Thomas,24,2,0,5,1,2,.500,0,0,,1,2,.500,.500,0,0,,2,0,2,0,0,0,0,1,2
6295,ATL,2004,Jason Terry,26,81,78,3018,499,1196,.417,146,421,.347,353,775,.455,.478,215,260,.827,49,287,336,437,124,16,229,192,1359
6296,ATL,2004,Stephen Jackson,25,80,78,2940,536,1261,.425,145,427,.340,391,834,.469,.483,233,297,.785,97,273,370,244,142,20,223,216,1450
6297,ATL,2004,Shareef Abdur-Rahim,27,53,53,1956,383,790,.485,5,23,.217,378,767,.493,.488,294,334,.880,141,354,495,127,44,19,131,147,1065
6298,ATL,2004,Boris Diaw,21,76,37,1919,140,313,.447,6,26,.231,134,287,.467,.457,56,93,.602,111,231,342,182,59,37,126,191,342
6299,ATL,2004,Theo Ratliff,30,53,52,1648,171,373,.458,0,0,,171,373,.458,.458,96,147,.653,105,276,381,51,30,166,86,189,438
6300,ATL,2004,Dion Glover,25,55,26,1465,205,524,.391,36,105,.343,169,419,.403,.426,110,142,.775,54,183,237,115,40,17,83,106,556
6301,ATL,2004,Jacque Vaughn,28,71,6,1271,107,277,.386,3,20,.150,104,257,.405,.392,53,68,.779,12,104,116,195,44,2,84,126,270
6302,ATL,2004,Chris Crawford,28,56,25,1207,211,471,.448,44,113,.389,167,358,.466,.495,103,119,.866,58,117,175,45,37,20,55,131,569
6303,ATL,2004,Bob Sura,30,27,18,956,131,312,.420,12,43,.279,119,269,.442,.439,123,157,.783,70,153,223,144,25,5,66,72,397
6304,ATL,2004,Nazr Mohammed,26,53,1,938,138,280,.493,0,0,,138,280,.493,.493,69,110,.627,101,166,267,20,22,27,55,113,345
6305,ATL,2004,Jason Collier,26,20,16,545,79,165,.479,1,4,.250,78,161,.484,.482,67,85,.788,36,75,111,17,11,11,31,71,226
6306,ATL,2004,Travis Hansen,25,41,4,507,46,130,.354,9,30,.300,37,100,.370,.388,22,27,.815,30,40,70,19,10,9,15,67,123
6307,ATL,2004,Mamadou N'Diaye,28,25,1,359,27,68,.397,0,0,,27,68,.397,.397,44,59,.746,43,68,111,0,8,24,17,58,98
6308,ATL,2004,Joel Przybilla,24,12,12,314,18,50,.360,0,0,,18,50,.360,.360,12,29,.414,31,70,101,4,5,17,16,48,48
6309,ATL,2004,Lee Nailon,28,27,0,300,63,138,.457,0,0,,63,138,.457,.457,16,19,.842,26,37,63,17,10,7,24,48,142
6310,ATL,2004,Dan Dickau,25,23,0,143,21,49,.429,3,10,.300,18,39,.462,.459,4,6,.667,4,12,16,18,9,0,13,22,49
6311,ATL,2004,Wesley Person,32,9,0,132,13,39,.333,8,19,.421,5,20,.250,.436,6,6,1.000,2,23,25,5,3,1,4,5,40
6312,ATL,2004,Alan Henderson,31,6,0,68,10,21,.476,0,0,,10,21,.476,.476,4,6,.667,11,10,21,2,1,2,3,1,24
6313,ATL,2004,Michael Bradley,24,11,1,60,6,12,.500,0,0,,6,12,.500,.500,0,0,,5,7,12,0,2,0,4,8,12
6314,ATL,2004,Željko Rebrača,31,3,0,51,12,23,.522,0,0,,12,23,.522,.522,1,2,.500,4,5,9,2,0,2,4,7,25
6315,ATL,2004,Hiram Fuller,22,4,0,43,3,8,.375,0,0,,3,8,.375,.375,2,6,.333,4,7,11,2,0,1,4,5,8
6316,ATL,2004,Rasheed Wallace,29,1,1,42,8,24,.333,1,6,.167,7,18,.389,.354,3,3,1.000,1,5,6,2,1,5,3,0,20
6317,ATL,2004,Josh Davis,23,4,1,23,2,5,.400,0,2,.000,2,3,.667,.400,1,1,1.000,1,4,5,0,0,0,2,3,5
6318,ATL,2003,Shareef Abdur-Rahim,26,81,81,3087,566,1183,.478,21,60,.350,545,1123,.485,.487,455,541,.841,175,502,677,242,87,38,212,240,1608
6319,ATL,2003,Jason Terry,25,81,81,3081,488,1141,.428,160,431,.371,328,710,.462,.498,259,292,.887,37,242,279,600,126,14,249,175,1395
6320,ATL,2003,Glenn Robinson,30,69,68,2591,539,1248,.432,90,263,.342,449,985,.456,.468,268,306,.876,86,371,457,205,91,26,248,183,1436
6321,ATL,2003,Theo Ratliff,29,81,81,2518,276,595,.464,0,0,,276,595,.464,.464,154,214,.720,154,453,607,73,56,262,137,271,706
6322,ATL,2003,Ira Newble,28,73,45,1931,231,467,.495,32,84,.381,199,383,.520,.529,70,90,.778,86,185,271,99,50,26,69,174,564
6323,ATL,2003,Dion Glover,24,76,42,1890,277,648,.427,56,158,.354,221,490,.451,.471,127,162,.784,62,220,282,141,71,15,108,146,737
6324,ATL,2003,Alan Henderson,30,82,3,1494,153,327,.468,0,2,.000,153,325,.471,.468,88,138,.638,156,242,398,41,33,32,61,168,394
6325,ATL,2003,Darvin Ham,29,75,1,926,71,159,.447,0,3,.000,71,156,.455,.447,38,79,.481,73,80,153,38,16,19,65,127,180
6326,ATL,2003,Dan Dickau,24,50,0,515,70,170,.412,22,61,.361,48,109,.440,.476,21,26,.808,9,34,43,85,14,2,53,66,183
6327,ATL,2003,Nazr Mohammed,25,35,0,445,67,159,.421,0,0,,67,159,.421,.421,26,41,.634,47,82,129,6,16,21,25,79,160
6328,ATL,2003,Mike Wilks,23,15,7,364,29,81,.358,6,17,.353,23,64,.359,.395,21,29,.724,9,32,41,42,16,1,16,38,85
6329,ATL,2003,Emanual Davis,34,24,1,340,32,88,.364,7,29,.241,25,59,.424,.403,17,22,.773,5,38,43,36,12,2,25,28,88
6330,ATL,2003,Jermaine Jackson,26,29,0,273,19,42,.452,0,1,.000,19,41,.463,.452,17,28,.607,9,23,32,35,10,3,15,27,55
6331,ATL,2003,Corey Benjamin,24,9,0,152,13,43,.302,2,13,.154,11,30,.367,.326,12,16,.750,10,21,31,10,1,2,6,20,40
6332,ATL,2003,Matt Maloney,31,14,0,103,8,25,.320,5,15,.333,3,10,.300,.420,3,5,.600,1,6,7,17,4,0,5,9,24
6333,ATL,2003,Amal McCaskill,29,11,0,70,4,17,.235,0,0,,4,17,.235,.235,3,4,.750,7,15,22,5,3,1,2,13,11
6334,ATL,2003,Chris Crawford,27,5,0,38,8,13,.615,1,3,.333,7,10,.700,.654,7,8,.875,3,4,7,1,2,3,2,7,24
6335,ATL,2003,Antonio Harvey,32,4,0,32,2,5,.400,0,0,,2,5,.400,.400,0,0,,1,5,6,0,1,4,3,7,4
6336,ATL,2003,Mikki Moore,27,5,0,31,5,12,.417,0,0,,5,12,.417,.417,8,10,.800,5,2,7,3,0,2,2,1,18
6337,ATL,2003,Brandon Williams,27,6,0,19,1,7,.143,0,1,.000,1,6,.167,.143,0,0,,2,0,2,0,2,0,3,4,2
6338,ATL,2003,Paul Shirley,25,2,0,5,0,4,.000,0,0,,0,4,.000,.000,0,0,,0,1,1,0,0,0,0,0,0
6339,ATL,2002,Shareef Abdur-Rahim,25,77,77,2980,598,1297,.461,21,70,.300,577,1227,.470,.469,419,523,.801,198,498,696,239,98,81,250,214,1636
6340,ATL,2002,Jason Terry,24,78,78,2967,524,1219,.430,172,444,.387,352,775,.454,.500,284,340,.835,40,230,270,444,144,13,181,156,1504
6341,ATL,2002,Nazr Mohammed,24,82,73,2168,329,713,.461,0,1,.000,329,712,.462,.461,137,222,.617,242,409,651,33,63,61,118,252,795
6342,ATL,2002,Jacque Vaughn,26,82,16,1856,206,438,.470,24,54,.444,182,384,.474,.498,104,126,.825,18,150,168,349,65,2,112,183,540
6343,ATL,2002,DerMarr Johnson,21,72,46,1727,214,540,.396,89,247,.360,125,293,.427,.479,85,105,.810,59,188,247,81,62,56,102,163,602
6344,ATL,2002,Toni Kukoč,33,59,9,1494,211,504,.419,53,171,.310,158,333,.474,.471,109,153,.712,43,175,218,210,48,17,113,91,584
6345,ATL,2002,Hanno Möttölä,25,82,14,1371,169,384,.440,1,13,.077,168,371,.453,.441,57,76,.750,81,187,268,50,20,19,70,174,396
6346,ATL,2002,Ira Newble,27,42,35,1273,131,263,.498,1,7,.143,130,256,.508,.500,75,88,.852,80,142,222,45,38,20,49,117,338
6347,ATL,2002,Dion Glover,23,55,25,1156,192,456,.421,30,91,.330,162,365,.444,.454,78,103,.757,36,133,169,84,45,14,76,89,492
6348,ATL,2002,Emanual Davis,33,28,20,774,70,198,.354,29,85,.341,41,113,.363,.427,16,18,.889,19,55,74,68,27,5,52,68,185
6349,ATL,2002,Mark Strickland,31,46,10,654,91,204,.446,1,4,.250,90,200,.450,.449,25,44,.568,41,90,131,20,19,17,28,48,208
6350,ATL,2002,Cal Bowdler,24,52,0,585,61,174,.351,1,5,.200,60,169,.355,.353,39,47,.830,38,72,110,11,18,15,11,64,162
6351,ATL,2002,Alan Henderson,29,26,1,422,59,116,.509,1,1,1.000,58,115,.504,.513,24,45,.533,31,66,97,11,11,15,21,40,143
6352,ATL,2002,Chris Crawford,26,7,4,131,21,45,.467,0,1,.000,21,44,.477,.467,11,15,.733,9,16,25,5,2,5,10,21,53
6353,ATL,2002,Leon Smith,21,14,0,100,10,26,.385,0,0,,10,26,.385,.385,11,17,.647,10,21,31,3,5,1,3,12,31
6354,ATL,2002,Theo Ratliff,28,3,2,82,10,20,.500,0,0,,10,20,.500,.500,6,11,.545,5,11,16,1,1,8,7,8,26
6355,ATL,2002,Reggie Slater,31,4,0,37,5,13,.385,0,0,,5,13,.385,.385,6,9,.667,5,2,7,1,1,1,0,2,16
6356,ATL,2002,Dickey Simpkins,29,1,0,3,0,0,,0,0,,0,0,,,0,0,,0,0,0,1,0,0,0,0,0
6357,ATL,2001,Jason Terry,23,82,77,3089,596,1367,.436,124,314,.395,472,1053,.448,.481,303,358,.846,42,227,269,403,104,12,239,204,1619
6358,ATL,2001,Lorenzen Wright,25,71,46,1988,363,811,.448,0,2,.000,363,809,.449,.448,155,216,.718,180,355,535,87,42,63,125,232,881
6359,ATL,2001,Alan Henderson,28,73,42,1810,298,671,.444,0,1,.000,298,670,.445,.444,173,271,.638,180,226,406,50,51,29,126,164,769
6360,ATL,2001,Dikembe Mutombo,34,49,49,1716,169,354,.477,0,0,,169,354,.477,.477,107,154,.695,188,505,693,54,20,137,92,139,445
6361,ATL,2001,Matt Maloney,29,55,27,1403,146,348,.420,51,142,.359,95,206,.461,.493,26,34,.765,14,103,117,154,56,5,70,94,369
6362,ATL,2001,Brevin Knight,25,47,43,1364,137,356,.385,1,10,.100,136,346,.393,.386,49,60,.817,22,139,161,286,95,3,84,138,324
6363,ATL,2001,DerMarr Johnson,20,78,21,1313,146,390,.374,41,127,.323,105,263,.399,.427,64,87,.736,56,122,178,64,43,30,93,134,397
6364,ATL,2001,Hanno Möttölä,24,73,3,989,123,277,.444,0,3,.000,123,274,.449,.444,73,90,.811,49,125,174,25,11,9,67,163,319
6365,ATL,2001,Dion Glover,22,57,7,929,141,336,.420,9,46,.196,132,290,.455,.433,47,69,.681,39,92,131,69,49,10,54,92,338
6366,ATL,2001,Roshown McLeod,25,34,25,907,144,330,.436,2,21,.095,142,309,.460,.439,45,51,.882,37,81,118,58,23,8,57,88,335
6367,ATL,2001,Chris Crawford,25,47,22,901,122,270,.452,6,22,.273,116,248,.468,.463,68,83,.819,28,82,110,37,21,16,62,117,318
6368,ATL,2001,Nazr Mohammed,23,28,19,716,135,281,.480,0,1,.000,135,280,.482,.480,75,98,.765,97,155,252,17,23,28,55,73,345
6369,ATL,2001,Larry Robinson,33,33,1,631,67,184,.364,44,116,.379,23,68,.338,.484,21,24,.875,23,64,87,36,28,2,24,46,199
6370,ATL,2001,Toni Kukoč,32,17,14,618,124,252,.492,38,79,.481,86,173,.497,.567,49,72,.681,19,78,97,106,13,5,51,36,335
6371,ATL,2001,Jim Jackson,30,17,14,550,77,217,.355,16,38,.421,61,179,.341,.392,73,85,.859,17,62,79,50,19,4,48,42,243
6372,ATL,2001,Cal Bowdler,23,44,0,375,53,114,.465,1,5,.200,52,109,.477,.469,33,40,.825,30,47,77,4,10,21,11,45,140
6373,ATL,2001,Anthony Johnson,26,25,0,279,26,71,.366,0,3,.000,26,68,.382,.366,12,17,.706,3,20,23,34,17,5,20,41,64
6374,ATL,2001,Tony Smith,32,6,0,78,8,23,.348,0,2,.000,8,21,.381,.348,1,2,.500,2,1,3,10,7,0,9,12,17
6375,ATL,2001,Pepe Sánchez,23,5,0,34,0,7,.000,0,0,,0,7,.000,.000,0,0,,1,0,1,5,2,0,3,3,0
6376,ATL,2001,Ira Bowman,27,3,0,19,0,2,.000,0,0,,0,2,.000,.000,0,0,,1,1,2,7,0,0,1,0,0
6377,ATL,2001,Sean Colson,25,3,0,14,0,5,.000,0,1,.000,0,4,.000,.000,0,0,,0,3,3,3,0,0,2,0,0
6378,ATL,2001,Anthony Miller,29,2,0,6,1,2,.500,0,0,,1,2,.500,.500,0,0,,0,2,2,0,0,0,1,0,2
6379,ATL,2001,Andy Panko,23,1,0,1,0,0,,0,0,,0,0,,,0,0,,0,0,0,0,0,0,0,0,0
6380,ATL,2000,Dikembe Mutombo,33,82,82,2984,322,573,.562,0,0,,322,573,.562,.562,298,421,.708,304,853,1157,105,27,269,174,248,942
6381,ATL,2000,Alan Henderson,27,82,82,2775,429,930,.461,1,10,.100,428,920,.465,.462,224,334,.671,265,306,571,77,81,54,139,233,1083
6382,ATL,2000,Jim Jackson,29,79,76,2767,507,1235,.411,117,303,.386,390,932,.418,.458,186,212,.877,101,293,394,230,57,10,185,167,1317
6383,ATL,2000,Isaiah Rider,28,60,47,2084,449,1072,.419,56,180,.311,393,892,.441,.445,204,260,.785,63,195,258,219,41,6,168,132,1158
6384,ATL,2000,Bimbo Coles,31,80,54,1924,276,607,.455,8,39,.205,268,568,.472,.461,85,104,.817,30,142,172,290,58,11,103,178,645
6385,ATL,2000,Jason Terry,22,81,27,1888,249,600,.415,46,157,.293,203,443,.458,.453,113,140,.807,24,142,166,346,90,10,156,133,657
6386,ATL,2000,LaPhonso Ellis,29,58,8,1309,209,464,.450,3,21,.143,206,443,.465,.454,66,95,.695,98,192,290,59,32,25,52,133,487
6387,ATL,2000,Lorenzen Wright,24,75,0,1205,180,361,.499,1,3,.333,179,358,.500,.500,87,135,.644,117,188,305,21,29,40,66,203,448
6388,ATL,2000,Roshown McLeod,24,44,20,860,131,332,.395,2,13,.154,129,319,.404,.398,54,70,.771,41,97,138,52,16,5,59,84,318
6389,ATL,2000,Chris Crawford,24,55,11,668,91,229,.397,7,27,.259,84,202,.416,.413,63,81,.778,51,48,99,33,17,16,37,83,252
6390,ATL,2000,Dion Glover,21,30,1,446,66,171,.386,12,45,.267,54,126,.429,.421,51,70,.729,15,23,38,27,15,4,28,28,195
6391,ATL,2000,Cal Bowdler,22,46,0,423,49,115,.426,0,1,.000,49,114,.430,.426,24,38,.632,22,63,85,14,14,9,21,46,122
6392,ATL,2000,Anthony Johnson,25,38,2,423,36,103,.350,1,6,.167,35,97,.361,.354,19,24,.792,15,24,39,59,23,2,24,41,92
6393,ATL,2000,Drew Barry,26,8,0,74,6,15,.400,4,9,.444,2,6,.333,.533,3,3,1.000,0,4,4,16,0,0,7,9,19
6394,ATL,1999,Dikembe Mutombo,32,50,50,1829,173,338,.512,0,0,,173,338,.512,.512,195,285,.684,192,418,610,57,16,147,94,145,541
6395,ATL,1999,Mookie Blaylock,31,48,48,1763,247,651,.379,77,251,.307,170,400,.425,.439,69,91,.758,45,179,224,278,99,9,115,61,640
6396,ATL,1999,Grant Long,32,50,13,1380,151,359,.421,3,18,.167,148,341,.434,.425,184,235,.783,100,196,296,53,57,16,74,143,489
6397,ATL,1999,Steve Smith,29,36,36,1314,217,540,.402,47,139,.338,170,401,.424,.445,191,225,.849,50,101,151,118,36,11,99,100,672
6398,ATL,1999,Alan Henderson,26,38,37,1142,187,423,.442,0,1,.000,187,422,.443,.442,100,149,.671,100,150,250,28,33,19,58,96,474
6399,ATL,1999,Tyrone Corbin,36,47,6,1066,131,335,.391,38,119,.319,93,216,.431,.448,52,80,.650,37,108,145,43,31,7,43,74,352
6400,ATL,1999,Anthony Johnson,24,49,2,885,91,225,.404,5,19,.263,86,206,.417,.416,57,82,.695,16,59,75,107,35,7,65,67,244
6401,ATL,1999,Chris Crawford,23,42,30,784,110,255,.431,11,33,.333,99,222,.446,.453,57,70,.814,37,53,90,24,10,13,48,106,288
6402,ATL,1999,LaPhonso Ellis,28,20,20,539,80,190,.421,1,5,.200,79,185,.427,.424,43,61,.705,25,84,109,18,8,7,34,48,204
6403,ATL,1999,Mark West,38,49,0,499,22,59,.373,0,0,,22,59,.373,.373,16,45,.356,49,76,125,13,4,22,17,81,60
6404,ATL,1999,Roshown McLeod,23,34,0,348,62,163,.380,1,10,.100,61,153,.399,.383,37,45,.822,12,38,50,14,2,1,23,24,162
6405,ATL,1999,Ed Gray,23,30,3,337,53,182,.291,12,42,.286,41,140,.293,.324,28,37,.757,7,21,28,12,12,1,29,30,146
6406,ATL,1999,Jeff Sheppard,24,18,5,185,15,39,.385,2,7,.286,13,32,.406,.410,8,13,.615,6,16,22,16,3,0,7,12,40
6407,ATL,1999,Shammond Williams,23,2,0,4,0,1,.000,0,0,,0,1,.000,.000,3,4,.750,0,0,0,1,0,0,0,0,3
6408,ATL,1998,Dikembe Mutombo,31,82,82,2917,399,743,.537,0,0,,399,743,.537,.537,303,452,.670,276,656,932,82,34,277,168,254,1101
6409,ATL,1998,Steve Smith,28,73,73,2857,489,1101,.444,97,276,.351,392,825,.475,.488,389,455,.855,133,176,309,292,75,29,176,219,1464
6410,ATL,1998,Mookie Blaylock,30,70,69,2700,368,938,.392,90,334,.269,278,604,.460,.440,95,134,.709,81,260,341,469,183,21,176,122,921
6411,ATL,1998,Tyrone Corbin,35,79,79,2699,328,747,.439,49,141,.348,279,606,.460,.472,101,128,.789,78,284,362,173,105,7,86,197,806
6412,ATL,1998,Christian Laettner,28,74,49,2282,354,730,.485,6,27,.222,348,703,.495,.489,306,354,.864,142,345,487,190,71,73,183,246,1020
6413,ATL,1998,Alan Henderson,25,69,33,2000,365,753,.485,3,6,.500,362,747,.485,.487,253,388,.652,200,242,442,73,42,36,110,175,986
6414,ATL,1998,Eldridge Recasner,30,59,14,1454,206,452,.456,62,148,.419,144,304,.474,.524,74,79,.937,32,110,142,117,41,1,91,94,548
6415,ATL,1998,Chucky Brown,29,77,8,1202,161,372,.433,2,8,.250,159,364,.437,.435,63,87,.724,57,126,183,55,23,13,51,100,387
6416,ATL,1998,Ed Gray,22,30,3,472,77,202,.381,18,46,.391,59,156,.378,.426,55,65,.846,9,36,45,34,15,11,30,73,227
6417,ATL,1998,Greg Anderson,33,50,0,398,36,81,.444,0,5,.000,36,76,.474,.444,16,41,.390,39,79,118,15,19,10,17,85,88
6418,ATL,1998,Drew Barry,24,27,0,256,18,38,.474,9,21,.429,9,17,.529,.592,11,13,.846,5,30,35,49,10,1,30,28,56
6419,ATL,1998,Chris Crawford,22,40,0,256,46,110,.418,1,3,.333,45,107,.421,.423,57,68,.838,20,21,41,9,12,7,18,27,150
6420,ATL,1998,Anthony Miller,26,37,0,228,29,52,.558,0,0,,29,52,.558,.558,21,39,.538,30,40,70,3,15,3,14,41,79
6421,ATL,1998,Randy Livingston,22,12,0,82,3,12,.250,0,0,,3,12,.250,.250,4,5,.800,1,5,6,5,7,2,6,6,10
6422,ATL,1998,Brian Oliver,29,5,0,61,7,19,.368,0,0,,7,19,.368,.368,1,4,.250,3,6,9,2,1,0,1,4,15
6423,ATL,1998,Donald Whiteside,28,3,0,16,1,2,.500,0,1,.000,1,1,1.000,.500,0,2,.000,0,1,1,1,0,0,1,0,2
6424,ATL,1997,Christian Laettner,27,82,82,3140,548,1128,.486,31,88,.352,517,1040,.497,.500,359,440,.816,212,508,720,223,102,64,218,277,1486
6425,ATL,1997,Mookie Blaylock,29,78,78,3056,501,1159,.432,221,604,.366,280,555,.505,.528,131,174,.753,114,299,413,463,212,20,185,141,1354
6426,ATL,1997,Dikembe Mutombo,30,80,80,2973,380,721,.527,0,0,,380,721,.527,.527,306,434,.705,268,661,929,110,49,264,186,249,1066
6427,ATL,1997,Steve Smith,27,72,72,2818,491,1145,.429,130,388,.335,361,757,.477,.486,333,393,.847,90,148,238,305,62,23,176,173,1445
6428,ATL,1997,Tyrone Corbin,34,70,65,2305,253,600,.422,74,208,.356,179,392,.457,.483,86,108,.796,76,218,294,124,90,7,85,176,666
6429,ATL,1997,Eldridge Recasner,29,71,4,1207,148,350,.423,58,140,.414,90,210,.429,.506,51,58,.879,35,80,115,94,38,4,65,97,405
6430,ATL,1997,Jon Barry,27,58,8,965,100,246,.407,48,124,.387,52,122,.426,.504,37,46,.804,26,73,99,115,55,3,59,56,285
6431,ATL,1997,Henry James,31,53,15,945,125,306,.408,76,181,.420,49,125,.392,.533,30,36,.833,27,54,81,21,11,1,29,98,356
6432,ATL,1997,Ivano Newbill,26,72,2,850,40,91,.440,0,0,,40,91,.440,.440,20,52,.385,76,128,204,24,28,15,42,115,100
6433,ATL,1997,Alan Henderson,24,30,0,501,77,162,.475,0,0,,77,162,.475,.475,45,75,.600,47,69,116,23,21,6,29,73,199
6434,ATL,1997,Willie Burton,28,24,2,380,39,116,.336,13,46,.283,26,70,.371,.392,57,68,.838,11,30,41,11,8,3,26,55,148
6435,ATL,1997,Ken Norman,32,17,0,220,27,94,.287,6,38,.158,21,56,.375,.319,4,12,.333,8,31,39,12,7,3,18,17,64
6436,ATL,1997,Priest Lauderdale,23,35,0,180,49,89,.551,0,1,.000,49,88,.557,.551,13,23,.565,16,27,43,12,1,9,37,39,111
6437,ATL,1997,Donnie Boyce,23,22,2,154,21,63,.333,2,16,.125,19,47,.404,.349,11,22,.500,7,8,15,13,10,4,16,17,55
6438,ATL,1997,Darrin Hancock,25,14,0,86,13,27,.481,0,0,,13,27,.481,.481,8,12,.667,3,10,13,7,7,1,7,6,34
6439,ATL,1997,Anthony Miller,25,1,0,14,0,5,.000,0,0,,0,5,.000,.000,0,0,,2,5,7,0,0,0,0,2,0
6440,ATL,1997,Derrick Alston,24,2,0,11,0,5,.000,0,0,,0,5,.000,.000,0,2,.000,3,1,4,0,0,0,0,0,0
6441,ATL,1996,Grant Long,29,82,82,3008,395,838,.471,31,86,.360,364,752,.484,.490,257,337,.763,248,540,788,183,108,34,157,233,1078
6442,ATL,1996,Mookie Blaylock,28,81,81,2893,455,1123,.405,231,623,.371,224,500,.448,.508,127,170,.747,110,222,332,478,212,17,188,151,1268
6443,ATL,1996,Steve Smith,26,80,80,2856,494,1143,.432,140,423,.331,354,720,.492,.493,318,385,.826,124,202,326,224,68,17,151,207,1446
6444,ATL,1996,Stacey Augmon,27,77,49,2294,362,738,.491,1,4,.250,361,734,.492,.491,251,317,.792,137,167,304,137,106,31,138,188,976
6445,ATL,1996,Andrew Lang,29,51,51,1815,281,619,.454,0,3,.000,281,616,.456,.454,95,118,.805,111,223,334,62,35,85,94,178,657
6446,ATL,1996,Craig Ehlo,34,79,8,1758,253,591,.428,82,221,.371,171,370,.462,.497,81,103,.786,65,191,256,138,85,9,104,138,669
6447,ATL,1996,Alan Henderson,23,79,4,1416,192,434,.442,0,3,.000,192,431,.445,.442,119,200,.595,164,192,356,51,44,43,87,217,503
6448,ATL,1996,Christian Laettner,26,30,27,977,159,325,.489,0,8,.000,159,317,.502,.489,107,130,.823,86,150,236,68,31,28,75,119,425
6449,ATL,1996,Spud Webb,32,51,0,817,104,222,.468,18,57,.316,86,165,.521,.509,74,87,.851,19,41,60,140,27,2,51,68,300
6450,ATL,1996,Ken Norman,31,34,28,770,127,273,.465,33,84,.393,94,189,.497,.526,17,48,.354,40,92,132,63,15,16,46,68,304
6451,ATL,1996,Matt Bullard,28,46,0,460,66,162,.407,26,72,.361,40,90,.444,.488,16,20,.800,18,42,60,18,17,11,24,50,174
6452,ATL,1996,Reggie Jordan,28,24,0,247,36,71,.507,0,0,,36,71,.507,.507,22,38,.579,23,29,52,29,12,7,19,30,94
6453,ATL,1996,Sean Rooks,26,16,0,215,32,58,.552,0,1,.000,32,57,.561,.552,29,43,.674,21,30,51,9,4,14,31,35,93
6454,ATL,1996,Todd Mundt,25,24,0,118,13,32,.406,0,0,,13,32,.406,.406,5,8,.625,10,15,25,2,1,4,3,23,31
6455,ATL,1996,Donnie Boyce,22,8,0,41,9,23,.391,4,8,.500,5,15,.333,.478,2,4,.500,5,5,10,3,3,1,6,2,24
6456,ATL,1996,Ron Grandison,31,4,0,19,2,4,.500,0,1,.000,2,3,.667,.500,0,0,,1,5,6,1,0,0,0,0,4
6457,ATL,1996,Howard Nathan,24,5,0,15,5,9,.556,0,1,.000,5,8,.625,.556,3,4,.750,0,0,0,2,3,0,8,2,13
6458,ATL,1996,Tim Kempton,32,3,0,11,0,0,,0,0,,0,0,,,0,0,,0,2,2,1,0,0,1,5,0
6459,ATL,1995,Mookie Blaylock,27,80,80,3069,509,1198,.425,199,555,.359,310,643,.482,.508,156,214,.729,117,276,393,616,200,26,242,164,1373
6460,ATL,1995,Steve Smith,25,78,59,2603,417,976,.427,135,404,.334,282,572,.493,.496,295,349,.845,100,170,270,267,60,32,151,216,1264
6461,ATL,1995,Grant Long,28,79,77,2579,337,704,.479,11,31,.355,326,673,.484,.487,238,315,.756,190,405,595,127,107,34,151,232,923
6462,ATL,1995,Stacey Augmon,26,76,76,2362,397,876,.453,7,26,.269,390,850,.459,.457,252,346,.728,157,211,368,197,100,47,152,163,1053
6463,ATL,1995,Andrew Lang,28,82,63,2340,320,677,.473,2,3,.667,318,674,.472,.474,152,188,.809,154,302,456,72,45,144,108,271,794
6464,ATL,1995,Ken Norman,30,74,27,1879,388,856,.453,98,285,.344,290,571,.508,.511,64,140,.457,103,259,362,94,34,20,96,154,938
6465,ATL,1995,Tyrone Corbin,32,81,4,1389,205,464,.442,14,56,.250,191,408,.468,.457,78,114,.684,98,164,262,67,55,16,74,161,502
6466,ATL,1995,Craig Ehlo,33,49,0,1166,191,422,.453,51,134,.381,140,288,.486,.513,44,71,.620,55,92,147,113,46,6,73,86,477
6467,ATL,1995,Jon Koncak,31,62,20,943,77,187,.412,12,36,.333,65,151,.430,.444,13,24,.542,23,161,184,52,36,46,20,137,179
6468,ATL,1995,Greg Anderson,30,51,0,622,57,104,.548,0,0,,57,104,.548,.548,34,71,.479,62,126,188,17,23,32,32,103,148
6469,ATL,1995,Ennis Whatley,32,27,2,292,24,53,.453,2,8,.250,22,45,.489,.472,20,32,.625,9,21,30,54,19,0,19,37,70
6470,ATL,1995,Doug Edwards,24,38,0,212,22,48,.458,0,1,.000,22,47,.468,.458,23,32,.719,19,29,48,13,5,4,22,30,67
6471,ATL,1995,Jim Les,31,24,0,188,11,38,.289,5,23,.217,6,15,.400,.355,23,27,.852,6,20,26,44,4,0,21,28,50
6472,ATL,1995,Kevin Willis,32,2,2,89,16,41,.390,0,1,.000,16,40,.400,.390,10,15,.667,10,26,36,3,1,3,7,7,42
6473,ATL,1995,Sergei Bazarevich,29,10,0,74,11,22,.500,1,6,.167,10,16,.625,.523,7,9,.778,1,6,7,14,1,1,7,10,30
6474,ATL,1995,Fred Vinson,24,5,0,27,1,7,.143,1,6,.167,0,1,.000,.214,1,1,1.000,0,0,0,1,0,0,2,4,4
6475,ATL,1995,Morlon Wiley,28,5,0,17,3,6,.500,1,4,.250,2,2,1.000,.583,0,0,,0,4,4,6,1,1,4,0,7
6476,ATL,1995,Tom Hovasse,28,2,0,4,0,1,.000,0,1,.000,0,0,,.000,0,0,,0,0,0,0,1,0,0,1,0
6477,ATL,1994,Mookie Blaylock,26,81,81,2915,444,1079,.411,114,341,.334,330,738,.447,.464,116,159,.730,117,307,424,789,212,44,196,144,1118
6478,ATL,1994,Kevin Willis,31,80,80,2867,627,1257,.499,9,24,.375,618,1233,.501,.502,268,376,.713,335,628,963,150,79,38,188,250,1531
6479,ATL,1994,Stacey Augmon,25,82,82,2605,439,861,.510,1,7,.143,438,854,.513,.510,333,436,.764,178,216,394,187,149,45,147,179,1212
6480,ATL,1994,Craig Ehlo,32,82,0,2147,316,708,.446,77,221,.348,239,487,.491,.501,112,154,.727,71,208,279,273,136,26,130,161,821
6481,ATL,1994,Jon Koncak,30,82,78,1823,159,369,.431,0,3,.000,159,366,.434,.431,24,36,.667,83,282,365,102,63,125,44,236,342
6482,ATL,1994,Dominique Wilkins,34,49,49,1687,430,996,.432,61,198,.308,369,798,.462,.462,275,322,.854,119,186,305,114,63,22,120,87,1196
6483,ATL,1994,Andrew Lang,27,82,0,1608,215,458,.469,1,4,.250,214,454,.471,.471,73,106,.689,126,187,313,51,38,87,81,192,504
6484,ATL,1994,Duane Ferrell,28,72,13,1155,184,379,.485,1,9,.111,183,370,.495,.487,144,184,.783,62,67,129,65,44,16,64,85,513
6485,ATL,1994,Ennis Whatley,31,82,1,1004,120,236,.508,0,6,.000,120,230,.522,.508,52,66,.788,22,77,99,181,59,2,78,93,292
6486,ATL,1994,Danny Manning,27,26,25,925,177,372,.476,1,3,.333,176,369,.477,.477,54,83,.651,49,120,169,85,46,25,86,93,409
6487,ATL,1994,Adam Keefe,23,63,1,763,96,213,.451,0,0,,96,213,.451,.451,81,111,.730,77,124,201,34,20,9,60,80,273
6488,ATL,1994,Paul Graham,26,21,0,128,21,57,.368,3,13,.231,18,44,.409,.395,13,17,.765,4,8,12,13,4,5,5,11,58
6489,ATL,1994,Doug Edwards,23,16,0,107,17,49,.347,0,1,.000,17,48,.354,.347,9,16,.563,7,11,18,8,2,5,6,9,43
6490,ATL,1994,John Bagley,33,3,0,13,0,2,.000,0,0,,0,2,.000,.000,2,2,1.000,0,1,1,3,0,0,0,2,2
6491,ATL,1994,Ricky Grace,26,3,0,8,2,3,.667,0,0,,2,3,.667,.667,0,2,.000,0,1,1,1,0,0,0,3,4
6492,ATL,1993,Kevin Willis,30,80,80,2878,616,1218,.506,7,29,.241,609,1189,.512,.509,196,300,.653,335,693,1028,165,68,41,213,264,1435
6493,ATL,1993,Mookie Blaylock,25,80,78,2820,414,964,.429,118,315,.375,296,649,.456,.491,123,169,.728,89,191,280,671,203,23,187,156,1069
6494,ATL,1993,Dominique Wilkins,33,71,70,2647,741,1584,.468,120,316,.380,621,1268,.490,.506,519,627,.828,187,295,482,227,70,27,184,116,2121
6495,ATL,1993,Stacey Augmon,24,73,66,2112,397,792,.501,0,4,.000,397,788,.504,.501,227,307,.739,141,146,287,170,91,18,157,141,1021
6496,ATL,1993,Jon Koncak,29,78,65,1975,124,267,.464,3,8,.375,121,259,.467,.470,24,50,.480,100,327,427,140,75,100,52,264,275
6497,ATL,1993,Duane Ferrell,27,82,15,1736,327,696,.470,9,36,.250,318,660,.482,.476,176,226,.779,97,94,191,132,59,17,103,160,839
6498,ATL,1993,Adam Keefe,22,82,6,1549,188,376,.500,0,1,.000,188,375,.501,.500,166,237,.700,171,261,432,80,57,16,100,195,542
6499,ATL,1993,Paul Graham,25,80,11,1508,256,560,.457,42,141,.298,214,419,.511,.495,96,131,.733,61,129,190,164,86,6,120,185,650
6500,ATL,1993,Travis Mays,24,49,9,787,129,309,.417,29,84,.345,100,225,.444,.464,54,82,.659,20,33,53,72,21,3,51,59,341
6501,ATL,1993,Steve Henson,24,53,2,719,71,182,.390,37,80,.463,34,102,.333,.492,34,40,.850,12,43,55,155,30,1,52,85,213
6502,ATL,1993,Morlon Wiley,26,25,2,354,26,81,.321,15,51,.294,11,30,.367,.414,5,8,.625,9,26,35,81,26,2,29,49,72
6503,ATL,1993,Blair Rasmussen,30,22,6,283,30,80,.375,2,6,.333,28,74,.378,.388,9,13,.692,20,35,55,5,5,10,12,61,71
6504,ATL,1993,Greg Foster,24,33,0,205,44,95,.463,0,4,.000,44,91,.484,.463,13,18,.722,24,32,56,10,3,9,16,41,101
6505,ATL,1993,Jeff Sanders,27,9,0,120,10,25,.400,0,0,,10,25,.400,.400,4,8,.500,12,17,29,6,8,1,11,16,24
6506,ATL,1993,Randy Breuer,32,12,0,107,15,31,.484,0,0,,15,31,.484,.484,2,5,.400,10,18,28,6,2,3,5,12,32
6507,ATL,1993,Andre Spencer,28,3,0,15,0,3,.000,0,0,,0,3,.000,.000,0,0,,0,1,1,0,2,0,2,3,0
6508,ATL,1993,Alex Stivrins,30,5,0,15,4,9,.444,0,1,.000,4,8,.500,.444,0,0,,2,3,5,0,0,1,0,0,8
6509,ATL,1992,Kevin Willis,29,81,80,2962,591,1224,.483,6,37,.162,585,1187,.493,.485,292,363,.804,418,840,1258,173,72,54,197,223,1480
6510,ATL,1992,Stacey Augmon,23,82,82,2505,440,899,.489,1,6,.167,439,893,.492,.490,213,320,.666,191,229,420,201,124,27,181,161,1094
6511,ATL,1992,Rumeal Robinson,25,81,64,2220,423,928,.456,34,104,.327,389,824,.472,.474,175,275,.636,64,155,219,446,105,24,206,178,1055
6512,ATL,1992,Blair Rasmussen,29,81,61,1968,347,726,.478,5,23,.217,342,703,.486,.481,30,40,.750,94,299,393,107,35,48,51,233,729
6513,ATL,1992,Paul Graham,24,78,9,1718,305,682,.447,55,141,.390,250,541,.462,.488,126,170,.741,72,159,231,175,96,21,91,193,791
6514,ATL,1992,Dominique Wilkins,32,42,42,1601,424,914,.464,37,128,.289,387,786,.492,.484,294,352,.835,103,192,295,158,52,24,122,77,1179
6515,ATL,1992,Duane Ferrell,26,66,12,1598,331,632,.524,11,33,.333,320,599,.534,.532,166,218,.761,105,105,210,92,49,17,99,134,839
6516,ATL,1992,Alexander Volkov,27,77,27,1516,251,569,.441,35,110,.318,216,459,.471,.472,125,198,.631,103,162,265,250,66,30,102,178,662
6517,ATL,1992,Jon Koncak,28,77,14,1489,111,284,.391,0,12,.000,111,272,.408,.391,19,29,.655,62,199,261,132,50,67,54,207,241
6518,ATL,1992,Maurice Cheeks,35,56,0,1086,115,249,.462,3,6,.500,112,243,.461,.468,26,43,.605,29,66,95,185,83,0,36,73,259
6519,ATL,1992,Morlon Wiley,25,41,19,767,71,160,.444,14,38,.368,57,122,.467,.488,21,30,.700,22,51,73,166,43,3,52,73,177
6520,ATL,1992,Rodney Monroe,23,38,0,313,53,144,.368,6,27,.222,47,117,.402,.389,19,23,.826,12,21,33,27,12,2,23,19,131
6521,ATL,1992,Jeff Sanders,26,12,0,117,20,45,.444,0,0,,20,45,.444,.444,7,9,.778,9,17,26,9,5,3,5,15,47
6522,ATL,1992,Travis Mays,23,2,0,32,6,14,.429,3,6,.500,3,8,.375,.536,2,2,1.000,1,1,2,1,0,0,3,4,17
6523,ATL,1992,Gary Leonard,24,5,0,13,4,6,.667,0,0,,4,6,.667,.667,2,2,1.000,3,2,5,1,1,0,1,3,10
6524,ATL,1991,Dominique Wilkins,31,81,81,3078,770,1640,.470,85,249,.341,685,1391,.492,.495,476,574,.829,261,471,732,265,123,65,201,156,2101
6525,ATL,1991,Doc Rivers,29,79,79,2586,444,1020,.435,88,262,.336,356,758,.470,.478,221,262,.844,47,206,253,340,148,47,125,216,1197
6526,ATL,1991,Kevin Willis,28,80,80,2373,444,881,.504,4,10,.400,440,871,.505,.506,159,238,.668,259,445,704,99,60,40,153,235,1051
6527,ATL,1991,Spud Webb,27,75,64,2197,359,803,.447,54,168,.321,305,635,.480,.481,231,266,.868,41,133,174,417,118,6,146,180,1003
6528,ATL,1991,Jon Koncak,27,77,61,1931,140,321,.436,1,8,.125,139,313,.444,.438,32,54,.593,101,274,375,124,74,76,50,265,313
6529,ATL,1991,Moses Malone,35,82,15,1912,280,598,.468,0,7,.000,280,591,.474,.468,309,372,.831,271,396,667,68,30,74,137,134,869
6530,ATL,1991,John Battle,28,79,2,1863,397,862,.461,14,49,.286,383,813,.471,.469,270,316,.854,34,125,159,217,45,6,113,145,1078
6531,ATL,1991,Duane Ferrell,25,78,2,1165,174,356,.489,2,3,.667,172,353,.487,.492,125,156,.801,97,82,179,55,33,27,78,151,475
6532,ATL,1991,Sidney Moncrief,33,72,3,1096,117,240,.488,21,64,.328,96,176,.545,.531,82,105,.781,31,97,128,104,50,9,66,112,337
6533,ATL,1991,Tim McCormick,28,56,7,689,93,187,.497,0,3,.000,93,184,.505,.497,66,90,.733,56,109,165,32,11,14,45,91,252
6534,ATL,1991,Rumeal Robinson,24,47,16,674,108,242,.446,2,11,.182,106,231,.459,.450,47,80,.588,20,51,71,132,32,8,76,65,265
6535,ATL,1991,Trevor Wilson,22,25,0,162,21,70,.300,0,2,.000,21,68,.309,.300,13,26,.500,16,24,40,11,5,1,17,13,55
6536,ATL,1991,Howard Wright,23,4,0,20,2,3,.667,0,0,,2,3,.667,.667,1,1,1.000,1,5,6,0,0,0,2,3,5
6537,ATL,1991,Gary Leonard,23,4,0,9,0,0,,0,0,,0,0,,,2,4,.500,0,2,2,0,0,1,0,2,2
6538,ATL,1990,Dominique Wilkins,30,80,79,2888,810,1672,.484,59,183,.322,751,1489,.504,.502,459,569,.807,217,304,521,200,126,47,174,141,2138
6539,ATL,1990,Moses Malone,34,81,81,2735,517,1077,.480,1,9,.111,516,1068,.483,.481,493,631,.781,364,448,812,130,47,84,232,158,1528
6540,ATL,1990,Kevin Willis,27,81,51,2273,418,805,.519,2,7,.286,416,798,.521,.520,168,246,.683,253,392,645,57,63,47,144,259,1006
6541,ATL,1990,Spud Webb,26,82,46,2184,294,616,.477,1,19,.053,293,597,.491,.478,162,186,.871,38,163,201,477,105,12,141,185,751
6542,ATL,1990,Cliff Levingston,29,75,5,1706,216,424,.509,1,5,.200,215,419,.513,.511,83,122,.680,113,206,319,80,55,41,49,216,516
6543,ATL,1990,Doc Rivers,28,48,44,1526,218,480,.454,24,66,.364,194,414,.469,.479,138,170,.812,47,153,200,264,116,22,98,151,598
6544,ATL,1990,John Battle,27,60,48,1477,275,544,.506,2,13,.154,273,531,.514,.507,102,135,.756,27,72,99,154,28,3,89,115,654
6545,ATL,1990,John Long,33,48,19,1030,174,384,.453,10,29,.345,164,355,.462,.466,46,55,.836,26,57,83,85,45,5,75,66,404
6546,ATL,1990,Jon Koncak,26,54,28,977,78,127,.614,0,1,.000,78,126,.619,.614,42,79,.532,58,168,226,23,38,34,47,182,198
6547,ATL,1990,Alexander Volkov,25,72,4,937,137,284,.482,13,34,.382,124,250,.496,.505,70,120,.583,52,67,119,83,36,22,52,166,357
6548,ATL,1990,Antoine Carr,28,44,0,803,128,248,.516,0,4,.000,128,244,.525,.516,79,102,.775,50,99,149,53,15,34,54,128,335
6549,ATL,1990,Kenny Smith,24,33,5,674,98,204,.480,4,24,.167,94,180,.522,.490,55,65,.846,7,30,37,142,22,1,47,45,255
6550,ATL,1990,Sedric Toney,27,32,0,286,30,72,.417,7,13,.538,23,59,.390,.465,21,25,.840,3,11,14,52,10,0,21,35,88
6551,ATL,1990,Roy Marble,23,24,0,162,16,58,.276,0,2,.000,16,56,.286,.276,19,29,.655,15,9,24,11,7,1,14,16,51
6552,ATL,1990,Duane Ferrell,24,14,0,29,5,14,.357,0,1,.000,5,13,.385,.357,2,6,.333,3,4,7,2,1,0,2,3,12
6553,ATL,1990,Haywoode Workman,24,6,0,16,2,3,.667,0,0,,2,3,.667,.667,2,2,1.000,0,3,3,2,3,0,0,3,6
6554,ATL,1990,Mike Williams,26,5,0,14,0,4,.000,0,0,,0,4,.000,.000,0,0,,0,1,1,0,0,0,0,2,0
6555,ATL,1990,Wes Matthews,30,1,0,13,1,3,.333,0,1,.000,1,2,.500,.333,2,2,1.000,0,0,0,5,0,0,0,0,4
6556,ATL,1989,Dominique Wilkins,29,80,80,2997,814,1756,.464,29,105,.276,785,1651,.475,.472,442,524,.844,256,297,553,211,117,52,181,138,2099
6557,ATL,1989,Moses Malone,33,81,80,2878,538,1096,.491,0,12,.000,538,1084,.496,.491,561,711,.789,386,570,956,112,79,100,245,154,1637
6558,ATL,1989,Reggie Theus,31,82,82,2517,497,1067,.466,17,58,.293,480,1009,.476,.474,285,335,.851,86,156,242,387,108,16,194,236,1296
6559,ATL,1989,Doc Rivers,27,76,76,2462,371,816,.455,43,124,.347,328,692,.474,.481,247,287,.861,89,197,286,525,181,40,158,263,1032
6560,ATL,1989,Cliff Levingston,28,80,52,2184,300,568,.528,1,5,.200,299,563,.531,.529,133,191,.696,194,304,498,75,97,70,105,270,734
6561,ATL,1989,John Battle,26,82,0,1672,287,628,.457,11,34,.324,276,594,.465,.466,194,238,.815,30,110,140,197,42,9,104,125,779
6562,ATL,1989,Jon Koncak,25,74,22,1531,141,269,.524,0,3,.000,141,266,.530,.524,63,114,.553,147,306,453,56,54,98,60,238,345
6563,ATL,1989,Antoine Carr,27,78,12,1488,226,471,.480,0,1,.000,226,470,.481,.480,130,152,.855,106,168,274,91,31,62,82,221,582
6564,ATL,1989,Spud Webb,25,81,6,1219,133,290,.459,1,22,.045,132,268,.493,.460,52,60,.867,21,102,123,284,70,6,83,104,319
6565,ATL,1989,Ray Tolbert,30,50,0,341,40,94,.426,0,0,,40,94,.426,.426,23,37,.622,31,57,88,16,13,13,35,55,103
6566,ATL,1989,Dudley Bradley,31,38,0,267,28,86,.326,8,31,.258,20,55,.364,.372,8,16,.500,7,25,32,24,16,2,14,41,72
6567,ATL,1989,Duane Ferrell,23,41,0,231,35,83,.422,0,0,,35,83,.422,.422,30,44,.682,19,22,41,10,7,6,12,33,100
6568,ATL,1989,Pace Mannion,28,5,0,18,2,6,.333,0,2,.000,2,4,.500,.333,0,0,,0,2,2,2,2,0,3,2,4
6569,ATL,1988,Dominique Wilkins,28,78,76,2948,909,1957,.464,38,129,.295,871,1828,.476,.474,541,655,.826,211,291,502,224,103,47,218,162,2397
6570,ATL,1988,Doc Rivers,26,80,80,2502,403,890,.453,9,33,.273,394,857,.460,.458,319,421,.758,83,283,366,747,140,41,210,272,1134
6571,ATL,1988,Randy Wittman,28,82,82,2412,376,787,.478,0,0,,376,787,.478,.478,71,89,.798,39,131,170,302,50,18,82,117,823
6572,ATL,1988,Cliff Levingston,27,82,32,2135,314,564,.557,1,2,.500,313,562,.557,.558,190,246,.772,228,276,504,71,52,84,94,287,819
6573,ATL,1988,Kevin Willis,25,75,55,2091,356,687,.518,0,2,.000,356,685,.520,.518,159,245,.649,235,312,547,28,68,41,138,240,871
6574,ATL,1988,Tree Rollins,32,76,59,1765,133,260,.512,0,0,,133,260,.512,.512,70,80,.875,142,317,459,20,31,132,51,229,336
6575,ATL,1988,Antoine Carr,26,80,2,1483,281,517,.544,1,4,.250,280,513,.546,.544,142,182,.780,94,195,289,103,38,83,116,272,705
6576,ATL,1988,Spud Webb,24,82,1,1347,191,402,.475,1,19,.053,190,383,.496,.476,107,131,.817,16,130,146,337,63,12,131,125,490
6577,ATL,1988,John Battle,25,67,1,1227,278,613,.454,16,41,.390,262,572,.458,.467,141,188,.750,26,87,113,158,31,5,75,84,713
6578,ATL,1988,Jon Koncak,24,49,22,1073,98,203,.483,0,2,.000,98,201,.488,.483,83,136,.610,103,230,333,19,36,56,53,161,279
6579,ATL,1988,Scott Hastings,27,55,0,403,40,82,.488,5,12,.417,35,70,.500,.518,25,27,.926,27,70,97,16,8,10,14,67,110
6580,ATL,1988,Chris Washburn,22,29,0,174,22,49,.449,0,0,,22,49,.449,.449,13,23,.565,19,36,55,3,4,8,10,19,57
6581,ATL,1988,Mike McGee,28,11,0,117,22,52,.423,5,19,.263,17,33,.515,.471,2,6,.333,4,12,16,13,5,0,7,6,51
6582,ATL,1988,Leon Wood,25,14,0,79,16,30,.533,9,19,.474,7,11,.636,.683,7,8,.875,1,5,6,19,4,0,5,6,48
6583,ATL,1988,Ennis Whatley,25,5,0,24,4,9,.444,0,0,,4,9,.444,.444,3,4,.750,0,4,4,2,2,0,4,3,11
6584,ATL,1987,Dominique Wilkins,27,79,79,2969,828,1787,.463,31,106,.292,797,1681,.474,.472,607,742,.818,210,284,494,261,117,51,215,149,2294
6585,ATL,1987,Kevin Willis,24,81,81,2626,538,1003,.536,1,4,.250,537,999,.538,.537,227,320,.709,321,528,849,62,65,61,173,313,1304
6586,ATL,1987,Doc Rivers,25,82,82,2590,342,758,.451,4,21,.190,338,737,.459,.454,365,441,.828,83,216,299,823,171,30,217,287,1053
6587,ATL,1987,Randy Wittman,27,71,65,2049,398,792,.503,4,12,.333,394,780,.505,.505,100,127,.787,30,94,124,211,39,16,88,107,900
6588,ATL,1987,Cliff Levingston,26,82,10,1848,251,496,.506,0,3,.000,251,493,.509,.506,155,212,.731,219,314,533,40,48,68,72,261,657
6589,ATL,1987,Tree Rollins,31,75,58,1764,171,313,.546,0,0,,171,313,.546,.546,63,87,.724,155,333,488,22,43,140,61,240,405
6590,ATL,1987,Jon Koncak,23,82,19,1684,169,352,.480,0,1,.000,169,351,.481,.480,125,191,.654,153,340,493,31,52,76,92,262,463
6591,ATL,1987,Mike McGee,27,76,6,1420,311,677,.459,86,229,.376,225,448,.502,.523,80,137,.584,71,88,159,149,61,2,104,156,788
6592,ATL,1987,John Battle,24,64,8,804,144,315,.457,0,10,.000,144,305,.472,.457,93,126,.738,16,44,60,124,29,5,60,76,381
6593,ATL,1987,Antoine Carr,25,65,2,695,134,265,.506,1,3,.333,133,262,.508,.508,73,103,.709,60,96,156,34,14,48,40,146,342
6594,ATL,1987,Spud Webb,23,33,0,532,71,162,.438,1,6,.167,70,156,.449,.441,80,105,.762,6,54,60,167,34,2,70,65,223
6595,ATL,1987,Gus Williams,33,33,0,481,53,146,.363,5,18,.278,48,128,.375,.380,27,40,.675,8,32,40,139,17,5,54,53,138
6596,ATL,1987,Scott Hastings,26,40,0,256,23,68,.338,2,12,.167,21,56,.375,.353,23,29,.793,16,54,70,13,10,7,13,35,71
6597,ATL,1987,Cedric Henderson,21,6,0,10,2,5,.400,0,0,,2,5,.400,.400,1,1,1.000,2,1,3,0,0,0,1,1,5
6598,ATL,1987,Michael Wilson,27,2,0,2,0,2,.000,0,0,,0,2,.000,.000,0,0,,0,0,0,1,0,0,1,1,0
6599,ATL,1986,Dominique Wilkins,26,78,78,3049,888,1897,.468,13,70,.186,875,1827,.479,.472,577,705,.818,261,357,618,206,138,49,251,170,2366
6600,ATL,1986,Randy Wittman,26,81,79,2760,467,881,.530,5,16,.313,462,865,.534,.533,104,135,.770,51,119,170,306,81,14,114,118,1043
6601,ATL,1986,Kevin Willis,23,82,59,2300,419,811,.517,0,6,.000,419,805,.520,.517,172,263,.654,243,461,704,45,66,44,177,294,1010
6602,ATL,1986,Cliff Levingston,25,81,35,1945,294,551,.534,0,1,.000,294,550,.535,.534,164,242,.678,193,341,534,72,76,39,113,260,752
6603,ATL,1986,Tree Rollins,30,74,61,1781,173,347,.499,0,1,.000,173,346,.500,.499,69,90,.767,131,327,458,41,38,167,91,239,415
6604,ATL,1986,Jon Koncak,22,82,15,1695,263,519,.507,0,1,.000,263,518,.508,.507,156,257,.607,171,296,467,55,37,69,111,296,682
6605,ATL,1986,Doc Rivers,24,53,50,1571,220,464,.474,0,16,.000,220,448,.491,.474,172,283,.608,49,113,162,443,120,13,141,185,612
6606,ATL,1986,Spud Webb,22,79,8,1229,199,412,.483,2,11,.182,197,401,.491,.485,216,275,.785,27,96,123,337,82,5,159,164,616
6607,ATL,1986,Eddie Johnson,30,39,5,862,155,328,.473,5,20,.250,150,308,.487,.480,79,110,.718,17,58,75,219,10,1,90,72,394
6608,ATL,1986,Scott Hastings,25,62,0,650,65,159,.409,3,4,.750,62,155,.400,.418,60,70,.857,44,80,124,26,14,8,40,118,193
6609,ATL,1986,John Battle,23,64,0,639,101,222,.455,0,7,.000,101,215,.470,.455,75,103,.728,12,50,62,74,23,3,47,80,277
6610,ATL,1986,Johnny Davis,30,27,7,402,46,107,.430,1,2,.500,45,105,.429,.435,51,59,.864,2,17,19,112,13,0,38,32,144
6611,ATL,1986,Ray Williams,31,19,13,367,57,143,.399,4,11,.364,53,132,.402,.413,41,48,.854,19,26,45,67,28,1,41,48,159
6612,ATL,1986,Lorenzo Charles,22,36,0,273,49,88,.557,0,0,,49,88,.557,.557,24,36,.667,13,26,39,8,2,6,18,37,122
6613,ATL,1986,Antoine Carr,24,17,0,258,49,93,.527,0,0,,49,93,.527,.527,18,27,.667,16,36,52,14,7,15,14,51,116
6614,ATL,1986,Sedric Toney,23,3,0,24,2,7,.286,0,0,,2,7,.286,.286,1,1,1.000,0,2,2,0,1,0,3,6,5
6615,ATL,1985,Dominique Wilkins,25,81,81,3023,853,1891,.451,25,81,.309,828,1810,.457,.458,486,603,.806,226,331,557,200,135,54,225,170,2217
6616,ATL,1985,Eddie Johnson,29,73,66,2367,453,946,.479,22,72,.306,431,874,.493,.490,265,332,.798,38,154,192,566,43,7,244,184,1193
6617,ATL,1985,Doc Rivers,23,69,58,2126,334,701,.476,15,36,.417,319,665,.480,.487,291,378,.770,66,148,214,410,163,53,176,250,974
6618,ATL,1985,Cliff Levingston,24,74,53,2017,291,552,.527,0,2,.000,291,550,.529,.527,145,222,.653,230,336,566,104,70,69,133,231,727
6619,ATL,1985,Kevin Willis,22,82,19,1785,322,690,.467,2,9,.222,320,681,.470,.468,119,181,.657,177,345,522,36,31,49,104,226,765
6620,ATL,1985,Tree Rollins,29,70,60,1750,186,339,.549,0,0,,186,339,.549,.549,67,93,.720,113,329,442,52,35,167,80,213,439
6621,ATL,1985,Antoine Carr,23,62,15,1195,198,375,.528,2,6,.333,196,369,.531,.531,101,128,.789,79,153,232,80,29,78,108,219,499
6622,ATL,1985,Randy Wittman,25,41,22,1168,187,352,.531,2,7,.286,185,345,.536,.534,30,41,.732,16,57,73,125,28,7,57,58,406
6623,ATL,1985,Mike Glenn,29,60,5,1126,228,388,.588,0,2,.000,228,386,.591,.588,62,76,.816,20,61,81,122,27,0,55,74,518
6624,ATL,1985,Sly Williams,27,34,20,867,167,380,.439,4,15,.267,163,365,.447,.445,79,123,.642,45,123,168,94,28,8,78,83,417
6625,ATL,1985,Scott Hastings,24,64,1,825,89,188,.473,0,0,,89,188,.473,.473,63,81,.778,59,100,159,46,24,23,50,135,241
6626,ATL,1985,Rickey Brown,26,69,5,814,78,192,.406,0,0,,78,192,.406,.406,39,68,.574,76,147,223,25,19,22,51,117,195
6627,ATL,1985,Walker Russell,24,21,2,377,34,63,.540,1,1,1.000,33,62,.532,.548,14,17,.824,8,32,40,66,17,4,40,37,83
6628,ATL,1985,Sidney Lowe,25,15,0,159,8,20,.400,0,1,.000,8,19,.421,.400,8,8,1.000,4,11,15,42,11,0,11,23,24
6629,ATL,1985,Charlie Criss,36,4,2,115,7,17,.412,0,2,.000,7,15,.467,.412,4,6,.667,2,12,14,22,3,0,11,5,18
6630,ATL,1985,Stewart Granger,23,9,1,92,6,17,.353,0,1,.000,6,16,.375,.353,4,8,.500,1,5,6,12,2,0,12,13,16
6631,ATL,1985,Jerry Eaves,25,3,0,37,3,6,.500,0,0,,3,6,.500,.500,5,6,.833,0,0,0,4,0,0,4,6,11
6632,ATL,1985,Leo Rautins,24,4,0,12,0,2,.000,0,0,,0,2,.000,.000,0,0,,1,1,2,3,0,0,1,3,0
6633,ATL,1984,Dominique Wilkins,24,81,81,2961,684,1429,.479,0,11,.000,684,1418,.482,.479,382,496,.770,254,328,582,126,117,87,215,197,1750
6634,ATL,1984,Dan Roundfield,30,73,72,2610,503,1038,.485,0,11,.000,503,1027,.490,.485,374,486,.770,206,515,721,184,61,74,205,221,1380
6635,ATL,1984,Tree Rollins,28,77,76,2351,274,529,.518,0,0,,274,529,.518,.518,118,190,.621,200,393,593,62,35,277,101,297,666
6636,ATL,1984,Johnny Davis,28,75,72,2079,354,800,.443,0,8,.000,354,792,.447,.443,217,256,.848,53,86,139,326,62,6,134,146,925
6637,ATL,1984,Doc Rivers,22,81,47,1938,250,541,.462,2,12,.167,248,529,.469,.464,255,325,.785,72,148,220,314,127,30,174,286,757
6638,ATL,1984,Eddie Johnson,28,67,43,1893,353,798,.442,16,43,.372,337,755,.446,.452,164,213,.770,31,115,146,374,58,7,173,155,886
6639,ATL,1984,Mike Glenn,28,81,0,1503,312,554,.563,1,2,.500,311,552,.563,.564,56,70,.800,17,87,104,171,46,5,63,146,681
6640,ATL,1984,Scott Hastings,23,68,8,1135,111,237,.468,1,4,.250,110,233,.472,.470,82,104,.788,96,174,270,46,40,36,66,220,305
6641,ATL,1984,Randy Wittman,24,78,1,1071,160,318,.503,2,5,.400,158,313,.505,.506,28,46,.609,14,57,71,71,17,0,32,82,350
6642,ATL,1984,Rickey Brown,25,68,3,785,94,201,.468,0,0,,94,201,.468,.468,48,65,.738,67,114,181,29,18,23,53,161,236
6643,ATL,1984,Billy Paultz,35,40,4,486,36,88,.409,0,0,,36,88,.409,.409,17,33,.515,35,78,113,18,8,7,22,57,89
6644,ATL,1984,Mark Landsberger,28,35,0,335,19,51,.373,0,0,,19,51,.373,.373,15,26,.577,42,77,119,10,6,3,21,32,53
6645,ATL,1984,Sly Williams,26,13,1,258,34,114,.298,1,9,.111,33,105,.314,.303,36,46,.783,19,31,50,16,14,1,18,33,105
6646,ATL,1984,Armond Hill,30,15,2,181,14,46,.304,0,0,,14,46,.304,.304,17,21,.810,2,8,10,35,7,0,14,30,45
6647,ATL,1984,Charlie Criss,35,9,0,108,9,22,.409,0,0,,9,22,.409,.409,5,5,1.000,3,8,11,21,3,0,6,4,23
6648,ATL,1984,Wes Matthews,24,6,0,96,16,30,.533,0,1,.000,16,29,.552,.533,18,22,.818,1,3,4,21,5,1,10,13,50
6649,ATL,1984,John Pinone,22,7,0,65,7,13,.538,0,0,,7,13,.538,.538,6,10,.600,0,10,10,3,2,1,5,11,20
6650,ATL,1983,Dan Roundfield,29,77,76,2811,561,1193,.470,5,27,.185,556,1166,.477,.472,337,450,.749,259,621,880,225,60,115,245,239,1464
6651,ATL,1983,Dominique Wilkins,23,82,82,2697,601,1220,.493,2,11,.182,599,1209,.495,.493,230,337,.682,226,252,478,129,84,63,180,210,1434
6652,ATL,1983,Tree Rollins,27,80,80,2472,261,512,.510,0,1,.000,261,511,.511,.510,98,135,.726,210,533,743,75,49,343,95,294,620
6653,ATL,1983,Eddie Johnson,27,61,57,1813,389,858,.453,14,41,.341,375,817,.459,.462,186,237,.785,26,98,124,318,61,6,156,138,978
6654,ATL,1983,Rory Sparrow,24,49,49,1548,264,512,.516,3,15,.200,261,497,.525,.519,84,113,.743,39,102,141,238,70,1,126,162,615
6655,ATL,1983,Johnny Davis,27,53,33,1465,258,567,.455,5,18,.278,253,549,.461,.459,164,206,.796,37,91,128,315,43,7,114,100,685
6656,ATL,1983,Tom McMillen,30,61,4,1364,198,424,.467,0,1,.000,198,423,.468,.467,108,133,.812,57,160,217,76,17,24,80,143,504
6657,ATL,1983,Wes Matthews,23,64,0,1187,171,424,.403,14,48,.292,157,376,.418,.420,86,112,.768,25,66,91,249,60,8,123,129,442
6658,ATL,1983,Rudy Macklin,24,73,20,1171,170,360,.472,0,4,.000,170,356,.478,.472,101,131,.771,85,105,190,71,41,10,89,189,441
6659,ATL,1983,Mike Glenn,27,73,4,1124,230,444,.518,0,1,.000,230,443,.519,.518,74,89,.831,16,74,90,125,30,9,52,132,534
6660,ATL,1983,Steve Hawes,32,46,3,860,91,244,.373,2,14,.143,89,230,.387,.377,46,62,.742,53,175,228,59,29,8,73,110,230
6661,ATL,1983,George Johnson,34,37,0,461,25,57,.439,0,0,,25,57,.439,.439,14,19,.737,44,73,117,17,10,59,19,69,64
6662,ATL,1983,Keith Edmonson,22,32,2,309,48,139,.345,0,2,.000,48,137,.350,.345,16,27,.593,20,19,39,22,11,6,20,41,112
6663,ATL,1983,Rickey Brown,24,26,0,305,49,104,.471,0,1,.000,49,103,.476,.471,25,40,.625,35,53,88,9,5,5,22,46,123
6664,ATL,1983,Randy Smith,34,15,0,142,29,66,.439,0,2,.000,29,64,.453,.439,13,14,.929,2,6,8,14,2,0,9,17,71
6665,ATL,1983,Scott Hastings,22,10,0,42,5,16,.313,0,2,.000,5,14,.357,.313,4,6,.667,5,5,10,2,1,1,3,3,14
6666,ATL,1983,Sam Pellom,31,2,0,9,2,6,.333,0,0,,2,6,.333,.333,0,0,,0,0,0,1,0,0,0,0,4
6667,ATL,1982,Rory Sparrow,23,82,82,2610,366,730,.501,1,15,.067,365,715,.510,.502,124,148,.838,53,171,224,424,87,13,145,240,857
6668,ATL,1982,Eddie Johnson,26,68,57,2314,455,1011,.450,7,30,.233,448,981,.457,.454,294,385,.764,63,128,191,358,102,16,186,188,1211
6669,ATL,1982,Dan Roundfield,28,61,58,2217,424,910,.466,1,5,.200,423,905,.467,.466,285,375,.760,227,494,721,162,64,93,183,210,1134
6670,ATL,1982,John Drew,27,70,51,2040,465,957,.486,4,12,.333,461,945,.488,.488,364,491,.741,169,206,375,96,64,3,178,250,1298
6671,ATL,1982,Tree Rollins,26,79,39,2018,202,346,.584,0,0,,202,346,.584,.584,79,129,.612,168,443,611,59,35,224,79,285,483
6672,ATL,1982,Tom McMillen,29,73,23,1792,291,572,.509,1,3,.333,290,569,.510,.510,140,170,.824,102,234,336,129,25,24,124,202,723
6673,ATL,1982,Rudy Macklin,23,79,32,1516,210,484,.434,0,3,.000,210,481,.437,.434,134,173,.775,113,150,263,47,40,20,112,225,554
6674,ATL,1982,Steve Hawes,31,49,42,1317,178,370,.481,4,10,.400,174,360,.483,.486,96,126,.762,89,231,320,142,36,34,87,156,456
6675,ATL,1982,Sam Pellom,30,69,4,1037,114,251,.454,0,1,.000,114,250,.456,.454,61,79,.772,90,139,229,28,29,47,57,164,289
6676,ATL,1982,Wes Matthews,22,47,5,837,131,298,.440,2,8,.250,129,290,.445,.443,60,79,.759,19,39,58,139,53,2,63,129,324
6677,ATL,1982,Mike Glenn,26,49,0,833,158,291,.543,1,2,.500,157,289,.543,.545,59,67,.881,5,56,61,87,26,3,27,80,376
6678,ATL,1982,Charlie Criss,33,27,0,552,84,210,.400,2,8,.250,82,202,.406,.405,65,73,.890,6,32,38,75,23,2,30,40,235
6679,ATL,1982,Jim McElroy,28,20,17,349,52,125,.416,1,5,.200,51,120,.425,.420,29,36,.806,6,11,17,39,8,3,22,44,134
6680,ATL,1982,Al Wood,23,19,0,238,36,105,.343,0,6,.000,36,99,.364,.343,20,28,.714,22,22,44,11,9,1,11,34,92
6681,ATL,1982,Freeman Williams,25,23,0,189,42,110,.382,4,20,.200,38,90,.422,.400,22,26,.846,2,10,12,19,6,0,18,18,110
6682,ATL,1982,Craig Shelton,24,4,0,21,2,6,.333,0,0,,2,6,.333,.333,1,2,.500,1,2,3,0,1,0,0,3,5
6683,ATL,1981,Eddie Johnson,25,75,,2693,573,1136,.504,6,20,.300,567,1116,.508,.507,279,356,.784,60,119,179,407,126,11,197,188,1431
6684,ATL,1981,Steve Hawes,30,74,,2309,333,637,.523,1,4,.250,332,633,.524,.524,222,278,.799,165,396,561,168,73,32,161,289,889
6685,ATL,1981,Dan Roundfield,27,63,,2128,426,808,.527,0,1,.000,426,807,.528,.527,256,355,.721,231,403,634,161,76,119,178,258,1108
6686,ATL,1981,John Drew,26,67,,2075,500,1096,.456,0,7,.000,500,1089,.459,.456,454,577,.787,145,238,383,79,98,15,194,264,1454
6687,ATL,1981,Charlie Criss,32,66,,1708,220,485,.454,1,21,.048,219,464,.472,.455,185,214,.864,26,74,100,283,61,3,134,87,626
6688,ATL,1981,Tom McMillen,28,79,,1564,253,519,.487,1,6,.167,252,513,.491,.488,80,108,.741,96,199,295,72,23,25,81,165,587
6689,ATL,1981,Sam Pellom,29,77,,1472,186,380,.489,0,1,.000,186,379,.491,.489,81,116,.698,122,234,356,48,50,92,99,228,453
6690,ATL,1981,Don Collins,22,47,,1184,230,530,.434,0,3,.000,230,527,.436,.434,137,162,.846,96,91,187,115,69,11,107,166,597
6691,ATL,1981,Wes Matthews,21,34,,1105,161,330,.488,0,6,.000,161,324,.497,.488,103,123,.837,16,56,72,212,61,7,112,122,425
6692,ATL,1981,Tree Rollins,25,40,,1044,116,210,.552,0,1,.000,116,209,.555,.552,46,57,.807,102,184,286,35,29,117,57,151,278
6693,ATL,1981,Jim McElroy,27,54,,680,78,202,.386,1,8,.125,77,194,.397,.389,48,59,.814,10,38,48,84,20,9,79,62,205
6694,ATL,1981,Armond Hill,27,24,,624,39,116,.336,0,1,.000,39,115,.339,.336,42,50,.840,10,41,51,118,26,3,58,60,120
6695,ATL,1981,Craig Shelton,23,55,,586,100,219,.457,0,1,.000,100,218,.459,.457,35,58,.603,59,79,138,27,18,5,61,128,235
6696,ATL,1981,Art Collins,26,29,,395,35,99,.354,0,2,.000,35,97,.361,.354,24,36,.667,19,22,41,25,11,1,32,35,94
6697,ATL,1981,Tom Burleson,28,31,,363,41,99,.414,0,0,,41,99,.414,.414,20,41,.488,44,50,94,12,8,19,24,73,102
6698,ATL,1980,Eddie Johnson,24,79,,2622,590,1212,.487,5,13,.385,585,1199,.488,.489,280,338,.828,95,105,200,370,120,24,189,216,1465
6699,ATL,1980,Dan Roundfield,26,81,,2588,502,1007,.499,0,4,.000,502,1003,.500,.499,330,465,.710,293,544,837,184,101,139,233,317,1334
6700,ATL,1980,John Drew,25,80,,2306,535,1182,.453,0,7,.000,535,1175,.455,.453,489,646,.757,203,268,471,101,91,23,240,313,1559
6701,ATL,1980,Tree Rollins,24,82,,2123,287,514,.558,0,0,,287,514,.558,.558,157,220,.714,283,491,774,76,54,244,99,322,731
6702,ATL,1980,Armond Hill,26,79,,2092,177,431,.411,1,4,.250,176,427,.412,.412,124,146,.849,31,107,138,424,107,8,171,261,479
6703,ATL,1980,Steve Hawes,29,82,,1853,304,605,.502,3,8,.375,301,597,.504,.505,150,182,.824,148,348,496,144,74,29,121,205,761
6704,ATL,1980,Charlie Criss,31,81,,1794,249,578,.431,1,17,.059,248,561,.442,.432,172,212,.811,27,89,116,246,74,4,130,133,671
6705,ATL,1980,Jack Givens,23,82,,1254,182,473,.385,0,2,.000,182,471,.386,.385,106,128,.828,114,128,242,59,51,19,59,132,470
6706,ATL,1980,Tom McMillen,27,53,,1071,191,382,.500,0,1,.000,191,381,.501,.500,81,107,.757,70,150,220,62,36,14,64,126,463
6707,ATL,1980,Jim McElroy,26,31,,516,66,171,.386,2,7,.286,64,164,.390,.392,37,53,.698,20,29,49,65,21,5,43,45,171
6708,ATL,1980,Terry Furlow,25,21,,404,66,161,.410,1,9,.111,65,152,.428,.413,44,51,.863,23,19,42,72,19,9,34,19,177
6709,ATL,1980,Sam Pellom,28,44,,373,44,108,.407,0,0,,44,108,.407,.407,21,30,.700,28,64,92,18,12,12,18,70,109
6710,ATL,1980,Ron Lee,27,30,,364,29,91,.319,0,3,.000,29,88,.330,.319,9,17,.529,11,22,33,67,15,4,33,65,67
6711,ATL,1980,John Brown,28,28,,361,37,98,.378,0,0,,37,98,.378,.378,34,44,.773,21,41,62,14,3,4,24,66,108
6712,ATL,1980,Rick Wilson,23,5,,59,2,14,.143,0,0,,2,14,.143,.143,4,6,.667,2,1,3,11,4,1,8,3,8
6713,IND,2024,Tyrese Haliburton,23,69,68,2224,500,1048,.477,195,535,.364,305,513,.595,.570,194,227,.855,35,236,271,752,83,48,159,75,1389
6714,IND,2024,Myles Turner,27,77,77,2076,476,909,.524,116,324,.358,360,585,.615,.587,245,317,.773,113,420,533,100,39,144,109,232,1313
6715,IND,2024,Aaron Nesmith,24,72,47,1995,315,635,.496,140,334,.419,175,301,.581,.606,107,137,.781,63,212,275,108,65,49,64,241,877
6716,IND,2024,Obi Toppin,25,82,28,1730,332,579,.573,102,253,.403,230,326,.706,.661,77,100,.770,85,235,320,128,47,43,69,143,843
6717,IND,2024,Andrew Nembhard,24,68,47,1697,260,522,.498,61,171,.357,199,351,.567,.557,45,56,.804,36,105,141,280,63,6,101,143,626
6718,IND,2024,Bennedict Mathurin,21,59,19,1538,296,663,.446,80,214,.374,216,449,.481,.507,184,224,.821,60,174,234,119,35,14,97,117,856
6719,IND,2024,Buddy Hield,31,52,28,1336,229,517,.443,137,357,.384,92,160,.575,.575,28,33,.848,34,133,167,139,43,31,62,103,623
6720,IND,2024,Pascal Siakam,29,41,41,1303,356,648,.549,39,101,.386,317,547,.580,.579,121,173,.699,85,234,319,152,31,15,58,106,872
6721,IND,2024,T.J. McConnell,31,71,4,1291,330,593,.556,18,44,.409,312,549,.568,.572,49,62,.790,36,155,191,390,72,8,108,79,727
6722,IND,2024,Jalen Smith,23,61,14,1047,234,395,.592,61,144,.424,173,251,.689,.670,72,104,.692,112,225,337,63,17,38,44,124,601
6723,IND,2024,Bruce Brown,27,33,33,981,149,314,.475,33,101,.327,116,213,.545,.527,67,82,.817,25,129,154,100,35,8,41,81,398
6724,IND,2024,Ben Sheppard,22,57,1,814,90,229,.393,49,156,.314,41,73,.562,.500,23,26,.885,15,74,89,53,33,2,15,88,252
6725,IND,2024,Isaiah Jackson,22,59,3,771,155,233,.665,0,4,.000,155,229,.677,.665,73,102,.716,94,144,238,50,34,61,39,137,383
6726,IND,2024,Jarace Walker,20,33,0,340,45,110,.409,22,55,.400,23,55,.418,.509,8,9,.889,12,51,63,40,15,11,17,29,120
6727,IND,2024,Doug McDermott,32,18,0,204,28,69,.406,18,56,.321,10,13,.769,.536,1,2,.500,2,9,11,13,5,0,4,16,75
6728,IND,2024,Jordan Nwora,25,18,0,183,37,82,.451,11,36,.306,26,46,.565,.518,9,11,.818,8,25,33,18,6,1,12,19,94
6729,IND,2024,Kendall Brown,20,15,0,63,8,15,.533,0,2,.000,8,13,.615,.533,5,8,.625,3,2,5,5,0,0,2,9,21
6730,IND,2024,James Johnson,36,9,0,47,3,10,.300,0,2,.000,3,8,.375,.300,2,2,1.000,1,3,4,8,5,1,5,9,8
6731,IND,2024,Oscar Tshiebwe,24,8,0,42,10,20,.500,0,0,,10,20,.500,.500,6,8,.750,8,8,16,2,2,1,0,3,26
6732,IND,2024,Quenton Jackson,25,3,0,11,0,1,.000,0,0,,0,1,.000,.000,2,2,1.000,0,4,4,2,1,0,0,1,2
6733,IND,2024,Daniel Theis,31,1,0,8,1,4,.250,0,1,.000,1,3,.333,.250,0,0,,0,0,0,0,0,0,0,1,2
6734,IND,2024,Isaiah Wong,23,1,0,4,1,3,.333,0,1,.000,1,2,.500,.333,0,0,,0,0,0,0,0,0,0,0,2
6735,IND,2023,Buddy Hield,30,80,73,2482,475,1038,.458,288,677,.425,187,361,.518,.596,106,129,.822,67,333,400,225,92,26,139,156,1344
6736,IND,2023,Bennedict Mathurin,20,78,17,2222,413,951,.434,100,310,.323,313,641,.488,.487,376,454,.828,87,231,318,116,48,13,152,162,1302
6737,IND,2023,Andrew Nembhard,23,75,63,2073,284,644,.441,92,263,.350,192,381,.504,.512,49,62,.790,35,164,199,341,70,13,126,179,709
6738,IND,2023,Tyrese Haliburton,22,56,56,1883,412,841,.490,161,402,.400,251,439,.572,.586,175,201,.871,33,172,205,585,91,25,141,69,1160
6739,IND,2023,Myles Turner,26,62,62,1825,402,733,.548,93,249,.373,309,484,.638,.612,216,276,.783,88,378,466,89,36,140,103,215,1113
6740,IND,2023,Aaron Nesmith,23,73,60,1816,252,590,.427,115,314,.366,137,276,.496,.525,119,142,.838,62,215,277,98,55,34,75,235,738
6741,IND,2023,T.J. McConnell,30,75,6,1526,283,521,.543,26,59,.441,257,462,.556,.568,58,68,.853,45,189,234,397,81,10,143,105,650
6742,IND,2023,Jalen Smith,22,68,31,1279,242,508,.476,54,191,.283,188,317,.593,.530,104,137,.759,129,265,394,66,21,60,72,153,642
6743,IND,2023,Oshae Brissett,24,65,2,1083,123,319,.386,48,155,.310,75,164,.457,.461,104,145,.717,62,156,218,44,33,13,34,79,398
6744,IND,2023,Isaiah Jackson,21,63,12,1042,179,318,.563,2,14,.143,177,304,.582,.566,95,146,.651,113,169,282,51,31,93,51,154,455
6745,IND,2023,Chris Duarte,25,46,12,897,123,333,.369,55,174,.316,68,159,.428,.452,61,72,.847,19,96,115,64,25,9,41,65,362
6746,IND,2023,Jordan Nwora,24,24,11,591,118,248,.476,46,109,.422,72,139,.518,.569,31,43,.721,22,90,112,50,12,7,32,40,313
6747,IND,2023,Terry Taylor,23,26,2,228,30,65,.462,4,18,.222,26,47,.553,.492,5,7,.714,22,17,39,10,3,5,9,24,69
6748,IND,2023,Goga Bitadze,23,21,0,202,27,52,.519,4,14,.286,23,38,.605,.558,11,24,.458,25,24,49,18,9,10,12,34,69
6749,IND,2023,George Hill,36,11,1,166,19,34,.559,11,21,.524,8,13,.615,.721,8,9,.889,2,16,18,21,7,3,7,14,57
6750,IND,2023,James Johnson,35,18,1,162,22,49,.449,3,15,.200,19,34,.559,.480,4,8,.500,4,26,30,15,7,6,8,32,51
6751,IND,2023,Daniel Theis,30,7,1,109,21,44,.477,2,11,.182,19,33,.576,.500,5,12,.417,7,15,22,9,2,6,3,7,49
6752,IND,2023,Trevelin Queen,25,7,0,70,7,29,.241,2,15,.133,5,14,.357,.276,5,5,1.000,8,9,17,6,2,5,7,4,21
6753,IND,2023,Gabe York,29,3,0,56,8,21,.381,6,18,.333,2,3,.667,.524,2,2,1.000,0,6,6,5,2,0,0,5,24
6754,IND,2023,Kendall Brown,19,6,0,40,4,7,.571,0,1,.000,4,6,.667,.571,1,2,.500,2,4,6,3,4,0,2,9,9
6755,IND,2022,Domantas Sabonis,25,47,46,1632,331,571,.580,35,108,.324,296,463,.639,.610,191,258,.740,155,412,567,236,46,22,143,146,888
6756,IND,2022,Oshae Brissett,23,67,25,1564,208,506,.411,83,237,.350,125,269,.465,.493,114,164,.695,108,250,358,72,44,29,54,116,613
6757,IND,2022,Chris Duarte,24,55,39,1541,268,621,.432,94,255,.369,174,366,.475,.507,90,112,.804,41,185,226,114,56,10,90,95,720
6758,IND,2022,Justin Holiday,32,49,40,1416,190,458,.415,127,336,.378,63,122,.516,.553,34,41,.829,18,117,135,90,36,18,49,105,541
6759,IND,2022,Myles Turner,25,42,42,1235,200,393,.509,61,183,.333,139,210,.662,.587,79,105,.752,65,232,297,44,28,118,54,119,540
6760,IND,2022,Caris LeVert,27,39,39,1214,278,622,.447,61,189,.323,217,433,.501,.496,111,146,.760,30,120,150,173,35,18,75,91,728
6761,IND,2022,Malcolm Brogdon,29,36,36,1206,243,543,.448,58,186,.312,185,357,.518,.501,143,167,.856,33,152,185,212,30,14,77,71,687
6762,IND,2022,Torrey Craig,31,51,14,1034,128,281,.456,46,138,.333,82,143,.573,.537,27,35,.771,59,136,195,58,24,19,39,95,329
6763,IND,2022,Duane Washington Jr.,21,48,7,968,173,427,.405,81,215,.377,92,212,.434,.500,46,61,.754,4,79,83,85,26,3,57,66,473
6764,IND,2022,Tyrese Haliburton,21,26,26,938,162,323,.502,57,137,.416,105,186,.565,.590,73,86,.849,22,90,112,249,48,15,84,50,454
6765,IND,2022,Buddy Hield,29,26,26,925,181,405,.447,80,221,.362,101,184,.549,.546,31,35,.886,23,109,132,124,25,10,63,71,473
6766,IND,2022,Lance Stephenson,31,40,1,744,142,310,.458,27,87,.310,115,223,.516,.502,62,78,.795,11,101,112,154,24,4,68,88,373
6767,IND,2022,Goga Bitadze,22,50,16,729,131,252,.520,23,80,.288,108,172,.628,.565,64,94,.681,79,98,177,55,21,42,46,107,349
6768,IND,2022,Terry Taylor,22,33,7,714,135,220,.614,12,38,.316,123,182,.676,.641,36,51,.706,95,77,172,41,14,8,23,61,318
6769,IND,2022,T.J. McConnell,29,27,8,652,100,208,.481,10,33,.303,90,175,.514,.505,19,23,.826,20,70,90,131,29,10,29,53,229
6770,IND,2022,Jeremy Lamb,29,39,0,613,85,228,.373,39,117,.333,46,111,.414,.458,67,80,.838,15,79,94,51,23,14,24,44,276
6771,IND,2022,Keifer Sykes,28,32,11,566,69,190,.363,27,90,.300,42,100,.420,.434,15,17,.882,8,37,45,62,12,4,33,51,180
6772,IND,2022,Jalen Smith,21,22,4,543,113,213,.531,31,83,.373,82,130,.631,.603,38,50,.760,46,122,168,18,9,23,20,44,295
6773,IND,2022,Isaiah Jackson,20,36,15,541,116,206,.563,5,16,.313,111,190,.584,.575,60,88,.682,60,89,149,10,25,52,40,92,297
6774,IND,2022,Kelan Martin,26,27,1,444,70,168,.417,22,74,.297,48,94,.511,.482,9,13,.692,16,37,53,21,13,9,14,36,171
6775,IND,2022,Brad Wanamaker,32,22,1,293,26,72,.361,4,17,.235,22,55,.400,.389,20,22,.909,6,29,35,48,5,6,23,42,76
6776,IND,2022,Justin Anderson,28,13,6,269,32,87,.368,13,53,.245,19,34,.559,.443,12,15,.800,4,36,40,27,7,6,6,18,89
6777,IND,2022,Tristan Thompson,30,4,0,66,13,24,.542,0,0,,13,24,.542,.542,3,8,.375,7,11,18,2,0,2,4,7,29
6778,IND,2022,Gabe York,28,2,0,21,2,7,.286,1,6,.167,1,1,1.000,.357,3,5,.600,0,2,2,4,2,1,1,4,8
6779,IND,2022,Reggie Perry,21,1,0,10,1,1,1.000,0,0,,1,1,1.000,1.000,0,0,,0,1,1,0,0,0,0,3,2
6780,IND,2022,Nate Hinton,22,2,0,2,0,1,.000,0,0,,0,1,.000,.000,0,0,,0,0,0,0,0,0,1,0,0
6781,IND,2022,DeJon Jarreau,24,1,0,1,0,0,,0,0,,0,0,,,0,0,,0,0,0,0,0,0,0,0,0
6782,IND,2022,Ahmad Caver,25,1,0,1,1,1,1.000,0,0,,1,1,1.000,1.000,0,0,,0,0,0,0,0,0,0,0,2
6783,IND,2021,Domantas Sabonis,24,62,62,2231,484,904,.535,52,162,.321,432,742,.582,.564,240,328,.732,150,592,742,415,76,33,213,203,1260
6784,IND,2021,Justin Holiday,31,72,52,2183,258,625,.413,173,453,.382,85,172,.494,.551,67,85,.788,32,224,256,119,74,41,54,135,756
6785,IND,2021,Malcolm Brogdon,28,56,56,1930,444,980,.453,145,374,.388,299,606,.493,.527,153,177,.864,58,236,294,329,49,15,115,110,1186
6786,IND,2021,T.J. McConnell,28,69,3,1796,274,490,.559,15,48,.313,259,442,.586,.574,33,48,.688,55,201,256,456,128,23,135,113,596
6787,IND,2021,Doug McDermott,29,66,29,1619,354,665,.532,111,286,.388,243,379,.641,.616,80,98,.816,60,161,221,85,20,6,53,117,899
6788,IND,2021,Myles Turner,24,47,47,1455,206,432,.477,69,206,.335,137,226,.606,.557,111,142,.782,63,243,306,48,40,159,67,165,592
6789,IND,2021,Aaron Holiday,24,66,8,1176,170,436,.390,67,182,.368,103,254,.406,.467,68,83,.819,15,74,89,123,46,13,66,94,475
6790,IND,2021,Caris LeVert,26,35,35,1152,272,614,.443,62,195,.318,210,419,.501,.493,120,146,.822,23,139,162,173,53,24,76,85,726
6791,IND,2021,Edmond Sumner,25,53,24,861,148,282,.525,35,88,.398,113,194,.582,.587,68,83,.819,18,76,94,49,33,10,51,88,399
6792,IND,2021,Jeremy Lamb,28,36,8,765,120,276,.435,52,128,.406,68,148,.459,.529,71,75,.947,25,106,131,53,34,23,22,72,363
6793,IND,2021,Goga Bitadze,21,45,3,561,83,194,.428,20,79,.253,63,115,.548,.479,45,61,.738,60,90,150,37,9,60,17,94,231
6794,IND,2021,Oshae Brissett,22,21,16,519,73,151,.483,33,78,.423,40,73,.548,.593,50,65,.769,29,86,115,18,19,20,10,32,229
6795,IND,2021,Kelan Martin,25,35,0,322,62,138,.449,24,60,.400,38,78,.487,.536,9,10,.900,18,60,78,17,10,10,16,35,157
6796,IND,2021,JaKarr Sampson,27,29,4,316,56,113,.496,3,15,.200,53,98,.541,.509,19,29,.655,27,50,77,4,2,14,15,52,134
6797,IND,2021,Victor Oladipo,28,9,9,300,64,152,.421,25,69,.362,39,83,.470,.503,27,37,.730,1,50,51,38,15,2,18,23,180
6798,IND,2021,T.J. Warren,27,4,4,117,27,51,.529,0,7,.000,27,44,.614,.529,8,10,.800,2,12,14,5,2,0,4,16,62
6799,IND,2021,Cassius Stanley,21,24,0,93,13,43,.302,3,13,.231,10,30,.333,.337,7,9,.778,8,12,20,1,1,2,1,14,36
6800,IND,2021,Amida Brimah,26,5,0,29,5,8,.625,0,0,,5,8,.625,.625,3,3,1.000,2,6,8,1,0,5,4,4,13
6801,IND,2021,Brian Bowen,22,6,0,15,1,4,.250,0,1,.000,1,3,.333,.250,1,1,1.000,0,3,3,0,0,0,0,1,3
6802,IND,2021,Jalen Lecque,20,4,0,12,1,9,.111,0,1,.000,1,8,.125,.111,3,3,1.000,2,3,5,2,0,0,0,0,5
6803,IND,2020,T.J. Warren,26,67,67,2202,534,997,.536,91,226,.403,443,771,.575,.581,167,204,.819,68,212,280,99,78,34,84,187,1326
6804,IND,2020,Domantas Sabonis,23,62,62,2159,458,848,.540,17,67,.254,441,781,.565,.550,214,296,.723,189,582,771,310,47,30,170,195,1147
6805,IND,2020,Justin Holiday,30,73,6,1826,208,486,.428,134,331,.405,74,155,.477,.566,53,67,.791,32,206,238,93,87,46,44,137,603
6806,IND,2020,Myles Turner,23,62,62,1826,268,587,.457,86,250,.344,182,337,.540,.530,127,169,.751,86,321,407,72,46,132,85,166,749
6807,IND,2020,Malcolm Brogdon,27,54,54,1666,326,744,.438,75,230,.326,251,514,.488,.489,166,186,.892,46,216,262,381,35,10,131,98,893
6808,IND,2020,Aaron Holiday,23,66,33,1617,233,563,.414,87,221,.394,146,342,.427,.491,74,87,.851,22,134,156,225,55,16,88,120,627
6809,IND,2020,Doug McDermott,28,69,0,1372,267,547,.488,128,294,.435,139,253,.549,.605,48,58,.828,26,148,174,78,12,5,42,117,710
6810,IND,2020,T.J. McConnell,27,71,3,1326,212,411,.516,5,17,.294,207,394,.525,.522,35,42,.833,38,151,189,355,56,11,100,73,464
6811,IND,2020,Jeremy Lamb,27,46,42,1291,216,479,.451,53,158,.335,163,321,.508,.506,92,110,.836,24,176,200,96,55,22,50,104,577
6812,IND,2020,Victor Oladipo,27,19,16,528,97,246,.394,33,104,.317,64,142,.451,.461,48,59,.814,9,66,75,56,17,4,47,36,275
6813,IND,2020,Goga Bitadze,20,54,2,471,70,150,.467,8,42,.190,62,108,.574,.493,24,33,.727,25,81,106,23,10,37,28,65,172
6814,IND,2020,JaKarr Sampson,26,34,12,471,68,115,.591,2,13,.154,66,102,.647,.600,18,27,.667,20,68,88,21,16,12,15,64,156
6815,IND,2020,Edmond Sumner,24,31,3,447,61,142,.430,14,53,.264,47,89,.528,.479,16,29,.552,11,35,46,55,15,9,22,44,152
6816,IND,2020,T.J. Leaf,22,28,1,222,36,86,.419,5,18,.278,31,68,.456,.448,7,16,.438,23,48,71,9,10,4,8,22,84
6817,IND,2020,Alize Johnson,23,17,1,118,12,29,.414,3,8,.375,9,21,.429,.466,7,10,.700,16,32,48,7,3,2,7,12,34
6818,IND,2020,Naz Mitrou-Long,26,5,0,47,6,17,.353,2,12,.167,4,5,.800,.412,0,0,,0,7,7,8,1,1,3,2,14
6819,IND,2020,Brian Bowen,21,6,1,31,3,10,.300,0,2,.000,3,8,.375,.300,0,0,,1,6,7,0,0,1,1,3,6
6820,IND,2019,Bojan Bogdanović,29,81,81,2573,522,1051,.497,164,386,.425,358,665,.538,.575,246,305,.807,33,300,333,161,69,1,134,138,1454
6821,IND,2019,Thaddeus Young,30,81,81,2489,443,841,.527,51,146,.349,392,695,.564,.557,87,135,.644,192,331,523,204,123,36,123,194,1024
6822,IND,2019,Darren Collison,31,76,76,2143,308,659,.467,79,194,.407,229,465,.492,.527,158,190,.832,36,196,232,459,110,9,125,138,853
6823,IND,2019,Myles Turner,22,74,74,2119,380,780,.487,76,196,.388,304,584,.521,.536,148,201,.736,101,430,531,115,60,199,100,195,984
6824,IND,2019,Cory Joseph,27,82,9,2063,226,548,.412,55,171,.322,171,377,.454,.463,30,43,.698,39,240,279,321,94,22,80,131,537
6825,IND,2019,Domantas Sabonis,22,74,5,1838,413,700,.590,9,17,.529,404,683,.592,.596,208,291,.715,186,504,690,212,48,30,160,239,1043
6826,IND,2019,Tyreke Evans,29,69,18,1402,257,660,.389,77,216,.356,180,444,.405,.448,115,160,.719,33,168,201,166,58,18,118,117,706
6827,IND,2019,Doug McDermott,27,77,1,1340,207,422,.491,84,206,.408,123,216,.569,.590,66,79,.835,17,92,109,67,18,8,42,104,564
6828,IND,2019,Victor Oladipo,26,36,36,1147,249,588,.423,74,216,.343,175,372,.470,.486,103,141,.730,21,181,202,186,60,11,82,72,675
6829,IND,2019,Wesley Matthews,32,23,23,725,81,210,.386,48,130,.369,33,80,.413,.500,41,48,.854,11,54,65,55,20,4,31,56,251
6830,IND,2019,Aaron Holiday,22,50,0,646,105,262,.401,43,127,.339,62,135,.459,.483,41,50,.820,5,62,67,87,21,13,40,71,294
6831,IND,2019,T.J. Leaf,21,58,1,522,99,183,.541,8,31,.258,91,152,.599,.563,19,31,.613,43,82,125,24,9,19,12,35,225
6832,IND,2019,Kyle O'Quinn,28,45,3,371,69,136,.507,1,12,.083,68,124,.548,.511,17,21,.810,29,90,119,56,9,25,31,68,156
6833,IND,2019,Edmond Sumner,23,23,2,210,22,64,.344,7,27,.259,15,37,.405,.398,15,24,.625,9,15,24,10,12,5,10,26,66
6834,IND,2019,Alize Johnson,22,14,0,64,4,16,.250,1,2,.500,3,14,.214,.281,4,8,.500,4,15,19,1,1,3,0,7,13
6835,IND,2019,Davon Reed,23,10,0,47,5,12,.417,2,4,.500,3,8,.375,.500,0,0,,2,4,6,3,1,0,1,3,12
6836,IND,2019,Ike Anigbogu,20,3,0,6,0,3,.000,0,0,,0,3,.000,.000,0,0,,1,2,3,1,0,1,1,0,0
6837,IND,2018,Thaddeus Young,29,81,81,2607,421,864,.487,58,181,.320,363,683,.531,.521,55,92,.598,184,328,512,152,135,36,105,175,955
6838,IND,2018,Victor Oladipo,25,75,75,2552,640,1342,.477,161,434,.371,479,908,.528,.537,294,368,.799,47,343,390,323,177,57,219,175,1735
6839,IND,2018,Bojan Bogdanović,28,80,80,2464,404,852,.474,155,386,.402,249,466,.534,.565,178,205,.868,30,240,270,119,55,8,106,129,1141
6840,IND,2018,Cory Joseph,26,82,17,2210,256,604,.424,67,190,.353,189,414,.457,.479,70,94,.745,39,224,263,260,80,18,87,141,649
6841,IND,2018,Darren Collison,30,69,64,2018,316,638,.495,96,205,.468,220,433,.508,.571,127,144,.882,37,141,178,368,92,15,86,122,855
6842,IND,2018,Lance Stephenson,27,82,7,1850,303,709,.427,67,232,.289,236,477,.495,.475,84,127,.661,62,362,424,235,46,17,131,177,757
6843,IND,2018,Myles Turner,21,65,62,1836,306,639,.479,56,157,.357,250,482,.519,.523,160,206,.777,93,324,417,87,38,118,96,186,828
6844,IND,2018,Domantas Sabonis,21,74,19,1810,340,661,.514,13,37,.351,327,624,.524,.524,168,224,.750,165,407,572,151,40,32,137,220,861
6845,IND,2018,Joe Young,25,53,1,558,80,186,.430,25,66,.379,55,120,.458,.497,22,29,.759,12,51,63,39,14,1,26,39,207
6846,IND,2018,Al Jefferson,33,36,1,484,111,208,.534,0,3,.000,111,205,.541,.534,30,36,.833,30,113,143,30,16,23,21,66,252
6847,IND,2018,T.J. Leaf,20,53,0,459,64,136,.471,18,42,.429,46,94,.489,.537,10,16,.625,29,53,82,9,5,4,10,45,156
6848,IND,2018,Glenn Robinson III,24,23,1,338,36,85,.424,14,34,.412,22,51,.431,.506,9,11,.818,11,26,37,17,13,1,5,14,95
6849,IND,2018,Trevor Booker,30,17,1,269,39,84,.464,3,14,.214,36,70,.514,.482,10,11,.909,32,45,77,17,4,5,9,26,91
6850,IND,2018,Damien Wilkins,38,19,1,152,13,39,.333,4,18,.222,9,21,.429,.385,3,4,.750,5,11,16,9,2,1,5,7,33
6851,IND,2018,Alex Poythress,24,25,0,104,11,26,.423,4,11,.364,7,15,.467,.500,0,0,,7,10,17,2,3,1,2,16,26
6852,IND,2018,Ike Anigbogu,19,11,0,30,4,9,.444,0,0,,4,9,.444,.444,5,6,.833,5,4,9,0,1,3,2,1,13
6853,IND,2018,Ben Moore,22,2,0,9,0,0,,0,0,,0,0,,,0,0,,0,1,1,1,0,0,0,4,0
6854,IND,2018,Edmond Sumner,22,1,0,2,1,1,1.000,0,0,,1,1,1.000,1.000,0,0,,0,1,1,0,0,0,0,1,2
6855,IND,2018,Trey McKinney-Jones,27,1,0,1,0,0,,0,0,,0,0,,,0,0,,0,0,0,0,0,0,0,0,0
6856,IND,2017,Paul George,26,75,75,2689,622,1348,.461,195,496,.393,427,852,.501,.534,336,374,.898,58,434,492,251,119,27,220,206,1775
6857,IND,2017,Jeff Teague,28,82,82,2657,402,909,.442,90,252,.357,312,657,.475,.492,360,415,.867,33,297,330,639,100,32,216,165,1254
6858,IND,2017,Myles Turner,20,81,81,2541,444,869,.511,40,115,.348,404,754,.536,.534,245,303,.809,139,450,589,106,74,172,105,262,1173
6859,IND,2017,Thaddeus Young,28,74,74,2237,362,687,.527,45,118,.381,317,569,.557,.560,45,86,.523,131,317,448,122,113,29,95,135,814
6860,IND,2017,Monta Ellis,31,74,33,1998,247,557,.443,43,135,.319,204,422,.483,.482,93,128,.727,19,185,204,236,78,27,135,149,630
6861,IND,2017,C.J. Miles,29,76,29,1776,281,647,.434,169,409,.413,112,238,.471,.565,84,93,.903,30,199,229,48,46,25,40,151,815
6862,IND,2017,Glenn Robinson III,23,69,27,1427,158,338,.467,49,125,.392,109,213,.512,.540,54,76,.711,57,189,246,47,41,20,37,63,419
6863,IND,2017,Al Jefferson,32,66,1,931,235,471,.499,0,1,.000,235,470,.500,.499,65,85,.765,75,203,278,57,19,16,33,125,535
6864,IND,2017,Aaron Brooks,32,65,0,894,121,300,.403,48,128,.375,73,172,.424,.483,32,40,.800,18,51,69,125,25,9,66,93,322
6865,IND,2017,Lavoy Allen,27,61,5,871,77,168,.458,0,1,.000,77,167,.461,.458,23,33,.697,105,114,219,57,18,24,29,78,177
6866,IND,2017,Rodney Stuckey,30,39,0,696,91,244,.373,19,60,.317,72,184,.391,.412,80,107,.748,6,78,84,84,16,0,53,44,281
6867,IND,2017,Kevin Séraphin,27,49,3,559,109,198,.551,0,2,.000,109,196,.556,.551,14,22,.636,41,101,142,23,7,20,29,66,232
6868,IND,2017,Rakeem Christmas,25,29,0,219,19,43,.442,0,0,,19,43,.442,.442,21,29,.724,26,30,56,4,3,6,8,37,59
6869,IND,2017,Joe Young,24,33,0,135,26,72,.361,5,23,.217,21,49,.429,.396,11,15,.733,1,16,17,15,4,0,5,5,68
6870,IND,2017,Lance Stephenson,26,6,0,132,18,44,.409,5,8,.625,13,36,.361,.466,2,3,.667,1,23,24,25,3,2,11,12,43
6871,IND,2017,Georges Niang,23,23,0,93,9,36,.250,1,12,.083,8,24,.333,.264,2,2,1.000,2,15,17,5,3,0,5,6,21
6872,IND,2016,Paul George,25,81,81,2819,605,1449,.418,210,566,.371,395,883,.447,.490,454,528,.860,79,484,563,329,152,29,265,230,1874
6873,IND,2016,Monta Ellis,30,81,81,2734,436,1021,.427,87,282,.309,349,739,.472,.470,162,206,.786,42,229,271,383,150,37,203,174,1121
6874,IND,2016,George Hill,29,74,73,2524,326,739,.441,128,314,.408,198,425,.466,.528,114,150,.760,58,240,298,259,83,17,101,149,894
6875,IND,2016,Ian Mahinmi,29,71,71,1816,264,448,.589,0,0,,264,448,.589,.589,132,225,.587,138,369,507,104,65,75,100,220,660
6876,IND,2016,Lavoy Allen,26,79,28,1599,191,370,.516,0,0,,191,370,.516,.516,46,73,.630,162,262,424,76,26,42,69,147,428
6877,IND,2016,Jordan Hill,28,73,11,1513,278,549,.506,0,1,.000,278,548,.507,.506,89,125,.712,156,295,451,87,36,37,92,155,645
6878,IND,2016,C.J. Miles,28,64,24,1464,259,634,.409,142,387,.367,117,247,.474,.521,93,124,.750,25,150,175,63,53,29,70,142,753
6879,IND,2016,Myles Turner,19,60,30,1367,264,530,.498,3,14,.214,261,516,.506,.501,88,121,.727,68,264,332,41,25,86,67,158,619
6880,IND,2016,Rodney Stuckey,29,58,1,1275,183,443,.413,20,83,.241,163,360,.453,.436,131,158,.829,19,137,156,142,43,8,76,77,517
6881,IND,2016,Solomon Hill,24,59,3,866,93,208,.447,24,74,.324,69,134,.515,.505,36,42,.857,39,127,166,57,37,11,33,68,246
6882,IND,2016,Chase Budinger,27,49,2,729,81,194,.418,20,69,.290,61,125,.488,.469,34,48,.708,31,90,121,49,29,9,31,46,216
6883,IND,2016,Glenn Robinson III,22,45,4,508,65,151,.430,14,37,.378,51,114,.447,.477,27,39,.692,12,56,68,26,17,9,18,21,171
6884,IND,2016,Joe Young,23,41,0,384,62,169,.367,10,46,.217,52,123,.423,.396,20,25,.800,6,44,50,65,15,0,33,30,154
6885,IND,2016,Ty Lawson,28,13,1,235,28,67,.418,5,14,.357,23,53,.434,.455,3,6,.500,6,25,31,57,10,1,13,16,64
6886,IND,2016,Shayne Whittington,24,7,0,41,5,11,.455,0,2,.000,5,9,.556,.455,1,2,.500,5,7,12,3,1,1,5,7,11
6887,IND,2016,Rakeem Christmas,24,1,0,6,2,2,1.000,0,0,,2,2,1.000,1.000,0,0,,1,0,1,0,0,0,0,1,4
6888,IND,2015,Solomon Hill,23,82,78,2381,251,634,.396,68,208,.327,183,426,.430,.450,159,193,.824,70,244,314,184,66,18,115,177,729
6889,IND,2015,Roy Hibbert,28,76,76,1926,317,710,.446,0,2,.000,317,708,.448,.446,168,204,.824,156,384,540,84,18,125,107,216,802
6890,IND,2015,David West,34,66,66,1895,323,686,.471,4,20,.200,319,666,.479,.474,119,161,.739,108,341,449,223,48,48,120,160,769
6891,IND,2015,Rodney Stuckey,28,71,36,1874,332,754,.440,55,141,.390,277,613,.452,.477,177,216,.819,36,212,248,219,56,10,118,131,896
6892,IND,2015,C.J. Miles,27,70,40,1841,329,827,.398,154,446,.345,175,381,.459,.491,130,161,.807,18,196,214,75,60,26,73,132,942
6893,IND,2015,Luis Scola,34,81,16,1659,300,642,.467,5,20,.250,295,622,.474,.471,158,226,.699,138,388,526,105,47,18,94,192,763
6894,IND,2015,C.J. Watson,30,57,21,1422,181,417,.434,70,175,.400,111,242,.459,.518,138,167,.826,18,145,163,208,57,9,100,107,570
6895,IND,2015,George Hill,28,43,36,1267,255,535,.477,69,193,.358,186,342,.544,.541,113,143,.790,25,154,179,220,44,14,69,111,692
6896,IND,2015,Ian Mahinmi,28,61,6,1146,117,212,.552,0,0,,117,212,.552,.552,31,102,.304,105,251,356,33,30,46,59,172,265
6897,IND,2015,Donald Sloan,27,53,21,1107,145,355,.408,41,131,.313,104,224,.464,.466,60,77,.779,12,131,143,190,23,0,65,47,391
6898,IND,2015,Lavoy Allen,25,63,0,1070,141,299,.472,0,0,,141,299,.472,.472,33,47,.702,123,200,323,73,15,42,40,102,315
6899,IND,2015,Damjan Rudež,28,68,2,1047,119,263,.452,69,170,.406,50,93,.538,.584,16,23,.696,8,39,47,53,16,5,47,79,323
6900,IND,2015,Chris Copeland,30,50,12,828,112,310,.361,52,167,.311,60,143,.420,.445,33,45,.733,23,88,111,51,11,11,59,78,309
6901,IND,2015,A.J. Price,28,10,0,193,39,89,.438,15,39,.385,24,50,.480,.522,12,18,.667,2,12,14,27,4,0,10,9,105
6902,IND,2015,Shayne Whittington,23,20,0,108,19,42,.452,1,6,.167,18,36,.500,.464,18,23,.783,10,19,29,6,5,2,5,18,57
6903,IND,2015,Paul George,24,6,0,91,18,49,.367,9,22,.409,9,27,.333,.459,8,11,.727,4,18,22,6,5,1,12,11,53
6904,IND,2014,Paul George,23,80,80,2898,577,1362,.424,182,500,.364,395,862,.458,.490,401,464,.864,64,478,542,283,151,22,224,198,1737
6905,IND,2014,Lance Stephenson,23,78,78,2752,427,870,.491,86,244,.352,341,626,.545,.540,140,197,.711,95,463,558,359,54,7,210,195,1080
6906,IND,2014,David West,33,80,80,2472,458,939,.488,4,15,.267,454,924,.491,.490,198,251,.789,120,422,542,223,61,74,133,186,1118
6907,IND,2014,George Hill,27,76,76,2434,272,616,.442,95,260,.365,177,356,.497,.519,142,176,.807,53,230,283,265,75,23,92,158,781
6908,IND,2014,Roy Hibbert,27,81,81,2409,331,754,.439,2,5,.400,329,749,.439,.440,207,269,.770,202,336,538,91,29,182,148,269,871
6909,IND,2014,Luis Scola,33,82,2,1399,263,560,.470,1,7,.143,262,553,.474,.471,99,136,.728,86,305,391,81,26,16,108,164,626
6910,IND,2014,Ian Mahinmi,27,77,1,1248,91,189,.481,0,1,.000,91,188,.484,.481,90,145,.621,107,150,257,24,41,72,58,207,272
6911,IND,2014,C.J. Watson,29,63,5,1193,146,334,.437,53,145,.366,93,189,.492,.516,69,88,.784,19,82,101,107,60,8,60,66,414
6912,IND,2014,Danny Granger,30,29,2,653,80,223,.359,31,94,.330,49,129,.380,.428,51,53,.962,24,81,105,33,9,13,36,41,242
6913,IND,2014,Evan Turner,25,27,2,571,78,190,.411,12,24,.500,66,166,.398,.442,24,34,.706,12,74,86,64,11,2,34,48,192
6914,IND,2014,Donald Sloan,26,48,1,392,44,117,.376,10,42,.238,34,75,.453,.419,12,20,.600,4,40,44,50,10,1,22,19,110
6915,IND,2014,Rasual Butler,34,50,2,378,51,110,.464,26,62,.419,25,48,.521,.582,8,14,.571,6,35,41,17,7,9,11,30,136
6916,IND,2014,Orlando Johnson,24,38,0,342,33,96,.344,8,41,.195,25,55,.455,.385,17,22,.773,7,44,51,16,6,1,14,23,91
6917,IND,2014,Chris Copeland,29,41,0,265,55,117,.470,33,79,.418,22,38,.579,.611,10,14,.714,7,25,32,18,3,7,14,38,153
6918,IND,2014,Solomon Hill,22,28,0,226,17,40,.425,7,23,.304,10,17,.588,.513,6,7,.857,9,32,41,12,5,2,13,19,47
6919,IND,2014,Lavoy Allen,24,14,0,112,17,34,.500,0,0,,17,34,.500,.500,6,10,.600,13,21,34,6,2,6,4,11,40
6920,IND,2014,Andrew Bynum,26,2,0,36,9,22,.409,0,0,,9,22,.409,.409,5,7,.714,6,13,19,2,0,1,4,3,23
6921,IND,2013,Paul George,22,79,79,2972,493,1176,.419,170,469,.362,323,707,.457,.491,221,274,.807,88,515,603,327,143,51,233,227,1377
6922,IND,2013,George Hill,26,76,76,2620,386,871,.443,130,353,.368,256,518,.494,.518,174,213,.817,47,237,284,355,81,26,116,134,1076
6923,IND,2013,David West,32,73,73,2435,502,1009,.498,4,19,.211,498,990,.503,.500,242,315,.768,145,418,563,213,74,69,157,149,1250
6924,IND,2013,Lance Stephenson,22,78,72,2278,275,598,.460,62,188,.330,213,410,.520,.512,75,115,.652,47,257,304,223,81,16,109,162,687
6925,IND,2013,Roy Hibbert,26,79,79,2269,385,859,.448,1,4,.250,384,855,.449,.449,166,224,.741,296,360,656,113,39,206,162,279,937
6926,IND,2013,Tyler Hansbrough,27,81,8,1366,176,407,.432,0,3,.000,176,404,.436,.432,216,300,.720,161,212,373,36,29,18,78,152,568
6927,IND,2013,Ian Mahinmi,26,80,2,1322,149,329,.453,0,2,.000,149,327,.456,.453,104,171,.608,115,196,311,27,39,66,92,201,402
6928,IND,2013,D.J. Augustin,25,76,5,1226,103,294,.350,67,190,.353,36,104,.346,.464,83,99,.838,20,71,91,170,34,3,68,64,356
6929,IND,2013,Gerald Green,27,60,7,1080,155,424,.366,59,188,.314,96,236,.407,.435,52,65,.800,31,110,141,50,19,23,53,64,421
6930,IND,2013,Sam Young,27,56,3,693,58,148,.392,16,52,.308,42,96,.438,.446,23,43,.535,26,97,123,42,15,8,33,62,155
6931,IND,2013,Orlando Johnson,23,51,0,619,72,180,.400,36,94,.383,36,86,.419,.500,23,32,.719,20,90,110,47,11,9,29,51,203
6932,IND,2013,Jeff Ayres,25,37,0,369,61,126,.484,2,4,.500,59,122,.484,.492,21,23,.913,29,75,104,15,6,12,23,44,145
6933,IND,2013,Ben Hansbrough,25,28,0,200,15,45,.333,6,23,.261,9,22,.409,.400,21,27,.778,2,16,18,21,7,2,18,23,57
6934,IND,2013,Danny Granger,29,5,0,74,10,35,.286,2,10,.200,8,25,.320,.314,5,8,.625,3,6,9,3,2,1,4,6,27
6935,IND,2013,Miles Plumlee,24,14,0,55,5,21,.238,0,0,,5,21,.238,.238,3,4,.750,12,10,22,2,0,3,3,5,13
6936,IND,2013,Dominic McGuire,27,2,1,12,0,3,.000,0,0,,0,3,.000,.000,0,2,.000,1,1,2,1,0,0,0,0,0
6937,IND,2012,Danny Granger,28,62,62,2062,391,941,.416,123,323,.381,268,618,.434,.481,254,291,.873,79,228,307,109,62,40,110,144,1159
6938,IND,2012,Paul George,21,66,66,1958,281,639,.440,90,234,.385,191,405,.472,.510,146,182,.802,56,314,370,158,108,38,117,191,798
6939,IND,2012,Roy Hibbert,25,65,65,1937,332,668,.497,0,1,.000,332,667,.498,.497,170,239,.711,213,359,572,108,32,128,128,195,834
6940,IND,2012,David West,31,66,66,1925,349,716,.487,2,9,.222,347,707,.491,.489,142,176,.807,118,315,433,140,52,46,93,160,842
6941,IND,2012,Darren Collison,24,60,56,1878,230,523,.440,34,94,.362,196,429,.457,.472,127,153,.830,30,157,187,287,49,14,114,101,621
6942,IND,2012,Tyler Hansbrough,26,66,0,1442,194,479,.405,0,1,.000,194,478,.406,.405,226,278,.813,113,177,290,30,54,9,65,159,614
6943,IND,2012,George Hill,25,50,9,1274,168,380,.442,54,147,.367,114,233,.489,.513,91,117,.778,31,120,151,145,42,17,52,98,481
6944,IND,2012,Dahntay Jones,31,65,3,1052,115,281,.409,33,77,.429,82,204,.402,.468,83,99,.838,23,94,117,63,23,11,46,119,346
6945,IND,2012,Lou Amundson,29,60,0,753,89,207,.430,0,0,,89,207,.430,.430,35,82,.427,94,128,222,14,27,44,45,125,213
6946,IND,2012,A.J. Price,25,44,1,568,59,174,.339,26,88,.295,33,86,.384,.414,28,35,.800,13,48,61,86,20,2,32,30,172
6947,IND,2012,Lance Stephenson,21,42,1,442,47,125,.376,4,30,.133,43,95,.453,.392,8,17,.471,12,41,53,46,21,5,36,30,106
6948,IND,2012,Leandro Barbosa,29,22,0,436,73,183,.399,25,59,.424,48,124,.387,.467,25,33,.758,12,37,49,33,20,0,26,34,196
6949,IND,2012,Jeff Foster,35,11,0,141,9,18,.500,1,1,1.000,8,17,.471,.528,6,9,.667,18,24,42,4,8,1,7,26,25
6950,IND,2012,Jeff Ayres,24,20,1,106,15,36,.417,0,0,,15,36,.417,.417,4,7,.571,12,21,33,4,3,2,2,16,34
6951,IND,2012,Kyrylo Fesenko,25,3,0,17,2,5,.400,0,0,,2,5,.400,.400,4,6,.667,2,7,9,1,2,0,0,2,8
6952,IND,2011,Danny Granger,27,79,79,2763,535,1260,.425,157,407,.386,378,853,.443,.487,395,466,.848,87,338,425,203,89,62,206,213,1622
6953,IND,2011,Darren Collison,23,79,79,2360,398,870,.457,41,124,.331,357,746,.479,.481,202,232,.871,40,185,225,403,87,14,194,109,1039
6954,IND,2011,Roy Hibbert,24,81,80,2244,410,890,.461,0,4,.000,410,886,.463,.461,205,275,.745,182,428,610,166,33,142,185,256,1025
6955,IND,2011,Brandon Rush,25,67,21,1754,217,515,.421,93,223,.417,124,292,.425,.512,80,106,.755,33,184,217,62,41,35,69,107,607
6956,IND,2011,Mike Dunleavy,30,61,44,1683,240,520,.462,102,254,.402,138,266,.519,.560,100,125,.800,28,248,276,105,40,30,69,107,682
6957,IND,2011,Josh McRoberts,23,72,51,1597,211,386,.547,23,60,.383,188,326,.577,.576,88,119,.739,109,273,382,150,47,57,93,165,533
6958,IND,2011,Tyler Hansbrough,25,70,29,1535,285,613,.465,0,2,.000,285,611,.466,.465,197,253,.779,145,221,366,41,37,15,76,160,767
6959,IND,2011,Paul George,20,61,19,1265,179,395,.453,41,138,.297,138,257,.537,.505,77,101,.762,37,187,224,65,62,26,70,127,476
6960,IND,2011,Jeff Foster,34,56,3,940,80,167,.479,0,3,.000,80,164,.488,.479,27,48,.563,160,190,350,46,24,31,26,127,187
6961,IND,2011,James Posey,34,49,0,839,81,241,.336,67,212,.316,14,29,.483,.475,11,15,.733,10,137,147,34,24,6,24,103,240
6962,IND,2011,A.J. Price,24,50,0,795,114,320,.356,41,149,.275,73,171,.427,.420,54,81,.667,16,56,72,111,29,1,53,61,323
6963,IND,2011,T.J. Ford,27,41,3,773,91,236,.386,6,32,.188,85,204,.417,.398,35,48,.729,17,64,81,141,35,8,63,69,223
6964,IND,2011,Dahntay Jones,30,45,2,589,100,214,.467,14,39,.359,86,175,.491,.500,69,90,.767,4,61,65,33,20,7,31,70,283
6965,IND,2011,Solomon Jones,26,39,0,528,49,121,.405,0,1,.000,49,120,.408,.405,41,62,.661,45,68,113,30,12,22,35,94,139
6966,IND,2011,Lance Stephenson,20,12,0,115,13,39,.333,0,5,.000,13,34,.382,.333,11,14,.786,1,17,18,21,4,0,16,14,37
6967,IND,2010,Brandon Rush,24,82,64,2491,297,702,.423,124,302,.411,173,400,.433,.511,56,89,.629,41,305,346,112,56,65,93,159,774
6968,IND,2010,Troy Murphy,29,72,69,2344,384,813,.472,128,333,.384,256,480,.533,.551,154,193,.798,129,608,737,150,72,34,100,175,1050
6969,IND,2010,Earl Watson,30,79,52,2322,223,524,.426,53,184,.288,170,340,.500,.476,120,169,.710,54,186,240,399,104,16,175,181,619
6970,IND,2010,Danny Granger,26,62,62,2278,488,1139,.428,158,438,.361,330,701,.471,.498,363,428,.848,67,275,342,171,94,51,157,183,1497
6971,IND,2010,Roy Hibbert,23,81,69,2035,387,782,.495,3,6,.500,384,776,.495,.497,169,224,.754,177,287,464,158,30,131,145,285,946
6972,IND,2010,Dahntay Jones,29,76,26,1892,287,623,.461,4,32,.125,283,591,.479,.464,198,257,.770,48,181,229,150,40,39,129,237,776
6973,IND,2010,Mike Dunleavy,29,67,15,1486,229,558,.410,75,236,.318,154,322,.478,.478,133,158,.842,25,211,236,103,38,15,72,105,666
6974,IND,2010,T.J. Ford,26,47,32,1189,186,418,.445,8,50,.160,178,368,.484,.455,104,135,.770,41,108,149,180,44,11,90,102,484
6975,IND,2010,A.J. Price,23,56,2,865,145,354,.410,60,174,.345,85,180,.472,.494,60,75,.800,12,76,88,106,35,3,59,53,410
6976,IND,2010,Luther Head,27,47,10,813,136,311,.437,37,105,.352,99,206,.481,.497,48,58,.828,6,74,80,72,18,9,54,53,357
6977,IND,2010,Solomon Jones,25,52,2,675,78,176,.443,0,3,.000,78,173,.451,.443,51,71,.718,51,93,144,32,14,37,40,125,207
6978,IND,2010,Josh McRoberts,22,42,3,524,76,146,.521,8,23,.348,68,123,.553,.548,19,38,.500,40,87,127,44,17,16,19,74,179
6979,IND,2010,Tyler Hansbrough,24,29,1,511,81,225,.360,0,4,.000,81,221,.367,.360,84,113,.743,60,78,138,28,17,8,21,70,246
6980,IND,2010,Jeff Foster,33,16,3,255,22,46,.478,0,1,.000,22,45,.489,.478,5,9,.556,34,47,81,21,3,4,14,45,49
6981,IND,2010,Travis Diener,27,4,0,25,1,6,.167,1,5,.200,0,1,.000,.250,0,2,.000,0,2,2,4,3,0,0,1,3
6982,IND,2009,Jarrett Jack,25,82,53,2716,386,853,.453,78,221,.353,308,632,.487,.498,224,263,.852,44,232,276,338,88,17,184,179,1074
6983,IND,2009,Troy Murphy,28,73,73,2482,364,767,.475,161,358,.450,203,409,.496,.580,152,184,.826,146,715,861,172,58,34,114,226,1041
6984,IND,2009,Danny Granger,25,67,66,2424,571,1277,.447,182,450,.404,389,827,.470,.518,404,460,.878,49,292,341,183,69,97,165,207,1728
6985,IND,2009,T.J. Ford,25,74,49,2258,413,913,.452,35,104,.337,378,809,.467,.472,245,281,.872,59,200,259,392,89,16,180,180,1106
6986,IND,2009,Jeff Foster,32,74,26,1828,177,353,.501,2,7,.286,175,346,.506,.504,96,146,.658,215,293,508,130,53,49,88,229,452
6987,IND,2009,Brandon Rush,23,75,19,1803,243,575,.423,78,209,.373,165,366,.451,.490,46,66,.697,34,199,233,66,38,37,75,128,610
6988,IND,2009,Marquis Daniels,28,54,43,1700,311,689,.451,18,90,.200,293,599,.489,.464,93,129,.721,80,168,248,114,62,26,94,120,733
6989,IND,2009,Rasho Nesterović,32,70,19,1214,224,437,.513,0,1,.000,224,436,.514,.513,25,32,.781,93,147,240,109,30,38,63,171,473
6990,IND,2009,Roy Hibbert,22,70,42,1009,198,420,.471,0,0,,198,420,.471,.471,98,147,.667,115,128,243,49,20,76,55,215,494
6991,IND,2009,Travis Diener,26,55,0,719,74,179,.413,46,118,.390,28,61,.459,.542,12,15,.800,6,80,86,122,26,5,21,42,206
6992,IND,2009,Stephen Graham,26,52,6,684,106,256,.414,20,66,.303,86,190,.453,.453,50,62,.806,21,75,96,33,10,4,45,82,282
6993,IND,2009,Mike Dunleavy,28,18,14,495,93,232,.401,32,90,.356,61,142,.430,.470,53,65,.815,14,54,68,44,12,9,38,36,271
6994,IND,2009,Josh McRoberts,21,33,0,279,35,83,.422,0,10,.000,35,73,.479,.422,10,13,.769,26,48,74,16,12,16,12,41,80
6995,IND,2009,Maceo Baston,33,27,0,217,25,46,.543,0,1,.000,25,45,.556,.543,17,27,.630,22,30,52,7,6,10,12,39,67
6996,IND,2008,Mike Dunleavy,27,82,82,2953,532,1117,.476,165,389,.424,367,728,.504,.550,336,403,.834,59,365,424,288,86,31,190,208,1565
6997,IND,2008,Danny Granger,24,80,80,2876,537,1205,.446,171,423,.404,366,782,.468,.517,322,378,.852,93,393,486,166,95,84,171,290,1567
6998,IND,2008,Troy Murphy,27,75,61,2106,315,693,.455,94,236,.398,221,457,.484,.522,192,241,.797,108,435,543,165,49,32,96,217,916
6999,IND,2008,Jeff Foster,31,77,52,1884,205,373,.550,0,3,.000,205,370,.554,.550,86,145,.593,264,404,668,129,56,32,62,221,496
7000,IND,2008,Marquis Daniels,27,74,1,1546,241,561,.430,27,102,.265,214,459,.466,.454,97,139,.698,66,146,212,137,79,18,112,121,606
7001,IND,2008,Kareem Rush,27,71,15,1504,228,569,.401,102,262,.389,126,307,.410,.490,30,42,.714,19,149,168,89,42,19,62,108,588
7002,IND,2008,Travis Diener,25,66,21,1356,159,430,.370,74,233,.318,85,197,.431,.456,64,71,.901,26,89,115,251,35,4,55,107,456
7003,IND,2008,Jamaal Tinsley,29,39,36,1293,176,463,.380,40,141,.284,136,322,.422,.423,72,100,.720,24,117,141,326,66,10,130,97,464
7004,IND,2008,Jermaine O'Neal,29,42,34,1206,225,512,.439,0,5,.000,225,507,.444,.439,121,163,.742,82,201,283,93,20,87,106,129,571
7005,IND,2008,Shawne Williams,21,65,3,967,159,372,.427,43,137,.314,116,235,.494,.485,76,106,.717,54,122,176,59,26,26,58,132,437
7006,IND,2008,David Harrison,25,55,0,702,90,170,.529,0,0,,90,170,.529,.529,49,96,.510,43,75,118,14,20,59,58,164,229
7007,IND,2008,Ronald Murray,28,23,17,527,97,228,.425,14,36,.389,83,192,.432,.456,46,61,.754,10,37,47,80,25,3,53,31,254
7008,IND,2008,Andre Owens,27,31,7,392,40,107,.374,18,40,.450,22,67,.328,.458,25,34,.735,13,34,47,47,13,3,24,37,123
7009,IND,2008,Ike Diogu,24,30,1,305,64,134,.478,0,0,,64,134,.478,.478,40,47,.851,38,47,85,10,7,3,20,43,168
7010,IND,2008,Stephen Graham,25,22,0,128,34,58,.586,7,14,.500,27,44,.614,.647,12,16,.750,4,18,22,9,4,1,10,14,87
7011,IND,2008,Courtney Sims,24,3,0,11,0,1,.000,0,0,,0,1,.000,.000,0,0,,1,1,2,1,0,0,0,2,0
7012,IND,2007,Danny Granger,23,82,57,2785,398,868,.459,110,288,.382,288,580,.497,.522,236,294,.803,114,267,381,114,67,61,135,245,1142
7013,IND,2007,Jermaine O'Neal,28,69,69,2459,498,1141,.436,0,7,.000,498,1134,.439,.436,343,447,.767,153,508,661,167,50,182,203,232,1339
7014,IND,2007,Jamaal Tinsley,28,72,72,2243,346,889,.389,61,193,.316,285,696,.409,.424,172,239,.720,60,180,240,494,117,25,200,190,925
7015,IND,2007,Jeff Foster,30,75,43,1740,122,260,.469,0,1,.000,122,259,.471,.469,78,122,.639,253,356,609,57,62,37,70,202,322
7016,IND,2007,Mike Dunleavy,26,43,43,1529,218,480,.454,34,120,.283,184,360,.511,.490,133,168,.792,44,200,244,111,46,10,78,120,603
7017,IND,2007,Darrell Armstrong,38,81,4,1275,156,377,.414,72,214,.336,84,163,.515,.509,73,93,.785,34,101,135,191,70,6,76,102,457
7018,IND,2007,Al Harrington,26,36,36,1208,223,487,.458,54,118,.458,169,369,.458,.513,72,101,.713,71,155,226,51,25,10,91,116,572
7019,IND,2007,Stephen Jackson,28,37,32,1186,180,430,.419,41,138,.297,139,292,.476,.466,120,146,.822,17,78,95,114,33,20,81,87,521
7020,IND,2007,Troy Murphy,26,42,31,1185,185,401,.461,36,88,.409,149,313,.476,.506,61,79,.772,63,194,257,66,25,25,49,133,467
7021,IND,2007,Marquis Daniels,26,45,4,800,129,281,.459,6,26,.231,123,255,.482,.470,56,80,.700,26,56,82,57,27,7,55,56,320
7022,IND,2007,Šarūnas Jasikevičius,30,37,1,664,91,221,.412,32,86,.372,59,135,.437,.484,59,64,.922,10,38,48,111,13,0,59,53,273
7023,IND,2007,Shawne Williams,20,46,3,556,75,160,.469,19,52,.365,56,108,.519,.528,11,20,.550,33,50,83,22,6,8,24,69,180
7024,IND,2007,Ike Diogu,23,42,2,538,83,183,.454,0,0,,83,183,.454,.454,77,96,.802,54,86,140,20,5,15,49,87,243
7025,IND,2007,Maceo Baston,31,47,2,405,49,76,.645,3,7,.429,46,69,.667,.664,37,47,.787,21,53,74,16,12,18,32,65,138
7026,IND,2007,Rawle Marshall,24,40,2,361,32,89,.360,4,18,.222,28,71,.394,.382,31,45,.689,8,21,29,13,12,5,19,22,99
7027,IND,2007,Keith McLeod,27,22,7,339,32,83,.386,7,22,.318,25,61,.410,.428,22,25,.880,1,21,22,45,7,2,23,30,93
7028,IND,2007,Orien Greene,24,41,0,254,23,62,.371,2,11,.182,21,51,.412,.387,15,25,.600,12,32,44,22,17,4,28,38,63
7029,IND,2007,David Harrison,24,24,2,190,30,58,.517,0,0,,30,58,.517,.517,11,22,.500,9,33,42,6,5,12,26,47,71
7030,IND,2007,Josh Powell,24,7,0,64,2,15,.133,0,0,,2,15,.133,.133,8,12,.667,7,12,19,3,0,0,5,18,12
7031,IND,2006,Stephen Jackson,27,81,81,2910,472,1148,.411,117,339,.345,355,809,.439,.462,268,341,.786,48,264,312,225,104,43,203,195,1329
7032,IND,2006,Anthony Johnson,31,75,53,1981,267,603,.443,51,155,.329,216,448,.482,.485,106,141,.752,31,137,168,324,63,22,115,132,691
7033,IND,2006,Fred Jones,26,68,2,1837,233,559,.417,63,187,.337,170,372,.457,.473,122,160,.763,18,152,170,154,55,20,107,142,651
7034,IND,2006,Jermaine O'Neal,27,51,47,1802,380,805,.472,3,10,.300,377,795,.474,.474,261,368,.709,102,374,476,133,27,117,151,177,1024
7035,IND,2006,Danny Granger,22,78,17,1765,221,478,.462,30,93,.323,191,385,.496,.494,115,148,.777,131,253,384,90,58,62,80,211,587
7036,IND,2006,Jeff Foster,29,63,37,1581,138,250,.552,0,4,.000,138,246,.561,.552,96,159,.604,224,350,574,50,41,27,64,191,372
7037,IND,2006,Šarūnas Jasikevičius,29,75,15,1557,170,429,.396,86,236,.364,84,193,.435,.497,121,133,.910,19,134,153,227,40,4,116,108,547
7038,IND,2006,Peja Stojaković,28,40,40,1454,274,594,.461,91,225,.404,183,369,.496,.538,140,155,.903,45,205,250,68,26,8,52,89,779
7039,IND,2006,Austin Croshere,30,50,26,1148,132,285,.463,54,140,.386,78,145,.538,.558,90,102,.882,62,203,265,62,22,7,48,105,408
7040,IND,2006,Jamaal Tinsley,27,42,27,1122,158,386,.409,16,70,.229,142,316,.449,.430,58,91,.637,35,98,133,211,49,6,109,96,390
7041,IND,2006,David Harrison,23,67,17,1034,148,294,.503,0,0,,148,294,.503,.503,89,174,.511,84,170,254,14,23,59,79,193,385
7042,IND,2006,Scot Pollard,30,45,32,771,70,154,.455,0,0,,70,154,.455,.455,29,38,.763,73,145,218,24,37,20,26,115,169
7043,IND,2006,Metta World Peace,26,16,16,603,109,237,.460,18,54,.333,91,183,.497,.498,74,121,.612,26,52,78,35,42,11,43,45,310
7044,IND,2006,Eddie Gill,27,41,0,122,10,45,.222,7,23,.304,3,22,.136,.300,18,23,.783,0,15,15,12,11,1,9,13,45
7045,IND,2006,Samaki Walker,29,7,0,22,0,2,.000,0,0,,0,2,.000,.000,2,2,1.000,0,3,3,0,0,1,2,7,2
7046,IND,2006,Jonathan Bender,25,2,0,21,4,5,.800,0,0,,4,5,.800,.800,2,2,1.000,0,4,4,2,0,1,0,2,10
7047,IND,2005,Fred Jones,25,77,14,2268,275,647,.425,87,229,.380,188,418,.450,.492,176,207,.850,34,208,242,196,61,31,114,171,813
7048,IND,2005,Reggie Miller,39,66,66,2105,314,719,.437,96,298,.322,218,421,.518,.503,250,268,.933,18,138,156,146,50,5,77,109,974
7049,IND,2005,Austin Croshere,29,73,22,1827,188,497,.378,45,174,.259,143,323,.443,.424,226,256,.883,103,272,375,98,48,17,104,154,647
7050,IND,2005,Stephen Jackson,26,51,49,1806,330,819,.403,103,286,.360,227,533,.426,.466,190,229,.830,44,206,250,119,64,14,123,154,953
7051,IND,2005,Anthony Johnson,30,63,36,1747,203,456,.445,41,108,.380,162,348,.466,.490,85,113,.752,32,147,179,302,59,15,96,144,532
7052,IND,2005,Jeff Foster,28,61,43,1594,168,324,.519,0,5,.000,168,319,.527,.519,90,142,.634,205,345,550,43,46,12,55,186,426
7053,IND,2005,Jermaine O'Neal,26,44,41,1530,386,854,.452,1,6,.167,385,848,.454,.453,295,391,.754,85,303,388,82,25,88,131,173,1068
7054,IND,2005,James Jones,24,75,24,1330,126,318,.396,66,166,.398,60,152,.395,.500,53,62,.855,39,135,174,57,31,28,43,123,371
7055,IND,2005,Jamaal Tinsley,26,40,40,1301,218,522,.418,58,156,.372,160,366,.437,.473,122,164,.744,26,134,160,257,81,12,134,112,616
7056,IND,2005,Eddie Gill,26,73,3,1021,81,242,.335,36,117,.308,45,125,.360,.409,71,81,.877,16,96,112,83,59,5,60,105,269
7057,IND,2005,Scot Pollard,29,49,17,865,79,167,.473,0,0,,79,167,.473,.473,33,49,.673,85,120,205,18,30,24,31,123,191
7058,IND,2005,David Harrison,22,43,14,760,106,184,.576,0,0,,106,184,.576,.576,52,91,.571,48,87,135,13,16,55,53,134,264
7059,IND,2005,Dale Davis,35,25,25,730,67,125,.536,0,0,,67,125,.536,.536,38,61,.623,91,131,222,24,19,33,23,83,172
7060,IND,2005,Metta World Peace,25,7,7,291,59,119,.496,7,17,.412,52,102,.510,.525,47,51,.922,8,37,45,22,12,6,17,27,172
7061,IND,2005,Michael Curry,36,18,7,249,13,29,.448,0,0,,13,29,.448,.448,4,8,.500,8,19,27,15,5,4,5,39,30
7062,IND,2005,John Edwards,23,25,1,139,11,30,.367,0,0,,11,30,.367,.367,7,14,.500,8,11,19,3,3,4,8,12,29
7063,IND,2005,Marcus Haislip,24,9,0,106,13,38,.342,0,1,.000,13,37,.351,.342,6,11,.545,5,10,15,3,2,2,6,15,32
7064,IND,2005,Jonathan Bender,24,7,0,93,16,40,.400,1,5,.200,15,35,.429,.413,3,6,.500,5,9,14,4,1,2,10,9,36
7065,IND,2005,Britton Johnsen,25,6,1,87,6,22,.273,0,4,.000,6,18,.333,.273,0,0,,5,5,10,4,1,0,3,10,12
7066,IND,2005,Tremaine Fowlkes,28,8,0,56,9,17,.529,1,3,.333,8,14,.571,.559,0,2,.000,3,5,8,0,2,0,5,7,19
7067,IND,2004,Jermaine O'Neal,25,78,78,2788,608,1400,.434,2,18,.111,606,1382,.438,.435,348,460,.757,193,585,778,164,59,199,181,248,1566
7068,IND,2004,Metta World Peace,24,73,71,2714,468,1112,.421,75,242,.310,393,870,.452,.455,322,439,.733,100,285,385,272,152,50,202,194,1333
7069,IND,2004,Al Harrington,23,79,15,2441,421,909,.463,21,77,.273,400,832,.481,.475,185,252,.734,163,345,508,131,80,22,163,250,1048
7070,IND,2004,Reggie Miller,38,80,80,2254,260,594,.438,134,334,.401,126,260,.485,.551,146,165,.885,18,170,188,249,65,11,68,96,800
7071,IND,2004,Jeff Foster,27,82,79,1961,197,362,.544,0,4,.000,197,358,.550,.544,103,154,.669,248,362,610,64,71,27,60,189,497
7072,IND,2004,Anthony Johnson,29,73,7,1598,167,411,.406,41,122,.336,126,289,.436,.456,75,94,.798,28,102,130,202,64,8,75,138,450
7073,IND,2004,Fred Jones,24,81,2,1508,123,311,.395,27,89,.303,96,222,.432,.439,124,149,.832,25,101,126,173,65,18,73,132,397
7074,IND,2004,Jamaal Tinsley,25,52,43,1378,153,370,.414,77,207,.372,76,163,.466,.518,49,67,.731,28,108,136,303,84,17,110,132,432
7075,IND,2004,Austin Croshere,28,77,0,1051,119,307,.388,56,144,.389,63,163,.387,.479,93,104,.894,60,183,243,52,24,14,55,101,387
7076,IND,2004,Kenny Anderson,33,44,31,905,113,256,.441,1,4,.250,112,252,.444,.443,35,48,.729,19,62,81,125,26,5,50,73,262
7077,IND,2004,Scot Pollard,28,61,3,678,47,114,.412,0,0,,47,114,.412,.412,12,21,.571,67,97,164,10,23,26,22,110,106
7078,IND,2004,Jonathan Bender,23,21,0,271,50,106,.472,9,22,.409,41,84,.488,.514,39,47,.830,9,31,40,9,5,11,33,23,148
7079,IND,2004,Jamison Brewer,23,13,1,160,13,35,.371,5,14,.357,8,21,.381,.443,1,6,.167,2,9,11,17,7,0,10,9,32
7080,IND,2004,Primož Brezec,24,18,0,72,12,26,.462,0,0,,12,26,.462,.462,4,6,.667,5,10,15,3,0,3,6,13,28
7081,IND,2004,James Jones,23,6,0,26,2,9,.222,1,4,.250,1,5,.200,.278,2,2,1.000,0,2,2,0,1,0,0,1,7
7082,IND,2003,Jermaine O'Neal,24,77,76,2864,610,1260,.484,7,21,.333,603,1239,.487,.487,373,510,.731,202,594,796,155,66,178,180,277,1600
7083,IND,2003,Al Harrington,22,82,37,2467,389,896,.434,13,46,.283,376,850,.442,.441,211,274,.770,159,352,511,125,71,33,163,280,1002
7084,IND,2003,Metta World Peace,23,69,67,2317,362,846,.428,71,211,.336,291,635,.458,.470,273,371,.736,101,261,362,198,159,50,145,242,1068
7085,IND,2003,Brad Miller,26,73,72,2270,329,667,.493,5,16,.313,324,651,.498,.497,292,357,.818,185,418,603,193,65,43,118,203,955
7086,IND,2003,Jamaal Tinsley,24,73,69,2237,220,556,.396,46,166,.277,174,390,.446,.437,80,112,.714,58,202,260,548,125,18,192,201,566
7087,IND,2003,Reggie Miller,37,70,70,2117,281,637,.441,113,318,.355,168,319,.527,.530,207,230,.900,21,151,172,170,62,4,66,89,882
7088,IND,2003,Ron Mercer,26,72,3,1671,244,597,.409,3,16,.188,241,581,.415,.411,65,81,.802,32,122,154,112,49,14,54,123,556
7089,IND,2003,Erick Strickland,29,71,10,1275,163,380,.429,62,160,.388,101,220,.459,.511,70,87,.805,23,122,145,209,38,7,98,111,458
7090,IND,2003,Jonathan Bender,22,46,2,819,112,254,.441,19,53,.358,93,201,.463,.478,60,84,.714,42,91,133,42,8,56,42,86,303
7091,IND,2003,Jeff Foster,26,77,2,802,64,178,.360,0,2,.000,64,176,.364,.360,34,63,.540,118,161,279,51,28,21,34,103,162
7092,IND,2003,Austin Croshere,27,49,0,633,86,209,.411,27,69,.391,59,140,.421,.476,53,65,.815,40,115,155,56,6,13,28,48,252
7093,IND,2003,Tim Hardaway,36,10,0,127,18,49,.367,11,31,.355,7,18,.389,.480,2,4,.500,1,14,15,24,9,0,11,8,49
7094,IND,2003,Fred Jones,23,19,1,115,9,24,.375,2,7,.286,7,17,.412,.417,3,4,.750,4,5,9,5,6,1,6,13,23
7095,IND,2003,Primož Brezec,23,22,1,111,15,38,.395,0,1,.000,15,37,.405,.395,12,20,.600,13,10,23,4,2,4,7,16,42
7096,IND,2003,Jamison Brewer,22,10,0,80,9,17,.529,0,2,.000,9,15,.600,.529,4,9,.444,5,4,9,18,2,1,6,11,22
7097,IND,2002,Reggie Miller,36,79,79,2889,414,913,.453,180,443,.406,234,470,.498,.552,296,325,.911,23,196,219,253,88,10,120,143,1304
7098,IND,2002,Jermaine O'Neal,23,72,72,2707,543,1133,.479,1,14,.071,542,1119,.484,.480,284,413,.688,188,569,757,118,45,166,174,269,1371
7099,IND,2002,Jamaal Tinsley,23,80,78,2442,289,760,.380,42,175,.240,247,585,.422,.408,131,186,.704,78,220,298,647,138,40,270,248,751
7100,IND,2002,Jalen Rose,29,53,53,1937,387,871,.444,52,146,.356,335,725,.462,.474,156,186,.839,29,220,249,197,45,29,105,148,982
7101,IND,2002,Jeff Foster,25,82,48,1786,177,394,.449,2,15,.133,175,379,.462,.452,111,182,.610,206,350,556,70,71,38,79,232,467
7102,IND,2002,Jonathan Bender,21,78,17,1647,198,460,.430,45,125,.360,153,335,.457,.479,140,181,.773,64,180,244,62,19,49,96,147,581
7103,IND,2002,Al Harrington,21,44,1,1313,230,484,.475,1,3,.333,229,481,.476,.476,115,144,.799,96,180,276,54,41,21,78,166,576
7104,IND,2002,Austin Croshere,26,76,1,1286,185,448,.413,49,145,.338,136,303,.449,.468,97,114,.851,74,220,294,77,26,29,67,106,516
7105,IND,2002,Travis Best,29,44,3,954,116,264,.439,13,34,.382,103,230,.448,.464,57,65,.877,10,60,70,175,57,6,59,101,302
7106,IND,2002,Brad Miller,25,28,28,872,158,281,.562,1,3,.333,157,278,.565,.564,107,130,.823,76,144,220,51,24,12,41,88,424
7107,IND,2002,Metta World Peace,22,28,24,819,117,285,.411,17,79,.215,100,206,.485,.440,55,75,.733,33,107,140,50,66,16,49,109,306
7108,IND,2002,Kevin Ollie,29,29,0,577,40,100,.400,0,0,,40,100,.400,.400,78,97,.804,7,49,56,98,26,1,26,33,158
7109,IND,2002,Ron Mercer,25,13,1,213,25,67,.373,1,5,.200,24,62,.387,.381,11,11,1.000,6,17,23,10,2,3,9,22,62
7110,IND,2002,Carlos Rogers,30,22,1,168,24,43,.558,1,6,.167,23,37,.622,.570,10,19,.526,14,24,38,3,5,6,5,17,59
7111,IND,2002,Primož Brezec,22,22,4,160,14,29,.483,0,0,,14,29,.483,.483,15,25,.600,16,12,28,6,0,7,6,28,43
7112,IND,2002,Bruno Šundov,21,22,0,88,16,40,.400,0,1,.000,16,39,.410,.400,0,2,.000,7,14,21,3,3,3,4,16,32
7113,IND,2002,Jamison Brewer,21,13,0,43,2,5,.400,0,1,.000,2,4,.500,.400,0,0,,2,6,8,9,2,0,3,3,4
7114,IND,2002,Norm Richardson,22,3,0,4,0,3,.000,0,0,,0,3,.000,.000,0,0,,1,0,1,1,0,0,0,0,0
7115,IND,2001,Reggie Miller,35,81,81,3181,517,1176,.440,170,464,.366,347,712,.487,.512,323,348,.928,38,247,285,260,81,15,133,162,1527
7116,IND,2001,Jalen Rose,28,72,72,2943,567,1242,.457,59,174,.339,508,1068,.476,.480,285,344,.828,37,322,359,435,65,43,211,230,1478
7117,IND,2001,Jermaine O'Neal,22,81,80,2641,404,868,.465,0,5,.000,404,863,.468,.465,233,388,.601,249,545,794,98,49,228,161,280,1041
7118,IND,2001,Travis Best,28,77,21,2457,347,788,.440,37,97,.381,310,691,.449,.464,187,226,.827,38,184,222,473,110,11,127,246,918
7119,IND,2001,Al Harrington,20,78,38,1892,241,543,.444,1,7,.143,240,536,.448,.445,103,157,.656,119,262,381,130,63,18,148,223,586
7120,IND,2001,Austin Croshere,25,81,23,1874,276,701,.394,70,207,.338,206,494,.417,.444,200,231,.866,123,264,387,92,36,50,136,180,822
7121,IND,2001,Jeff Foster,24,71,9,1152,100,213,.469,2,7,.286,98,206,.476,.474,47,91,.516,144,245,389,33,39,28,52,152,249
7122,IND,2001,Sam Perkins,39,64,41,999,86,226,.381,38,110,.345,48,116,.414,.465,32,38,.842,32,136,168,41,33,18,19,61,242
7123,IND,2001,Derrick McKey,34,66,20,987,60,136,.441,4,20,.200,56,116,.483,.456,21,27,.778,49,127,176,74,48,13,47,136,145
7124,IND,2001,Žan Tabak,30,55,14,777,98,186,.527,0,0,,98,186,.527,.527,20,47,.426,65,148,213,33,10,30,57,125,216
7125,IND,2001,Jonathan Bender,20,59,7,574,66,186,.355,11,41,.268,55,145,.379,.384,50,68,.735,14,60,74,32,7,28,42,73,193
7126,IND,2001,Tyus Edney,27,24,0,263,35,91,.385,1,6,.167,34,85,.400,.390,35,39,.897,5,19,24,54,17,0,25,17,106
7127,IND,2001,Bruno Šundov,20,11,4,120,20,41,.488,0,4,.000,20,37,.541,.488,3,5,.600,4,19,23,2,2,4,3,21,43
7128,IND,2001,Terry Mills,33,14,0,113,11,34,.324,3,17,.176,8,17,.471,.368,0,0,,4,17,21,5,3,1,10,20,25
7129,IND,2001,Lari Ketner,23,3,0,7,0,0,,0,0,,0,0,,,0,0,,0,0,0,1,0,0,2,0,0
7130,IND,2000,Reggie Miller,34,81,81,2987,466,1041,.448,165,404,.408,301,637,.473,.527,373,406,.919,50,189,239,187,85,25,129,126,1470
7131,IND,2000,Jalen Rose,27,80,80,2978,563,1196,.471,77,196,.393,486,1000,.486,.503,254,307,.827,42,345,387,320,84,49,188,234,1457
7132,IND,2000,Mark Jackson,34,81,81,2190,246,570,.432,89,221,.403,157,349,.450,.510,79,98,.806,63,233,296,650,76,10,174,111,660
7133,IND,2000,Dale Davis,30,74,72,2127,302,602,.502,0,0,,302,602,.502,.502,139,203,.685,256,473,729,64,52,94,91,203,743
7134,IND,2000,Austin Croshere,24,81,14,1885,288,653,.441,63,174,.362,225,479,.470,.489,196,231,.848,135,381,516,89,44,60,121,203,835
7135,IND,2000,Rik Smits,33,79,79,1852,431,890,.484,0,1,.000,431,889,.485,.484,156,211,.739,94,307,401,85,20,100,108,249,1018
7136,IND,2000,Travis Best,27,82,0,1691,271,561,.483,35,93,.376,236,468,.504,.514,156,190,.821,16,126,142,272,76,5,107,204,733
7137,IND,2000,Sam Perkins,38,81,0,1620,184,441,.417,89,218,.408,95,223,.426,.518,80,97,.825,64,225,289,68,31,33,63,136,537
7138,IND,2000,Al Harrington,19,50,0,854,121,264,.458,8,34,.235,113,230,.491,.473,78,111,.703,47,112,159,38,25,9,65,130,328
7139,IND,2000,Derrick McKey,33,32,0,634,43,108,.398,10,23,.435,33,85,.388,.444,43,56,.768,29,106,135,35,29,13,19,81,139
7140,IND,2000,Chris Mullin,36,47,2,582,80,187,.428,45,110,.409,35,77,.455,.548,37,41,.902,14,62,76,37,28,9,28,60,242
7141,IND,2000,Jonathan Bender,19,24,1,130,23,70,.329,2,12,.167,21,58,.362,.343,16,24,.667,4,17,21,3,1,5,7,18,64
7142,IND,2000,Žan Tabak,29,18,0,114,16,34,.471,0,0,,16,34,.471,.471,5,8,.625,16,16,32,4,3,9,11,13,37
7143,IND,2000,Jeff Foster,23,19,0,86,13,23,.565,0,1,.000,13,22,.591,.565,17,25,.680,12,20,32,5,5,1,2,18,43
7144,IND,1999,Reggie Miller,33,50,50,1787,294,671,.438,106,275,.385,188,396,.475,.517,226,247,.915,25,110,135,112,37,9,76,101,920
7145,IND,1999,Mark Jackson,33,49,49,1382,138,329,.419,32,103,.311,106,226,.469,.468,65,79,.823,33,151,184,386,42,3,99,58,373
7146,IND,1999,Dale Davis,29,50,50,1374,161,302,.533,0,0,,161,302,.533,.533,76,123,.618,155,261,416,22,20,57,43,115,398
7147,IND,1999,Antonio Davis,30,49,1,1271,164,348,.471,0,0,,164,348,.471,.471,135,192,.703,116,228,344,33,22,42,50,136,463
7148,IND,1999,Rik Smits,32,49,49,1271,310,633,.490,0,2,.000,310,631,.491,.490,108,132,.818,73,202,275,52,18,52,75,159,728
7149,IND,1999,Jalen Rose,26,49,1,1238,200,496,.403,17,65,.262,183,431,.425,.420,125,158,.791,34,120,154,93,50,15,72,128,542
7150,IND,1999,Chris Mullin,35,50,50,1179,177,371,.477,73,157,.465,104,214,.486,.575,80,92,.870,25,135,160,81,47,13,60,101,507
7151,IND,1999,Travis Best,26,49,0,1043,127,305,.416,22,59,.373,105,246,.427,.452,70,83,.843,19,61,80,169,42,4,62,111,346
7152,IND,1999,Sam Perkins,37,48,0,789,80,200,.400,35,90,.389,45,110,.409,.488,43,60,.717,36,102,138,25,15,14,22,74,238
7153,IND,1999,Austin Croshere,23,27,0,249,32,75,.427,8,29,.276,24,46,.522,.480,20,23,.870,16,29,45,10,7,8,23,32,92
7154,IND,1999,Derrick McKey,32,13,0,244,23,52,.442,0,1,.000,23,51,.451,.442,14,17,.824,18,23,41,13,12,4,12,24,60
7155,IND,1999,Al Harrington,18,21,0,160,18,56,.321,0,5,.000,18,51,.353,.321,9,15,.600,20,19,39,5,4,2,11,26,45
7156,IND,1999,Fred Hoiberg,26,12,0,87,6,21,.286,1,9,.111,5,12,.417,.310,6,6,1.000,2,9,11,4,0,0,3,11,19
7157,IND,1999,Mark Pope,26,4,0,26,1,7,.143,0,4,.000,1,3,.333,.143,0,1,.000,2,2,4,0,0,0,1,6,2
7158,IND,1998,Reggie Miller,32,81,81,2795,516,1081,.477,164,382,.429,352,699,.504,.553,382,440,.868,46,186,232,171,78,11,128,148,1578
7159,IND,1998,Mark Jackson,32,82,82,2413,249,598,.416,43,137,.314,206,461,.447,.452,137,180,.761,67,255,322,713,84,2,174,132,678
7160,IND,1998,Antonio Davis,29,82,12,2191,254,528,.481,0,3,.000,254,525,.484,.481,277,398,.696,192,368,560,61,45,72,103,234,785
7161,IND,1998,Chris Mullin,34,82,82,2177,333,692,.481,107,243,.440,226,449,.503,.559,154,164,.939,38,211,249,186,95,39,117,186,927
7162,IND,1998,Dale Davis,28,78,78,2174,273,498,.548,0,0,,273,498,.548,.548,80,172,.465,233,378,611,70,51,87,73,209,626
7163,IND,1998,Rik Smits,31,73,69,2085,514,1038,.495,0,3,.000,514,1035,.497,.495,188,240,.783,127,378,505,101,40,88,134,243,1216
7164,IND,1998,Jalen Rose,25,82,0,1706,290,607,.478,25,73,.342,265,534,.496,.498,166,228,.728,28,167,195,155,56,14,132,171,771
7165,IND,1998,Travis Best,25,82,0,1547,201,480,.419,21,70,.300,180,410,.439,.441,112,131,.855,28,94,122,281,85,5,111,193,535
7166,IND,1998,Derrick McKey,31,57,4,1316,150,327,.459,4,17,.235,146,310,.471,.465,55,77,.714,74,137,211,88,57,30,79,156,359
7167,IND,1998,Fred Hoiberg,25,65,1,874,85,222,.383,32,85,.376,53,137,.387,.455,59,69,.855,14,109,123,45,40,3,22,101,261
7168,IND,1998,Austin Croshere,22,26,0,243,32,86,.372,4,13,.308,28,73,.384,.395,8,14,.571,10,35,45,8,9,5,13,32,76
7169,IND,1998,Mark Pope,25,28,0,193,14,41,.341,1,3,.333,13,38,.342,.354,10,17,.588,9,17,26,7,3,6,10,36,39
7170,IND,1998,Mark West,37,15,1,105,10,21,.476,0,0,,10,21,.476,.476,3,6,.500,6,9,15,2,2,4,8,15,23
7171,IND,1998,Etdrick Bohannon,24,5,0,11,0,4,.000,0,0,,0,4,.000,.000,0,0,,2,4,6,1,0,2,3,3,0
7172,IND,1997,Reggie Miller,31,81,81,2966,552,1244,.444,229,536,.427,323,708,.456,.536,418,475,.880,53,233,286,273,75,25,166,172,1751
7173,IND,1997,Dale Davis,27,80,76,2589,370,688,.538,0,0,,370,688,.538,.538,92,215,.428,301,471,772,59,60,77,108,233,832
7174,IND,1997,Antonio Davis,28,82,28,2335,308,641,.480,1,14,.071,307,627,.490,.481,241,362,.666,190,408,598,65,42,84,141,260,858
7175,IND,1997,Travis Best,24,76,46,2064,274,620,.442,57,155,.368,217,465,.467,.488,149,197,.756,36,130,166,318,98,5,153,221,754
7176,IND,1997,Rik Smits,30,52,52,1518,356,733,.486,2,8,.250,354,725,.488,.487,173,217,.797,105,256,361,67,22,59,126,175,887
7177,IND,1997,Derrick McKey,30,50,49,1449,148,379,.391,15,58,.259,133,321,.414,.410,89,123,.724,80,161,241,135,47,30,83,141,400
7178,IND,1997,Jalen Rose,24,66,6,1188,172,377,.456,21,72,.292,151,305,.495,.484,117,156,.750,27,94,121,155,57,18,107,136,482
7179,IND,1997,Duane Ferrell,31,62,18,1115,159,337,.472,18,44,.409,141,293,.481,.499,58,94,.617,57,84,141,66,38,6,55,120,394
7180,IND,1997,Mark Jackson,31,30,30,1053,97,227,.427,18,57,.316,79,170,.465,.467,59,77,.766,20,104,124,294,46,3,102,57,271
7181,IND,1997,Erick Dampier,21,72,21,1052,131,336,.390,1,1,1.000,130,335,.388,.391,107,168,.637,96,198,294,43,19,73,84,153,370
7182,IND,1997,Vincent Askew,30,41,0,822,79,183,.432,7,24,.292,72,159,.453,.451,68,86,.791,25,73,98,90,17,6,42,122,233
7183,IND,1997,Jerome Allen,24,51,1,692,57,147,.388,23,59,.390,34,88,.386,.466,27,47,.574,13,52,65,109,27,0,56,67,164
7184,IND,1997,Fred Hoiberg,24,47,0,572,67,156,.429,29,70,.414,38,86,.442,.522,61,77,.792,13,68,81,41,27,6,22,51,224
7185,IND,1997,Eddie Johnson,37,28,0,306,59,136,.434,9,28,.321,50,108,.463,.467,20,27,.741,3,37,40,17,5,1,17,33,147
7186,IND,1997,Haywoode Workman,31,4,2,81,11,20,.550,0,3,.000,11,17,.647,.550,0,1,.000,4,3,7,11,3,0,5,10,22
7187,IND,1997,Brent Scott,25,16,0,55,8,17,.471,0,0,,8,17,.471,.471,3,6,.500,3,6,9,3,1,1,4,14,19
7188,IND,1997,LaSalle Thompson,35,9,0,35,0,3,.000,0,0,,0,3,.000,.000,3,4,.750,2,6,8,2,0,0,2,7,3
7189,IND,1997,Reggie Williams,32,2,0,33,2,9,.222,0,1,.000,2,8,.250,.222,1,2,.500,1,6,7,2,0,0,2,5,5
7190,IND,1997,Darvin Ham,23,1,0,5,1,1,1.000,0,0,,1,1,1.000,1.000,1,2,.500,0,0,0,0,1,0,1,0,3
7191,IND,1996,Mark Jackson,30,81,81,2643,296,626,.473,64,149,.430,232,477,.486,.524,150,191,.785,66,241,307,635,100,5,201,153,806
7192,IND,1996,Reggie Miller,30,76,76,2621,504,1066,.473,168,410,.410,336,656,.512,.552,430,498,.863,38,176,214,253,77,13,189,175,1606
7193,IND,1996,Dale Davis,26,78,77,2617,334,599,.558,0,0,,334,599,.558,.558,135,289,.467,252,457,709,76,56,112,119,238,803
7194,IND,1996,Derrick McKey,29,75,75,2440,346,712,.486,17,68,.250,329,644,.511,.498,170,221,.769,123,238,361,262,83,44,143,246,879
7195,IND,1996,Antonio Davis,27,82,14,2092,236,482,.490,1,2,.500,235,480,.490,.491,246,345,.713,188,313,501,43,33,66,87,248,719
7196,IND,1996,Rik Smits,29,63,63,1901,466,894,.521,1,5,.200,465,889,.523,.522,231,293,.788,119,314,433,110,21,45,160,226,1164
7197,IND,1996,Ricky Pierce,36,76,2,1404,264,590,.447,35,104,.337,229,486,.471,.477,174,205,.849,40,96,136,101,57,6,93,188,737
7198,IND,1996,Haywoode Workman,30,77,4,1164,101,259,.390,23,71,.324,78,188,.415,.434,54,73,.740,27,97,124,213,65,4,93,152,279
7199,IND,1996,Eddie Johnson,36,62,1,1002,180,436,.413,45,128,.352,135,308,.438,.464,70,79,.886,45,108,153,69,20,4,56,104,475
7200,IND,1996,Duane Ferrell,30,54,6,591,80,166,.482,0,8,.000,80,158,.506,.482,42,57,.737,32,61,93,30,23,3,34,83,202
7201,IND,1996,Travis Best,23,59,1,571,69,163,.423,8,25,.320,61,138,.442,.448,75,90,.833,11,33,44,97,20,3,63,80,221
7202,IND,1996,Adrian Caldwell,29,51,1,327,46,83,.554,0,0,,46,83,.554,.554,18,36,.500,42,68,110,6,9,5,35,73,110
7203,IND,1996,Dwayne Schintzius,27,33,8,297,49,110,.445,0,0,,49,110,.445,.445,13,21,.619,23,55,78,14,9,12,19,53,111
7204,IND,1996,Fred Hoiberg,23,15,1,85,8,19,.421,1,3,.333,7,16,.438,.447,15,18,.833,4,5,9,8,6,1,7,12,32
7205,IND,1995,Derrick McKey,28,81,81,2805,411,833,.493,32,89,.360,379,744,.509,.513,221,297,.744,125,269,394,276,125,49,168,260,1075
7206,IND,1995,Reggie Miller,29,81,81,2665,505,1092,.462,195,470,.415,310,622,.498,.552,383,427,.897,30,180,210,242,98,16,151,157,1588
7207,IND,1995,Mark Jackson,29,82,67,2402,239,566,.422,27,87,.310,212,479,.443,.446,119,153,.778,73,233,306,616,105,16,210,148,624
7208,IND,1995,Rik Smits,28,78,78,2381,558,1060,.526,0,2,.000,558,1058,.527,.526,284,377,.753,192,409,601,111,40,79,189,278,1400
7209,IND,1995,Dale Davis,25,74,70,2346,324,576,.563,0,1,.000,324,575,.563,.563,138,259,.533,259,437,696,58,72,116,124,222,786
7210,IND,1995,Byron Scott,33,80,1,1528,265,583,.455,79,203,.389,186,380,.489,.522,193,227,.850,18,133,151,108,61,13,119,123,802
7211,IND,1995,Sam Mitchell,31,81,12,1377,201,413,.487,1,10,.100,200,403,.496,.488,126,174,.724,95,148,243,61,43,20,54,206,529
7212,IND,1995,Antonio Davis,26,44,1,1030,109,245,.445,0,0,,109,245,.445,.445,117,174,.672,105,175,280,25,19,29,64,134,335
7213,IND,1995,Haywoode Workman,29,69,14,1028,101,269,.375,35,98,.357,66,171,.386,.441,55,74,.743,21,90,111,194,59,5,73,115,292
7214,IND,1995,Vern Fleming,32,55,1,686,93,188,.495,0,7,.000,93,181,.514,.495,65,90,.722,20,68,88,109,27,1,43,80,251
7215,IND,1995,Duane Ferrell,29,56,1,607,83,173,.480,1,6,.167,82,167,.491,.483,64,85,.753,50,38,88,31,26,6,43,79,231
7216,IND,1995,LaSalle Thompson,33,38,3,453,49,118,.415,0,0,,49,118,.415,.415,14,16,.875,28,61,89,18,18,10,33,76,112
7217,IND,1995,John Williams,28,34,0,402,41,115,.357,4,12,.333,37,103,.359,.374,14,25,.560,23,39,62,27,10,2,35,48,100
7218,IND,1995,Greg Kite,33,9,0,61,3,14,.214,0,0,,3,14,.214,.214,2,10,.200,10,8,18,1,0,0,5,13,8
7219,IND,1995,Mark Strickland,24,4,0,9,1,3,.333,0,0,,1,3,.333,.333,1,2,.500,2,2,4,0,0,1,1,0,3
7220,IND,1994,Reggie Miller,28,79,79,2638,524,1042,.503,123,292,.421,401,750,.535,.562,403,444,.908,30,182,212,248,119,24,175,193,1574
7221,IND,1994,Derrick McKey,27,76,76,2613,355,710,.500,9,31,.290,346,679,.510,.506,192,254,.756,129,273,402,327,111,49,228,248,911
7222,IND,1994,Dale Davis,24,66,64,2292,308,582,.529,0,1,.000,308,581,.530,.529,155,294,.527,280,438,718,100,48,106,102,214,771
7223,IND,1994,Rik Smits,27,78,75,2113,493,923,.534,0,1,.000,493,922,.535,.534,238,300,.793,135,348,483,156,49,82,151,281,1224
7224,IND,1994,Antonio Davis,25,81,4,1732,216,425,.508,0,1,.000,216,424,.509,.508,194,302,.642,190,315,505,55,45,84,107,189,626
7225,IND,1994,Haywoode Workman,28,65,52,1714,195,460,.424,18,56,.321,177,404,.438,.443,93,116,.802,32,172,204,404,85,4,151,152,501
7226,IND,1994,Byron Scott,32,67,2,1197,256,548,.467,27,74,.365,229,474,.483,.492,157,195,.805,19,91,110,133,62,9,103,80,696
7227,IND,1994,Sam Mitchell,30,75,18,1084,140,306,.458,0,5,.000,140,301,.465,.458,82,110,.745,71,119,190,65,33,9,50,152,362
7228,IND,1994,Vern Fleming,31,55,5,1053,147,318,.462,0,4,.000,147,314,.468,.462,64,87,.736,27,96,123,173,40,6,87,98,358
7229,IND,1994,Pooh Richardson,27,37,25,1022,160,354,.452,3,12,.250,157,342,.459,.456,47,77,.610,28,82,110,237,32,3,88,78,370
7230,IND,1994,Kenny Williams,24,68,1,982,191,391,.488,0,4,.000,191,387,.494,.488,45,64,.703,93,112,205,52,24,49,45,99,427
7231,IND,1994,Malik Sealy,23,43,5,623,111,274,.405,4,16,.250,107,258,.415,.412,59,87,.678,43,75,118,48,31,8,51,84,285
7232,IND,1994,LaSalle Thompson,32,30,1,282,27,77,.351,0,0,,27,77,.351,.351,16,30,.533,26,49,75,16,10,8,23,59,70
7233,IND,1994,Scott Haskin,23,27,2,186,21,45,.467,0,0,,21,45,.467,.467,13,19,.684,17,38,55,6,2,15,13,33,55
7234,IND,1994,Lester Conner,34,11,0,169,14,38,.368,0,3,.000,14,35,.400,.368,3,6,.500,10,14,24,31,14,1,9,12,31
7235,IND,1994,Gerald Paddio,28,7,1,55,9,23,.391,0,0,,9,23,.391,.391,1,2,.500,0,5,5,4,1,0,4,2,19
7236,IND,1993,Detlef Schrempf,30,82,60,3098,517,1085,.476,8,52,.154,509,1033,.493,.480,525,653,.804,210,570,780,493,79,27,243,305,1567
7237,IND,1993,Reggie Miller,27,82,82,2954,571,1193,.479,167,419,.399,404,774,.522,.549,427,485,.880,67,191,258,262,120,26,145,182,1736
7238,IND,1993,Pooh Richardson,26,74,73,2396,337,703,.479,3,29,.103,334,674,.496,.482,92,124,.742,63,204,267,573,94,12,167,132,769
7239,IND,1993,Dale Davis,23,82,82,2264,304,535,.568,0,0,,304,535,.568,.568,119,225,.529,291,432,723,69,63,148,79,274,727
7240,IND,1993,Rik Smits,26,81,81,2072,494,1017,.486,0,0,,494,1017,.486,.486,167,228,.732,126,306,432,121,27,75,147,285,1155
7241,IND,1993,Vern Fleming,30,75,8,1503,280,554,.505,7,36,.194,273,518,.527,.512,143,197,.726,63,106,169,224,63,9,121,126,710
7242,IND,1993,George McCloud,25,78,21,1500,216,525,.411,58,181,.320,158,344,.459,.467,75,102,.735,60,145,205,192,53,11,107,165,565
7243,IND,1993,Sam Mitchell,29,81,1,1402,215,483,.445,4,23,.174,211,460,.459,.449,150,185,.811,93,155,248,76,23,10,51,207,584
7244,IND,1993,Kenny Williams,23,57,0,844,150,282,.532,0,3,.000,150,279,.538,.532,48,68,.706,102,126,228,38,21,45,28,87,348
7245,IND,1993,LaSalle Thompson,31,63,0,730,104,213,.488,0,1,.000,104,212,.491,.488,29,39,.744,55,123,178,34,29,24,47,137,237
7246,IND,1993,Malik Sealy,22,58,2,672,136,319,.426,7,31,.226,129,288,.448,.437,51,74,.689,60,52,112,47,36,7,58,74,330
7247,IND,1993,Greg Dreiling,30,43,0,239,19,58,.328,0,4,.000,19,54,.352,.328,8,15,.533,26,40,66,8,5,8,9,60,46
7248,IND,1993,Sean Green,22,13,0,81,28,55,.509,3,10,.300,25,45,.556,.536,3,4,.750,4,5,9,7,2,1,9,11,62
7249,IND,1992,Reggie Miller,26,82,82,3120,562,1121,.501,129,341,.378,433,780,.555,.559,442,515,.858,82,236,318,314,105,26,157,210,1695
7250,IND,1992,Chuck Person,27,81,81,2923,616,1284,.480,132,354,.373,484,930,.520,.531,133,197,.675,114,312,426,382,68,18,216,247,1497
7251,IND,1992,Micheal Williams,25,79,76,2750,404,824,.490,8,33,.242,396,791,.501,.495,372,427,.871,73,209,282,647,233,22,240,262,1188
7252,IND,1992,Detlef Schrempf,29,80,4,2605,496,925,.536,23,71,.324,473,854,.554,.549,365,441,.828,202,568,770,312,62,37,191,286,1380
7253,IND,1992,Rik Smits,25,74,55,1772,436,855,.510,0,2,.000,436,853,.511,.510,152,193,.788,124,293,417,116,29,100,130,231,1024
7254,IND,1992,Vern Fleming,29,82,6,1737,294,610,.482,6,27,.222,288,583,.494,.487,132,179,.737,69,140,209,266,56,7,140,134,726
7255,IND,1992,Dale Davis,22,64,23,1301,154,279,.552,0,1,.000,154,278,.554,.552,87,152,.572,158,252,410,30,27,74,49,191,395
7256,IND,1992,LaSalle Thompson,30,80,49,1299,168,359,.468,0,2,.000,168,357,.471,.468,58,71,.817,98,283,381,102,52,34,98,207,394
7257,IND,1992,George McCloud,24,51,5,892,128,313,.409,32,94,.340,96,219,.438,.460,50,64,.781,45,87,132,116,26,11,62,95,338
7258,IND,1992,Kenny Williams,22,60,6,565,113,218,.518,0,4,.000,113,214,.528,.518,26,43,.605,64,65,129,40,20,41,22,99,252
7259,IND,1992,Greg Dreiling,29,60,23,509,43,87,.494,1,1,1.000,42,86,.488,.500,30,40,.750,22,74,96,25,10,16,31,123,117
7260,IND,1992,Sean Green,21,35,0,256,62,158,.392,2,10,.200,60,148,.405,.399,15,28,.536,22,20,42,22,13,6,27,31,141
7261,IND,1992,Randy Wittman,32,24,0,115,8,19,.421,0,0,,8,19,.421,.421,1,2,.500,1,8,9,11,2,0,3,4,17
7262,IND,1992,Mike Sanders,31,10,0,81,11,22,.500,0,0,,11,22,.500,.500,5,6,.833,0,8,8,11,2,1,6,8,27
7263,IND,1992,Jerome Lane,25,3,0,30,3,5,.600,0,0,,3,5,.600,.600,0,6,.000,9,9,18,4,0,0,3,9,6
7264,IND,1991,Reggie Miller,25,82,82,2972,596,1164,.512,112,322,.348,484,842,.575,.560,551,600,.918,81,200,281,331,109,13,163,165,1855
7265,IND,1991,Detlef Schrempf,28,82,3,2632,432,831,.520,15,40,.375,417,791,.527,.529,441,539,.818,178,482,660,301,58,22,175,262,1320
7266,IND,1991,Chuck Person,26,80,79,2566,620,1231,.504,69,203,.340,551,1028,.536,.532,165,229,.721,121,296,417,238,56,17,184,221,1474
7267,IND,1991,LaSalle Thompson,29,82,77,1946,276,565,.488,1,5,.200,275,560,.491,.489,72,104,.692,154,409,563,147,63,63,168,265,625
7268,IND,1991,Vern Fleming,28,69,45,1929,356,671,.531,4,18,.222,352,653,.539,.534,161,221,.729,83,131,214,369,76,13,137,116,877
7269,IND,1991,Micheal Williams,24,73,37,1706,261,523,.499,1,7,.143,260,516,.504,.500,290,330,.879,49,127,176,348,150,17,150,202,813
7270,IND,1991,Rik Smits,24,76,38,1690,342,705,.485,0,0,,342,705,.485,.485,144,189,.762,116,241,357,84,24,111,86,246,828
7271,IND,1991,Mike Sanders,30,80,7,1357,206,494,.417,4,20,.200,202,474,.426,.421,47,57,.825,73,112,185,106,37,26,65,198,463
7272,IND,1991,George McCloud,23,74,0,1070,131,351,.373,43,124,.347,88,227,.388,.434,38,49,.776,35,83,118,150,40,11,91,141,343
7273,IND,1991,Greg Dreiling,28,73,42,1031,98,194,.505,0,2,.000,98,192,.510,.505,63,105,.600,66,189,255,51,24,29,57,178,259
7274,IND,1991,Kenny Williams,21,75,0,527,93,179,.520,0,3,.000,93,176,.528,.520,34,50,.680,56,75,131,31,11,31,41,81,220
7275,IND,1991,Randy Wittman,31,41,0,355,35,79,.443,0,5,.000,35,74,.473,.443,4,6,.667,6,27,33,25,10,4,10,9,74
7276,IND,1991,Jawann Oldham,33,4,0,19,3,6,.500,0,0,,3,6,.500,.500,0,0,,0,3,3,0,0,0,0,1,6
7277,IND,1991,Byron Dinkins,23,2,0,5,1,1,1.000,0,0,,1,1,1.000,1.000,0,0,,0,1,1,0,0,0,0,3,2
7278,IND,1990,Reggie Miller,24,82,82,3192,661,1287,.514,150,362,.414,511,925,.552,.572,544,627,.868,95,200,295,311,110,18,222,175,2016
7279,IND,1990,Vern Fleming,27,82,82,2876,467,919,.508,12,34,.353,455,885,.514,.515,230,294,.782,118,204,322,610,92,10,206,213,1176
7280,IND,1990,Chuck Person,25,77,73,2714,605,1242,.487,94,253,.372,511,989,.517,.525,211,270,.781,126,319,445,230,53,20,170,217,1515
7281,IND,1990,Detlef Schrempf,27,78,18,2573,424,822,.516,17,48,.354,407,774,.526,.526,402,490,.820,149,471,620,247,59,16,180,271,1267
7282,IND,1990,Rik Smits,23,82,82,2404,515,967,.533,0,1,.000,515,966,.533,.533,241,297,.811,135,377,512,142,45,169,143,328,1271
7283,IND,1990,LaSalle Thompson,28,82,60,2126,223,471,.473,1,5,.200,222,466,.476,.475,107,134,.799,175,455,630,106,65,71,150,313,554
7284,IND,1990,Mike Sanders,29,82,13,1531,225,479,.470,5,14,.357,220,465,.473,.475,55,75,.733,78,152,230,89,43,23,79,220,510
7285,IND,1990,Rickey Green,35,69,0,927,100,231,.433,1,11,.091,99,220,.450,.435,43,51,.843,9,45,54,182,51,1,62,60,244
7286,IND,1990,Randy Wittman,30,61,0,544,62,122,.508,1,2,.500,61,120,.508,.512,5,6,.833,4,26,30,39,7,4,23,21,130
7287,IND,1990,George McCloud,22,44,0,413,45,144,.313,13,40,.325,32,104,.308,.358,15,19,.789,12,30,42,45,19,3,36,56,118
7288,IND,1990,Greg Dreiling,27,49,0,307,20,53,.377,0,0,,20,53,.377,.377,25,34,.735,21,66,87,8,4,14,19,69,65
7289,IND,1990,Calvin Natt,33,14,0,164,20,31,.645,0,0,,20,31,.645,.645,17,22,.773,10,25,35,9,1,0,5,14,57
7290,IND,1990,Dyron Nix,22,20,0,109,14,39,.359,0,0,,14,39,.359,.359,11,16,.688,8,18,26,5,3,1,7,15,39
7291,IND,1989,Chuck Person,24,80,79,3012,711,1453,.489,63,205,.307,648,1248,.519,.511,243,307,.792,144,372,516,289,83,18,308,280,1728
7292,IND,1989,Vern Fleming,26,76,69,2552,419,814,.515,3,23,.130,416,791,.526,.517,243,304,.799,85,225,310,494,77,12,192,212,1084
7293,IND,1989,Reggie Miller,23,74,70,2536,398,831,.479,98,244,.402,300,587,.511,.538,287,340,.844,73,219,292,227,93,29,143,170,1181
7294,IND,1989,Rik Smits,22,82,71,2041,386,746,.517,0,1,.000,386,745,.518,.517,184,255,.722,185,315,500,70,37,151,130,310,956
7295,IND,1989,Scott Skiles,24,80,13,1571,198,442,.448,20,75,.267,178,367,.485,.471,130,144,.903,21,128,149,390,64,2,177,151,546
7296,IND,1989,Herb Williams,30,46,46,1567,244,542,.450,0,3,.000,244,539,.453,.450,90,126,.714,87,309,396,88,31,80,108,156,578
7297,IND,1989,Wayman Tisdale,24,48,5,1326,285,564,.505,0,4,.000,285,560,.509,.505,198,250,.792,99,211,310,75,35,32,107,181,768
7298,IND,1989,LaSalle Thompson,27,33,29,1053,169,314,.538,0,0,,169,314,.538,.538,75,93,.806,104,222,326,37,33,39,62,132,413
7299,IND,1989,Detlef Schrempf,26,32,12,1005,162,315,.514,5,19,.263,157,296,.530,.522,146,189,.772,70,159,229,93,29,10,77,102,475
7300,IND,1989,Stuart Gray,25,72,0,783,72,153,.471,0,1,.000,72,152,.474,.471,44,64,.688,84,161,245,29,11,21,48,128,188
7301,IND,1989,John Long,32,44,1,767,128,319,.401,8,20,.400,120,299,.401,.414,59,63,.937,16,50,66,65,29,1,48,68,323
7302,IND,1989,Randy Wittman,29,33,11,704,80,169,.473,1,2,.500,79,167,.473,.476,12,19,.632,20,34,54,79,13,2,20,31,173
7303,IND,1989,Greg Dreiling,26,53,4,396,43,77,.558,0,0,,43,77,.558,.558,43,64,.672,39,53,92,18,5,11,39,100,129
7304,IND,1989,Anthony Frederick,24,46,0,313,63,125,.504,2,5,.400,61,120,.508,.512,24,34,.706,26,26,52,20,14,6,34,59,152
7305,IND,1989,Everette Stephens,22,35,0,209,23,72,.319,2,10,.200,21,62,.339,.333,17,22,.773,11,12,23,37,9,4,29,22,65
7306,IND,1989,Richard Morton,22,2,0,11,3,4,.750,0,0,,3,4,.750,.750,0,0,,0,0,0,1,0,0,1,2,6
7307,IND,1989,Sedric Toney,26,2,0,9,1,5,.200,0,3,.000,1,2,.500,.200,0,1,.000,1,1,2,0,0,0,2,1,2
7308,IND,1988,Chuck Person,23,79,71,2807,575,1252,.459,59,177,.333,516,1075,.480,.483,132,197,.670,171,365,536,309,73,8,210,266,1341
7309,IND,1988,Vern Fleming,25,80,80,2733,442,845,.523,0,13,.000,442,832,.531,.523,227,283,.802,106,258,364,568,115,11,175,225,1111
7310,IND,1988,Steve Stipanovich,27,80,80,2692,411,828,.496,3,15,.200,408,813,.502,.498,254,314,.809,157,505,662,183,90,69,156,302,1079
7311,IND,1988,Wayman Tisdale,23,79,57,2378,511,998,.512,0,2,.000,511,996,.513,.512,246,314,.783,168,323,491,103,54,34,145,274,1268
7312,IND,1988,John Long,31,81,81,2022,417,879,.474,34,77,.442,383,802,.478,.494,166,183,.907,72,157,229,173,84,11,127,164,1034
7313,IND,1988,Herb Williams,29,75,37,1966,311,732,.425,0,6,.000,311,726,.428,.425,126,171,.737,116,353,469,98,37,146,119,244,748
7314,IND,1988,Reggie Miller,22,82,1,1840,306,627,.488,61,172,.355,245,455,.538,.537,149,186,.801,95,95,190,132,53,19,101,157,822
7315,IND,1988,Ron Anderson,29,74,1,1097,217,436,.498,0,2,.000,217,434,.500,.498,108,141,.766,89,127,216,78,41,6,73,98,542
7316,IND,1988,Stuart Gray,24,74,0,807,90,193,.466,0,1,.000,90,192,.469,.466,44,73,.603,70,180,250,44,11,32,50,152,224
7317,IND,1988,Scott Skiles,23,51,2,760,86,209,.411,6,20,.300,80,189,.423,.426,45,54,.833,11,55,66,180,22,3,76,97,223
7318,IND,1988,Clinton Wheeler,28,59,0,513,62,132,.470,0,0,,62,132,.470,.470,25,34,.735,19,21,40,103,36,2,52,37,149
7319,IND,1988,Greg Dreiling,25,20,0,74,8,17,.471,0,0,,8,17,.471,.471,18,26,.692,3,14,17,5,2,4,11,19,34
7320,IND,1988,Brian Rowsom,22,4,0,16,0,6,.000,0,0,,0,6,.000,.000,6,6,1.000,1,4,5,1,1,0,1,3,6
7321,IND,1987,Chuck Person,22,82,78,2956,635,1358,.468,49,138,.355,586,1220,.480,.486,222,297,.747,168,509,677,295,90,16,211,310,1541
7322,IND,1987,Steve Stipanovich,26,81,81,2761,382,760,.503,1,4,.250,381,756,.504,.503,307,367,.837,184,486,670,180,106,97,130,304,1072
7323,IND,1987,Vern Fleming,24,82,82,2549,370,727,.509,2,10,.200,368,717,.513,.510,238,302,.788,109,225,334,473,109,18,167,222,980
7324,IND,1987,Herb Williams,28,74,67,2526,451,939,.480,0,9,.000,451,930,.485,.480,199,269,.740,143,400,543,174,59,93,145,255,1101
7325,IND,1987,John Long,30,80,68,2265,490,1170,.419,19,67,.284,471,1103,.427,.427,219,246,.890,75,142,217,258,96,8,153,167,1218
7326,IND,1987,Wayman Tisdale,22,81,15,2159,458,892,.513,0,2,.000,458,890,.515,.513,258,364,.709,217,258,475,117,50,26,139,293,1174
7327,IND,1987,Clint Richardson,30,78,14,1396,218,467,.467,6,17,.353,212,450,.471,.473,59,74,.797,51,92,143,241,49,7,85,106,501
7328,IND,1987,Kyle Macy,29,76,0,1250,164,341,.481,14,46,.304,150,295,.508,.501,34,41,.829,25,88,113,197,59,7,58,136,376
7329,IND,1987,Ron Anderson,28,63,0,721,139,294,.473,0,5,.000,139,289,.481,.473,85,108,.787,73,78,151,54,31,3,55,65,363
7330,IND,1987,Walker Russell,26,48,0,511,64,165,.388,2,16,.125,62,149,.416,.394,27,37,.730,18,37,55,129,20,5,60,62,157
7331,IND,1987,Stuart Gray,23,55,1,456,41,101,.406,0,0,,41,101,.406,.406,28,39,.718,39,90,129,26,10,28,36,93,110
7332,IND,1987,Michael Brooks,28,10,0,148,13,37,.351,0,0,,13,37,.351,.351,7,10,.700,9,19,28,11,9,0,11,19,33
7333,IND,1987,Greg Dreiling,24,24,0,128,16,37,.432,0,0,,16,37,.432,.432,10,12,.833,12,31,43,7,2,2,7,42,42
7334,IND,1987,Clark Kellogg,25,4,4,60,8,22,.364,1,2,.500,7,20,.350,.386,3,4,.750,7,4,11,6,5,0,4,12,20
7335,IND,1987,Pete Verhoeven,27,5,0,44,5,14,.357,0,0,,5,14,.357,.357,0,0,,2,5,7,2,2,1,0,11,10
7336,IND,1986,Vern Fleming,23,80,77,2870,436,862,.506,1,6,.167,435,856,.508,.506,263,353,.745,102,284,386,505,131,5,208,230,1136
7337,IND,1986,Herb Williams,27,78,74,2770,627,1275,.492,1,12,.083,626,1263,.496,.492,294,403,.730,172,538,710,174,50,184,210,244,1549
7338,IND,1986,Steve Stipanovich,25,79,65,2397,416,885,.470,2,10,.200,414,875,.473,.471,242,315,.768,173,450,623,206,75,69,146,261,1076
7339,IND,1986,Wayman Tisdale,21,81,60,2277,516,1002,.515,0,2,.000,516,1000,.516,.515,160,234,.684,191,393,584,79,32,44,188,290,1192
7340,IND,1986,Clint Richardson,29,82,61,2224,335,736,.455,1,9,.111,334,727,.459,.456,123,147,.837,69,182,251,372,58,8,136,153,794
7341,IND,1986,Ron Anderson,27,60,27,1469,273,554,.493,2,8,.250,271,546,.496,.495,73,111,.658,125,123,248,136,55,6,76,105,621
7342,IND,1986,Terence Stansbury,24,74,17,1331,191,441,.433,9,53,.170,182,388,.469,.443,107,132,.811,29,110,139,206,59,8,139,200,498
7343,IND,1986,Bill Garnett,25,80,2,1197,112,239,.469,0,2,.000,112,237,.473,.469,116,162,.716,106,169,275,95,39,22,91,174,340
7344,IND,1986,Bill Martin,23,66,0,691,143,298,.480,0,8,.000,143,290,.493,.480,46,54,.852,42,60,102,52,21,7,58,108,332
7345,IND,1986,Bryan Warrick,26,31,5,658,81,172,.471,2,10,.200,79,162,.488,.477,53,67,.791,10,56,66,109,25,2,48,76,217
7346,IND,1986,Clark Kellogg,24,19,12,568,139,294,.473,4,13,.308,135,281,.480,.480,53,69,.768,51,117,168,57,28,8,61,59,335
7347,IND,1986,Dwayne McClain,22,45,4,461,69,180,.383,1,9,.111,68,171,.398,.386,18,35,.514,14,16,30,67,38,4,40,61,157
7348,IND,1986,Stuart Gray,22,67,3,423,54,108,.500,0,0,,54,108,.500,.500,47,74,.635,45,73,118,15,8,11,32,94,155
7349,IND,1986,Quinn Buckner,31,32,3,419,49,104,.471,0,1,.000,49,103,.476,.471,19,27,.704,9,42,51,86,40,3,55,80,117
7350,IND,1985,Herb Williams,26,75,70,2557,575,1211,.475,1,9,.111,574,1202,.478,.475,224,341,.657,154,480,634,252,54,134,265,218,1375
7351,IND,1985,Vern Fleming,22,80,65,2486,433,922,.470,0,4,.000,433,918,.472,.470,260,339,.767,148,175,323,247,99,8,197,232,1126
7352,IND,1985,Clark Kellogg,23,77,65,2449,562,1112,.505,7,14,.500,555,1098,.505,.509,301,396,.760,224,500,724,244,86,26,231,247,1432
7353,IND,1985,Steve Stipanovich,24,82,66,2315,414,871,.475,1,11,.091,413,860,.480,.476,297,372,.798,141,473,614,199,71,78,184,265,1126
7354,IND,1985,Jim Thomas,24,80,52,2059,347,726,.478,8,42,.190,339,684,.496,.483,183,234,.782,74,187,261,234,76,5,131,195,885
7355,IND,1985,Jerry Sichting,28,70,25,1808,325,624,.521,9,37,.243,316,587,.538,.528,112,128,.875,24,90,114,264,47,4,102,116,771
7356,IND,1985,Tony Brown,24,82,26,1586,214,465,.460,0,6,.000,214,459,.466,.460,116,171,.678,146,142,288,159,59,12,116,212,544
7357,IND,1985,Terence Stansbury,23,74,14,1278,210,458,.459,4,25,.160,206,433,.476,.463,102,126,.810,39,75,114,127,47,12,80,205,526
7358,IND,1985,Bill Garnett,24,65,13,1123,149,310,.481,0,2,.000,149,308,.484,.481,120,174,.690,98,188,286,67,28,15,92,196,418
7359,IND,1985,Devin Durrant,24,59,8,756,114,274,.416,0,3,.000,114,271,.421,.416,72,102,.706,49,75,124,80,19,10,77,106,300
7360,IND,1985,Granville Waiters,24,62,5,703,85,190,.447,0,1,.000,85,189,.450,.447,29,50,.580,57,113,170,30,16,44,55,107,199
7361,IND,1985,Stuart Gray,21,52,0,391,35,92,.380,0,0,,35,92,.380,.380,32,47,.681,29,94,123,15,9,14,51,82,102
7362,IND,1985,Kenton Edelin,22,10,1,143,4,13,.308,0,0,,4,13,.308,.308,3,8,.375,8,18,26,10,5,4,3,39,11
7363,IND,1985,Greg Kelser,27,10,0,114,21,53,.396,0,1,.000,21,52,.404,.396,20,28,.714,6,13,19,13,7,0,12,16,62
7364,IND,1985,Ralph Jackson,22,1,0,12,1,3,.333,0,0,,1,3,.333,.333,0,0,,1,0,1,4,2,0,1,1,2
7365,IND,1984,Clark Kellogg,22,79,79,2676,619,1193,.519,7,21,.333,612,1172,.522,.522,261,340,.768,230,489,719,234,121,28,218,242,1506
7366,IND,1984,Jerry Sichting,27,80,80,2497,397,746,.532,6,20,.300,391,726,.539,.536,117,135,.867,44,127,171,457,90,8,144,179,917
7367,IND,1984,Steve Stipanovich,23,81,73,2426,392,816,.480,3,16,.188,389,800,.486,.482,183,243,.753,116,446,562,170,73,67,161,303,970
7368,IND,1984,Herb Williams,25,69,53,2279,411,860,.478,0,4,.000,411,856,.480,.478,207,295,.702,154,400,554,215,60,108,207,193,1029
7369,IND,1984,George Johnson,27,81,20,2073,411,884,.465,11,47,.234,400,837,.478,.471,223,270,.826,139,321,460,195,82,49,186,256,1056
7370,IND,1984,Butch Carter,25,73,54,2045,413,862,.479,15,46,.326,398,816,.488,.488,136,178,.764,70,83,153,206,128,13,141,211,977
7371,IND,1984,Sidney Lowe,24,78,2,1238,107,259,.413,2,18,.111,105,241,.436,.417,108,139,.777,30,92,122,269,93,5,106,112,324
7372,IND,1984,Jim Thomas,23,72,15,1219,187,403,.464,1,11,.091,186,392,.474,.465,80,110,.727,59,90,149,130,60,6,69,115,455
7373,IND,1984,Granville Waiters,23,78,8,1040,123,238,.517,0,1,.000,123,237,.519,.517,31,51,.608,64,163,227,60,24,85,65,164,277
7374,IND,1984,Kevin McKenna,25,61,13,923,152,371,.410,3,17,.176,149,354,.421,.414,80,98,.816,30,65,95,114,46,5,62,133,387
7375,IND,1984,Brook Steppe,24,61,13,857,148,314,.471,0,3,.000,148,311,.476,.471,134,161,.832,43,79,122,79,34,6,83,93,430
7376,IND,1984,Leroy Combs,23,48,0,446,81,163,.497,0,3,.000,81,160,.506,.497,56,91,.615,19,37,56,38,23,18,46,49,218
7377,IND,1984,Bruce Kuczenski,22,5,0,51,5,17,.294,0,0,,5,17,.294,.294,4,4,1.000,3,6,9,2,0,0,8,8,14
7378,IND,1984,Tracy Jackson,24,2,0,10,1,4,.250,0,0,,1,4,.250,.250,4,4,1.000,1,0,1,0,0,0,1,3,6
7379,IND,1983,Clark Kellogg,21,81,81,2761,680,1420,.479,4,18,.222,676,1402,.482,.480,261,352,.741,340,520,860,223,141,43,217,298,1625
7380,IND,1983,Herb Williams,24,78,74,2513,580,1163,.499,0,7,.000,580,1156,.502,.499,155,220,.705,151,432,583,262,54,171,229,230,1315
7381,IND,1983,Jerry Sichting,26,78,58,2435,316,661,.478,3,18,.167,313,643,.487,.480,92,107,.860,33,122,155,433,104,2,138,185,727
7382,IND,1983,George Johnson,26,82,64,2297,409,858,.477,7,38,.184,402,820,.490,.481,126,172,.733,176,369,545,220,77,53,242,279,951
7383,IND,1983,Billy Knight,30,80,54,2262,512,984,.520,3,19,.158,509,965,.527,.522,343,408,.841,152,172,324,192,66,8,193,143,1370
7384,IND,1983,Butch Carter,24,81,28,1716,354,706,.501,17,51,.333,337,655,.515,.513,124,154,.805,62,88,150,194,78,13,118,207,849
7385,IND,1983,Marty Byrnes,26,80,12,1436,157,374,.420,6,26,.231,151,348,.434,.428,71,95,.747,75,116,191,179,41,6,73,149,391
7386,IND,1983,John Duren,24,82,24,1433,163,360,.453,0,13,.000,163,347,.470,.453,43,54,.796,38,69,107,200,66,5,96,203,369
7387,IND,1983,Clemon Johnson,26,51,7,1216,208,399,.521,0,1,.000,208,398,.523,.521,77,122,.631,115,204,319,115,51,63,88,137,493
7388,IND,1983,Brad Branson,24,62,2,680,131,308,.425,0,1,.000,131,307,.427,.425,76,108,.704,73,100,173,46,27,26,45,81,338
7389,IND,1983,Russ Schoene,22,31,5,520,101,228,.443,1,3,.333,100,225,.444,.445,40,55,.727,44,57,101,27,12,14,35,74,243
7390,IND,1983,Jose Slaughter,22,63,1,515,89,238,.374,9,41,.220,80,197,.406,.393,38,59,.644,34,34,68,52,36,7,42,93,225
7391,IND,1983,Guy Morgan,22,8,0,46,7,24,.292,0,0,,7,24,.292,.292,1,4,.250,6,11,17,7,2,0,2,7,15
7392,IND,1982,Johnny Davis,26,82,70,2664,538,1153,.467,5,27,.185,533,1126,.473,.469,315,394,.799,72,106,178,346,76,11,186,176,1396
7393,IND,1982,Don Buse,31,82,78,2529,312,685,.455,73,189,.386,239,496,.482,.509,100,123,.813,46,177,223,407,164,27,95,176,797
7394,IND,1982,Herb Williams,23,82,75,2277,407,854,.477,2,7,.286,405,847,.478,.478,126,188,.670,175,430,605,139,53,178,137,200,942
7395,IND,1982,Clemon Johnson,25,79,42,1979,312,641,.487,0,0,,312,641,.487,.487,123,189,.651,184,387,571,127,60,112,138,241,747
7396,IND,1982,Louis Orr,23,80,41,1951,357,719,.497,1,8,.125,356,711,.501,.497,203,254,.799,127,204,331,134,56,26,137,182,918
7397,IND,1982,Billy Knight,29,81,19,1803,378,764,.495,9,32,.281,369,732,.504,.501,233,282,.826,97,160,257,118,63,14,137,132,998
7398,IND,1982,Tom Owens,32,74,40,1599,299,636,.470,1,2,.500,298,634,.470,.471,181,226,.801,142,230,372,127,41,37,137,259,780
7399,IND,1982,George McGinnis,31,76,4,1341,141,378,.373,0,3,.000,141,375,.376,.373,72,159,.453,93,305,398,204,96,28,131,198,354
7400,IND,1982,Mike Bantom,30,39,37,1037,178,406,.438,1,3,.333,177,403,.439,.440,101,153,.660,87,127,214,68,38,24,85,139,458
7401,IND,1982,Butch Carter,23,75,0,1035,188,402,.468,8,25,.320,180,377,.477,.478,58,70,.829,30,49,79,60,34,11,54,110,442
7402,IND,1982,Jerry Sichting,25,51,0,800,91,194,.469,1,9,.111,90,185,.486,.472,29,38,.763,14,41,55,117,33,1,42,63,212
7403,IND,1982,George Johnson,25,59,4,720,120,291,.412,0,2,.000,120,289,.415,.412,60,80,.750,72,145,217,40,36,25,68,147,300
7404,IND,1982,Raymond Townsend,26,14,0,95,11,41,.268,2,9,.222,9,32,.281,.293,11,20,.550,2,11,13,10,3,0,6,18,35
7405,IND,1981,Johnny Davis,25,76,,2536,426,917,.465,4,33,.121,422,884,.477,.467,238,299,.796,56,114,170,480,95,14,167,179,1094
7406,IND,1981,Billy Knight,28,82,,2385,546,1025,.533,3,19,.158,543,1006,.540,.534,341,410,.832,191,219,410,157,84,12,177,155,1436
7407,IND,1981,Mike Bantom,29,76,,2375,431,882,.489,0,6,.000,431,876,.492,.489,199,281,.708,150,277,427,240,80,85,197,284,1061
7408,IND,1981,James Edwards,25,81,,2375,511,1004,.509,0,3,.000,511,1001,.510,.509,244,347,.703,191,380,571,212,32,128,164,304,1266
7409,IND,1981,Dudley Bradley,23,82,,1867,265,559,.474,2,16,.125,263,543,.484,.476,125,178,.702,70,123,193,188,186,37,122,236,657
7410,IND,1981,George McGinnis,30,69,,1845,348,768,.453,0,7,.000,348,761,.457,.453,207,385,.538,164,364,528,210,99,28,221,242,903
7411,IND,1981,Louis Orr,22,82,,1787,348,709,.491,0,6,.000,348,703,.495,.491,163,202,.807,172,189,361,132,55,25,123,153,859
7412,IND,1981,Clemon Johnson,24,81,,1643,235,466,.504,0,1,.000,235,465,.505,.504,112,189,.593,173,295,468,144,44,119,121,185,582
7413,IND,1981,Don Buse,30,58,,1095,114,287,.397,19,58,.328,95,229,.415,.430,50,65,.769,19,65,84,140,74,8,38,61,297
7414,IND,1981,George Johnson,24,43,,930,182,394,.462,0,5,.000,182,389,.468,.462,93,122,.762,99,179,278,86,47,23,85,120,457
7415,IND,1981,Jerry Sichting,24,47,,450,34,95,.358,0,5,.000,34,90,.378,.358,25,32,.781,11,32,43,70,23,1,28,38,93
7416,IND,1981,Tom Abernethy,26,29,,259,24,56,.429,0,1,.000,24,55,.436,.429,11,19,.579,19,21,40,18,6,3,6,29,59
7417,IND,1981,Kenny Natt,22,19,,149,25,77,.325,2,8,.250,23,69,.333,.338,7,11,.636,9,6,15,10,5,1,10,18,59
7418,IND,1981,Dick Miller,22,5,,34,2,6,.333,0,1,.000,2,5,.400,.333,0,0,,1,3,4,4,3,0,4,2,4
7419,IND,1980,Johnny Davis,24,82,82,2912,496,1159,.428,4,42,.095,492,1117,.440,.430,304,352,.864,102,124,226,440,110,23,202,178,1300
7420,IND,1980,Mickey Johnson,27,82,,2647,588,1271,.463,5,32,.156,583,1239,.471,.465,385,482,.799,258,423,681,344,153,112,286,291,1566
7421,IND,1980,Mike Bantom,28,77,,2330,384,760,.505,1,3,.333,383,757,.506,.506,139,209,.665,192,264,456,279,85,49,189,268,908
7422,IND,1980,James Edwards,24,82,82,2314,528,1032,.512,0,1,.000,528,1031,.512,.512,231,339,.681,179,399,578,127,55,104,131,324,1287
7423,IND,1980,Dudley Bradley,22,82,,2027,275,609,.452,2,5,.400,273,604,.452,.453,136,174,.782,69,154,223,252,211,48,166,194,688
7424,IND,1980,Billy Knight,27,75,,1910,385,722,.533,4,15,.267,381,707,.539,.536,212,262,.809,136,225,361,155,82,9,132,96,986
7425,IND,1980,Clemon Johnson,23,79,,1541,199,396,.503,0,0,,199,396,.503,.503,74,117,.632,145,249,394,115,48,121,78,211,472
7426,IND,1980,Alex English,26,54,,1526,346,686,.504,0,3,.000,346,683,.507,.504,114,140,.814,167,213,380,142,45,33,124,128,806
7427,IND,1980,Joe Hassett,24,74,,1135,215,509,.422,69,198,.348,146,311,.469,.490,24,29,.828,35,59,94,104,46,8,45,85,523
7428,IND,1980,George McGinnis,29,28,,784,132,302,.437,1,8,.125,131,294,.446,.439,104,181,.575,88,149,237,112,32,6,93,116,369
7429,IND,1980,Phil Chenier,29,23,,380,52,135,.385,2,6,.333,50,129,.388,.393,18,26,.692,9,26,35,47,15,10,26,29,124
7430,IND,1980,Ron Carter,23,13,,117,15,37,.405,0,0,,15,37,.405,.405,2,7,.286,5,14,19,9,2,3,10,19,32
7431,IND,1980,John Kuester,24,24,,100,12,34,.353,0,1,.000,12,33,.364,.353,5,7,.714,3,11,14,16,7,1,5,8,29
7432,IND,1980,Tony Zeno,22,8,,59,6,21,.286,0,0,,6,21,.286,.286,2,2,1.000,3,11,14,1,4,3,9,13,14
7433,IND,1980,Brad Davis,24,5,,43,2,7,.286,0,0,,2,7,.286,.286,3,4,.750,0,2,2,5,3,0,3,7,7
7434,IND,1980,Corky Calhoun,29,7,,30,4,9,.444,0,0,,4,9,.444,.444,0,2,.000,7,3,10,0,2,0,1,6,8
7435,CLE,2024,Jarrett Allen,25,77,77,2442,519,819,.634,0,6,.000,519,813,.638,.634,233,314,.742,243,568,811,210,53,81,121,147,1271
7436,CLE,2024,Max Strus,27,70,70,2239,304,728,.418,168,479,.351,136,249,.546,.533,77,97,.794,66,272,338,283,64,29,112,170,853
7437,CLE,2024,Caris LeVert,29,68,10,1958,345,820,.421,108,332,.325,237,488,.486,.487,154,201,.766,39,241,280,346,76,34,117,121,952
7438,CLE,2024,Donovan Mitchell,27,55,55,1942,503,1089,.462,182,494,.368,321,595,.539,.545,275,318,.865,46,234,280,333,101,30,154,118,1463
7439,CLE,2024,Darius Garland,24,57,57,1901,375,841,.446,132,356,.371,243,485,.501,.524,146,175,.834,30,122,152,373,74,7,176,95,1028
7440,CLE,2024,Isaac Okoro,23,69,42,1887,235,480,.490,84,215,.391,151,265,.570,.577,93,137,.679,67,139,206,132,57,34,54,140,647
7441,CLE,2024,Georges Niang,30,82,10,1831,284,632,.449,149,396,.376,135,236,.572,.567,51,60,.850,22,256,278,98,30,18,72,192,768
7442,CLE,2024,Evan Mobley,22,50,50,1532,320,552,.580,22,59,.373,298,493,.604,.600,123,171,.719,111,357,468,160,45,72,90,134,785
7443,CLE,2024,Dean Wade,27,54,32,1108,96,232,.414,79,202,.391,17,30,.567,.584,20,26,.769,37,181,218,43,40,25,20,93,291
7444,CLE,2024,Sam Merrill,27,61,1,1069,158,393,.402,143,354,.404,15,39,.385,.584,26,28,.929,22,98,120,108,19,4,19,72,485
7445,CLE,2024,Craig Porter Jr.,23,51,6,649,116,228,.509,12,34,.353,104,194,.536,.535,41,56,.732,21,88,109,118,21,15,45,40,285
7446,CLE,2024,Tristan Thompson,32,49,0,549,73,120,.608,0,1,.000,73,119,.613,.608,15,52,.288,73,101,174,51,12,14,29,59,161
7447,CLE,2024,Damian Jones,28,39,0,270,43,72,.597,3,14,.214,40,58,.690,.618,18,21,.857,20,42,62,15,7,13,13,27,107
7448,CLE,2024,Marcus Morris,34,12,0,180,26,59,.441,12,29,.414,14,30,.467,.542,5,8,.625,5,20,25,10,2,2,11,13,69
7449,CLE,2024,Emoni Bates,20,15,0,133,15,49,.306,10,33,.303,5,16,.313,.408,1,4,.250,1,13,14,10,1,2,8,5,41
7450,CLE,2024,Isaiah Mobley,24,10,0,72,10,24,.417,3,10,.300,7,14,.500,.479,0,1,.000,3,7,10,6,2,0,2,6,23
7451,CLE,2024,Pete Nance,23,8,0,27,1,6,.167,1,1,1.000,0,5,.000,.250,0,2,.000,0,3,3,0,1,0,1,2,3
7452,CLE,2024,Ty Jerome,26,2,0,15,2,4,.500,0,1,.000,2,3,.667,.500,0,0,,1,0,1,3,0,0,1,2,4
7453,CLE,2023,Evan Mobley,21,79,79,2715,525,947,.554,22,102,.216,503,845,.595,.566,205,304,.674,187,524,711,224,60,119,146,218,1277
7454,CLE,2023,Darius Garland,23,69,69,2447,522,1129,.462,169,412,.410,353,717,.492,.537,277,321,.863,28,157,185,538,85,9,199,148,1490
7455,CLE,2023,Donovan Mitchell,26,68,68,2432,679,1402,.484,245,635,.386,434,767,.566,.572,319,368,.867,63,226,289,301,99,27,180,168,1922
7456,CLE,2023,Caris LeVert,28,74,30,2237,320,742,.431,127,324,.392,193,418,.462,.517,130,180,.722,53,229,282,287,72,24,116,170,897
7457,CLE,2023,Jarrett Allen,24,68,68,2220,403,626,.644,1,10,.100,402,616,.653,.645,162,221,.733,221,445,666,113,54,84,93,153,969
7458,CLE,2023,Isaac Okoro,22,76,46,1652,175,354,.494,62,171,.363,113,183,.617,.582,78,103,.757,52,135,187,87,56,30,42,158,490
7459,CLE,2023,Cedi Osman,27,77,2,1548,239,530,.451,116,312,.372,123,218,.564,.560,75,108,.694,25,151,176,115,35,11,52,122,669
7460,CLE,2023,Lamar Stevens,25,62,25,1120,129,288,.448,30,95,.316,99,193,.513,.500,40,57,.702,48,159,207,33,27,19,27,79,328
7461,CLE,2023,Dean Wade,26,44,13,891,73,177,.412,45,127,.354,28,50,.560,.540,15,23,.652,20,130,150,37,28,21,17,89,206
7462,CLE,2023,Kevin Love,34,41,3,821,111,285,.389,69,195,.354,42,90,.467,.511,56,63,.889,42,238,280,76,7,7,47,65,347
7463,CLE,2023,Ricky Rubio,32,33,2,566,61,178,.343,21,82,.256,40,96,.417,.402,28,35,.800,9,61,70,115,26,6,31,51,171
7464,CLE,2023,Raul Neto,30,48,1,505,57,110,.518,12,42,.286,45,68,.662,.573,31,34,.912,10,36,46,79,17,4,24,49,157
7465,CLE,2023,Robin Lopez,34,37,2,299,48,75,.640,2,4,.500,46,71,.648,.653,14,18,.778,23,28,51,19,2,8,25,43,112
7466,CLE,2023,Mamadi Diakite,26,22,2,176,24,50,.480,7,21,.333,17,29,.586,.550,2,2,1.000,8,22,30,8,4,9,12,26,57
7467,CLE,2023,Danny Green,35,8,0,95,19,38,.500,13,29,.448,6,9,.667,.671,1,1,1.000,2,8,10,4,5,3,7,10,52
7468,CLE,2023,Isaiah Mobley,23,12,0,84,12,28,.429,3,8,.375,9,20,.450,.482,4,4,1.000,4,16,20,3,4,3,1,8,31
7469,CLE,2023,Sam Merrill,26,5,0,59,9,22,.409,5,18,.278,4,4,1.000,.523,2,2,1.000,0,9,9,5,4,0,0,3,25
7470,CLE,2023,Dylan Windler,26,3,0,10,2,3,.667,1,2,.500,1,1,1.000,.833,0,0,,0,0,0,1,1,0,1,0,5
7471,CLE,2022,Darius Garland,22,68,68,2430,542,1173,.462,174,454,.383,368,719,.512,.536,215,241,.892,39,185,224,583,89,7,248,115,1473
7472,CLE,2022,Evan Mobley,20,69,69,2331,422,830,.508,23,92,.250,399,738,.541,.522,167,252,.663,143,427,570,174,56,115,133,147,1034
7473,CLE,2022,Isaac Okoro,21,67,61,1981,207,431,.480,55,157,.350,152,274,.555,.544,119,155,.768,72,129,201,121,56,22,58,164,588
7474,CLE,2022,Lauri Markkanen,24,61,61,1878,313,703,.445,136,380,.358,177,323,.548,.542,138,159,.868,59,286,345,81,45,30,54,130,900
7475,CLE,2022,Jarrett Allen,23,56,56,1810,369,545,.677,1,10,.100,368,535,.688,.678,165,233,.708,192,410,602,92,44,75,94,97,904
7476,CLE,2022,Kevin Love,33,74,4,1665,327,761,.430,187,477,.392,140,284,.493,.553,166,198,.838,87,449,536,160,26,18,98,101,1007
7477,CLE,2022,Cedi Osman,26,66,3,1462,247,572,.432,128,359,.357,119,213,.559,.544,87,131,.664,25,121,146,135,52,10,67,127,709
7478,CLE,2022,Lamar Stevens,24,63,13,1015,156,319,.489,18,65,.277,138,254,.543,.517,53,75,.707,47,117,164,44,31,18,41,106,383
7479,CLE,2022,Dean Wade,25,51,28,980,99,217,.456,51,142,.359,48,75,.640,.574,20,30,.667,31,119,150,52,29,7,16,88,269
7480,CLE,2022,Ricky Rubio,31,34,8,970,149,411,.363,59,174,.339,90,237,.380,.434,88,103,.854,15,126,141,225,49,7,90,75,445
7481,CLE,2022,Caris LeVert,27,19,10,567,101,232,.435,21,67,.313,80,165,.485,.481,35,47,.745,13,51,64,75,16,5,33,40,258
7482,CLE,2022,Brandon Goodwin,26,36,5,502,64,154,.416,19,55,.345,45,99,.455,.477,24,38,.632,14,53,67,91,25,1,36,39,171
7483,CLE,2022,Dylan Windler,25,50,0,459,37,98,.378,21,70,.300,16,28,.571,.485,15,18,.833,21,68,89,34,14,3,16,47,110
7484,CLE,2022,Rajon Rondo,35,21,1,409,45,105,.429,23,58,.397,22,47,.468,.538,18,24,.750,5,54,59,103,18,1,34,31,131
7485,CLE,2022,Collin Sexton,23,11,11,316,68,151,.450,11,45,.244,57,106,.538,.487,29,39,.744,13,23,36,23,10,0,31,25,176
7486,CLE,2022,Denzel Valentine,28,22,0,204,23,62,.371,18,44,.409,5,18,.278,.516,0,0,,9,29,38,11,7,0,10,17,64
7487,CLE,2022,Ed Davis,32,31,3,201,11,16,.688,0,0,,11,16,.688,.688,6,14,.429,14,50,64,7,3,9,5,33,28
7488,CLE,2022,Moses Brown,22,14,5,176,37,58,.638,0,0,,37,58,.638,.638,16,29,.552,23,51,74,0,4,7,6,25,90
7489,CLE,2022,Kevin Pangos,29,24,3,166,15,46,.326,6,26,.231,9,20,.450,.391,3,4,.750,2,9,11,30,3,0,7,11,39
7490,CLE,2022,RJ Nembhard Jr.,22,14,0,63,6,18,.333,0,2,.000,6,16,.375,.333,3,4,.750,3,4,7,12,1,0,3,2,15
7491,CLE,2022,Tacko Fall,26,11,1,59,5,12,.417,0,0,,5,12,.417,.417,2,7,.286,7,16,23,2,0,6,3,3,12
7492,CLE,2022,Justin Anderson,28,3,0,47,4,8,.500,2,6,.333,2,2,1.000,.625,3,4,.750,0,6,6,6,1,0,2,4,13
7493,CLE,2022,Luke Kornet,26,2,0,15,1,5,.200,0,1,.000,1,4,.250,.200,2,3,.667,2,1,3,1,0,1,0,1,4
7494,CLE,2022,Tre Scott,25,2,0,11,3,6,.500,0,1,.000,3,5,.600,.500,0,0,,1,1,2,0,1,1,0,2,6
7495,CLE,2022,Malik Newman,24,1,0,8,3,5,.600,0,1,.000,3,4,.750,.600,2,2,1.000,0,1,1,1,0,0,1,0,8
7496,CLE,2022,Tim Frazier,31,2,0,8,1,2,.500,0,0,,1,2,.500,.500,0,0,,0,0,0,1,0,0,2,3,2
7497,CLE,2021,Isaac Okoro,20,67,67,2173,235,559,.420,62,214,.290,173,345,.501,.476,114,157,.726,68,138,206,128,62,24,86,185,646
7498,CLE,2021,Collin Sexton,22,60,60,2115,525,1105,.475,98,264,.371,427,841,.508,.519,312,383,.815,58,129,187,262,62,10,167,157,1460
7499,CLE,2021,Darius Garland,21,54,50,1790,362,802,.451,105,266,.395,257,536,.479,.517,112,132,.848,23,106,129,329,66,6,164,110,941
7500,CLE,2021,Jarrett Allen,22,51,40,1544,254,417,.609,6,19,.316,248,398,.623,.616,158,229,.690,158,348,506,86,25,71,78,75,672
7501,CLE,2021,Cedi Osman,25,59,26,1510,219,586,.374,99,324,.306,120,262,.458,.458,76,95,.800,38,163,201,174,53,9,80,119,613
7502,CLE,2021,Dean Wade,24,63,19,1212,134,311,.431,78,213,.366,56,98,.571,.556,30,39,.769,38,177,215,74,35,21,30,78,376
7503,CLE,2021,Larry Nance Jr.,28,35,27,1091,128,272,.471,41,114,.360,87,158,.551,.546,30,49,.612,54,181,235,107,61,17,55,72,327
7504,CLE,2021,Damyean Dotson,26,46,7,907,119,293,.406,46,159,.289,73,134,.545,.485,24,36,.667,5,88,93,91,16,4,42,42,308
7505,CLE,2021,Andre Drummond,27,25,25,722,180,380,.474,0,8,.000,180,372,.484,.474,77,129,.597,101,236,337,64,40,29,81,69,437
7506,CLE,2021,Taurean Prince,26,29,6,687,101,253,.399,49,118,.415,52,135,.385,.496,41,49,.837,17,91,108,69,20,15,36,54,292
7507,CLE,2021,Kevin Love,32,25,25,622,103,252,.409,57,156,.365,46,96,.479,.522,42,51,.824,17,169,186,63,16,2,38,26,305
7508,CLE,2021,Dylan Windler,24,31,0,513,57,130,.438,26,77,.338,31,53,.585,.538,21,27,.778,20,87,107,33,19,12,32,37,161
7509,CLE,2021,JaVale McGee,33,33,1,503,112,215,.521,5,20,.250,107,195,.549,.533,36,55,.655,54,116,170,33,16,40,45,80,265
7510,CLE,2021,Lamar Stevens,23,40,0,499,62,136,.456,4,25,.160,58,111,.523,.471,37,51,.725,24,72,96,25,17,13,23,53,165
7511,CLE,2021,Brodric Thomas,24,28,1,375,37,101,.366,15,53,.283,22,48,.458,.441,26,39,.667,7,42,49,26,14,9,18,35,115
7512,CLE,2021,Isaiah Hartenstein,22,16,2,287,53,91,.582,2,6,.333,51,85,.600,.593,24,35,.686,25,71,96,40,8,19,23,45,132
7513,CLE,2021,Matthew Dellavedova,30,13,1,224,14,56,.250,4,25,.160,10,31,.323,.286,4,4,1.000,6,18,24,58,4,1,6,21,36
7514,CLE,2021,Mfiondu Kabengele,23,16,0,186,24,57,.421,9,32,.281,15,25,.600,.500,11,14,.786,11,35,46,12,6,10,9,18,68
7515,CLE,2021,Dante Exum,25,6,3,116,10,26,.385,2,11,.182,8,15,.533,.423,1,2,.500,2,15,17,13,4,2,7,9,23
7516,CLE,2021,Quinn Cook,27,7,0,95,17,42,.405,6,13,.462,11,29,.379,.476,3,3,1.000,2,10,12,13,3,0,4,8,43
7517,CLE,2021,Thon Maker,23,8,0,76,10,18,.556,0,2,.000,10,16,.625,.556,10,11,.909,8,10,18,4,2,4,3,7,30
7518,CLE,2021,Jeremiah Martin,24,9,0,75,9,33,.273,3,12,.250,6,21,.286,.318,1,5,.200,2,5,7,4,5,2,6,1,22
7519,CLE,2021,Yogi Ferrell,27,2,0,40,8,21,.381,3,9,.333,5,12,.417,.452,0,2,.000,3,4,7,5,3,1,3,4,19
7520,CLE,2021,Anderson Varejão,38,5,0,36,4,16,.250,0,1,.000,4,15,.267,.250,5,9,.556,7,13,20,3,0,2,1,3,13
7521,CLE,2021,Marques Bolden,22,6,0,29,1,3,.333,0,0,,1,3,.333,.333,5,8,.625,3,3,6,0,2,2,2,0,7
7522,CLE,2020,Collin Sexton,21,65,65,2143,513,1086,.472,97,255,.380,416,831,.501,.517,226,267,.846,61,143,204,192,65,7,158,142,1349
7523,CLE,2020,Cedi Osman,24,65,65,1910,266,609,.437,123,321,.383,143,288,.497,.538,63,94,.670,39,192,231,154,54,16,91,160,718
7524,CLE,2020,Darius Garland,20,59,59,1824,280,699,.401,105,296,.355,175,403,.434,.476,63,72,.875,27,84,111,229,42,4,151,92,728
7525,CLE,2020,Kevin Love,31,56,56,1780,327,727,.450,146,390,.374,181,337,.537,.550,187,219,.854,54,493,547,178,33,19,140,90,987
7526,CLE,2020,Tristan Thompson,28,57,51,1721,288,562,.512,9,23,.391,279,539,.518,.520,99,161,.615,226,351,577,120,33,50,103,124,684
7527,CLE,2020,Larry Nance Jr.,27,56,10,1472,229,431,.531,56,159,.352,173,272,.636,.596,50,74,.676,106,303,409,123,56,22,60,91,564
7528,CLE,2020,Kevin Porter Jr.,19,50,3,1162,186,421,.442,53,158,.335,133,263,.506,.505,73,101,.723,22,140,162,109,46,14,93,135,498
7529,CLE,2020,Matthew Dellavedova,29,57,4,821,62,175,.354,21,91,.231,41,84,.488,.414,32,37,.865,18,57,75,180,20,2,59,78,177
7530,CLE,2020,Jordan Clarkson,27,29,0,666,144,326,.442,59,159,.371,85,167,.509,.532,76,86,.884,21,48,69,70,17,8,39,33,423
7531,CLE,2020,Alfonzo McKinnie,27,40,1,593,73,171,.427,14,65,.215,59,106,.557,.468,22,31,.710,37,76,113,14,23,8,26,72,182
7532,CLE,2020,John Henson,29,29,2,412,61,120,.508,6,31,.194,55,89,.618,.533,17,33,.515,32,82,114,43,16,32,21,55,145
7533,CLE,2020,Dante Exum,24,24,1,402,46,96,.479,13,37,.351,33,59,.559,.547,30,41,.732,9,46,55,33,12,6,21,30,135
7534,CLE,2020,Brandon Knight,28,16,0,241,28,86,.326,19,64,.297,9,22,.409,.436,4,13,.308,3,17,20,31,5,2,16,20,79
7535,CLE,2020,Andre Drummond,26,8,8,225,58,105,.552,4,14,.286,54,91,.593,.571,20,39,.513,24,65,89,14,12,11,29,25,140
7536,CLE,2020,Ante Žižić,23,22,0,221,41,72,.569,0,0,,41,72,.569,.569,14,19,.737,18,48,66,6,7,5,10,27,96
7537,CLE,2020,Dean Wade,23,12,0,71,9,13,.692,2,4,.500,7,9,.778,.769,0,1,.000,3,16,19,2,2,4,3,8,20
7538,CLE,2020,Tyler Cook,22,11,0,35,7,10,.700,0,0,,7,10,.700,.700,5,6,.833,4,6,10,1,1,0,1,4,19
7539,CLE,2020,Matt Mooney,23,4,0,19,1,4,.250,0,2,.000,1,2,.500,.250,0,0,,0,3,3,1,2,1,0,1,2
7540,CLE,2020,Malik Newman,22,1,0,4,0,2,.000,0,1,.000,0,1,.000,.000,2,2,1.000,0,0,0,0,0,0,1,0,2
7541,CLE,2020,Marques Bolden,21,1,0,3,0,0,,0,0,,0,0,,,0,0,,0,2,2,0,1,0,0,1,0
7542,CLE,2020,J.P. Macura,24,1,0,1,0,0,,0,0,,0,0,,,0,0,,0,0,0,0,0,0,0,0,0
7543,CLE,2019,Collin Sexton,20,82,72,2605,519,1206,.430,119,296,.402,400,910,.440,.480,214,255,.839,57,179,236,243,44,6,185,186,1371
7544,CLE,2019,Cedi Osman,23,76,75,2444,360,844,.427,130,374,.348,230,470,.489,.504,141,181,.779,45,312,357,195,60,11,114,195,991
7545,CLE,2019,Jordan Clarkson,26,81,0,2214,529,1180,.448,144,445,.324,385,735,.524,.509,162,192,.844,82,188,270,196,57,13,135,112,1364
7546,CLE,2019,Larry Nance Jr.,26,67,30,1795,249,479,.520,33,98,.337,216,381,.567,.554,96,134,.716,168,384,552,214,100,40,97,192,627
7547,CLE,2019,Rodney Hood,26,45,45,1234,194,454,.427,55,152,.362,139,302,.460,.488,104,114,.912,18,94,112,92,38,5,36,101,547
7548,CLE,2019,Tristan Thompson,27,43,40,1198,201,380,.529,0,0,,201,380,.529,.529,68,106,.642,173,265,438,86,28,16,59,89,470
7549,CLE,2019,Ante Žižić,22,59,25,1082,183,331,.553,0,0,,183,331,.553,.553,93,132,.705,108,212,320,53,13,22,61,113,459
7550,CLE,2019,David Nwaba,26,51,14,984,126,262,.481,24,75,.320,102,187,.545,.527,58,85,.682,41,122,163,54,36,17,29,106,334
7551,CLE,2019,Alec Burks,27,34,24,979,136,340,.400,45,119,.378,91,221,.412,.466,79,98,.806,26,160,186,98,25,16,46,62,396
7552,CLE,2019,Matthew Dellavedova,28,36,0,715,92,223,.413,40,119,.336,52,104,.500,.502,38,48,.792,6,61,67,152,12,2,57,66,262
7553,CLE,2019,Brandon Knight,27,27,26,618,88,213,.413,36,97,.371,52,116,.448,.498,18,23,.783,9,41,50,62,19,2,25,48,230
7554,CLE,2019,Kevin Love,30,22,21,598,109,283,.385,53,147,.361,56,136,.412,.479,103,114,.904,33,206,239,48,6,5,42,54,374
7555,CLE,2019,Jaron Blossomgame,25,27,4,439,47,106,.443,10,39,.256,37,67,.552,.491,10,13,.769,26,72,98,13,7,8,11,20,114
7556,CLE,2019,Marquese Chriss,21,27,2,395,56,146,.384,15,57,.263,41,89,.461,.435,26,38,.684,33,81,114,16,15,7,24,64,153
7557,CLE,2019,George Hill,32,13,13,344,55,107,.514,13,28,.464,42,79,.532,.575,17,20,.850,12,15,27,36,12,1,20,35,140
7558,CLE,2019,Nik Stauskas,25,24,0,342,40,109,.367,27,63,.429,13,46,.283,.491,25,28,.893,8,39,47,19,7,3,11,19,132
7559,CLE,2019,Channing Frye,35,36,6,341,43,117,.368,32,79,.405,11,38,.289,.504,11,14,.786,4,48,52,20,6,5,13,44,129
7560,CLE,2019,Kyle Korver,37,16,0,251,35,76,.461,25,54,.463,10,22,.455,.625,13,16,.813,0,29,29,17,3,2,17,22,108
7561,CLE,2019,J.R. Smith,33,11,4,222,27,79,.342,12,39,.308,15,40,.375,.418,8,10,.800,0,18,18,21,11,3,11,19,74
7562,CLE,2019,Jalen Jones,25,16,0,214,26,62,.419,10,28,.357,16,34,.471,.500,19,27,.704,11,23,34,7,9,2,8,27,81
7563,CLE,2019,Deng Adel,21,19,3,194,11,36,.306,6,23,.261,5,13,.385,.389,4,4,1.000,3,16,19,5,1,4,6,13,32
7564,CLE,2019,Cameron Payne,24,9,1,176,27,55,.491,9,25,.360,18,30,.600,.573,11,16,.688,3,16,19,23,8,3,11,15,74
7565,CLE,2019,Sam Dekker,24,9,5,169,22,48,.458,5,13,.385,17,35,.486,.510,8,10,.800,9,24,33,9,11,0,5,13,57
7566,CLE,2019,Andrew Harrison,24,10,0,144,12,39,.308,3,14,.214,9,25,.360,.346,16,16,1.000,4,11,15,17,4,2,10,26,43
7567,CLE,2019,Patrick McCaw,23,3,0,53,2,9,.222,1,4,.250,1,5,.200,.278,0,0,,0,3,3,2,2,0,3,1,5
7568,CLE,2019,Kobi Simmons,21,1,0,2,0,0,,0,0,,0,0,,,0,0,,0,0,0,0,0,0,0,0,0
7569,CLE,2019,John Holland,30,1,0,1,0,0,,0,0,,0,0,,,0,0,,0,0,0,0,0,0,0,0,0
7570,CLE,2018,LeBron James,33,82,82,3026,857,1580,.542,149,406,.367,708,1174,.603,.590,388,531,.731,97,612,709,747,116,71,347,136,2251
7571,CLE,2018,J.R. Smith,32,80,61,2244,240,595,.403,143,381,.375,97,214,.453,.524,39,56,.696,29,206,235,141,68,11,81,161,662
7572,CLE,2018,Jeff Green,31,78,14,1828,295,618,.477,53,170,.312,242,448,.540,.520,203,234,.868,60,186,246,99,41,34,75,149,846
7573,CLE,2018,Kevin Love,29,59,59,1651,334,729,.458,137,330,.415,197,399,.494,.552,234,266,.880,101,445,546,103,43,24,90,120,1039
7574,CLE,2018,Kyle Korver,36,73,4,1574,222,484,.459,164,376,.436,58,108,.537,.628,64,72,.889,9,156,165,88,31,27,55,130,672
7575,CLE,2018,Jae Crowder,27,53,47,1346,157,376,.418,62,189,.328,95,187,.508,.500,78,92,.848,41,132,173,58,41,12,42,124,454
7576,CLE,2018,Tristan Thompson,26,53,22,1072,132,235,.562,0,0,,132,235,.562,.562,43,79,.544,126,226,352,33,16,17,36,102,307
7577,CLE,2018,Dwyane Wade,36,46,3,1069,198,435,.455,23,70,.329,175,365,.479,.482,94,134,.701,39,142,181,163,42,32,92,84,513
7578,CLE,2018,José Calderón,36,57,32,914,93,185,.503,45,97,.464,48,88,.545,.624,24,30,.800,14,70,84,117,27,2,41,81,255
7579,CLE,2018,Cedi Osman,22,61,12,672,90,186,.484,32,87,.368,58,99,.586,.570,26,46,.565,19,101,120,41,22,3,32,78,238
7580,CLE,2018,George Hill,31,24,24,669,83,187,.444,27,77,.351,56,110,.509,.516,33,41,.805,20,44,64,67,22,15,28,53,226
7581,CLE,2018,Jordan Clarkson,25,28,0,632,131,287,.456,44,108,.407,87,179,.486,.533,47,58,.810,13,45,58,48,19,3,32,44,353
7582,CLE,2018,Channing Frye,34,44,1,545,84,169,.497,30,90,.333,54,79,.684,.586,14,15,.933,10,100,110,28,17,12,17,54,212
7583,CLE,2018,Rodney Hood,25,21,11,532,88,199,.442,25,71,.352,63,128,.492,.505,26,32,.813,8,46,54,30,15,5,7,41,227
7584,CLE,2018,Larry Nance Jr.,25,24,9,499,88,160,.550,1,8,.125,87,152,.572,.553,36,50,.720,53,115,168,25,29,18,10,59,213
7585,CLE,2018,Isaiah Thomas,28,15,14,406,70,194,.361,22,87,.253,48,107,.449,.418,59,68,.868,7,24,31,68,9,2,41,25,221
7586,CLE,2018,Derrick Rose,29,16,7,308,58,132,.439,6,24,.250,52,108,.481,.462,35,41,.854,10,19,29,26,3,4,28,14,157
7587,CLE,2018,Iman Shumpert,27,14,6,276,22,58,.379,7,26,.269,15,32,.469,.440,11,15,.733,7,34,41,17,9,4,16,22,62
7588,CLE,2018,Ante Žižić,21,32,2,214,49,67,.731,0,0,,49,67,.731,.731,21,29,.724,24,36,60,5,2,13,11,30,119
7589,CLE,2018,John Holland,29,24,0,174,17,59,.288,11,36,.306,6,23,.261,.381,9,13,.692,6,18,24,5,7,2,8,10,54
7590,CLE,2018,London Perrantes,23,14,0,66,2,13,.154,0,3,.000,2,10,.200,.154,3,5,.600,1,3,4,5,2,1,1,6,7
7591,CLE,2018,Kendrick Perkins,33,1,0,15,1,2,.500,0,0,,1,2,.500,.500,1,2,.500,0,1,1,2,1,0,1,1,3
7592,CLE,2017,LeBron James,32,74,74,2794,736,1344,.548,124,342,.363,612,1002,.611,.594,358,531,.674,97,542,639,646,92,44,303,134,1954
7593,CLE,2017,Kyrie Irving,24,72,72,2525,671,1420,.473,177,441,.401,494,979,.505,.535,297,328,.905,52,178,230,418,83,24,180,157,1816
7594,CLE,2017,Tristan Thompson,25,78,78,2336,262,437,.600,0,3,.000,262,434,.604,.600,106,213,.498,286,429,715,77,39,84,64,176,630
7595,CLE,2017,Iman Shumpert,26,76,31,1937,201,489,.411,94,261,.360,107,228,.469,.507,71,90,.789,39,179,218,109,62,27,78,150,567
7596,CLE,2017,Kevin Love,28,60,60,1885,370,867,.427,145,389,.373,225,478,.471,.510,257,295,.871,148,518,666,116,53,21,122,125,1142
7597,CLE,2017,Richard Jefferson,36,79,13,1614,153,343,.446,62,186,.333,91,157,.580,.536,80,108,.741,28,175,203,78,26,10,52,153,448
7598,CLE,2017,Channing Frye,33,74,15,1398,238,520,.458,137,335,.409,101,185,.546,.589,63,74,.851,37,253,290,45,33,37,53,138,676
7599,CLE,2017,J.R. Smith,31,41,35,1187,123,356,.346,95,271,.351,28,85,.329,.479,10,15,.667,17,96,113,62,40,11,26,77,351
7600,CLE,2017,Kyle Korver,35,35,1,859,131,269,.487,97,200,.485,34,69,.493,.667,14,15,.933,7,90,97,35,11,8,29,60,373
7601,CLE,2017,DeAndre Liggins,28,61,19,752,52,136,.382,17,45,.378,35,91,.385,.445,23,37,.622,17,84,101,54,45,14,42,78,144
7602,CLE,2017,Deron Williams,32,24,4,486,68,147,.463,22,53,.415,46,94,.489,.537,21,25,.840,1,44,45,86,6,6,40,42,179
7603,CLE,2017,Derrick Williams,25,25,0,427,54,107,.505,21,52,.404,33,55,.600,.603,27,39,.692,3,54,57,14,5,2,14,27,156
7604,CLE,2017,Kay Felder,21,42,0,386,62,158,.392,7,22,.318,55,136,.404,.415,35,49,.714,3,38,41,58,18,7,30,38,166
7605,CLE,2017,Jordan McRae,25,37,4,384,58,150,.387,18,51,.353,40,99,.404,.447,27,34,.794,6,35,41,19,8,6,14,31,161
7606,CLE,2017,James Jones,36,48,2,381,44,92,.478,31,66,.470,13,26,.500,.647,13,20,.650,3,34,37,14,6,10,10,37,132
7607,CLE,2017,Mike Dunleavy,36,23,2,366,36,90,.400,20,57,.351,16,33,.485,.511,14,19,.737,5,42,47,20,6,2,14,32,106
7608,CLE,2017,Chris Andersen,38,12,0,114,9,22,.409,0,3,.000,9,19,.474,.409,10,14,.714,9,22,31,5,5,7,5,20,28
7609,CLE,2017,Edy Tavares,24,1,0,24,3,4,.750,0,0,,3,4,.750,.750,0,1,.000,4,6,10,1,0,6,2,3,6
7610,CLE,2017,Larry Sanders,28,5,0,13,1,4,.250,0,0,,1,4,.250,.250,2,2,1.000,3,1,4,0,1,1,2,5,4
7611,CLE,2017,Dahntay Jones,36,1,0,12,3,8,.375,0,2,.000,3,6,.500,.375,3,4,.750,1,1,2,1,0,0,1,1,9
7612,CLE,2017,Andrew Bogut,32,1,0,1,0,0,,0,0,,0,0,,,0,0,,0,0,0,0,0,0,0,2,0
7613,CLE,2016,LeBron James,31,76,76,2709,737,1416,.520,87,282,.309,650,1134,.573,.551,359,491,.731,111,454,565,514,104,49,249,143,1920
7614,CLE,2016,Kevin Love,27,77,77,2424,409,977,.419,158,439,.360,251,538,.467,.499,258,314,.822,149,613,762,186,58,41,142,159,1234
7615,CLE,2016,J.R. Smith,30,77,77,2362,353,850,.415,204,510,.400,149,340,.438,.535,45,71,.634,43,174,217,130,81,21,59,204,955
7616,CLE,2016,Tristan Thompson,24,82,34,2269,247,420,.588,0,0,,247,420,.588,.588,149,242,.616,268,470,738,62,38,51,61,202,643
7617,CLE,2016,Matthew Dellavedova,25,76,14,1867,207,511,.405,98,239,.410,109,272,.401,.501,57,66,.864,33,129,162,337,44,9,116,178,569
7618,CLE,2016,Kyrie Irving,23,53,53,1667,394,879,.448,84,262,.321,310,617,.502,.496,169,191,.885,44,113,157,249,56,18,124,107,1041
7619,CLE,2016,Richard Jefferson,35,74,5,1326,143,312,.458,66,173,.382,77,139,.554,.564,58,87,.667,15,113,128,59,33,14,43,129,410
7620,CLE,2016,Timofey Mozgov,29,76,48,1326,203,359,.565,1,7,.143,202,352,.574,.567,68,95,.716,110,227,337,33,22,57,71,159,475
7621,CLE,2016,Iman Shumpert,25,54,5,1316,114,305,.374,43,146,.295,71,159,.447,.444,40,51,.784,32,171,203,92,54,19,57,119,311
7622,CLE,2016,Mo Williams,33,41,14,748,132,302,.437,36,102,.353,96,200,.480,.497,38,42,.905,6,66,72,98,14,5,57,60,338
7623,CLE,2016,James Jones,35,48,0,463,58,142,.408,41,104,.394,17,38,.447,.553,21,26,.808,8,42,50,14,11,10,13,50,178
7624,CLE,2016,Channing Frye,32,26,3,446,71,161,.441,43,114,.377,28,47,.596,.575,11,14,.786,12,81,93,26,8,8,13,56,196
7625,CLE,2016,Jared Cunningham,24,40,3,355,32,91,.352,10,32,.313,22,59,.373,.407,30,48,.625,3,26,29,19,12,2,18,37,104
7626,CLE,2016,Anderson Varejão,33,31,0,310,32,76,.421,0,1,.000,32,75,.427,.421,16,21,.762,24,67,91,20,11,5,16,35,80
7627,CLE,2016,Jordan McRae,24,15,1,113,23,52,.442,7,11,.636,16,41,.390,.510,9,13,.692,2,10,12,15,0,1,9,10,62
7628,CLE,2016,Sasha Kaun,30,25,0,95,9,17,.529,0,0,,9,17,.529,.529,5,11,.455,12,14,26,3,4,5,7,11,23
7629,CLE,2016,Dahntay Jones,35,1,0,42,6,14,.429,1,2,.500,5,12,.417,.464,0,0,,1,4,5,2,1,2,0,6,13
7630,CLE,2016,Joe Harris,24,5,0,15,1,4,.250,1,4,.250,0,0,,.375,0,0,,0,3,3,2,0,0,1,1,3
7631,CLE,2015,Kyrie Irving,22,75,75,2730,578,1235,.468,157,378,.415,421,857,.491,.532,315,365,.863,55,182,237,389,114,20,186,146,1628
7632,CLE,2015,Kevin Love,26,75,75,2532,413,952,.434,144,392,.367,269,560,.480,.509,258,321,.804,142,589,731,168,51,39,122,140,1228
7633,CLE,2015,LeBron James,30,69,69,2493,624,1279,.488,120,339,.354,504,940,.536,.535,375,528,.710,51,365,416,511,109,49,272,135,1743
7634,CLE,2015,Tristan Thompson,23,82,15,2194,267,488,.547,0,0,,267,488,.547,.547,159,248,.641,274,383,657,39,34,61,83,189,693
7635,CLE,2015,J.R. Smith,29,46,45,1461,214,504,.425,131,336,.390,83,168,.494,.555,27,33,.818,26,134,160,114,64,18,52,119,586
7636,CLE,2015,Matthew Dellavedova,24,67,13,1380,111,307,.362,68,167,.407,43,140,.307,.472,29,38,.763,37,89,126,204,24,2,61,152,319
7637,CLE,2015,Timofey Mozgov,28,46,45,1148,197,334,.590,0,0,,197,334,.590,.590,92,130,.708,112,207,319,39,18,56,69,113,486
7638,CLE,2015,Shawn Marion,36,57,24,1101,119,267,.446,12,46,.261,107,221,.484,.468,26,34,.765,64,138,202,51,27,27,33,58,276
7639,CLE,2015,Iman Shumpert,24,38,1,920,105,256,.410,44,130,.338,61,126,.484,.496,18,27,.667,33,110,143,57,51,13,49,71,272
7640,CLE,2015,Dion Waiters,23,33,3,786,138,342,.404,22,86,.256,116,256,.453,.436,47,60,.783,12,45,57,74,44,10,50,59,345
7641,CLE,2015,Mike Miller,34,52,15,701,37,114,.325,32,98,.327,5,16,.313,.465,3,4,.750,4,87,91,46,14,4,23,74,109
7642,CLE,2015,James Jones,34,57,2,669,74,201,.368,63,175,.360,11,26,.423,.525,39,46,.848,9,53,62,24,13,8,13,67,250
7643,CLE,2015,Anderson Varejão,32,26,26,636,111,200,.555,0,2,.000,111,198,.561,.555,33,45,.733,57,113,170,35,19,16,35,58,255
7644,CLE,2015,Joe Harris,23,51,1,493,48,120,.400,31,84,.369,17,36,.472,.529,9,15,.600,7,34,41,26,7,2,27,62,136
7645,CLE,2015,Kendrick Perkins,30,17,0,167,20,41,.488,0,0,,20,41,.488,.488,4,8,.500,11,30,41,8,2,4,21,27,44
7646,CLE,2015,Brendan Haywood,35,22,1,119,14,30,.467,0,0,,14,30,.467,.467,7,13,.538,6,23,29,2,2,10,10,17,35
7647,CLE,2015,A.J. Price,28,11,0,87,9,34,.265,0,11,.000,9,23,.391,.265,4,6,.667,4,11,15,13,3,0,3,1,22
7648,CLE,2015,Lou Amundson,32,12,0,79,4,12,.333,0,0,,4,12,.333,.333,3,5,.600,5,15,20,5,1,0,5,11,11
7649,CLE,2015,Will Cherry,23,8,0,69,5,19,.263,2,9,.222,3,10,.300,.316,3,6,.500,1,4,5,8,6,1,4,10,15
7650,CLE,2015,Alex Kirk,23,5,0,14,1,4,.250,0,0,,1,4,.250,.250,2,2,1.000,1,0,1,1,0,0,0,1,4
7651,CLE,2014,Tristan Thompson,22,82,82,2594,363,761,.477,0,1,.000,363,760,.478,.477,235,339,.693,269,485,754,72,42,35,108,188,961
7652,CLE,2014,Kyrie Irving,21,71,71,2496,532,1237,.430,123,344,.358,409,893,.458,.480,291,338,.861,52,207,259,433,108,23,190,163,1478
7653,CLE,2014,Jarrett Jack,30,80,31,2252,286,698,.410,63,185,.341,223,513,.435,.455,125,149,.839,22,201,223,324,56,22,133,133,760
7654,CLE,2014,Dion Waiters,22,70,24,2072,430,993,.433,92,250,.368,338,743,.455,.479,161,235,.685,32,163,195,209,63,17,154,153,1113
7655,CLE,2014,Anderson Varejão,31,65,29,1800,227,459,.495,0,7,.000,227,452,.502,.495,92,135,.681,187,442,629,140,69,39,72,164,546
7656,CLE,2014,Luol Deng,28,40,40,1353,211,506,.417,40,127,.315,171,379,.451,.457,111,144,.771,59,144,203,98,38,5,55,58,573
7657,CLE,2014,Matthew Dellavedova,23,72,4,1271,122,296,.412,57,155,.368,65,141,.461,.508,38,48,.792,29,94,123,187,33,5,60,121,339
7658,CLE,2014,Tyler Zeller,24,70,9,1049,156,290,.538,0,1,.000,156,289,.540,.538,87,121,.719,103,179,282,36,18,38,60,137,399
7659,CLE,2014,Alonzo Gee,26,65,24,1020,98,236,.415,19,58,.328,79,178,.444,.456,43,61,.705,35,114,149,47,39,15,44,96,258
7660,CLE,2014,C.J. Miles,26,51,34,984,178,409,.435,83,211,.393,95,198,.480,.537,64,75,.853,18,85,103,52,46,15,44,103,503
7661,CLE,2014,Spencer Hawes,25,27,25,804,139,297,.468,47,105,.448,92,192,.479,.547,40,51,.784,43,165,208,64,13,27,54,83,365
7662,CLE,2014,Earl Clark,26,45,17,698,90,240,.375,40,116,.345,50,124,.403,.458,14,24,.583,20,107,127,16,16,19,30,61,234
7663,CLE,2014,Anthony Bennett,20,52,0,663,80,225,.356,13,53,.245,67,172,.390,.384,44,69,.638,49,106,155,17,21,8,47,93,217
7664,CLE,2014,Andrew Bynum,26,24,19,480,85,203,.419,0,0,,85,203,.419,.419,32,42,.762,47,79,126,27,6,28,30,28,202
7665,CLE,2014,Henry Sims,23,20,0,168,18,45,.400,0,0,,18,45,.400,.400,8,14,.571,22,34,56,5,5,7,8,32,44
7666,CLE,2014,Sergey Karasev,20,22,1,156,12,35,.343,4,19,.211,8,16,.500,.400,9,10,.900,0,16,16,6,3,1,11,22,37
7667,CLE,2014,Carrick Felix,23,7,0,38,7,14,.500,2,5,.400,5,9,.556,.571,3,4,.750,1,5,6,4,0,0,4,4,19
7668,CLE,2014,Shane Edwards,26,2,0,12,1,3,.333,0,0,,1,3,.333,.333,0,0,,1,1,2,0,0,0,1,1,2
7669,CLE,2014,Seth Curry,23,1,0,9,1,3,.333,1,1,1.000,0,2,.000,.500,0,0,,0,1,1,0,2,0,0,0,3
7670,CLE,2014,Scotty Hopson,24,2,0,7,0,4,.000,0,2,.000,0,2,.000,.000,1,2,.500,0,0,0,1,1,0,0,0,1
7671,CLE,2014,Arinze Onuaku,26,2,0,5,0,1,.000,0,0,,0,1,.000,.000,0,0,,0,1,1,0,0,0,0,0,0
7672,CLE,2013,Tristan Thompson,21,82,82,2564,390,799,.488,0,3,.000,390,796,.490,.488,177,291,.608,306,467,773,108,60,71,123,234,957
7673,CLE,2013,Alonzo Gee,25,82,82,2541,305,744,.410,69,219,.315,236,525,.450,.456,163,205,.795,75,245,320,133,107,29,132,199,842
7674,CLE,2013,Kyrie Irving,20,59,59,2048,484,1070,.452,109,279,.391,375,791,.474,.503,248,290,.855,34,182,216,350,89,21,191,146,1325
7675,CLE,2013,Tyler Zeller,23,77,55,2033,245,559,.438,0,4,.000,245,555,.441,.438,120,157,.764,159,279,438,96,35,70,95,251,610
7676,CLE,2013,Dion Waiters,21,61,48,1756,336,815,.412,63,203,.310,273,612,.446,.451,159,213,.746,22,127,149,183,59,16,121,113,894
7677,CLE,2013,C.J. Miles,25,65,13,1364,255,614,.415,126,328,.384,129,286,.451,.518,93,107,.869,24,150,174,63,49,17,69,138,729
7678,CLE,2013,Shaun Livingston,27,49,12,1135,142,280,.507,0,1,.000,142,279,.509,.507,70,83,.843,29,92,121,177,37,29,59,105,354
7679,CLE,2013,Wayne Ellington,25,38,17,985,145,330,.439,53,143,.371,92,187,.492,.520,53,59,.898,20,94,114,62,29,2,33,43,396
7680,CLE,2013,Daniel Gibson,26,46,3,919,84,247,.340,56,163,.344,28,84,.333,.453,26,37,.703,5,55,60,82,30,4,31,89,250
7681,CLE,2013,Anderson Varejão,30,25,25,901,138,289,.478,0,5,.000,138,284,.486,.478,77,102,.755,138,223,361,84,37,14,44,68,353
7682,CLE,2013,Luke Walton,32,50,0,857,71,181,.392,20,67,.299,51,114,.447,.448,10,20,.500,38,107,145,166,42,13,60,98,172
7683,CLE,2013,Marreese Speights,25,39,1,721,154,337,.457,1,5,.200,153,332,.461,.458,87,108,.806,70,127,197,29,14,26,45,89,396
7684,CLE,2013,Omri Casspi,24,43,1,503,63,160,.394,25,76,.329,38,84,.452,.472,22,41,.537,20,94,114,28,25,12,22,45,173
7685,CLE,2013,Jeremy Pargo,26,25,11,447,75,187,.401,18,57,.316,57,130,.438,.449,28,41,.683,7,25,32,64,12,2,37,32,196
7686,CLE,2013,Kevin Jones,23,32,0,334,43,107,.402,0,0,,43,107,.402,.402,9,15,.600,38,40,78,10,9,5,8,25,95
7687,CLE,2013,Donald Sloan,25,20,0,257,27,78,.346,7,19,.368,20,59,.339,.391,20,25,.800,3,25,28,37,5,0,13,17,81
7688,CLE,2013,Samardo Samuels,24,18,1,196,22,60,.367,0,1,.000,22,59,.373,.367,14,24,.583,10,18,28,8,3,3,6,30,58
7689,CLE,2013,Jon Leuer,23,9,0,91,10,28,.357,0,3,.000,10,25,.400,.357,2,6,.333,5,8,13,5,2,0,5,11,22
7690,CLE,2013,Chris Quinn,29,7,0,78,4,16,.250,0,5,.000,4,11,.364,.250,2,2,1.000,1,1,2,9,3,0,6,4,10
7691,CLE,2012,Antawn Jamison,35,65,65,2151,421,1044,.403,91,267,.341,330,777,.425,.447,185,271,.683,123,285,408,131,51,43,90,164,1118
7692,CLE,2012,Alonzo Gee,24,63,31,1827,227,551,.412,44,137,.321,183,414,.442,.452,167,212,.788,101,221,322,113,83,17,114,149,665
7693,CLE,2012,Kyrie Irving,19,51,51,1558,350,747,.469,73,183,.399,277,564,.491,.517,171,196,.872,44,147,191,275,54,20,160,110,944
7694,CLE,2012,Tristan Thompson,20,60,25,1424,194,442,.439,0,2,.000,194,440,.441,.439,106,192,.552,187,202,389,27,27,62,81,134,494
7695,CLE,2012,Omri Casspi,23,65,35,1341,166,412,.403,53,168,.315,113,244,.463,.467,74,108,.685,63,165,228,66,37,21,64,115,459
7696,CLE,2012,Anthony Parker,36,51,51,1280,141,326,.433,50,138,.362,91,188,.484,.509,35,56,.625,10,128,138,120,38,7,50,65,367
7697,CLE,2012,Ramon Sessions,25,41,4,1006,141,354,.398,26,62,.419,115,292,.394,.435,122,147,.830,19,108,127,212,27,1,82,63,430
7698,CLE,2012,Daniel Gibson,25,35,7,916,87,248,.351,55,139,.396,32,109,.294,.462,34,43,.791,11,90,101,76,26,16,45,69,263
7699,CLE,2012,Samardo Samuels,23,54,0,825,105,231,.455,0,0,,105,231,.455,.455,82,117,.701,63,117,180,20,20,20,56,113,292
7700,CLE,2012,Anderson Varejão,29,25,25,785,114,222,.514,0,4,.000,114,218,.523,.514,43,64,.672,109,178,287,43,35,17,45,62,271
7701,CLE,2012,Donald Sloan,24,25,11,608,71,176,.403,2,22,.091,69,154,.448,.409,21,26,.808,15,44,59,92,10,3,42,32,165
7702,CLE,2012,Manny Harris,22,26,5,456,60,150,.400,12,36,.333,48,114,.421,.440,41,59,.695,11,59,70,31,13,6,27,28,173
7703,CLE,2012,Ryan Hollins,27,24,7,362,28,56,.500,0,0,,28,56,.500,.500,33,55,.600,25,31,56,6,4,12,24,55,89
7704,CLE,2012,Semih Erden,25,28,9,333,39,74,.527,0,0,,39,74,.527,.527,21,41,.512,20,52,72,9,10,5,16,60,99
7705,CLE,2012,Lester Hudson,27,13,0,314,59,151,.391,15,61,.246,44,90,.489,.440,32,38,.842,7,39,46,35,14,3,30,26,165
7706,CLE,2012,Luke Walton,31,21,0,299,18,51,.353,7,16,.438,11,35,.314,.422,0,0,,7,28,35,30,3,1,25,32,43
7707,CLE,2012,Luke Harangody,24,21,1,231,23,65,.354,5,21,.238,18,44,.409,.392,9,12,.750,20,33,53,6,6,3,4,17,60
7708,CLE,2012,Mychel Thompson,23,5,3,95,7,24,.292,4,11,.364,3,13,.231,.375,0,0,,0,5,5,7,2,1,5,8,18
7709,CLE,2012,Christian Eyenga,22,6,0,83,3,19,.158,1,2,.500,2,17,.118,.184,2,6,.333,3,9,12,4,3,4,2,7,9
7710,CLE,2012,D.J. Kennedy,22,2,0,59,5,12,.417,2,4,.500,3,8,.375,.500,0,2,.000,1,6,7,3,2,0,3,7,12
7711,CLE,2012,Ben Uzoh,23,2,0,13,2,5,.400,0,0,,2,5,.400,.400,0,0,,2,2,4,2,1,0,0,1,4
7712,CLE,2011,J.J. Hickson,22,80,66,2256,429,936,.458,0,5,.000,429,931,.461,.458,247,367,.673,217,478,695,91,48,54,173,215,1105
7713,CLE,2011,Ramon Sessions,24,81,38,2133,362,776,.466,3,15,.200,359,761,.472,.468,348,423,.823,46,209,255,419,60,8,178,93,1075
7714,CLE,2011,Anthony Parker,35,72,65,2091,220,552,.399,86,227,.379,134,325,.412,.476,74,95,.779,33,185,218,218,67,10,80,109,600
7715,CLE,2011,Daniel Gibson,24,67,15,1865,264,660,.400,118,293,.403,146,367,.398,.489,134,163,.822,24,153,177,201,48,21,80,154,780
7716,CLE,2011,Antawn Jamison,34,56,38,1842,374,876,.427,91,263,.346,283,613,.462,.479,171,234,.731,86,289,375,93,50,30,77,137,1010
7717,CLE,2011,Ryan Hollins,26,70,16,1182,131,219,.598,0,0,,131,219,.598,.598,111,163,.681,70,116,186,26,22,42,67,199,373
7718,CLE,2011,Mo Williams,28,36,34,1065,178,462,.385,36,136,.265,142,326,.436,.424,85,102,.833,15,82,97,257,33,10,105,91,477
7719,CLE,2011,Anderson Varejão,28,31,31,994,114,216,.528,0,2,.000,114,214,.533,.528,54,81,.667,98,203,301,45,27,38,40,87,282
7720,CLE,2011,Alonzo Gee,23,40,29,973,108,234,.462,17,49,.347,91,185,.492,.498,64,80,.800,49,108,157,33,33,16,44,81,297
7721,CLE,2011,Christian Eyenga,21,44,18,947,130,306,.425,25,91,.275,105,215,.488,.466,18,28,.643,27,96,123,35,34,28,47,78,303
7722,CLE,2011,Manny Harris,21,54,15,933,108,289,.374,34,92,.370,74,197,.376,.433,71,93,.763,36,104,140,85,31,7,63,65,321
7723,CLE,2011,Jamario Moon,30,40,13,764,76,189,.402,27,95,.284,49,94,.521,.474,10,11,.909,14,104,118,45,25,27,17,39,189
7724,CLE,2011,Samardo Samuels,22,37,10,701,110,241,.456,0,3,.000,110,238,.462,.456,68,110,.618,75,83,158,17,15,18,53,88,288
7725,CLE,2011,Joey Graham,28,39,8,586,82,179,.458,9,30,.300,73,149,.490,.483,29,36,.806,8,76,84,18,6,7,28,73,202
7726,CLE,2011,Luke Harangody,23,21,0,399,51,135,.378,14,56,.250,37,79,.468,.430,14,18,.778,23,65,88,20,11,10,11,44,130
7727,CLE,2011,Jawad Williams,27,26,1,391,41,126,.325,13,45,.289,28,81,.346,.377,9,12,.750,7,41,48,22,9,3,16,34,104
7728,CLE,2011,Baron Davis,31,15,9,380,75,178,.421,36,87,.414,39,91,.429,.522,22,27,.815,6,30,36,92,16,6,39,29,208
7729,CLE,2011,Leon Powe,27,14,3,187,29,59,.492,0,0,,29,59,.492,.492,12,26,.462,16,22,38,2,7,3,5,20,70
7730,CLE,2011,Semih Erden,24,4,1,64,4,14,.286,0,0,,4,14,.286,.286,5,6,.833,6,5,11,1,2,3,2,12,13
7731,CLE,2010,LeBron James,25,76,76,2966,768,1528,.503,129,387,.333,639,1141,.560,.545,593,773,.767,71,483,554,651,125,77,261,119,2258
7732,CLE,2010,Mo Williams,27,69,68,2359,378,855,.442,159,371,.429,219,484,.452,.535,177,198,.894,28,178,206,368,70,21,173,170,1092
7733,CLE,2010,Anthony Parker,34,81,81,2289,206,475,.434,108,261,.414,98,214,.458,.547,75,95,.789,30,201,231,157,63,18,71,151,595
7734,CLE,2010,Anderson Varejão,27,76,7,2166,267,467,.572,1,5,.200,266,462,.576,.573,116,175,.663,189,389,578,87,71,67,67,223,651
7735,CLE,2010,J.J. Hickson,21,81,73,1691,289,522,.554,0,1,.000,289,521,.555,.554,111,163,.681,110,290,400,40,36,39,92,132,689
7736,CLE,2010,Delonte West,26,60,3,1500,194,436,.445,25,77,.325,169,359,.471,.474,115,142,.810,29,140,169,196,55,28,90,86,528
7737,CLE,2010,Zydrunas Ilgauskas,34,64,6,1339,194,438,.443,11,23,.478,183,415,.441,.455,75,101,.743,114,231,345,48,14,50,63,183,474
7738,CLE,2010,Shaquille O'Neal,37,53,53,1240,262,463,.566,0,1,.000,262,462,.567,.566,112,226,.496,93,262,355,80,15,62,105,169,636
7739,CLE,2010,Daniel Gibson,23,56,10,1068,125,268,.466,71,149,.477,54,119,.454,.599,34,49,.694,13,60,73,70,25,7,36,79,355
7740,CLE,2010,Jamario Moon,29,61,2,1052,114,247,.462,32,100,.320,82,147,.558,.526,36,45,.800,26,165,191,49,34,30,23,69,296
7741,CLE,2010,Antawn Jamison,33,25,23,811,163,336,.485,27,79,.342,136,257,.529,.525,42,83,.506,37,156,193,32,28,12,30,67,395
7742,CLE,2010,Jawad Williams,26,54,6,742,81,206,.393,30,93,.323,51,113,.451,.466,32,45,.711,16,67,83,34,12,5,18,73,224
7743,CLE,2010,Leon Powe,26,20,2,236,21,49,.429,0,0,,21,49,.429,.429,37,63,.587,19,42,61,0,6,2,11,36,79
7744,CLE,2010,Danny Green,22,20,0,115,15,39,.385,6,22,.273,9,17,.529,.462,4,6,.667,8,9,17,5,6,3,5,9,40
7745,CLE,2010,Darnell Jackson,24,27,0,114,8,25,.320,1,3,.333,7,22,.318,.340,4,6,.667,8,12,20,4,2,4,13,19,21
7746,CLE,2010,Sebastian Telfair,24,4,0,77,16,35,.457,2,9,.222,14,26,.538,.486,5,6,.833,0,4,4,12,2,0,6,6,39
7747,CLE,2010,Cedric Jackson,23,5,0,10,0,2,.000,0,1,.000,0,1,.000,.000,1,4,.250,0,1,1,2,0,0,1,0,1
7748,CLE,2010,Coby Karl,26,3,0,5,0,0,,0,0,,0,0,,,0,0,,0,2,2,0,0,0,4,0,0
7749,CLE,2009,LeBron James,24,81,81,3054,789,1613,.489,132,384,.344,657,1229,.535,.530,594,762,.780,106,507,613,587,137,93,241,139,2304
7750,CLE,2009,Mo Williams,26,81,81,2834,526,1126,.467,183,420,.436,343,706,.486,.548,208,228,.912,47,232,279,329,69,9,179,215,1443
7751,CLE,2009,Anderson Varejão,26,81,42,2306,270,504,.536,0,2,.000,270,502,.538,.536,154,250,.616,166,415,581,81,75,66,80,239,694
7752,CLE,2009,Delonte West,25,64,64,2152,285,624,.457,91,228,.399,194,396,.490,.530,90,108,.833,31,172,203,226,94,13,92,125,751
7753,CLE,2009,Daniel Gibson,22,75,0,1795,206,527,.391,108,283,.382,98,244,.402,.493,66,86,.767,31,124,155,132,44,16,61,163,586
7754,CLE,2009,Zydrunas Ilgauskas,33,65,65,1765,342,724,.472,15,39,.385,327,685,.477,.483,139,174,.799,157,333,490,64,28,84,90,183,838
7755,CLE,2009,Wally Szczerbiak,31,74,5,1527,179,398,.450,69,168,.411,110,230,.478,.536,90,106,.849,43,189,232,82,28,10,55,130,517
7756,CLE,2009,Ben Wallace,34,56,53,1314,69,155,.445,0,0,,69,155,.445,.445,27,64,.422,136,226,362,44,48,75,34,82,165
7757,CLE,2009,Sasha Pavlović,25,66,12,1053,116,275,.422,48,117,.410,68,158,.430,.509,25,54,.463,31,96,127,72,22,16,48,122,305
7758,CLE,2009,J.J. Hickson,20,62,0,705,100,194,.515,0,0,,100,194,.515,.515,45,67,.672,52,113,165,9,14,30,45,81,245
7759,CLE,2009,Darnell Jackson,23,51,2,430,37,86,.430,0,2,.000,37,84,.440,.430,24,35,.686,32,55,87,8,10,4,14,77,98
7760,CLE,2009,Joe Smith,33,21,0,411,57,115,.496,1,3,.333,56,112,.500,.500,21,28,.750,36,64,100,16,7,14,10,50,136
7761,CLE,2009,Tarence Kinsey,24,50,3,277,31,69,.449,7,18,.389,24,51,.471,.500,33,38,.868,10,28,38,10,12,0,22,34,102
7762,CLE,2009,Lorenzen Wright,33,17,2,125,10,27,.370,0,0,,10,27,.370,.370,3,8,.375,7,18,25,3,4,5,9,17,23
7763,CLE,2009,Jawad Williams,25,10,0,20,5,12,.417,2,6,.333,3,6,.500,.500,0,0,,1,1,2,0,1,0,1,2,12
7764,CLE,2009,Trey Johnson,24,4,0,14,0,5,.000,0,0,,0,5,.000,.000,4,4,1.000,0,1,1,0,0,0,1,4,4
7765,CLE,2008,LeBron James,23,75,74,3027,794,1642,.484,113,359,.315,681,1283,.531,.518,549,771,.712,133,459,592,539,138,81,255,165,2250
7766,CLE,2008,Zydrunas Ilgauskas,32,73,73,2222,417,879,.474,0,1,.000,417,878,.475,.474,195,243,.802,263,419,682,104,34,120,135,247,1029
7767,CLE,2008,Daniel Gibson,21,58,26,1765,201,465,.432,118,268,.440,83,197,.421,.559,85,105,.810,30,104,134,145,47,14,76,163,605
7768,CLE,2008,Devin Brown,29,78,20,1762,217,531,.409,45,146,.308,172,385,.447,.451,107,142,.754,65,198,263,175,52,7,99,144,586
7769,CLE,2008,Drew Gooden,26,51,51,1564,232,523,.444,0,3,.000,232,520,.446,.444,110,151,.728,117,306,423,50,35,30,91,144,574
7770,CLE,2008,Damon Jones,31,67,3,1336,151,363,.416,115,276,.417,36,87,.414,.574,20,28,.714,5,67,72,126,19,1,36,66,437
7771,CLE,2008,Anderson Varejão,25,48,13,1320,136,295,.461,0,2,.000,136,293,.464,.461,49,82,.598,134,265,399,53,37,26,59,134,321
7772,CLE,2008,Larry Hughes,29,40,32,1210,180,478,.377,43,126,.341,137,352,.389,.422,88,108,.815,27,116,143,94,60,11,72,91,491
7773,CLE,2008,Sasha Pavlović,24,51,45,1188,146,403,.362,34,114,.298,112,289,.388,.404,53,77,.688,35,93,128,82,29,6,55,117,379
7774,CLE,2008,Delonte West,24,26,26,806,99,225,.440,29,79,.367,70,146,.479,.504,41,52,.788,18,79,97,116,29,19,51,59,268
7775,CLE,2008,Ira Newble,33,41,13,650,71,158,.449,15,45,.333,56,113,.496,.497,20,26,.769,41,73,114,14,27,7,31,64,177
7776,CLE,2008,Joe Smith,32,27,1,580,87,170,.512,0,2,.000,87,168,.518,.512,45,69,.652,55,81,136,19,9,16,22,73,219
7777,CLE,2008,Ben Wallace,33,22,22,578,37,81,.457,0,0,,37,81,.457,.457,19,44,.432,59,104,163,13,19,37,18,35,93
7778,CLE,2008,Wally Szczerbiak,30,25,1,556,75,209,.359,19,52,.365,56,157,.357,.404,36,41,.878,18,63,81,35,9,7,20,36,205
7779,CLE,2008,Dwayne Jones,24,56,0,472,25,47,.532,0,1,.000,25,46,.543,.532,28,58,.483,69,71,140,10,10,25,17,88,78
7780,CLE,2008,Eric Snow,34,22,5,305,6,38,.158,0,2,.000,6,36,.167,.158,10,22,.455,4,16,20,42,10,4,10,30,22
7781,CLE,2008,Shannon Brown,22,15,4,218,41,111,.369,9,29,.310,32,82,.390,.410,14,23,.609,5,13,18,17,10,1,19,27,105
7782,CLE,2008,Donyell Marshall,34,11,1,156,13,44,.295,8,23,.348,5,21,.238,.386,7,9,.778,9,21,30,5,2,9,6,16,41
7783,CLE,2008,Cedric Simmons,22,7,0,68,2,6,.333,0,0,,2,6,.333,.333,0,8,.000,5,10,15,0,2,5,4,7,4
7784,CLE,2008,Billy Thomas,32,7,0,34,4,14,.286,4,13,.308,0,1,.000,.429,0,0,,0,2,2,0,1,0,3,4,12
7785,CLE,2008,Demetris Nichols,23,3,0,14,1,8,.125,0,3,.000,1,5,.200,.125,0,0,,0,1,1,0,0,0,2,0,2
7786,CLE,2008,Kaniel Dickens,29,5,0,12,1,3,.333,0,0,,1,3,.333,.333,0,0,,0,1,1,1,0,1,0,1,2
7787,CLE,2008,Lance Allred,26,3,0,10,1,4,.250,0,0,,1,4,.250,.250,1,2,.500,0,1,1,0,0,0,0,1,3
7788,CLE,2007,LeBron James,22,78,78,3190,772,1621,.476,99,310,.319,673,1311,.513,.507,489,701,.698,83,443,526,470,125,55,250,171,2132
7789,CLE,2007,Larry Hughes,28,70,68,2596,381,953,.400,74,222,.333,307,731,.420,.439,209,309,.676,41,226,267,256,89,26,154,164,1045
7790,CLE,2007,Drew Gooden,25,80,80,2238,371,784,.473,1,6,.167,370,778,.476,.474,142,199,.714,263,418,681,88,70,28,115,210,885
7791,CLE,2007,Zydrunas Ilgauskas,31,78,78,2130,385,793,.485,0,1,.000,385,792,.486,.485,155,192,.807,242,357,599,123,48,98,141,257,925
7792,CLE,2007,Anderson Varejão,24,81,6,1932,191,401,.476,0,9,.000,191,392,.487,.476,165,268,.616,191,354,545,75,76,52,67,269,547
7793,CLE,2007,Eric Snow,33,82,45,1929,135,324,.417,0,4,.000,135,320,.422,.417,72,113,.637,35,153,188,330,55,16,111,185,342
7794,CLE,2007,Sasha Pavlović,23,67,28,1534,222,490,.453,60,148,.405,162,342,.474,.514,100,126,.794,23,135,158,105,55,17,102,145,604
7795,CLE,2007,Donyell Marshall,33,81,0,1360,209,493,.424,95,271,.351,114,222,.514,.520,53,80,.663,86,237,323,46,39,43,67,130,566
7796,CLE,2007,Damon Jones,30,60,0,1173,137,355,.386,89,231,.385,48,124,.387,.511,30,44,.682,9,57,66,94,16,2,36,53,393
7797,CLE,2007,Daniel Gibson,20,60,16,988,98,231,.424,52,124,.419,46,107,.430,.537,28,39,.718,28,64,92,69,23,8,44,94,276
7798,CLE,2007,David Wesley,36,35,5,352,22,75,.293,9,38,.237,13,37,.351,.353,20,28,.714,3,32,35,37,12,4,17,32,73
7799,CLE,2007,Shannon Brown,21,23,5,202,28,74,.378,7,25,.280,21,49,.429,.426,10,14,.714,6,15,21,10,7,3,14,24,73
7800,CLE,2007,Ira Newble,32,15,1,129,16,37,.432,8,15,.533,8,22,.364,.541,6,10,.600,13,17,30,2,6,0,3,17,46
7801,CLE,2007,Scot Pollard,31,24,0,109,11,26,.423,0,0,,11,26,.423,.423,2,4,.500,15,16,31,3,4,1,4,27,24
7802,CLE,2007,Dwayne Jones,23,4,0,18,0,1,.000,0,0,,0,1,.000,.000,3,6,.500,1,5,6,0,0,0,2,3,3
7803,CLE,2006,LeBron James,21,79,79,3361,875,1823,.480,127,379,.335,748,1444,.518,.515,601,814,.738,75,481,556,521,123,66,260,181,2478
7804,CLE,2006,Eric Snow,32,82,82,2351,163,399,.409,1,10,.100,162,389,.416,.410,64,93,.688,38,160,198,346,76,19,116,218,391
7805,CLE,2006,Zydrunas Ilgauskas,30,78,78,2283,450,889,.506,0,5,.000,450,884,.509,.506,317,380,.834,245,346,591,91,38,136,155,280,1217
7806,CLE,2006,Drew Gooden,24,79,79,2174,334,652,.512,1,3,.333,333,649,.513,.513,176,258,.682,237,428,665,56,52,49,106,190,845
7807,CLE,2006,Damon Jones,29,82,7,2089,190,491,.387,140,371,.377,50,120,.417,.530,32,50,.640,14,119,133,169,37,1,55,112,552
7808,CLE,2006,Donyell Marshall,32,81,0,2077,265,671,.395,128,395,.324,137,276,.496,.490,92,123,.748,105,387,492,60,59,41,90,160,750
7809,CLE,2006,Larry Hughes,27,36,31,1281,192,469,.409,28,76,.368,164,393,.417,.439,146,193,.756,26,135,161,131,53,21,99,117,558
7810,CLE,2006,Ronald Murray,26,28,25,1027,142,317,.448,20,65,.308,122,252,.484,.479,73,104,.702,15,52,67,77,38,7,56,64,377
7811,CLE,2006,Sasha Pavlović,22,53,19,813,87,212,.410,35,96,.365,52,116,.448,.493,32,49,.653,16,64,80,25,19,6,42,103,241
7812,CLE,2006,Anderson Varejão,23,48,4,760,79,150,.527,0,1,.000,79,149,.530,.527,61,119,.513,77,158,235,19,31,19,27,118,219
7813,CLE,2006,Alan Henderson,33,51,3,531,47,91,.516,0,0,,47,91,.516,.516,33,49,.673,60,77,137,10,9,12,22,58,127
7814,CLE,2006,Ira Newble,31,36,3,353,17,57,.298,3,13,.231,14,44,.318,.325,11,16,.688,21,35,56,9,5,10,12,47,48
7815,CLE,2006,Luke Jackson,24,36,0,315,29,85,.341,12,36,.333,17,49,.347,.412,26,33,.788,16,24,40,25,11,2,31,30,96
7816,CLE,2006,Mike Wilks,26,37,0,243,17,59,.288,2,14,.143,15,45,.333,.305,6,12,.500,6,21,27,18,8,1,15,27,42
7817,CLE,2006,Stephen Graham,23,13,0,117,14,33,.424,0,1,.000,14,32,.438,.424,8,9,.889,4,13,17,3,3,2,7,23,36
7818,CLE,2006,Zendon Hamilton,30,11,0,46,7,13,.538,0,0,,7,13,.538,.538,11,16,.688,3,8,11,0,3,0,6,4,25
7819,CLE,2006,Martynas Andriuškevičius,19,6,0,9,0,1,.000,0,0,,0,1,.000,.000,0,0,,1,3,4,0,2,0,0,1,0
7820,CLE,2005,LeBron James,20,80,80,3388,795,1684,.472,108,308,.351,687,1376,.499,.504,477,636,.750,111,477,588,577,177,52,262,146,2175
7821,CLE,2005,Jeff McInnis,30,76,69,2651,377,915,.412,91,264,.345,286,651,.439,.462,130,160,.813,32,125,157,391,56,1,117,177,975
7822,CLE,2005,Zydrunas Ilgauskas,29,78,78,2615,458,979,.468,2,7,.286,456,972,.469,.469,402,503,.799,299,373,672,100,53,165,191,313,1320
7823,CLE,2005,Drew Gooden,23,82,80,2523,464,943,.492,5,28,.179,459,915,.502,.495,251,310,.810,207,546,753,130,77,76,133,233,1184
7824,CLE,2005,Eric Snow,31,81,15,1844,125,327,.382,13,45,.289,112,282,.397,.402,59,80,.738,37,118,155,317,67,16,89,189,322
7825,CLE,2005,Ira Newble,30,74,69,1832,182,424,.429,19,53,.358,163,371,.439,.452,55,69,.797,78,142,220,91,50,18,61,144,438
7826,CLE,2005,Robert Traylor,27,74,6,1327,177,399,.444,0,8,.000,177,391,.453,.444,55,102,.539,136,196,332,61,54,50,73,215,409
7827,CLE,2005,Lucious Harris,34,73,4,1128,118,299,.395,21,65,.323,97,234,.415,.430,56,69,.812,39,82,121,49,27,6,29,68,313
7828,CLE,2005,Anderson Varejão,22,54,0,863,99,193,.513,0,2,.000,99,191,.518,.513,68,127,.535,109,148,257,27,41,38,26,122,266
7829,CLE,2005,Sasha Pavlović,21,65,9,862,120,276,.435,30,78,.385,90,198,.455,.489,44,64,.688,15,56,71,49,29,4,47,121,314
7830,CLE,2005,DeSagana Diop,23,39,0,306,20,69,.290,0,2,.000,20,67,.299,.290,0,5,.000,30,40,70,15,8,27,12,53,40
7831,CLE,2005,Jiří Welsch,25,16,0,192,12,51,.235,2,11,.182,10,40,.250,.255,20,28,.714,6,22,28,19,5,0,15,16,46
7832,CLE,2005,Scott Williams,36,19,0,152,12,41,.293,0,1,.000,12,40,.300,.293,9,11,.818,15,15,30,8,4,6,5,30,33
7833,CLE,2005,Dajuan Wagner,21,11,0,102,18,55,.327,5,26,.192,13,29,.448,.373,3,4,.750,0,2,2,13,5,0,9,15,44
7834,CLE,2005,Luke Jackson,23,10,0,43,10,27,.370,4,6,.667,6,21,.286,.444,5,6,.833,2,4,6,3,0,0,2,4,29
7835,CLE,2005,Jérôme Moïso,26,4,0,27,3,5,.600,0,0,,3,5,.600,.600,0,0,,1,6,7,1,1,2,0,4,6
7836,CLE,2004,LeBron James,19,79,79,3122,622,1492,.417,63,217,.290,559,1275,.438,.438,347,460,.754,99,333,432,465,130,58,273,149,1654
7837,CLE,2004,Carlos Boozer,22,75,75,2592,471,900,.523,1,6,.167,470,894,.526,.524,219,285,.768,230,627,857,148,74,55,134,199,1162
7838,CLE,2004,Zydrunas Ilgauskas,28,81,81,2539,466,965,.483,2,7,.286,464,958,.484,.484,303,406,.746,279,374,653,109,39,201,163,277,1237
7839,CLE,2004,Kevin Ollie,31,82,7,1401,95,257,.370,4,9,.444,91,248,.367,.377,147,176,.835,23,147,170,234,51,8,81,119,341
7840,CLE,2004,Eric Williams,31,50,36,1373,154,421,.366,24,95,.253,130,326,.399,.394,137,174,.787,44,147,191,95,48,8,57,128,469
7841,CLE,2004,Ira Newble,29,64,25,1245,108,276,.391,2,19,.105,106,257,.412,.395,36,46,.783,65,90,155,72,25,19,54,109,254
7842,CLE,2004,Jeff McInnis,29,31,31,1096,138,331,.417,31,80,.388,107,251,.426,.464,56,67,.836,17,65,82,234,36,4,59,69,363
7843,CLE,2004,Tony Battie,27,50,1,977,114,267,.427,1,8,.125,113,259,.436,.429,43,56,.768,79,162,241,37,18,47,39,104,272
7844,CLE,2004,Darius Miles,22,37,16,888,143,331,.432,5,30,.167,138,301,.458,.440,39,72,.542,48,119,167,80,25,27,56,84,330
7845,CLE,2004,Ricky Davis,24,22,22,796,134,311,.431,17,48,.354,117,263,.445,.458,51,75,.680,18,103,121,111,25,8,68,51,336
7846,CLE,2004,DeSagana Diop,22,56,3,730,57,147,.388,0,0,,57,147,.388,.388,12,20,.600,72,127,199,34,26,51,29,116,126
7847,CLE,2004,Dajuan Wagner,20,44,4,708,112,306,.366,31,86,.360,81,220,.368,.417,32,47,.681,9,49,58,51,26,7,41,89,287
7848,CLE,2004,Kedrick Brown,22,34,16,561,72,155,.465,26,67,.388,46,88,.523,.548,9,14,.643,23,55,78,39,13,5,17,42,179
7849,CLE,2004,Jason Kapono,22,41,3,427,52,129,.403,21,44,.477,31,85,.365,.484,20,24,.833,19,36,55,14,13,2,21,41,145
7850,CLE,2004,J.R. Bremer,23,31,2,403,39,137,.285,19,66,.288,20,71,.282,.354,13,20,.650,7,26,33,39,18,4,19,27,110
7851,CLE,2004,Lee Nailon,28,22,4,397,73,162,.451,0,3,.000,73,159,.459,.451,24,30,.800,30,36,66,17,4,1,21,36,170
7852,CLE,2004,Chris Mihm,24,22,1,391,59,127,.465,0,0,,59,127,.465,.465,34,48,.708,47,93,140,10,9,22,25,58,152
7853,CLE,2004,Mateen Cleaves,26,4,2,92,7,23,.304,0,1,.000,7,22,.318,.304,1,2,.500,1,6,7,19,4,2,5,13,15
7854,CLE,2004,Michael Stewart,28,8,2,76,3,7,.429,0,0,,3,7,.429,.429,2,2,1.000,5,13,18,0,1,8,1,21,8
7855,CLE,2004,Bruno Šundov,23,4,0,29,3,9,.333,0,0,,3,9,.333,.333,3,6,.500,2,8,10,0,0,0,3,7,9
7856,CLE,2004,Jelani McCoy,26,2,0,12,0,0,,0,0,,0,0,,,0,0,,1,3,4,0,0,0,1,4,0
7857,CLE,2003,Ricky Davis,23,79,76,3131,602,1470,.410,74,204,.363,528,1266,.417,.435,348,465,.748,97,293,390,436,125,36,277,180,1626
7858,CLE,2003,Zydrunas Ilgauskas,27,81,81,2432,495,1122,.441,0,5,.000,495,1117,.443,.441,400,512,.781,240,371,611,127,56,152,210,274,1390
7859,CLE,2003,Jumaine Jones,23,80,12,2204,308,710,.434,111,314,.354,197,396,.497,.512,57,83,.687,106,299,405,112,67,22,107,176,784
7860,CLE,2003,Carlos Boozer,21,81,54,2049,331,618,.536,0,1,.000,331,617,.536,.536,148,192,.771,202,407,609,106,59,50,103,224,810
7861,CLE,2003,Darius Miles,21,67,62,2008,263,642,.410,0,14,.000,263,628,.419,.410,92,155,.594,113,250,363,176,67,69,178,159,618
7862,CLE,2003,Milt Palacio,24,80,46,1976,162,388,.418,8,37,.216,154,351,.439,.428,65,87,.747,48,187,235,259,68,16,131,168,397
7863,CLE,2003,Dajuan Wagner,19,47,24,1385,223,605,.369,55,174,.316,168,431,.390,.414,128,160,.800,20,62,82,130,38,7,85,107,629
7864,CLE,2003,Smush Parker,21,66,18,1103,136,338,.402,38,118,.322,98,220,.445,.459,98,118,.831,29,90,119,162,48,12,133,106,408
7865,CLE,2003,DeSagana Diop,21,80,1,943,54,154,.351,0,0,,54,154,.351,.351,11,30,.367,63,152,215,43,33,81,56,148,119
7866,CLE,2003,Tyrone Hill,34,32,25,855,85,197,.431,0,0,,85,197,.431,.431,33,45,.733,70,197,267,32,31,19,52,104,203
7867,CLE,2003,Chris Mihm,23,52,0,809,116,287,.404,0,3,.000,116,284,.408,.404,76,105,.724,93,138,231,28,18,38,48,124,308
7868,CLE,2003,Bimbo Coles,34,21,11,516,34,119,.286,7,25,.280,27,94,.287,.315,27,34,.794,10,38,48,56,11,4,18,43,102
7869,CLE,2003,Michael Stewart,27,47,0,251,14,37,.378,0,0,,14,37,.378,.378,8,12,.667,19,36,55,6,2,15,10,42,36
7870,CLE,2003,Tierre Brown,23,15,0,168,27,59,.458,0,1,.000,27,58,.466,.458,11,14,.786,8,22,30,39,13,0,22,9,65
7871,CLE,2002,Andre Miller,25,81,81,3023,474,1045,.454,22,87,.253,452,958,.472,.464,365,447,.817,108,271,379,882,126,34,245,228,1335
7872,CLE,2002,Wesley Person,30,78,78,2793,467,944,.495,143,322,.444,324,622,.521,.570,99,124,.798,50,244,294,173,77,37,74,93,1176
7873,CLE,2002,Lamond Murray,28,71,68,2312,430,986,.436,101,238,.424,329,748,.440,.487,215,263,.817,81,291,372,157,70,43,141,148,1176
7874,CLE,2002,Jumaine Jones,22,81,36,2142,287,640,.448,52,168,.310,235,472,.498,.489,45,68,.662,125,365,490,116,75,46,79,184,671
7875,CLE,2002,Ricky Davis,22,82,8,1954,376,781,.481,11,35,.314,365,746,.489,.488,196,248,.790,63,180,243,178,69,23,148,145,959
7876,CLE,2002,Chris Mihm,22,74,60,1659,221,526,.420,3,7,.429,218,519,.420,.423,124,179,.693,133,259,392,24,18,89,97,260,569
7877,CLE,2002,Zydrunas Ilgauskas,26,62,23,1329,241,567,.425,0,5,.000,241,562,.429,.425,208,276,.754,136,198,334,70,17,84,94,187,690
7878,CLE,2002,Brian Skinner,25,65,8,1107,88,162,.543,0,0,,88,162,.543,.543,48,79,.608,93,188,281,17,24,61,42,130,224
7879,CLE,2002,Tyrone Hill,33,26,26,810,71,182,.390,0,1,.000,71,181,.392,.390,67,103,.650,79,195,274,23,17,13,48,102,209
7880,CLE,2002,Michael Doleac,24,42,15,705,78,187,.417,0,0,,78,187,.417,.417,38,46,.826,47,121,168,25,15,11,37,98,194
7881,CLE,2002,Bimbo Coles,33,47,1,693,56,146,.384,4,20,.200,52,126,.413,.397,33,37,.892,12,43,55,107,13,4,31,59,149
7882,CLE,2002,Bryant Stith,31,50,5,665,70,188,.372,24,68,.353,46,120,.383,.436,44,52,.846,20,65,85,42,29,6,30,42,208
7883,CLE,2002,Trajan Langdon,25,44,0,477,70,176,.398,27,74,.365,43,102,.422,.474,42,46,.913,13,42,55,60,13,5,40,49,209
7884,CLE,2002,DeSagana Diop,20,18,1,109,12,29,.414,0,0,,12,29,.414,.414,1,5,.200,5,12,17,5,1,10,12,19,25
7885,CLE,2002,Jeff Trepagnier,22,12,0,77,7,23,.304,0,1,.000,7,22,.318,.304,4,7,.571,3,9,12,12,8,4,11,8,18
7886,CLE,2001,Andre Miller,24,82,82,2848,452,999,.452,17,64,.266,435,935,.465,.461,375,450,.833,94,266,360,657,119,28,265,229,1296
7887,CLE,2001,Clarence Weatherspoon,30,82,82,2774,347,692,.501,0,0,,347,692,.501,.501,230,291,.790,223,573,796,103,85,105,112,171,924
7888,CLE,2001,Lamond Murray,27,78,46,2225,391,925,.423,61,165,.370,330,760,.434,.456,155,211,.735,104,236,340,124,83,27,141,173,998
7889,CLE,2001,Chris Gatling,33,74,6,1670,329,733,.449,28,92,.304,301,641,.470,.468,156,228,.684,99,292,391,61,52,27,119,185,842
7890,CLE,2001,Matt Harpring,24,56,55,1615,238,524,.454,13,52,.250,225,472,.477,.467,134,165,.812,90,152,242,102,42,17,90,161,623
7891,CLE,2001,Robert Traylor,23,70,7,1212,161,324,.497,0,2,.000,161,322,.500,.497,80,141,.567,124,176,300,63,49,76,98,204,402
7892,CLE,2001,Chris Mihm,21,59,43,1166,173,391,.442,0,1,.000,173,390,.444,.442,100,126,.794,106,174,280,16,20,53,80,156,446
7893,CLE,2001,Jim Jackson,30,39,26,1140,162,415,.390,10,42,.238,152,373,.408,.402,66,84,.786,36,109,145,113,34,6,82,97,400
7894,CLE,2001,Trajan Langdon,24,65,5,1116,135,313,.431,51,124,.411,84,189,.444,.513,68,76,.895,12,77,89,81,38,9,52,114,389
7895,CLE,2001,Cedric Henderson,25,55,10,961,102,262,.389,1,8,.125,101,254,.398,.391,30,46,.652,19,71,90,79,29,23,63,101,235
7896,CLE,2001,Wesley Person,29,44,22,958,128,292,.438,34,84,.405,94,208,.452,.497,24,30,.800,11,119,130,64,27,11,40,62,314
7897,CLE,2001,Bimbo Coles,32,47,0,804,91,239,.381,2,16,.125,89,223,.399,.385,48,56,.857,9,39,48,138,27,6,59,87,232
7898,CLE,2001,Zydrunas Ilgauskas,25,24,24,616,114,234,.487,0,2,.000,114,232,.491,.487,53,78,.679,65,95,160,18,15,37,60,78,281
7899,CLE,2001,Chucky Brown,32,20,2,265,31,75,.413,0,1,.000,31,74,.419,.413,16,24,.667,5,31,36,6,6,6,6,27,78
7900,CLE,2001,Anthony Johnson,26,28,0,232,27,81,.333,1,2,.500,26,79,.329,.340,11,16,.688,7,14,21,44,6,1,14,21,66
7901,CLE,2001,Brevin Knight,25,6,0,93,2,15,.133,0,0,,2,15,.133,.133,5,6,.833,1,6,7,25,6,1,7,17,9
7902,CLE,2001,Michael Hawkins,28,10,0,76,3,9,.333,2,4,.500,1,5,.200,.444,0,0,,2,3,5,13,2,0,6,13,8
7903,CLE,2001,J.R. Reid,32,6,0,39,2,5,.400,0,0,,2,5,.400,.400,6,8,.750,5,3,8,1,2,1,1,4,10
7904,CLE,2001,Etdrick Bohannon,27,6,0,19,2,4,.500,0,0,,2,4,.500,.500,4,4,1.000,3,4,7,0,0,2,1,4,8
7905,CLE,2001,Larry Robinson,33,1,0,1,0,0,,0,0,,0,0,,,0,0,,0,0,0,0,0,0,1,0,0
7906,CLE,2000,Shawn Kemp,30,82,82,2492,484,1160,.417,2,6,.333,482,1154,.418,.418,493,635,.776,231,494,725,138,100,96,291,371,1463
7907,CLE,2000,Lamond Murray,26,74,72,2365,460,1019,.451,51,139,.367,409,880,.465,.476,204,268,.761,127,296,423,132,105,36,184,208,1175
7908,CLE,2000,Bob Sura,26,73,45,2216,356,815,.437,122,332,.367,234,483,.484,.512,175,251,.697,50,238,288,284,91,19,148,201,1009
7909,CLE,2000,Andre Miller,23,82,36,2093,339,755,.449,10,49,.204,329,706,.466,.456,226,292,.774,85,195,280,476,84,17,166,194,914
7910,CLE,2000,Wesley Person,28,79,38,2056,280,654,.428,106,250,.424,174,404,.431,.509,61,77,.792,44,223,267,146,40,19,60,119,727
7911,CLE,2000,Andrew DeClercq,26,82,31,1831,225,443,.508,0,0,,225,443,.508,.508,94,160,.588,156,283,439,58,63,66,108,275,544
7912,CLE,2000,Brevin Knight,24,65,46,1754,230,558,.412,2,10,.200,228,548,.416,.414,140,184,.761,38,155,193,458,107,21,157,185,602
7913,CLE,2000,Mark Bryant,34,75,50,1712,174,346,.503,0,0,,174,346,.503,.503,76,94,.809,126,226,352,61,31,31,87,250,424
7914,CLE,2000,Danny Ferry,33,63,3,1326,189,380,.497,33,75,.440,156,305,.511,.541,52,57,.912,55,183,238,67,22,24,55,181,463
7915,CLE,2000,Cedric Henderson,24,61,7,1107,129,326,.396,1,15,.067,128,311,.412,.397,69,104,.663,34,106,140,55,39,17,68,99,328
7916,CLE,2000,Earl Boykins,23,25,0,253,53,112,.473,8,20,.400,45,92,.489,.509,18,23,.783,11,14,25,45,12,1,17,23,132
7917,CLE,2000,Ryan Stack,24,25,0,198,17,51,.333,0,1,.000,17,50,.340,.333,18,27,.667,15,30,45,5,4,11,17,47,52
7918,CLE,2000,Trajan Langdon,23,10,0,145,15,40,.375,8,19,.421,7,21,.333,.475,11,11,1.000,4,11,15,11,5,0,6,16,49
7919,CLE,2000,Lari Ketner,22,16,0,91,9,22,.409,0,0,,9,22,.409,.409,6,10,.600,12,15,27,0,3,2,7,12,24
7920,CLE,2000,A.J. Bramlett,23,8,0,61,4,21,.190,0,0,,4,21,.190,.190,0,0,,12,10,22,0,1,0,3,13,8
7921,CLE,2000,Mark Hendrickson,25,10,0,47,5,7,.714,0,0,,5,7,.714,.714,2,2,1.000,2,9,11,3,2,1,3,7,12
7922,CLE,2000,Donny Marshall,27,6,0,39,3,11,.273,0,3,.000,3,8,.375,.273,5,6,.833,0,1,1,0,2,0,3,7,11
7923,CLE,2000,Kornél Dávid,28,6,0,31,4,9,.444,0,0,,4,9,.444,.444,3,4,.750,4,4,8,1,4,1,2,7,11
7924,CLE,2000,Pete Chilcutt,31,6,0,30,0,2,.000,0,0,,0,2,.000,.000,0,0,,4,5,9,1,0,0,0,3,0
7925,CLE,2000,Benoit Benjamin,35,3,0,8,1,3,.333,0,0,,1,3,.333,.333,0,0,,0,1,1,0,0,1,0,1,2
7926,CLE,1999,Cedric Henderson,23,50,48,1517,189,453,.417,2,12,.167,187,441,.424,.419,74,91,.813,45,152,197,113,58,24,97,136,454
7927,CLE,1999,Shawn Kemp,29,42,42,1475,277,575,.482,1,2,.500,276,573,.482,.483,307,389,.789,131,257,388,101,48,45,127,159,862
7928,CLE,1999,Wesley Person,27,45,42,1342,198,437,.453,75,200,.375,123,237,.519,.539,32,53,.604,19,123,142,80,37,16,41,52,503
7929,CLE,1999,Brevin Knight,23,39,38,1186,134,315,.425,0,5,.000,134,310,.432,.425,105,141,.745,16,115,131,302,70,7,105,115,373
7930,CLE,1999,Danny Ferry,32,50,10,1058,141,296,.476,38,97,.392,103,199,.518,.541,29,33,.879,16,86,102,53,23,10,39,113,349
7931,CLE,1999,Derek Anderson,24,38,13,978,125,314,.398,21,69,.304,104,245,.424,.432,138,165,.836,20,89,109,145,48,4,82,73,409
7932,CLE,1999,Johnny Newman,35,50,2,949,106,251,.422,23,61,.377,83,190,.437,.468,68,84,.810,15,60,75,41,28,12,41,126,303
7933,CLE,1999,Andrew DeClercq,25,33,31,844,110,219,.502,0,0,,110,219,.502,.502,76,112,.679,71,121,192,21,37,20,32,110,296
7934,CLE,1999,Bob Sura,25,50,6,841,70,210,.333,9,45,.200,61,165,.370,.355,65,103,.631,21,81,102,152,46,14,67,98,214
7935,CLE,1999,Vitaly Potapenko,23,17,12,467,55,126,.437,0,1,.000,55,125,.440,.437,33,49,.673,23,71,94,16,11,16,28,53,143
7936,CLE,1999,Mitchell Butler,28,31,1,418,67,139,.482,11,29,.379,56,110,.509,.522,23,32,.719,13,31,44,22,15,4,29,41,168
7937,CLE,1999,Corie Blount,30,20,0,368,23,67,.343,0,0,,23,67,.343,.343,22,42,.524,34,71,105,10,18,12,15,47,68
7938,CLE,1999,Ryan Stack,23,18,0,199,14,37,.378,0,0,,14,37,.378,.378,19,20,.950,19,15,34,5,2,11,9,31,47
7939,CLE,1999,Zydrunas Ilgauskas,23,5,5,171,29,57,.509,0,0,,29,57,.509,.509,18,30,.600,17,27,44,4,4,7,9,24,76
7940,CLE,1999,Earl Boykins,22,17,0,170,20,58,.345,2,13,.154,18,45,.400,.362,2,3,.667,6,7,13,27,5,0,13,17,44
7941,CLE,1999,Antonio Lang,26,10,0,65,4,6,.667,0,0,,4,6,.667,.667,5,9,.556,6,10,16,1,2,1,4,13,13
7942,CLE,1999,Litterial Green,28,1,0,2,0,1,.000,0,0,,0,1,.000,.000,0,0,,0,0,0,0,0,0,0,0,0
7943,CLE,1998,Wesley Person,26,82,82,3198,440,957,.460,192,447,.430,248,510,.486,.560,132,170,.776,65,298,363,188,129,49,110,108,1204
7944,CLE,1998,Shawn Kemp,28,80,80,2769,518,1164,.445,2,8,.250,516,1156,.446,.446,404,556,.727,219,526,745,197,108,90,271,310,1442
7945,CLE,1998,Cedric Henderson,22,82,71,2527,348,725,.480,0,4,.000,348,721,.483,.480,136,190,.716,71,254,325,168,96,45,165,238,832
7946,CLE,1998,Brevin Knight,22,80,76,2483,261,592,.441,0,7,.000,261,585,.446,.441,201,251,.801,67,186,253,656,196,18,194,271,723
7947,CLE,1998,Zydrunas Ilgauskas,22,82,81,2379,454,876,.518,1,4,.250,453,872,.519,.519,230,302,.762,279,444,723,71,52,135,146,288,1139
7948,CLE,1998,Derek Anderson,23,66,13,1839,239,586,.408,17,84,.202,222,502,.442,.422,275,315,.873,55,132,187,227,86,13,128,136,770
7949,CLE,1998,Vitaly Potapenko,22,80,0,1412,234,488,.480,0,1,.000,234,487,.480,.480,102,144,.708,110,203,313,57,27,28,132,198,570
7950,CLE,1998,Danny Ferry,31,69,3,1034,113,286,.395,33,99,.333,80,187,.428,.453,32,40,.800,23,91,114,59,26,17,53,118,291
7951,CLE,1998,Bob Sura,24,46,4,942,87,231,.377,19,60,.317,68,171,.398,.418,74,131,.565,25,69,94,171,44,7,93,113,267
7952,CLE,1998,Scott Brooks,32,43,0,312,28,66,.424,5,11,.455,23,55,.418,.462,18,20,.900,6,24,30,49,18,3,12,25,79
7953,CLE,1998,Carl Thomas,28,29,0,272,27,70,.386,15,38,.395,12,32,.375,.493,8,13,.615,6,31,37,9,16,5,12,27,77
7954,CLE,1998,Mitchell Butler,27,18,0,206,15,47,.319,1,6,.167,14,41,.341,.330,6,10,.600,6,16,22,18,8,0,8,26,37
7955,CLE,1998,Shawnelle Scott,25,41,0,188,16,36,.444,0,0,,16,36,.444,.444,12,18,.667,20,39,59,8,6,8,10,45,44
7956,CLE,1998,Henry James,32,28,0,166,24,59,.407,11,25,.440,13,34,.382,.500,21,22,.955,2,13,15,5,1,1,12,24,80
7957,CLE,1998,Greg Graham,27,6,0,56,7,12,.583,0,3,.000,7,9,.778,.583,2,2,1.000,0,1,1,6,1,0,10,7,16
7958,CLE,1998,Tony Dumas,25,7,0,47,6,12,.500,2,4,.500,4,8,.500,.583,0,3,.000,1,4,5,5,0,0,5,5,14
7959,CLE,1997,Chris Mills,27,80,79,3167,405,894,.453,86,220,.391,319,674,.473,.501,176,209,.842,118,379,497,198,86,41,120,222,1072
7960,CLE,1997,Terrell Brandon,26,78,78,2868,575,1313,.438,101,271,.373,474,1042,.455,.476,268,297,.902,48,253,301,490,138,30,178,177,1519
7961,CLE,1997,Danny Ferry,30,82,48,2633,341,794,.429,114,284,.401,227,510,.445,.501,74,87,.851,82,255,337,151,56,32,94,245,870
7962,CLE,1997,Tyrone Hill,28,74,70,2582,357,595,.600,0,1,.000,357,594,.601,.600,241,381,.633,259,477,736,92,63,30,147,268,955
7963,CLE,1997,Bobby Phills,27,69,65,2375,328,766,.428,85,216,.394,243,550,.442,.484,125,174,.718,63,182,245,233,113,21,135,174,866
7964,CLE,1997,Bob Sura,23,82,23,2269,253,587,.431,53,164,.323,200,423,.473,.476,196,319,.614,76,232,308,390,90,33,181,218,755
7965,CLE,1997,Vitaly Potapenko,21,80,3,1238,186,423,.440,1,2,.500,185,421,.439,.441,92,125,.736,105,112,217,40,26,34,109,216,465
7966,CLE,1997,Mark West,36,70,43,959,100,180,.556,0,0,,100,180,.556,.556,27,56,.482,69,117,186,19,11,55,52,142,227
7967,CLE,1997,Antonio Lang,24,64,1,843,68,162,.420,0,6,.000,68,156,.436,.420,35,48,.729,52,75,127,33,33,30,50,111,171
7968,CLE,1997,Donny Marshall,24,56,0,548,52,160,.325,33,87,.379,19,73,.260,.428,38,54,.704,22,48,70,24,24,3,32,60,175
7969,CLE,1997,Reggie Geary,23,39,0,246,22,58,.379,8,21,.381,14,37,.378,.448,5,11,.455,4,11,15,36,13,2,15,36,57
7970,CLE,1997,Carl Thomas,27,19,0,77,9,24,.375,2,12,.167,7,12,.583,.417,1,1,1.000,3,10,13,8,2,1,6,7,21
7971,CLE,1997,Shawnelle Scott,24,16,0,50,8,16,.500,0,0,,8,16,.500,.500,4,11,.364,8,8,16,0,0,3,0,6,20
7972,CLE,1996,Chris Mills,26,80,80,3060,454,971,.468,79,210,.376,375,761,.493,.508,218,263,.829,112,331,443,188,73,52,121,241,1205
7973,CLE,1996,Danny Ferry,29,82,79,2680,422,919,.459,143,363,.394,279,556,.502,.537,103,134,.769,71,238,309,191,57,37,122,233,1090
7974,CLE,1996,Michael Cage,34,82,80,2631,220,396,.556,0,1,.000,220,395,.557,.556,50,92,.543,288,441,729,53,87,79,54,215,490
7975,CLE,1996,Terrell Brandon,25,75,75,2570,510,1096,.465,91,235,.387,419,861,.487,.507,338,381,.887,47,201,248,487,132,33,142,146,1449
7976,CLE,1996,Bobby Phills,26,72,69,2530,386,826,.467,93,211,.441,293,615,.476,.524,186,240,.775,62,199,261,271,102,27,126,192,1051
7977,CLE,1996,Dan Majerle,30,82,15,2367,303,748,.405,146,414,.353,157,334,.470,.503,120,169,.710,70,235,305,214,81,34,93,131,872
7978,CLE,1996,Bob Sura,22,79,3,1150,148,360,.411,27,78,.346,121,282,.429,.449,99,141,.702,34,101,135,233,56,21,115,126,422
7979,CLE,1996,Tyrone Hill,27,44,2,929,130,254,.512,0,0,,130,254,.512,.512,81,135,.600,94,150,244,33,31,20,64,144,341
7980,CLE,1996,John Crotty,26,58,4,617,51,114,.447,8,27,.296,43,87,.494,.482,62,72,.861,20,34,54,102,22,6,51,60,172
7981,CLE,1996,Antonio Lang,23,41,0,367,41,77,.532,0,2,.000,41,75,.547,.532,34,47,.723,17,36,53,12,14,12,24,61,116
7982,CLE,1996,John Amaechi,25,28,3,357,29,70,.414,0,0,,29,70,.414,.414,19,33,.576,13,39,52,9,6,11,34,49,77
7983,CLE,1996,Donny Marshall,23,34,0,208,24,68,.353,7,30,.233,17,38,.447,.404,22,35,.629,9,17,26,7,8,2,7,26,77
7984,CLE,1996,Joe Courtney,26,23,0,200,15,35,.429,0,0,,15,35,.429,.429,8,18,.444,24,25,49,9,5,6,17,35,38
7985,CLE,1996,Harold Miner,24,19,0,136,23,52,.442,2,10,.200,21,42,.500,.462,13,13,1.000,4,8,12,8,0,0,14,23,61
7986,CLE,1996,Darryl Johnson,30,11,0,28,5,12,.417,0,1,.000,5,11,.455,.417,2,2,1.000,2,0,2,1,0,0,1,3,12
7987,CLE,1995,Chris Mills,25,80,79,2814,359,855,.420,94,240,.392,265,615,.431,.475,174,213,.817,99,267,366,154,59,35,120,242,986
7988,CLE,1995,Hot Rod Williams,32,74,73,2641,366,810,.452,1,5,.200,365,805,.453,.452,196,286,.685,173,334,507,192,83,101,149,211,929
7989,CLE,1995,Bobby Phills,25,80,79,2500,338,816,.414,19,55,.345,319,761,.419,.426,183,235,.779,90,175,265,180,115,25,113,206,878
7990,CLE,1995,Tyrone Hill,26,70,67,2397,350,694,.504,0,1,.000,350,693,.505,.504,263,397,.662,269,496,765,55,55,41,151,245,963
7991,CLE,1995,Michael Cage,33,82,21,2040,177,340,.521,0,2,.000,177,338,.524,.521,53,88,.602,203,361,564,56,61,67,56,149,407
7992,CLE,1995,Terrell Brandon,24,67,41,1961,341,762,.448,48,121,.397,293,641,.457,.479,159,186,.855,35,151,186,363,107,14,144,118,889
7993,CLE,1995,Mark Price,30,48,34,1375,253,612,.413,103,253,.407,150,359,.418,.498,148,162,.914,25,87,112,335,35,4,142,50,757
7994,CLE,1995,Danny Ferry,28,82,6,1290,223,500,.446,94,233,.403,129,267,.483,.540,74,84,.881,30,113,143,96,27,22,59,131,614
7995,CLE,1995,Tony Campbell,32,78,0,1128,161,392,.411,15,42,.357,146,350,.417,.430,132,159,.830,60,93,153,69,32,8,65,122,469
7996,CLE,1995,Steve Colter,32,57,7,752,67,169,.396,8,35,.229,59,134,.440,.420,54,71,.761,13,46,59,101,30,6,36,53,196
7997,CLE,1995,Greg Dreiling,32,58,3,483,42,102,.412,0,0,,42,102,.412,.412,26,41,.634,32,84,116,22,6,22,25,108,110
7998,CLE,1995,John Battle,32,28,0,280,43,114,.377,11,31,.355,32,83,.386,.425,19,26,.731,3,8,11,37,8,1,17,28,116
7999,CLE,1995,Fred Roberts,34,21,0,223,28,72,.389,4,11,.364,24,61,.393,.417,20,26,.769,13,21,34,8,6,3,7,26,80
8000,CLE,1995,Gerald Madkins,25,7,0,28,2,6,.333,1,2,.500,1,4,.250,.417,3,4,.750,0,0,0,1,2,0,3,2,8
8001,CLE,1995,Elmer Bennett,24,4,0,18,6,11,.545,0,2,.000,6,9,.667,.545,3,4,.750,0,1,1,3,4,0,3,3,15
8002,CLE,1994,Gerald Wilkins,30,82,82,2768,446,975,.457,84,212,.396,362,763,.474,.501,194,250,.776,106,197,303,255,105,38,131,186,1170
8003,CLE,1994,Hot Rod Williams,31,76,72,2660,394,825,.478,0,0,,394,825,.478,.478,252,346,.728,207,368,575,193,78,130,139,219,1040
8004,CLE,1994,Mark Price,29,76,73,2386,480,1005,.478,118,297,.397,362,708,.511,.536,238,268,.888,39,189,228,589,103,11,189,93,1316
8005,CLE,1994,Chris Mills,24,79,18,2022,284,677,.419,38,122,.311,246,555,.443,.448,137,176,.778,134,267,401,128,54,50,89,232,743
8006,CLE,1994,Brad Daugherty,28,50,50,1838,296,606,.488,0,0,,296,606,.488,.488,256,326,.785,128,380,508,149,41,36,110,145,848
8007,CLE,1994,Terrell Brandon,23,73,10,1548,230,548,.420,7,32,.219,223,516,.432,.426,139,162,.858,38,121,159,277,84,16,111,108,606
8008,CLE,1994,Bobby Phills,24,72,53,1531,242,514,.471,1,12,.083,241,502,.480,.472,113,157,.720,71,141,212,133,67,12,63,135,598
8009,CLE,1994,Tyrone Hill,25,57,20,1447,216,398,.543,0,2,.000,216,396,.545,.543,171,256,.668,184,315,499,46,53,35,78,193,603
8010,CLE,1994,Danny Ferry,27,70,1,965,149,334,.446,14,51,.275,135,283,.477,.467,38,43,.884,47,94,141,74,28,22,41,113,350
8011,CLE,1994,Larry Nance,34,33,19,909,153,314,.487,0,0,,153,314,.487,.487,64,85,.753,77,150,227,49,27,55,38,96,370
8012,CLE,1994,John Battle,31,51,1,814,130,273,.476,5,19,.263,125,254,.492,.485,73,97,.753,7,32,39,83,22,1,41,66,338
8013,CLE,1994,Rod Higgins,34,36,11,547,71,163,.436,22,50,.440,49,113,.434,.503,31,42,.738,25,57,82,36,25,14,21,53,195
8014,CLE,1994,Gerald Madkins,24,22,0,149,11,31,.355,5,15,.333,6,16,.375,.435,8,10,.800,1,10,11,19,9,0,13,16,35
8015,CLE,1994,Jay Guidinger,24,32,0,131,16,32,.500,0,0,,16,32,.500,.500,15,21,.714,15,18,33,3,4,5,16,23,47
8016,CLE,1994,Sedric Toney,31,12,0,64,2,12,.167,0,1,.000,2,11,.182,.167,2,2,1.000,1,2,3,11,0,0,5,8,6
8017,CLE,1994,Gary Alexander,24,7,0,43,7,12,.583,0,0,,7,12,.583,.583,3,7,.429,6,6,12,1,3,0,7,7,17
8018,CLE,1994,Tim Kempton,30,4,0,33,6,12,.500,0,0,,6,12,.500,.500,2,6,.333,4,6,10,3,2,1,7,8,14
8019,CLE,1993,Larry Nance,33,77,77,2753,533,971,.549,0,4,.000,533,967,.551,.549,202,247,.818,184,484,668,223,54,198,107,223,1268
8020,CLE,1993,Brad Daugherty,27,71,71,2691,520,911,.571,1,2,.500,519,909,.571,.571,391,492,.795,164,562,726,312,53,56,150,174,1432
8021,CLE,1993,Craig Ehlo,31,82,73,2559,385,785,.490,93,244,.381,292,541,.540,.550,86,120,.717,113,290,403,254,104,22,124,170,949
8022,CLE,1993,Mark Price,28,75,74,2380,477,986,.484,122,293,.416,355,693,.512,.546,289,305,.948,37,164,201,602,89,11,196,105,1365
8023,CLE,1993,Gerald Wilkins,29,80,35,2079,361,797,.453,16,58,.276,345,739,.467,.463,152,181,.840,74,140,214,183,78,18,94,154,890
8024,CLE,1993,Hot Rod Williams,30,67,13,2055,263,560,.470,0,0,,263,560,.470,.470,212,296,.716,127,288,415,152,48,105,116,171,738
8025,CLE,1993,Terrell Brandon,22,82,8,1622,297,621,.478,13,42,.310,284,579,.491,.489,118,143,.825,37,142,179,302,79,27,107,122,725
8026,CLE,1993,Danny Ferry,26,76,1,1461,220,459,.479,34,82,.415,186,377,.493,.516,99,113,.876,81,198,279,137,29,49,83,171,573
8027,CLE,1993,Mike Sanders,32,53,51,1189,197,396,.497,1,4,.250,196,392,.500,.499,59,78,.756,52,118,170,75,39,30,57,150,454
8028,CLE,1993,John Battle,30,41,0,497,83,200,.415,1,6,.167,82,194,.423,.418,56,72,.778,4,25,29,54,9,5,22,39,223
8029,CLE,1993,Jay Guidinger,23,32,5,215,19,55,.345,0,0,,19,55,.345,.345,13,25,.520,26,38,64,17,9,10,10,48,51
8030,CLE,1993,Jerome Lane,26,21,2,149,27,54,.500,0,0,,27,54,.500,.500,5,20,.250,24,29,53,17,12,3,7,32,59
8031,CLE,1993,Bobby Phills,23,31,0,139,38,82,.463,2,5,.400,36,77,.468,.476,15,25,.600,6,11,17,10,10,2,18,19,93
8032,CLE,1993,Steve Kerr,27,5,0,41,5,10,.500,0,2,.000,5,8,.625,.500,2,2,1.000,0,7,7,11,2,0,2,2,12
8033,CLE,1992,Larry Nance,32,81,81,2880,556,1032,.539,0,6,.000,556,1026,.542,.539,263,320,.822,213,457,670,232,80,243,87,200,1375
8034,CLE,1992,Brad Daugherty,26,73,73,2643,576,1010,.570,0,2,.000,576,1008,.571,.570,414,533,.777,191,569,760,262,65,78,185,190,1566
8035,CLE,1992,Hot Rod Williams,29,80,12,2432,341,678,.503,0,4,.000,341,674,.506,.503,270,359,.752,228,379,607,196,60,182,83,191,952
8036,CLE,1992,Mark Price,27,72,72,2138,438,897,.488,101,261,.387,337,636,.530,.545,270,285,.947,38,135,173,535,94,12,159,113,1247
8037,CLE,1992,Craig Ehlo,30,63,62,2016,310,684,.453,69,167,.413,241,517,.466,.504,87,123,.707,94,213,307,238,78,22,104,150,776
8038,CLE,1992,John Battle,29,76,2,1637,316,659,.480,2,17,.118,314,642,.489,.481,145,171,.848,19,93,112,159,36,5,91,116,779
8039,CLE,1992,Terrell Brandon,21,82,9,1605,252,601,.419,1,23,.043,251,578,.434,.420,100,124,.806,49,113,162,316,81,22,136,107,605
8040,CLE,1992,Danny Ferry,25,68,1,937,134,328,.409,17,48,.354,117,280,.418,.434,61,73,.836,53,160,213,75,22,15,46,135,346
8041,CLE,1992,Henry James,26,65,5,866,164,403,.407,29,90,.322,135,313,.431,.443,61,76,.803,35,77,112,25,16,11,43,94,418
8042,CLE,1992,Steve Kerr,26,48,20,847,121,237,.511,32,74,.432,89,163,.546,.578,45,54,.833,14,64,78,110,27,10,31,29,319
8043,CLE,1992,Winston Bennett,26,52,45,831,79,209,.378,0,1,.000,79,208,.380,.378,35,50,.700,62,99,161,38,19,9,33,121,193
8044,CLE,1992,Mike Sanders,31,21,20,552,81,139,.583,1,3,.333,80,136,.588,.586,31,41,.756,27,61,88,42,22,9,16,75,194
8045,CLE,1992,Jimmy Oliver,22,27,8,252,39,98,.398,1,9,.111,38,89,.427,.403,17,22,.773,9,18,27,20,9,2,9,22,96
8046,CLE,1992,Bobby Phills,22,10,0,65,12,28,.429,0,2,.000,12,26,.462,.429,7,11,.636,4,4,8,4,3,1,8,3,31
8047,CLE,1992,John Morton,24,4,0,54,3,12,.250,0,1,.000,3,11,.273,.250,8,9,.889,3,4,7,5,1,0,4,3,14
8048,CLE,1992,Chucky Brown,23,6,0,50,5,10,.500,0,0,,5,10,.500,.500,5,8,.625,2,4,6,3,3,0,2,7,15
8049,CLE,1991,Brad Daugherty,25,76,76,2946,605,1155,.524,0,3,.000,605,1152,.525,.524,435,579,.751,177,653,830,253,74,46,211,191,1645
8050,CLE,1991,Larry Nance,31,80,78,2927,635,1211,.524,2,8,.250,633,1203,.526,.525,265,330,.803,201,485,686,237,66,200,131,219,1537
8051,CLE,1991,Craig Ehlo,29,82,68,2766,344,773,.445,49,149,.329,295,624,.473,.477,95,140,.679,142,246,388,376,121,34,160,209,832
8052,CLE,1991,Darnell Valentine,31,65,60,1841,230,496,.464,6,25,.240,224,471,.476,.470,143,172,.831,37,135,172,351,98,12,126,170,609
8053,CLE,1991,Danny Ferry,24,81,2,1661,275,643,.428,23,77,.299,252,566,.445,.446,124,152,.816,99,187,286,142,43,25,120,230,697
8054,CLE,1991,Chucky Brown,22,74,51,1485,263,502,.524,0,4,.000,263,498,.528,.524,101,144,.701,78,135,213,80,26,24,94,130,627
8055,CLE,1991,Hot Rod Williams,28,43,14,1293,199,430,.463,0,1,.000,199,429,.464,.463,107,164,.652,111,179,290,100,36,69,63,126,505
8056,CLE,1991,John Morton,23,66,2,1207,120,274,.438,4,12,.333,116,262,.443,.445,113,139,.813,41,62,103,243,61,18,107,112,357
8057,CLE,1991,Gerald Paddio,25,70,22,1181,212,506,.419,6,24,.250,206,482,.427,.425,74,93,.796,38,80,118,90,20,6,71,71,504
8058,CLE,1991,Steve Kerr,25,57,4,905,99,223,.444,28,62,.452,71,161,.441,.507,45,53,.849,5,32,37,131,29,4,40,52,271
8059,CLE,1991,Mark Price,26,16,16,571,97,195,.497,18,53,.340,79,142,.556,.544,59,62,.952,8,37,45,166,42,2,56,23,271
8060,CLE,1991,Henry James,25,37,4,505,112,254,.441,24,60,.400,88,194,.454,.488,52,72,.722,26,53,79,32,15,5,37,59,300
8061,CLE,1991,Winston Bennett,25,27,13,334,40,107,.374,0,0,,40,107,.374,.374,35,47,.745,30,34,64,28,8,2,20,50,115
8062,CLE,1991,Derrick Chievous,23,18,0,110,17,46,.370,0,0,,17,46,.370,.370,9,16,.563,11,7,18,2,3,1,6,16,43
8063,CLE,1991,Miloš Babić,22,12,0,52,6,19,.316,0,0,,6,19,.316,.316,7,12,.583,6,3,9,4,1,1,5,7,19
8064,CLE,1991,Mike Woodson,32,4,0,46,5,23,.217,0,1,.000,5,22,.227,.217,1,1,1.000,1,1,2,5,0,1,5,7,11
8065,CLE,1990,Craig Ehlo,28,81,64,2894,436,940,.464,104,248,.419,332,692,.480,.519,126,185,.681,147,292,439,371,126,23,161,226,1102
8066,CLE,1990,Hot Rod Williams,27,82,29,2776,528,1070,.493,0,0,,528,1070,.493,.493,325,440,.739,220,443,663,168,86,167,143,214,1381
8067,CLE,1990,Mark Price,25,73,73,2706,489,1066,.459,152,374,.406,337,692,.487,.530,300,338,.888,66,185,251,666,114,5,214,89,1430
8068,CLE,1990,Larry Nance,30,62,53,2065,412,807,.511,1,1,1.000,411,806,.510,.511,186,239,.778,162,354,516,161,54,122,110,185,1011
8069,CLE,1990,Steve Kerr,24,78,5,1664,192,432,.444,73,144,.507,119,288,.413,.529,63,73,.863,12,86,98,248,45,7,74,59,520
8070,CLE,1990,Brad Daugherty,24,41,40,1438,244,509,.479,0,2,.000,244,507,.481,.479,202,287,.704,77,296,373,130,29,22,110,108,690
8071,CLE,1990,Chucky Brown,21,75,35,1339,210,447,.470,0,7,.000,210,440,.477,.470,125,164,.762,83,148,231,50,33,26,69,148,545
8072,CLE,1990,Winston Bennett,24,55,34,990,137,286,.479,0,0,,137,286,.479,.479,64,96,.667,84,104,188,54,23,10,62,133,338
8073,CLE,1990,Randolph Keys,23,48,13,892,151,359,.421,2,10,.200,149,349,.427,.423,61,82,.744,52,85,137,39,38,2,47,117,365
8074,CLE,1990,Chris Dudley,24,37,22,684,79,203,.389,0,0,,79,203,.389,.389,26,77,.338,88,115,203,20,19,41,48,83,184
8075,CLE,1990,Tree Rollins,34,48,19,674,57,125,.456,0,1,.000,57,124,.460,.456,11,16,.688,58,95,153,24,13,53,35,83,125
8076,CLE,1990,Reggie Williams,25,32,12,542,91,239,.381,6,27,.222,85,212,.401,.393,30,41,.732,17,43,60,38,22,10,32,79,218
8077,CLE,1990,Paul Mokeski,33,38,1,449,63,150,.420,0,1,.000,63,149,.423,.420,25,36,.694,27,72,99,17,8,10,26,76,151
8078,CLE,1990,John Morton,22,37,3,402,48,161,.298,7,30,.233,41,131,.313,.320,43,62,.694,7,25,32,67,18,4,51,30,146
8079,CLE,1990,Ron Harper,26,7,7,262,61,138,.442,1,5,.200,60,133,.451,.446,31,41,.756,19,29,48,49,14,9,18,25,154
8080,CLE,1990,Derrick Chievous,22,14,0,99,15,42,.357,0,1,.000,15,41,.366,.357,19,24,.792,7,8,15,4,3,1,5,11,49
8081,CLE,1990,Gary Voce,24,1,0,4,1,3,.333,0,0,,1,3,.333,.333,0,0,,2,0,2,0,0,0,0,0,2
8082,CLE,1989,Ron Harper,25,82,82,2851,587,1149,.511,29,116,.250,558,1033,.540,.523,323,430,.751,122,287,409,434,185,74,230,224,1526
8083,CLE,1989,Brad Daugherty,23,78,78,2821,544,1012,.538,1,3,.333,543,1009,.538,.538,386,524,.737,167,551,718,285,63,40,230,175,1475
8084,CLE,1989,Mark Price,24,75,74,2728,529,1006,.526,93,211,.441,436,795,.548,.572,263,292,.901,48,178,226,631,115,7,212,98,1414
8085,CLE,1989,Larry Nance,29,73,72,2526,496,920,.539,0,4,.000,496,916,.541,.539,267,334,.799,156,425,581,159,57,206,117,186,1259
8086,CLE,1989,Hot Rod Williams,26,82,10,2125,356,700,.509,1,4,.250,355,696,.510,.509,235,314,.748,173,304,477,108,77,134,102,188,948
8087,CLE,1989,Mike Sanders,28,82,82,2102,332,733,.453,3,10,.300,329,723,.455,.455,97,135,.719,98,209,307,133,89,32,104,230,764
8088,CLE,1989,Craig Ehlo,27,82,4,1867,249,524,.475,39,100,.390,210,424,.495,.512,71,117,.607,100,195,295,266,110,19,116,161,608
8089,CLE,1989,Darnell Valentine,29,77,4,1086,136,319,.426,3,14,.214,133,305,.436,.431,91,112,.813,22,81,103,174,57,7,83,88,366
8090,CLE,1989,Tree Rollins,33,60,2,583,62,138,.449,0,1,.000,62,137,.453,.449,12,19,.632,38,101,139,19,11,38,22,89,136
8091,CLE,1989,Chris Dudley,23,61,2,544,73,168,.435,0,1,.000,73,167,.437,.435,39,107,.364,72,85,157,21,9,23,44,82,185
8092,CLE,1989,Randolph Keys,22,42,0,331,74,172,.430,1,10,.100,73,162,.451,.433,20,29,.690,23,33,56,19,12,6,21,51,169
8093,CLE,1989,Phil Hubbard,32,31,0,191,28,63,.444,0,0,,28,63,.444,.444,17,25,.680,14,26,40,11,6,0,9,20,73
8094,CLE,1988,Brad Daugherty,22,79,78,2957,551,1081,.510,0,2,.000,551,1079,.511,.510,378,528,.716,151,514,665,333,48,56,267,235,1480
8095,CLE,1988,Mark Price,23,80,79,2626,493,974,.506,72,148,.486,421,826,.510,.543,221,252,.877,54,126,180,480,99,12,184,119,1279
8096,CLE,1988,Hot Rod Williams,25,77,50,2106,316,663,.477,0,1,.000,316,662,.477,.477,211,279,.756,159,347,506,103,61,145,104,203,843
8097,CLE,1988,Ron Harper,24,57,52,1830,340,732,.464,3,20,.150,337,712,.473,.467,196,278,.705,64,159,223,281,122,52,158,157,879
8098,CLE,1988,Craig Ehlo,26,79,27,1709,226,485,.466,22,64,.344,204,421,.485,.489,89,132,.674,86,188,274,206,82,30,107,182,563
8099,CLE,1988,Phil Hubbard,31,78,59,1631,237,485,.489,0,5,.000,237,480,.494,.489,182,243,.749,117,164,281,81,50,7,118,167,656
8100,CLE,1988,Dell Curry,23,79,8,1499,340,742,.458,28,81,.346,312,661,.472,.477,79,101,.782,43,123,166,149,94,22,108,128,787
8101,CLE,1988,Mark West,27,54,12,1183,182,316,.576,0,0,,182,316,.576,.576,95,153,.621,83,198,281,50,25,79,91,158,459
8102,CLE,1988,Tyrone Corbin,25,54,4,1148,158,322,.491,0,3,.000,158,319,.495,.491,77,98,.786,79,141,220,56,42,15,66,128,393
8103,CLE,1988,Kevin Johnson,21,52,3,1043,143,311,.460,2,9,.222,141,302,.467,.463,92,112,.821,10,62,72,193,60,17,82,96,380
8104,CLE,1988,Larry Nance,28,27,26,906,160,304,.526,0,1,.000,160,303,.528,.526,117,141,.830,74,139,213,84,18,63,49,90,437
8105,CLE,1988,Chris Dudley,22,55,1,513,65,137,.474,0,0,,65,137,.474,.474,40,71,.563,74,70,144,23,13,19,31,87,170
8106,CLE,1988,Mike Sanders,27,24,11,417,71,132,.538,0,0,,71,132,.538,.538,20,23,.870,10,37,47,26,13,5,23,58,162
8107,CLE,1988,Johnny Rogers,24,24,0,168,26,61,.426,0,2,.000,26,59,.441,.426,10,13,.769,8,19,27,3,4,3,10,23,62
8108,CLE,1988,Kevin Henderson,23,5,0,20,2,5,.400,0,0,,2,5,.400,.400,5,12,.417,3,1,4,2,0,0,2,2,9
8109,CLE,1988,Kent Benson,33,2,0,12,2,2,1.000,0,0,,2,2,1.000,1.000,1,2,.500,0,1,1,0,1,1,2,2,5
8110,CLE,1988,Kannard Johnson,22,4,0,12,1,3,.333,0,0,,1,3,.333,.333,0,0,,0,0,0,0,1,0,2,1,2
8111,CLE,1987,Ron Harper,23,82,82,3064,734,1614,.455,20,94,.213,714,1520,.470,.461,386,564,.684,169,223,392,394,209,84,345,247,1874
8112,CLE,1987,Hot Rod Williams,24,80,80,2714,435,897,.485,0,1,.000,435,896,.485,.485,298,400,.745,222,407,629,154,58,167,139,197,1168
8113,CLE,1987,Brad Daugherty,21,80,80,2695,487,905,.538,0,0,,487,905,.538,.538,279,401,.696,152,495,647,304,49,63,248,248,1253
8114,CLE,1987,John Bagley,26,72,67,2182,312,732,.426,31,103,.301,281,629,.447,.447,113,136,.831,55,197,252,379,91,7,163,114,768
8115,CLE,1987,Phil Hubbard,30,68,68,2083,321,605,.531,0,4,.000,321,601,.534,.531,162,272,.596,178,210,388,136,66,7,156,224,804
8116,CLE,1987,Mark West,26,78,13,1333,209,385,.543,0,2,.000,209,383,.546,.543,89,173,.514,126,213,339,41,22,81,106,229,507
8117,CLE,1987,Mark Price,22,67,0,1217,173,424,.408,23,70,.329,150,354,.424,.435,95,114,.833,33,84,117,202,43,4,105,75,464
8118,CLE,1987,Craig Ehlo,25,44,15,890,99,239,.414,5,29,.172,94,210,.448,.425,70,99,.707,55,106,161,92,40,30,61,80,273
8119,CLE,1987,Keith Lee,24,67,1,870,170,374,.455,0,1,.000,170,373,.456,.455,72,101,.713,93,158,251,69,25,40,85,147,412
8120,CLE,1987,Melvin Turpin,26,64,1,801,169,366,.462,0,0,,169,366,.462,.462,55,77,.714,62,128,190,33,11,40,63,90,393
8121,CLE,1987,Johnny Newman,23,59,0,630,113,275,.411,1,22,.045,112,253,.443,.413,66,76,.868,36,34,70,27,20,7,46,67,293
8122,CLE,1987,Tyrone Corbin,24,32,0,438,43,117,.368,1,4,.250,42,113,.372,.372,42,57,.737,36,60,96,17,17,2,20,48,129
8123,CLE,1987,Ben Poquette,31,37,1,437,41,82,.500,0,3,.000,41,79,.519,.500,31,39,.795,20,57,77,28,6,22,17,51,113
8124,CLE,1987,Scooter McCray,26,24,2,279,30,65,.462,0,0,,30,65,.462,.462,20,41,.488,19,39,58,23,9,4,24,28,80
8125,CLE,1987,Dirk Minniefield,26,11,0,122,13,42,.310,0,5,.000,13,37,.351,.310,1,4,.250,1,9,10,13,6,1,12,8,27
8126,CLE,1986,Roy Hinson,24,82,82,2834,621,1167,.532,0,4,.000,621,1163,.534,.532,364,506,.719,167,472,639,102,62,112,188,316,1606
8127,CLE,1986,World B. Free,32,75,75,2535,652,1433,.455,71,169,.420,581,1264,.460,.480,379,486,.780,72,146,218,314,91,19,172,186,1754
8128,CLE,1986,John Bagley,25,78,77,2472,366,865,.423,9,37,.243,357,828,.431,.428,170,215,.791,76,199,275,735,122,10,239,165,911
8129,CLE,1986,Melvin Turpin,25,80,69,2292,456,838,.544,0,4,.000,456,834,.547,.544,185,228,.811,182,374,556,55,65,106,134,260,1097
8130,CLE,1986,Ben Poquette,30,81,3,1496,166,348,.477,2,10,.200,164,338,.485,.480,72,100,.720,121,252,373,78,33,32,68,187,406
8131,CLE,1986,Keith Lee,23,58,38,1197,177,380,.466,2,9,.222,175,371,.472,.468,75,96,.781,116,235,351,67,29,37,78,204,431
8132,CLE,1986,Mark West,25,67,26,1172,113,209,.541,0,0,,113,209,.541,.541,54,103,.524,97,225,322,20,27,62,91,235,280
8133,CLE,1986,Dirk Minniefield,25,76,2,1131,167,347,.481,10,37,.270,157,310,.506,.496,73,93,.785,43,88,131,269,65,1,108,165,417
8134,CLE,1986,Edgar Jones,29,53,6,1011,187,370,.505,7,23,.304,180,347,.519,.515,132,178,.742,71,136,207,45,30,38,64,142,513
8135,CLE,1986,Lonnie Shelton,30,44,1,682,92,188,.489,0,2,.000,92,186,.495,.489,14,16,.875,38,105,143,61,21,4,48,128,198
8136,CLE,1986,Phil Hubbard,29,23,21,640,93,198,.470,0,1,.000,93,197,.472,.470,76,112,.679,48,72,120,29,20,3,66,78,262
8137,CLE,1986,Eddie Johnson,30,32,4,615,129,293,.440,24,65,.369,105,228,.461,.481,33,45,.733,13,33,46,114,8,1,60,56,315
8138,CLE,1986,Johnny Davis,30,39,0,612,102,237,.430,2,11,.182,100,226,.442,.435,67,79,.848,6,30,36,105,24,4,40,44,273
8139,CLE,1986,Ron Brewer,30,40,3,552,83,215,.386,5,17,.294,78,198,.394,.398,33,37,.892,14,39,53,40,17,6,21,43,204
8140,CLE,1986,Ben McDonald,23,21,0,266,28,58,.483,0,1,.000,28,57,.491,.483,5,8,.625,15,23,38,9,7,1,10,30,61
8141,CLE,1986,Ron Anderson,27,17,3,207,37,74,.500,0,1,.000,37,73,.507,.500,12,16,.750,5,21,26,8,1,0,6,20,86
8142,CLE,1986,Ennis Whatley,23,8,0,66,9,19,.474,0,0,,9,19,.474,.474,4,7,.571,2,5,7,13,5,0,6,8,22
8143,CLE,1985,John Bagley,24,81,65,2401,338,693,.488,3,26,.115,335,667,.502,.490,125,167,.749,54,237,291,697,129,5,207,132,804
8144,CLE,1985,Roy Hinson,23,76,75,2344,465,925,.503,0,3,.000,465,922,.504,.503,271,376,.721,186,410,596,68,51,173,171,311,1201
8145,CLE,1985,World B. Free,31,71,50,2249,609,1328,.459,71,193,.368,538,1135,.474,.485,308,411,.749,61,150,211,320,75,16,139,163,1597
8146,CLE,1985,Phil Hubbard,28,76,55,2249,415,822,.505,0,4,.000,415,818,.507,.505,371,494,.751,214,265,479,114,81,9,178,258,1201
8147,CLE,1985,Melvin Turpin,24,79,45,1949,363,711,.511,0,0,,363,711,.511,.511,109,139,.784,155,297,452,36,38,87,118,211,835
8148,CLE,1985,Johnny Davis,29,76,30,1920,337,791,.426,12,46,.261,325,745,.436,.434,255,300,.850,35,84,119,426,43,4,152,136,941
8149,CLE,1985,Ben Poquette,29,79,6,1656,210,457,.460,3,17,.176,207,440,.470,.463,109,137,.796,148,325,473,79,47,58,70,220,532
8150,CLE,1985,Lonnie Shelton,29,57,14,1244,158,363,.435,0,5,.000,158,358,.441,.435,51,77,.662,82,185,267,96,44,18,74,187,367
8151,CLE,1985,Mark West,24,65,25,882,106,193,.549,0,1,.000,106,192,.552,.549,41,85,.482,89,161,250,15,13,48,57,193,253
8152,CLE,1985,Paul Thompson,23,33,27,715,148,354,.418,6,23,.261,142,331,.429,.427,45,53,.849,36,80,116,58,41,20,42,77,347
8153,CLE,1985,Ron Anderson,26,36,7,520,84,195,.431,1,2,.500,83,193,.430,.433,41,50,.820,39,49,88,34,9,7,34,40,210
8154,CLE,1985,Edgar Jones,28,26,4,447,86,184,.467,0,3,.000,86,181,.475,.467,41,60,.683,34,75,109,11,11,11,33,71,213
8155,CLE,1985,Jeff Cook,28,18,3,440,46,105,.438,0,1,.000,46,104,.442,.438,17,27,.630,41,63,104,23,5,9,16,53,109
8156,CLE,1985,Kevin Williams,23,46,4,413,58,134,.433,0,5,.000,58,129,.450,.433,47,64,.734,19,44,63,61,22,4,49,86,163
8157,CLE,1985,Michael Wilson,25,11,0,175,27,54,.500,0,0,,27,54,.500,.500,23,30,.767,10,8,18,24,10,3,15,14,77
8158,CLE,1985,Geoff Huston,27,8,0,93,12,25,.480,0,0,,12,25,.480,.480,2,3,.667,0,1,1,23,0,0,8,8,26
8159,CLE,1985,Robert Smith,29,7,0,48,4,17,.235,0,4,.000,4,13,.308,.235,8,10,.800,0,4,4,7,2,0,3,6,16
8160,CLE,1985,Campy Russell,33,3,0,24,2,7,.286,0,1,.000,2,6,.333,.286,2,3,.667,0,5,5,3,0,0,5,3,6
8161,CLE,1985,Butch Graves,23,4,0,11,2,6,.333,0,1,.000,2,5,.400,.333,1,5,.200,0,2,2,1,1,0,1,4,5
8162,CLE,1984,Cliff Robinson,23,73,70,2402,533,1185,.450,1,2,.500,532,1183,.450,.450,234,334,.701,156,597,753,185,51,32,187,195,1301
8163,CLE,1984,World B. Free,30,75,71,2375,626,1407,.445,22,69,.319,604,1338,.451,.453,395,504,.784,89,128,217,226,94,8,154,214,1669
8164,CLE,1984,Lonnie Shelton,28,79,78,2101,371,779,.476,1,5,.200,370,774,.478,.477,107,140,.764,140,241,381,179,76,55,165,279,850
8165,CLE,1984,Geoff Huston,26,77,56,2041,348,699,.498,2,11,.182,346,688,.503,.499,110,154,.714,32,64,96,413,38,1,145,126,808
8166,CLE,1984,Jeff Cook,27,81,21,1950,188,387,.486,1,2,.500,187,385,.486,.487,94,130,.723,174,310,484,123,68,47,91,282,471
8167,CLE,1984,Roy Hinson,22,80,61,1858,184,371,.496,0,0,,184,371,.496,.496,69,117,.590,175,324,499,69,31,145,109,306,437
8168,CLE,1984,Phil Hubbard,27,80,6,1799,321,628,.511,0,1,.000,321,627,.512,.511,221,299,.739,172,208,380,86,71,6,115,244,863
8169,CLE,1984,Paul Thompson,22,82,10,1731,309,662,.467,9,39,.231,300,623,.482,.474,115,149,.772,120,192,312,122,70,37,73,192,742
8170,CLE,1984,John Bagley,23,76,19,1712,257,607,.423,2,17,.118,255,590,.432,.425,157,198,.793,49,107,156,333,78,4,170,113,673
8171,CLE,1984,Ben Poquette,28,51,4,858,75,171,.439,1,5,.200,74,166,.446,.442,34,43,.791,57,125,182,49,20,33,28,114,185
8172,CLE,1984,Stewart Granger,22,56,13,738,97,226,.429,4,13,.308,93,213,.437,.438,53,70,.757,8,47,55,134,24,0,57,97,251
8173,CLE,1984,John Garris,24,33,1,267,52,102,.510,0,0,,52,102,.510,.510,27,34,.794,35,42,77,10,8,6,11,40,131
8174,CLE,1984,Geoff Crompton,28,7,0,23,1,8,.125,0,0,,1,8,.125,.125,3,6,.500,6,3,9,1,1,1,4,4,5
8175,CLE,1983,Geoff Huston,25,80,79,2716,401,832,.482,4,12,.333,397,820,.484,.484,168,245,.686,41,118,159,487,74,4,195,215,974
8176,CLE,1983,Cliff Robinson,22,77,75,2601,587,1230,.477,0,5,.000,587,1225,.479,.477,213,301,.708,190,666,856,145,61,58,224,272,1387
8177,CLE,1983,Phil Hubbard,26,82,38,1953,288,597,.482,0,2,.000,288,595,.484,.482,204,296,.689,222,249,471,89,87,8,158,271,780
8178,CLE,1983,World B. Free,29,54,51,1938,485,1059,.458,15,42,.357,470,1017,.462,.465,324,434,.747,70,87,157,201,82,12,159,175,1309
8179,CLE,1983,Bob Wilkerson,28,77,11,1702,213,511,.417,0,4,.000,213,507,.420,.417,93,124,.750,62,180,242,189,68,16,160,157,519
8180,CLE,1983,Scott Wedman,30,35,35,1290,280,583,.480,9,22,.409,271,561,.483,.488,65,77,.844,69,139,208,86,23,11,94,145,634
8181,CLE,1983,Sam Lacey,34,60,33,1232,111,264,.420,2,9,.222,109,255,.427,.424,29,37,.784,62,169,231,118,29,25,98,209,253
8182,CLE,1983,Steve Hayes,27,65,3,1058,104,217,.479,0,1,.000,104,216,.481,.479,29,51,.569,102,134,236,36,17,41,49,215,237
8183,CLE,1983,John Bagley,22,68,3,990,161,373,.432,0,14,.000,161,359,.448,.432,64,84,.762,17,79,96,167,54,5,118,74,386
8184,CLE,1983,Jeff Cook,26,30,20,782,87,162,.537,0,1,.000,87,161,.540,.537,38,50,.760,75,131,206,44,27,18,49,92,212
8185,CLE,1983,Bruce Flowers,25,53,5,699,110,206,.534,0,2,.000,110,204,.539,.534,41,53,.774,71,109,180,47,19,12,43,99,261
8186,CLE,1983,Larry Kenon,30,32,7,624,100,212,.472,0,1,.000,100,211,.474,.472,35,46,.761,52,65,117,34,21,9,39,49,235
8187,CLE,1983,Ron Brewer,27,21,18,563,98,245,.400,0,3,.000,98,242,.405,.400,44,51,.863,9,28,37,27,20,6,25,27,240
8188,CLE,1983,Paul Mokeski,26,23,18,539,55,121,.455,0,0,,55,121,.455,.455,16,26,.615,47,91,138,26,12,23,27,85,126
8189,CLE,1983,Darren Tillis,22,37,4,482,69,158,.437,0,0,,69,158,.437,.437,14,22,.636,37,84,121,16,8,28,18,68,152
8190,CLE,1983,James Edwards,27,15,8,382,73,150,.487,0,0,,73,150,.487,.487,38,61,.623,37,59,96,13,7,14,30,61,184
8191,CLE,1983,Carl Nicks,24,9,2,148,26,59,.441,0,1,.000,26,58,.448,.441,11,17,.647,8,18,26,11,6,0,11,17,63
8192,CLE,1983,Dave Magley,23,14,0,56,4,16,.250,0,1,.000,4,15,.267,.250,4,8,.500,2,8,10,2,2,0,2,5,12
8193,CLE,1982,James Edwards,26,77,75,2539,528,1033,.511,0,4,.000,528,1029,.513,.511,232,339,.684,189,392,581,123,24,117,162,347,1288
8194,CLE,1982,Geoff Huston,24,78,43,2409,325,672,.484,3,10,.300,322,662,.486,.486,153,200,.765,53,97,150,590,70,11,171,169,806
8195,CLE,1982,Bob Wilkerson,27,65,38,1805,284,679,.418,3,18,.167,281,661,.425,.420,145,185,.784,60,190,250,237,92,25,138,188,716
8196,CLE,1982,Ron Brewer,26,47,41,1724,387,833,.465,5,21,.238,382,812,.470,.468,134,172,.779,42,69,111,121,59,23,91,114,913
8197,CLE,1982,Scott Wedman,29,54,39,1638,260,589,.441,5,23,.217,255,566,.451,.446,66,90,.733,128,176,304,133,73,14,73,189,591
8198,CLE,1982,Kenny Carr,26,46,42,1482,271,524,.517,1,9,.111,270,515,.524,.518,145,220,.659,114,280,394,63,58,16,112,180,688
8199,CLE,1982,James Silas,32,67,34,1447,251,573,.438,0,5,.000,251,568,.442,.438,246,286,.860,26,83,109,222,40,6,107,109,748
8200,CLE,1982,Mike Mitchell,26,27,26,973,229,504,.454,0,6,.000,229,498,.460,.454,72,100,.720,71,70,141,39,27,15,55,77,530
8201,CLE,1982,Cliff Robinson,21,30,29,946,196,435,.451,0,1,.000,196,434,.452,.451,97,133,.729,91,196,287,49,42,43,63,102,489
8202,CLE,1982,Bill Laimbeer,24,50,4,894,119,253,.470,3,6,.500,116,247,.470,.476,93,120,.775,124,153,277,45,22,30,61,170,334
8203,CLE,1982,Phil Hubbard,25,31,2,735,119,255,.467,0,1,.000,119,254,.469,.467,85,117,.726,86,115,201,24,27,3,62,116,323
8204,CLE,1982,Reggie Johnson,24,23,22,617,94,175,.537,0,0,,94,175,.537,.537,35,44,.795,43,82,125,22,6,17,24,73,223
8205,CLE,1982,Roger Phegley,25,27,8,566,104,214,.486,4,13,.308,100,201,.498,.495,36,45,.800,28,43,71,53,16,2,33,61,248
8206,CLE,1982,Paul Mokeski,25,28,1,345,35,82,.427,0,2,.000,35,80,.438,.427,23,30,.767,24,62,86,11,20,17,16,68,93
8207,CLE,1982,Kevin Restani,30,34,0,338,23,60,.383,0,1,.000,23,59,.390,.383,7,12,.583,31,46,77,15,10,7,14,40,53
8208,CLE,1982,Richard Washington,26,18,2,313,50,115,.435,0,2,.000,50,113,.442,.435,9,15,.600,32,43,75,15,8,2,35,51,109
8209,CLE,1982,Keith Herron,25,30,0,269,39,106,.368,0,1,.000,39,105,.371,.368,7,8,.875,10,11,21,23,8,2,12,25,85
8210,CLE,1982,Mickey Dillard,23,33,0,221,29,79,.367,0,4,.000,29,75,.387,.367,15,23,.652,6,9,15,34,8,2,17,40,73
8211,CLE,1982,Don Ford,29,21,1,201,9,24,.375,0,1,.000,9,23,.391,.375,5,6,.833,14,21,35,11,8,0,15,30,23
8212,CLE,1982,Brad Branson,23,10,3,176,21,52,.404,0,0,,21,52,.404,.404,11,12,.917,14,19,33,6,5,4,13,17,53
8213,CLE,1982,Mike Evans,26,8,0,74,11,35,.314,0,4,.000,11,31,.355,.314,5,8,.625,2,8,10,20,4,0,11,10,27
8214,CLE,1982,Lowes Moore,24,4,0,70,19,38,.500,1,5,.200,18,33,.545,.513,6,8,.750,1,3,4,15,6,1,5,15,45
8215,CLE,1982,Mel Bennett,27,3,0,23,2,4,.500,0,0,,2,4,.500,.500,1,6,.167,1,2,3,0,1,0,4,2,5
8216,CLE,1981,Mike Mitchell,25,82,82,3194,853,1791,.476,4,9,.444,849,1782,.476,.477,302,385,.784,215,287,502,139,63,52,175,199,2012
8217,CLE,1981,Kenny Carr,25,81,,2615,469,918,.511,0,4,.000,469,914,.513,.511,292,409,.714,260,575,835,192,76,42,231,296,1230
8218,CLE,1981,Mike Bratz,25,80,,2595,319,817,.390,57,169,.337,262,648,.404,.425,107,132,.811,66,132,198,452,136,17,162,194,802
8219,CLE,1981,Bill Laimbeer,23,81,,2460,337,670,.503,0,0,,337,670,.503,.503,117,153,.765,266,427,693,216,56,78,132,332,791
8220,CLE,1981,Roger Phegley,24,82,,2269,474,965,.491,8,28,.286,466,937,.497,.495,224,267,.839,90,156,246,184,65,15,165,262,1180
8221,CLE,1981,Randy Smith,32,82,,2199,486,1043,.466,1,28,.036,485,1015,.478,.466,221,271,.815,46,147,193,357,113,14,195,132,1194
8222,CLE,1981,Richard Washington,25,69,,1505,289,630,.459,1,2,.500,288,628,.459,.460,102,136,.750,133,236,369,113,41,54,108,246,681
8223,CLE,1981,Don Ford,28,64,,996,100,224,.446,0,3,.000,100,221,.452,.446,22,24,.917,74,90,164,84,15,12,49,100,222
8224,CLE,1981,Geoff Huston,23,25,,542,76,153,.497,0,1,.000,76,152,.500,.497,22,27,.815,12,27,39,117,13,1,31,35,174
8225,CLE,1981,Dave Robisch,31,11,,372,37,98,.378,0,0,,37,98,.378,.378,29,36,.806,27,58,85,44,7,6,14,21,103
8226,CLE,1981,Kim Hughes,28,45,,331,16,45,.356,0,0,,16,45,.356,.356,0,0,,29,48,77,24,17,21,33,73,32
8227,CLE,1981,Chad Kinch,22,29,,247,38,96,.396,0,0,,38,96,.396,.396,4,5,.800,7,17,24,35,9,5,22,24,80
8228,CLE,1981,Walter Jordan,24,30,,207,29,75,.387,0,0,,29,75,.387,.387,10,17,.588,23,19,42,11,11,5,17,35,68
8229,CLE,1981,Mack Calvin,33,21,,128,13,39,.333,1,5,.200,12,34,.353,.346,25,35,.714,2,10,12,28,5,0,17,13,52
8230,CLE,1981,Bill Robinzine,28,8,,84,14,32,.438,0,0,,14,32,.438,.438,5,8,.625,4,9,13,5,4,0,10,19,33
8231,CLE,1981,Robert Smith,25,1,,20,2,5,.400,0,0,,2,5,.400,.400,4,4,1.000,1,2,3,3,0,0,3,6,8
8232,CLE,1981,Jerome Whitehead,24,3,,8,1,3,.333,0,0,,1,3,.333,.333,0,0,,2,1,3,0,1,0,0,6,2
8233,CLE,1981,John Lambert,28,3,,8,3,5,.600,0,0,,3,5,.600,.600,0,0,,1,2,3,3,0,0,2,2,6
8234,CLE,1980,Mike Mitchell,24,82,82,2802,775,1482,.523,0,6,.000,775,1476,.525,.523,270,343,.787,206,385,591,93,70,77,172,259,1820
8235,CLE,1980,Randy Smith,31,82,82,2677,599,1326,.452,10,53,.189,589,1273,.463,.456,233,283,.823,93,163,256,363,125,7,200,190,1441
8236,CLE,1980,Dave Robisch,30,82,,2670,489,940,.520,0,3,.000,489,937,.522,.520,277,329,.842,225,433,658,192,53,53,138,211,1255
8237,CLE,1980,Foots Walker,28,76,,2422,258,568,.454,1,9,.111,257,559,.460,.455,195,243,.802,78,209,287,607,155,12,157,202,712
8238,CLE,1980,Kenny Carr,24,74,,1781,371,752,.493,0,4,.000,371,748,.496,.493,171,261,.655,194,377,571,76,64,51,145,240,913
8239,CLE,1980,Austin Carr,31,77,,1595,390,839,.465,2,6,.333,388,833,.466,.466,127,172,.738,81,84,165,150,39,3,108,120,909
8240,CLE,1980,Bill Willoughby,22,78,,1447,219,457,.479,1,9,.111,218,448,.487,.480,96,127,.756,122,207,329,72,32,62,68,189,535
8241,CLE,1980,Campy Russell,28,41,,1331,284,630,.451,1,9,.111,283,621,.456,.452,178,239,.745,76,149,225,173,72,20,148,113,747
8242,CLE,1980,John Lambert,27,74,,1324,165,400,.413,0,3,.000,165,397,.416,.413,73,101,.723,138,214,352,56,47,42,64,203,403
8243,CLE,1980,Willie Smith,26,62,,1051,121,315,.384,17,71,.239,104,244,.426,.411,40,52,.769,56,65,121,259,75,1,95,110,299
8244,CLE,1980,Don Ford,27,21,,419,65,144,.451,1,2,.500,64,142,.451,.455,22,25,.880,21,66,87,29,11,6,21,45,153
8245,CLE,1980,Earl Tatum,26,33,,225,36,94,.383,2,6,.333,34,88,.386,.394,11,19,.579,11,15,26,20,16,5,17,29,85
8246,CLE,1980,Bingo Smith,33,8,,135,33,72,.458,1,5,.200,32,67,.478,.465,7,8,.875,2,12,14,7,3,2,9,21,74
8247,CLE,1980,Walt Frazier,34,3,,27,4,11,.364,0,1,.000,4,10,.400,.364,2,2,1.000,1,2,3,8,2,1,4,2,10
8248,CLE,1980,Butch Lee,23,3,,24,2,11,.182,0,0,,2,11,.182,.182,0,1,.000,3,0,3,3,0,0,3,0,4
8249,BOS,2024,Jayson Tatum,25,74,74,2645,672,1426,.471,229,609,.376,443,817,.542,.552,414,497,.833,67,534,601,364,75,43,188,145,1987
8250,BOS,2024,Derrick White,29,73,73,2381,387,839,.461,196,495,.396,191,344,.555,.578,137,152,.901,51,259,310,377,74,87,112,152,1107
8251,BOS,2024,Jaylen Brown,27,70,70,2343,627,1256,.499,145,410,.354,482,846,.570,.557,211,300,.703,84,303,387,249,83,37,166,185,1610
8252,BOS,2024,Jrue Holiday,33,69,69,2263,331,689,.480,138,322,.429,193,367,.526,.581,60,72,.833,84,289,373,333,61,53,124,108,860
8253,BOS,2024,Payton Pritchard,26,82,5,1825,297,635,.468,147,382,.385,150,253,.593,.583,46,56,.821,70,195,265,281,39,6,61,106,787
8254,BOS,2024,Sam Hauser,26,79,13,1741,249,558,.446,197,465,.424,52,93,.559,.623,17,19,.895,45,231,276,82,40,25,32,99,712
8255,BOS,2024,Al Horford,37,65,33,1740,214,419,.511,108,258,.419,106,161,.658,.640,26,30,.867,82,331,413,168,38,62,48,93,562
8256,BOS,2024,Kristaps Porziņģis,28,57,57,1690,388,752,.516,110,293,.375,278,459,.606,.589,259,302,.858,97,312,409,115,42,111,89,156,1145
8257,BOS,2024,Luke Kornet,28,63,7,983,142,203,.700,1,1,1.000,141,202,.698,.702,49,54,.907,118,143,261,67,23,61,21,77,334
8258,BOS,2024,Oshae Brissett,25,55,1,630,68,153,.444,15,55,.273,53,98,.541,.493,50,83,.602,61,99,160,44,19,8,20,54,201
8259,BOS,2024,Svi Mykhailiuk,26,41,2,413,57,137,.416,42,108,.389,15,29,.517,.569,6,9,.667,11,40,51,35,11,1,12,19,162
8260,BOS,2024,Neemias Queta,24,28,0,333,67,104,.644,0,0,,67,104,.644,.644,20,28,.714,53,69,122,20,13,21,13,50,154
8261,BOS,2024,Xavier Tillman Sr.,25,20,2,274,34,66,.515,8,28,.286,26,38,.684,.576,4,7,.571,14,40,54,20,9,9,5,15,80
8262,BOS,2024,Dalano Banton,24,24,1,171,19,51,.373,2,16,.125,17,35,.486,.392,16,20,.800,12,23,35,19,5,3,10,20,56
8263,BOS,2024,Jaden Springer,21,17,1,130,13,30,.433,2,11,.182,11,19,.579,.467,7,8,.875,8,12,20,9,11,4,8,17,35
8264,BOS,2024,Lamar Stevens,26,19,1,122,21,45,.467,3,8,.375,18,37,.486,.500,8,11,.727,12,19,31,8,6,5,9,14,53
8265,BOS,2024,Jordan Walsh,19,9,1,83,6,15,.400,2,9,.222,4,6,.667,.467,1,2,.500,5,15,20,5,5,1,3,11,15
8266,BOS,2024,JD Davison,21,8,0,39,5,12,.417,3,7,.429,2,5,.400,.542,3,4,.750,2,8,10,10,1,1,2,4,16
8267,BOS,2024,Drew Peterson,24,3,0,23,4,6,.667,3,5,.600,1,1,1.000,.917,0,0,,0,1,1,1,2,0,1,1,11
8268,BOS,2023,Jayson Tatum,24,74,74,2732,727,1559,.466,240,686,.350,487,873,.558,.543,531,622,.854,78,571,649,342,78,51,213,160,2225
8269,BOS,2023,Jaylen Brown,26,67,67,2405,679,1383,.491,163,487,.335,516,896,.576,.550,263,344,.765,78,381,459,232,75,26,197,172,1784
8270,BOS,2023,Derrick White,28,82,70,2319,350,758,.462,149,391,.381,201,367,.548,.560,168,192,.875,52,241,293,321,54,76,95,177,1017
8271,BOS,2023,Grant Williams,24,79,23,2045,216,476,.454,115,291,.395,101,185,.546,.575,94,122,.770,87,276,363,131,41,31,82,192,641
8272,BOS,2023,Marcus Smart,28,61,61,1957,250,602,.415,115,342,.336,135,260,.519,.511,88,118,.746,46,145,191,382,93,23,143,172,703
8273,BOS,2023,Al Horford,36,63,63,1922,228,479,.476,145,325,.446,83,154,.539,.627,15,21,.714,73,317,390,189,30,61,37,121,616
8274,BOS,2023,Malcolm Brogdon,30,67,0,1744,354,732,.484,132,297,.444,222,435,.510,.574,160,184,.870,42,238,280,248,45,18,98,109,1000
8275,BOS,2023,Sam Hauser,25,80,8,1290,180,396,.455,140,335,.418,40,61,.656,.631,12,17,.706,35,169,204,71,29,21,30,99,512
8276,BOS,2023,Robert Williams,25,35,20,824,127,170,.747,0,1,.000,127,169,.751,.747,25,41,.610,104,188,292,50,22,48,34,68,279
8277,BOS,2023,Luke Kornet,27,69,0,804,113,170,.665,3,13,.231,110,157,.701,.674,32,39,.821,86,111,197,53,11,46,25,81,261
8278,BOS,2023,Payton Pritchard,25,48,3,643,101,245,.412,56,154,.364,45,91,.495,.527,12,16,.750,25,63,88,64,14,1,40,37,270
8279,BOS,2023,Blake Griffin,33,41,16,569,63,130,.485,23,66,.348,40,64,.625,.573,21,32,.656,47,108,155,61,14,9,22,75,170
8280,BOS,2023,Mike Muscala,31,20,4,323,42,89,.472,25,65,.385,17,24,.708,.612,9,13,.692,14,54,68,12,4,5,9,28,118
8281,BOS,2023,Noah Vonleh,27,23,1,171,11,24,.458,1,4,.250,10,20,.500,.479,2,2,1.000,18,30,48,7,2,8,11,35,25
8282,BOS,2023,Justin Jackson,27,23,0,107,7,27,.259,5,20,.250,2,7,.286,.352,1,2,.500,2,15,17,9,4,4,2,7,20
8283,BOS,2023,JD Davison,20,12,0,66,8,19,.421,2,7,.286,6,12,.500,.474,1,2,.500,2,7,9,11,2,2,4,5,19
8284,BOS,2023,Mfiondu Kabengele,25,4,0,36,2,7,.286,0,3,.000,2,4,.500,.286,2,2,1.000,5,5,10,0,2,0,1,3,6
8285,BOS,2023,Justin Champagnie,21,2,0,23,2,12,.167,1,5,.200,1,7,.143,.208,0,0,,2,2,4,3,1,0,0,1,5
8286,BOS,2022,Jayson Tatum,23,76,76,2731,708,1564,.453,230,651,.353,478,913,.524,.526,400,469,.853,85,524,609,334,75,49,217,174,2046
8287,BOS,2022,Marcus Smart,27,71,71,2296,300,718,.418,119,360,.331,181,358,.506,.501,142,179,.793,42,228,270,417,119,18,159,160,861
8288,BOS,2022,Jaylen Brown,25,66,66,2220,576,1217,.473,166,464,.358,410,753,.544,.541,241,318,.758,53,351,404,231,70,18,178,163,1559
8289,BOS,2022,Al Horford,35,69,69,2005,266,569,.467,89,265,.336,177,304,.582,.546,80,95,.842,108,422,530,232,49,92,65,130,701
8290,BOS,2022,Grant Williams,23,77,21,1875,205,432,.475,106,258,.411,99,174,.569,.597,86,95,.905,64,210,274,78,38,57,62,186,602
8291,BOS,2022,Robert Williams,24,61,61,1804,271,368,.736,0,1,.000,271,367,.738,.736,65,90,.722,238,350,588,121,56,134,63,137,607
8292,BOS,2022,Dennis Schröder,28,49,25,1433,257,584,.440,67,192,.349,190,392,.485,.497,123,145,.848,28,136,164,208,41,5,104,116,704
8293,BOS,2022,Josh Richardson,28,44,0,1087,152,343,.443,62,156,.397,90,187,.481,.534,61,71,.859,26,99,125,66,34,23,39,82,427
8294,BOS,2022,Payton Pritchard,24,71,2,1001,160,373,.429,101,245,.412,59,128,.461,.564,21,21,1.000,32,102,134,139,25,6,41,61,442
8295,BOS,2022,Romeo Langford,22,44,5,728,79,184,.429,29,83,.349,50,101,.495,.508,20,34,.588,30,74,104,19,21,16,16,46,207
8296,BOS,2022,Derrick White,27,26,4,713,94,230,.409,34,111,.306,60,119,.504,.483,64,75,.853,13,75,88,92,15,16,32,56,286
8297,BOS,2022,Aaron Nesmith,22,52,3,574,72,182,.396,31,115,.270,41,67,.612,.481,21,26,.808,15,74,89,22,20,5,31,70,196
8298,BOS,2022,Enes Freedom,29,35,1,411,51,97,.526,2,5,.400,49,92,.533,.536,24,28,.857,61,99,160,8,5,14,20,42,128
8299,BOS,2022,Daniel Theis,29,21,6,393,67,112,.598,10,28,.357,57,84,.679,.643,22,32,.688,27,71,98,21,9,14,15,49,166
8300,BOS,2022,Sam Hauser,24,26,0,158,23,50,.460,19,44,.432,4,6,.667,.650,0,0,,5,24,29,10,1,2,2,7,65
8301,BOS,2022,Jabari Parker,26,12,0,112,18,38,.474,8,16,.500,10,22,.455,.579,9,9,1.000,5,23,28,6,4,1,8,13,53
8302,BOS,2022,Juancho Hernangómez,26,18,0,96,5,27,.185,3,18,.167,2,9,.222,.241,6,9,.667,9,16,25,3,4,2,6,7,19
8303,BOS,2022,Luke Kornet,26,12,0,85,12,21,.571,0,4,.000,12,17,.706,.571,2,3,.667,10,15,25,8,3,2,0,7,26
8304,BOS,2022,Brodric Thomas,25,12,0,60,8,18,.444,2,9,.222,6,9,.667,.500,3,5,.600,2,8,10,11,1,1,6,7,21
8305,BOS,2022,Bruno Fernando,23,20,0,58,7,14,.500,1,1,1.000,6,13,.462,.536,4,5,.800,7,8,15,4,0,3,5,6,19
8306,BOS,2022,Malik Fitts,24,8,0,28,6,10,.600,3,6,.500,3,4,.750,.750,0,0,,2,5,7,5,0,0,0,1,15
8307,BOS,2022,Nik Stauskas,28,6,0,15,2,6,.333,2,6,.333,0,0,,.500,1,2,.500,0,0,0,1,0,0,1,0,7
8308,BOS,2022,Kelan Martin,26,3,0,6,0,3,.000,0,1,.000,0,2,.000,.000,0,0,,1,1,2,0,0,0,0,0,0
8309,BOS,2022,Matt Ryan,24,1,0,5,1,5,.200,1,5,.200,0,0,,.300,0,0,,0,0,0,0,1,0,0,0,3
8310,BOS,2022,Juwan Morgan,24,1,0,4,0,0,,0,0,,0,0,,,0,0,,0,0,0,0,0,0,0,0,0
8311,BOS,2022,C.J. Miles,34,1,0,2,0,0,,0,0,,0,0,,,0,0,,0,0,0,0,0,0,0,1,0
8312,BOS,2022,Joe Johnson,40,1,0,2,1,1,1.000,0,0,,1,1,1.000,1.000,0,0,,0,0,0,0,0,0,0,0,2
8313,BOS,2022,Justin Jackson,26,1,0,2,0,1,.000,0,0,,0,1,.000,.000,2,2,1.000,0,0,0,0,0,0,0,0,2
8314,BOS,2021,Jayson Tatum,22,64,64,2290,605,1318,.459,187,485,.386,418,833,.502,.530,295,340,.868,50,422,472,276,75,31,171,122,1692
8315,BOS,2021,Jaylen Brown,24,58,58,1999,538,1111,.484,163,411,.397,375,700,.536,.558,191,250,.764,71,276,347,195,72,32,158,168,1430
8316,BOS,2021,Marcus Smart,26,48,45,1581,203,510,.398,93,282,.330,110,228,.482,.489,128,162,.790,36,131,167,273,72,23,96,126,627
8317,BOS,2021,Kemba Walker,30,43,43,1369,284,676,.420,127,353,.360,157,323,.486,.514,134,149,.899,16,154,170,212,48,12,88,61,829
8318,BOS,2021,Tristan Thompson,29,54,43,1287,169,326,.518,0,3,.000,169,323,.523,.518,71,120,.592,169,270,439,67,24,33,62,119,409
8319,BOS,2021,Payton Pritchard,23,66,4,1268,184,418,.440,102,248,.411,82,170,.482,.562,40,45,.889,33,125,158,120,37,9,53,104,510
8320,BOS,2021,Grant Williams,22,63,9,1138,108,247,.437,48,129,.372,60,118,.508,.534,30,51,.588,48,130,178,64,32,24,56,161,294
8321,BOS,2021,Daniel Theis,28,42,37,1027,159,288,.552,33,95,.347,126,193,.653,.609,46,67,.687,54,166,220,67,25,43,41,120,397
8322,BOS,2021,Robert Williams,23,52,13,985,186,258,.721,0,2,.000,186,256,.727,.721,45,73,.616,133,225,358,94,43,91,52,105,417
8323,BOS,2021,Semi Ojeleye,26,56,15,950,89,221,.403,58,158,.367,31,63,.492,.534,24,32,.750,31,116,147,37,17,0,21,56,260
8324,BOS,2021,Aaron Nesmith,21,46,1,669,78,178,.438,40,108,.370,38,70,.543,.551,22,28,.786,28,99,127,23,15,9,23,87,218
8325,BOS,2021,Jeff Teague,32,34,5,616,78,188,.415,26,56,.464,52,132,.394,.484,51,61,.836,10,47,57,73,26,7,39,43,233
8326,BOS,2021,Evan Fournier,28,16,10,472,77,172,.448,44,95,.463,33,77,.429,.576,10,14,.714,5,48,53,49,20,10,19,41,208
8327,BOS,2021,Javonte Green,27,25,2,345,39,71,.549,7,22,.318,32,49,.653,.599,20,30,.667,20,32,52,11,18,2,13,32,105
8328,BOS,2021,Romeo Langford,21,18,4,283,21,59,.356,5,18,.278,16,41,.390,.398,9,12,.750,12,23,35,13,6,5,10,24,56
8329,BOS,2021,Carsen Edwards,22,31,1,276,47,111,.423,18,63,.286,29,48,.604,.505,11,13,.846,3,23,26,14,7,1,7,25,123
8330,BOS,2021,Luke Kornet,25,18,2,254,35,74,.473,9,36,.250,26,38,.684,.534,1,2,.500,13,39,52,20,2,25,6,19,80
8331,BOS,2021,Tremont Waters,23,26,3,238,34,84,.405,15,38,.395,19,46,.413,.494,16,17,.941,5,16,21,62,15,1,27,17,99
8332,BOS,2021,Jabari Parker,25,10,0,138,26,48,.542,2,10,.200,24,38,.632,.563,10,13,.769,9,27,36,10,1,4,7,9,64
8333,BOS,2021,Tacko Fall,25,19,0,136,21,29,.724,0,0,,21,29,.724,.724,5,15,.333,16,36,52,3,1,20,6,22,47
8334,BOS,2021,Moritz Wagner,23,9,1,61,4,14,.286,2,6,.333,2,8,.250,.357,1,2,.500,3,16,19,6,0,1,9,10,11
8335,BOS,2020,Jayson Tatum,21,66,66,2265,552,1226,.450,189,469,.403,363,757,.480,.527,254,313,.812,64,396,460,200,93,57,155,136,1547
8336,BOS,2020,Jaylen Brown,23,57,57,1934,427,887,.481,129,338,.382,298,549,.543,.554,176,243,.724,62,302,364,118,65,20,125,167,1159
8337,BOS,2020,Marcus Smart,25,60,40,1919,256,682,.375,137,395,.347,119,287,.415,.476,127,152,.836,42,183,225,291,101,29,103,162,776
8338,BOS,2020,Kemba Walker,29,56,56,1742,378,889,.425,180,473,.381,198,416,.476,.526,209,242,.864,36,181,217,268,48,28,117,91,1145
8339,BOS,2020,Gordon Hayward,29,52,52,1740,350,700,.500,85,222,.383,265,478,.554,.561,124,145,.855,55,293,348,212,38,22,96,96,909
8340,BOS,2020,Daniel Theis,27,65,64,1566,241,426,.566,32,96,.333,209,330,.633,.603,87,114,.763,140,286,426,111,37,84,54,219,601
8341,BOS,2020,Brad Wanamaker,30,71,1,1369,162,362,.448,37,102,.363,125,260,.481,.499,126,136,.926,22,122,144,179,61,14,76,133,487
8342,BOS,2020,Grant Williams,21,69,5,1043,87,211,.412,24,96,.250,63,115,.548,.469,39,54,.722,59,119,178,68,30,36,50,163,237
8343,BOS,2020,Semi Ojeleye,25,69,6,1011,80,196,.408,48,127,.378,32,69,.464,.531,28,32,.875,26,119,145,37,21,5,19,80,236
8344,BOS,2020,Enes Freedom,27,58,7,983,199,348,.572,1,7,.143,198,341,.581,.573,70,99,.707,163,268,431,56,22,41,56,100,469
8345,BOS,2020,Javonte Green,26,48,2,468,63,126,.500,9,33,.273,54,93,.581,.536,28,42,.667,24,69,93,26,24,8,23,43,163
8346,BOS,2020,Robert Williams,22,29,1,388,64,88,.727,0,0,,64,88,.727,.727,22,34,.647,40,88,128,27,22,35,21,51,150
8347,BOS,2020,Romeo Langford,20,32,2,370,28,80,.350,5,27,.185,23,53,.434,.381,18,25,.720,15,26,41,13,8,8,11,33,79
8348,BOS,2020,Carsen Edwards,21,37,0,351,42,128,.328,24,76,.316,18,52,.346,.422,13,19,.684,6,41,47,24,12,4,15,34,121
8349,BOS,2020,Vincent Poirier,26,22,0,130,17,36,.472,1,2,.500,16,34,.471,.486,6,7,.857,13,30,43,8,2,9,8,25,41
8350,BOS,2020,Tremont Waters,22,11,1,119,14,49,.286,4,24,.167,10,25,.400,.327,8,8,1.000,0,12,12,16,10,2,15,13,40
8351,BOS,2020,Tacko Fall,24,7,0,33,11,14,.786,0,0,,11,14,.786,.786,1,3,.333,1,14,15,1,1,4,3,7,23
8352,BOS,2019,Jayson Tatum,20,79,79,2455,466,1036,.450,116,311,.373,350,725,.483,.506,195,228,.855,70,407,477,168,84,57,122,168,1243
8353,BOS,2019,Kyrie Irving,26,67,67,2214,604,1241,.487,174,434,.401,430,807,.533,.557,214,245,.873,71,264,335,464,103,34,172,167,1596
8354,BOS,2019,Marcus Smart,24,80,60,2200,239,567,.422,126,346,.364,113,221,.511,.533,104,129,.806,57,177,234,321,143,28,123,201,708
8355,BOS,2019,Marcus Morris,29,75,53,2091,377,844,.447,146,389,.375,231,455,.508,.533,146,173,.844,76,382,458,109,43,25,92,181,1046
8356,BOS,2019,Al Horford,32,68,68,1973,387,723,.535,73,203,.360,314,520,.604,.586,78,95,.821,120,338,458,283,59,86,102,126,925
8357,BOS,2019,Jaylen Brown,22,74,25,1913,368,792,.465,95,276,.344,273,516,.529,.525,133,202,.658,65,248,313,100,69,32,99,186,964
8358,BOS,2019,Gordon Hayward,28,72,18,1863,296,635,.466,77,231,.333,219,404,.542,.527,156,187,.834,51,271,322,244,62,23,105,104,825
8359,BOS,2019,Terry Rozier,24,79,14,1791,258,666,.387,119,337,.353,139,329,.422,.477,73,93,.785,32,275,307,231,68,21,68,101,708
8360,BOS,2019,Daniel Theis,26,66,2,908,146,266,.549,26,67,.388,120,199,.603,.598,56,76,.737,87,138,225,68,21,42,33,161,374
8361,BOS,2019,Aron Baynes,32,51,18,821,105,223,.471,21,61,.344,84,162,.519,.518,53,62,.855,88,152,240,57,12,34,40,125,284
8362,BOS,2019,Semi Ojeleye,24,56,3,594,67,158,.424,28,89,.315,39,69,.565,.513,24,39,.615,24,62,86,23,10,4,19,43,186
8363,BOS,2019,Brad Wanamaker,29,36,0,343,50,105,.476,16,39,.410,34,66,.515,.552,24,28,.857,3,38,41,56,12,2,19,34,140
8364,BOS,2019,Robert Williams,21,32,2,283,36,51,.706,0,0,,36,51,.706,.706,9,15,.600,27,54,81,7,9,40,10,36,81
8365,BOS,2019,Guerschon Yabusele,23,41,1,251,35,77,.455,9,28,.321,26,49,.531,.513,15,22,.682,23,30,53,15,8,7,15,32,94
8366,BOS,2019,PJ Dozier,22,6,0,51,8,21,.381,2,8,.250,6,13,.462,.429,1,2,.500,6,11,17,5,2,0,0,2,19
8367,BOS,2019,R.J. Hunter,25,1,0,26,6,13,.462,4,10,.400,2,3,.667,.615,1,2,.500,1,2,3,3,1,0,0,3,17
8368,BOS,2019,Greg Monroe,28,2,0,5,3,5,.600,0,0,,3,5,.600,.600,0,0,,3,0,3,1,0,0,0,0,6
8369,BOS,2018,Jayson Tatum,19,80,80,2443,397,835,.475,105,242,.434,292,593,.492,.538,213,258,.826,50,352,402,128,83,58,114,170,1112
8370,BOS,2018,Al Horford,31,72,72,2277,368,753,.489,97,226,.429,271,527,.514,.553,94,120,.783,103,427,530,339,43,78,132,138,927
8371,BOS,2018,Jaylen Brown,21,70,70,2152,373,803,.465,121,306,.395,252,497,.507,.540,150,233,.644,66,280,346,114,70,26,124,181,1017
8372,BOS,2018,Terry Rozier,23,80,16,2068,316,800,.395,153,402,.381,163,398,.410,.491,115,149,.772,63,313,376,232,80,19,80,123,900
8373,BOS,2018,Kyrie Irving,25,60,60,1931,534,1087,.491,166,407,.408,368,680,.541,.568,232,261,.889,33,194,227,306,65,17,140,122,1466
8374,BOS,2018,Marcus Smart,23,54,11,1614,189,515,.367,75,249,.301,114,266,.429,.440,97,133,.729,43,146,189,259,71,23,129,133,550
8375,BOS,2018,Aron Baynes,31,81,67,1485,210,446,.471,3,21,.143,207,425,.487,.474,59,78,.756,130,304,434,93,22,51,80,200,482
8376,BOS,2018,Marcus Morris,28,54,21,1442,262,611,.429,86,234,.368,176,377,.467,.499,124,154,.805,43,246,289,72,35,12,65,100,734
8377,BOS,2018,Semi Ojeleye,23,73,0,1150,65,188,.346,40,125,.320,25,63,.397,.452,25,41,.610,37,124,161,20,21,4,25,91,195
8378,BOS,2018,Daniel Theis,25,63,3,936,126,233,.541,18,58,.310,108,175,.617,.579,61,81,.753,90,184,274,56,30,48,56,157,331
8379,BOS,2018,Shane Larkin,25,54,2,775,84,219,.384,31,86,.360,53,133,.398,.454,32,37,.865,15,77,92,98,29,2,33,58,231
8380,BOS,2018,Abdel Nader,24,48,1,522,50,149,.336,23,65,.354,27,84,.321,.413,23,39,.590,13,58,71,26,15,10,34,45,146
8381,BOS,2018,Greg Monroe,27,26,0,496,105,198,.530,0,0,,105,198,.530,.530,55,69,.797,53,112,165,59,28,17,48,48,265
8382,BOS,2018,Guerschon Yabusele,22,33,4,235,26,61,.426,12,37,.324,14,24,.583,.525,15,22,.682,17,35,52,16,4,5,12,23,79
8383,BOS,2018,Jabari Bird,23,13,1,115,15,26,.577,3,7,.429,12,19,.632,.635,6,13,.462,6,13,19,8,3,1,8,7,39
8384,BOS,2018,Kadeem Allen,25,18,1,107,6,22,.273,0,11,.000,6,11,.545,.273,7,9,.778,4,7,11,12,3,2,9,15,19
8385,BOS,2018,Jonathan Gibson,30,4,0,40,14,23,.609,6,12,.500,8,11,.727,.739,0,0,,0,3,3,4,0,0,3,5,34
8386,BOS,2018,Xavier Silas,30,2,0,7,0,3,.000,0,2,.000,0,1,.000,.000,0,0,,1,1,2,0,1,0,0,1,0
8387,BOS,2018,Jarell Eddie,26,2,0,6,0,1,.000,0,1,.000,0,0,,.000,0,0,,0,1,1,0,1,0,0,0,0
8388,BOS,2018,Gordon Hayward,27,1,1,5,1,2,.500,0,1,.000,1,1,1.000,.500,0,0,,0,1,1,0,0,0,0,1,2
8389,BOS,2017,Isaiah Thomas,27,76,76,2569,682,1473,.463,245,646,.379,437,827,.528,.546,590,649,.909,43,162,205,448,70,13,210,167,2199
8390,BOS,2017,Marcus Smart,22,79,24,2399,269,749,.359,94,332,.283,175,417,.420,.422,203,250,.812,78,227,305,364,125,34,159,192,835
8391,BOS,2017,Jae Crowder,26,72,72,2335,333,720,.463,157,394,.398,176,326,.540,.572,176,217,.811,48,367,415,155,73,23,80,161,999
8392,BOS,2017,Al Horford,30,68,68,2193,379,801,.473,86,242,.355,293,559,.524,.527,108,135,.800,95,370,465,337,52,86,115,138,952
8393,BOS,2017,Avery Bradley,26,55,55,1835,359,775,.463,108,277,.390,251,498,.504,.533,68,93,.731,65,269,334,122,68,11,88,141,894
8394,BOS,2017,Amir Johnson,29,80,77,1608,213,370,.576,27,66,.409,186,304,.612,.612,67,100,.670,118,248,366,140,51,62,77,211,520
8395,BOS,2017,Kelly Olynyk,25,75,6,1538,260,508,.512,68,192,.354,192,316,.608,.579,90,123,.732,73,288,361,148,43,29,96,207,678
8396,BOS,2017,Jaylen Brown,20,78,20,1341,192,423,.454,46,135,.341,146,288,.507,.508,85,124,.685,45,175,220,64,35,18,68,142,515
8397,BOS,2017,Terry Rozier,22,74,0,1263,151,411,.367,57,179,.318,94,232,.405,.437,51,66,.773,40,187,227,131,46,11,47,69,410
8398,BOS,2017,Jonas Jerebko,29,78,6,1232,114,262,.435,45,130,.346,69,132,.523,.521,26,37,.703,59,213,272,71,25,17,39,122,299
8399,BOS,2017,Gerald Green,31,47,0,538,95,232,.409,39,111,.351,56,121,.463,.494,33,41,.805,16,68,84,33,9,7,25,48,262
8400,BOS,2017,Tyler Zeller,27,51,5,525,78,158,.494,0,1,.000,78,157,.497,.494,22,39,.564,43,81,124,42,7,21,20,61,178
8401,BOS,2017,James Young,21,29,0,220,25,58,.431,12,35,.343,13,23,.565,.534,6,9,.667,6,20,26,4,10,2,4,15,68
8402,BOS,2017,Jordan Mickey,22,25,1,141,15,34,.441,0,1,.000,15,33,.455,.441,8,14,.571,13,21,34,7,3,6,9,12,38
8403,BOS,2017,Demetrius Jackson,22,5,0,17,3,4,.750,1,1,1.000,2,3,.667,.875,3,6,.500,2,2,4,3,0,0,0,0,10
8404,BOS,2016,Isaiah Thomas,26,82,79,2644,591,1382,.428,167,465,.359,424,917,.462,.488,474,544,.871,46,197,243,509,91,9,220,167,1823
8405,BOS,2016,Avery Bradley,25,76,72,2536,456,1019,.447,147,407,.361,309,612,.505,.520,96,123,.780,48,172,220,158,117,19,109,164,1155
8406,BOS,2016,Jae Crowder,25,73,73,2308,360,813,.443,122,363,.336,238,450,.529,.518,196,239,.820,70,303,373,135,126,35,83,198,1038
8407,BOS,2016,Evan Turner,27,81,12,2271,343,753,.456,20,83,.241,323,670,.482,.469,148,179,.827,50,347,397,359,80,28,169,139,854
8408,BOS,2016,Jared Sullinger,23,81,73,1915,351,806,.435,29,103,.282,322,703,.458,.453,103,161,.640,194,479,673,187,75,47,102,209,834
8409,BOS,2016,Amir Johnson,28,79,76,1800,249,426,.585,10,43,.233,239,383,.624,.596,69,121,.570,178,327,505,138,52,83,94,214,577
8410,BOS,2016,Marcus Smart,21,61,10,1667,184,529,.348,61,241,.253,123,288,.427,.405,129,166,.777,76,179,255,185,91,18,80,183,558
8411,BOS,2016,Kelly Olynyk,24,69,8,1395,253,556,.455,85,210,.405,168,346,.486,.531,96,128,.750,72,209,281,105,52,33,74,163,687
8412,BOS,2016,Jonas Jerebko,28,78,0,1176,118,286,.413,43,108,.398,75,178,.421,.488,61,78,.782,77,211,288,62,20,24,52,137,340
8413,BOS,2016,Tyler Zeller,26,60,3,710,138,290,.476,0,0,,138,290,.476,.476,88,108,.815,62,116,178,29,10,22,46,97,364
8414,BOS,2016,David Lee,32,30,4,470,87,192,.453,0,1,.000,87,191,.455,.453,40,51,.784,41,89,130,54,12,13,38,51,214
8415,BOS,2016,R.J. Hunter,22,36,0,315,36,98,.367,19,63,.302,17,35,.486,.464,6,7,.857,2,35,37,13,14,4,11,29,97
8416,BOS,2016,Terry Rozier,21,39,0,311,29,106,.274,6,27,.222,23,79,.291,.302,8,10,.800,24,39,63,37,6,1,19,23,72
8417,BOS,2016,James Young,20,29,0,199,11,36,.306,6,26,.231,5,10,.500,.389,1,4,.250,4,22,26,9,6,1,5,17,29
8418,BOS,2016,Jordan Mickey,21,16,0,57,8,22,.364,0,0,,8,22,.364,.364,5,10,.500,6,7,13,1,0,11,1,5,21
8419,BOS,2016,Coty Clarke,23,3,0,6,2,4,.500,2,2,1.000,0,2,.000,.750,0,0,,0,1,1,0,0,0,1,0,6
8420,BOS,2015,Avery Bradley,24,77,77,2428,434,1012,.429,124,352,.352,310,660,.470,.490,79,100,.790,46,195,241,135,82,15,109,177,1071
8421,BOS,2015,Evan Turner,26,82,57,2260,320,746,.429,33,119,.277,287,627,.458,.451,106,141,.752,40,377,417,449,83,19,198,180,779
8422,BOS,2015,Brandon Bass,29,82,43,1929,344,683,.504,9,32,.281,335,651,.515,.510,169,214,.790,139,259,398,104,41,32,83,140,866
8423,BOS,2015,Marcus Smart,20,67,38,1808,175,477,.367,91,272,.335,84,205,.410,.462,82,127,.646,61,161,222,208,99,18,90,176,523
8424,BOS,2015,Tyler Zeller,25,82,59,1731,340,619,.549,0,0,,340,619,.549,.549,153,186,.823,146,319,465,113,18,52,76,205,833
8425,BOS,2015,Jared Sullinger,22,58,49,1566,311,708,.439,52,184,.283,259,524,.494,.476,96,129,.744,147,294,441,134,44,42,78,153,770
8426,BOS,2015,Kelly Olynyk,23,64,13,1423,251,528,.475,61,175,.349,190,353,.538,.533,93,136,.684,92,211,303,109,64,39,98,213,656
8427,BOS,2015,Jae Crowder,24,57,17,1382,196,469,.418,48,170,.282,148,299,.495,.469,99,130,.762,60,204,264,82,57,20,39,111,539
8428,BOS,2015,Jeff Green,28,33,33,1093,206,475,.434,47,154,.305,159,321,.495,.483,121,144,.840,21,120,141,53,27,13,56,66,580
8429,BOS,2015,Rajon Rondo,28,22,22,699,81,200,.405,8,32,.250,73,168,.435,.425,12,36,.333,25,140,165,237,37,3,75,42,182
8430,BOS,2015,Marcus Thornton,27,39,0,640,127,305,.416,52,124,.419,75,181,.414,.502,42,51,.824,19,54,73,34,21,7,22,35,348
8431,BOS,2015,Phil Pressey,23,50,0,600,64,174,.368,16,65,.246,48,109,.440,.414,33,49,.673,13,67,80,117,30,6,41,54,177
8432,BOS,2015,Isaiah Thomas,25,21,0,545,117,285,.411,48,139,.345,69,146,.473,.495,118,137,.861,7,37,44,113,12,0,54,45,400
8433,BOS,2015,Jonas Jerebko,27,29,0,527,78,181,.431,26,64,.406,52,117,.444,.503,25,30,.833,46,94,140,30,19,7,18,58,207
8434,BOS,2015,James Young,19,31,0,332,36,102,.353,17,66,.258,19,36,.528,.436,16,29,.552,9,33,42,13,8,2,5,22,105
8435,BOS,2015,Gerald Wallace,32,32,0,286,14,34,.412,1,3,.333,13,31,.419,.426,6,15,.400,17,40,57,11,15,4,18,19,35
8436,BOS,2015,Tayshaun Prince,34,9,0,198,33,59,.559,5,8,.625,28,51,.549,.602,5,6,.833,6,24,30,18,5,2,4,7,76
8437,BOS,2015,Gigi Datome,27,18,1,192,38,77,.494,17,36,.472,21,41,.512,.604,1,1,1.000,2,23,25,7,1,7,7,14,94
8438,BOS,2015,Jameer Nelson,32,6,1,121,9,41,.220,5,25,.200,4,16,.250,.280,6,9,.667,3,14,17,33,7,0,9,13,29
8439,BOS,2015,Brandan Wright,27,8,0,86,12,21,.571,0,0,,12,21,.571,.571,2,4,.500,7,10,17,8,1,5,5,4,26
8440,BOS,2015,Shavlik Randolph,31,5,0,25,3,10,.300,0,1,.000,3,9,.333,.300,1,2,.500,4,8,12,1,1,1,1,3,7
8441,BOS,2015,Dwight Powell,23,5,0,9,4,5,.800,0,0,,4,5,.800,.800,1,2,.500,0,1,1,0,2,0,2,1,9
8442,BOS,2014,Jeff Green,27,82,82,2805,482,1171,.412,135,396,.341,347,775,.448,.469,283,356,.795,54,326,380,138,57,47,165,180,1382
8443,BOS,2014,Brandon Bass,28,82,73,2266,352,725,.486,2,6,.333,350,719,.487,.487,205,239,.858,161,309,470,87,36,71,102,190,911
8444,BOS,2014,Jared Sullinger,21,74,44,2041,384,899,.427,56,208,.269,328,691,.475,.458,158,203,.778,241,360,601,118,35,49,119,251,982
8445,BOS,2014,Avery Bradley,23,60,58,1855,361,825,.438,79,200,.395,282,625,.451,.485,90,112,.804,48,178,226,85,63,11,96,145,891
8446,BOS,2014,Gerald Wallace,31,58,16,1416,116,230,.504,19,64,.297,97,166,.584,.546,47,101,.465,36,176,212,143,73,14,97,79,298
8447,BOS,2014,Kelly Olynyk,22,70,9,1400,234,502,.466,40,114,.351,194,388,.500,.506,99,122,.811,140,225,365,109,35,27,106,227,607
8448,BOS,2014,Kris Humphries,28,69,30,1376,231,461,.501,0,2,.000,231,459,.503,.501,117,144,.813,127,282,409,67,31,61,64,136,579
8449,BOS,2014,Jordan Crawford,25,39,35,1198,188,455,.413,50,157,.318,138,298,.463,.468,110,126,.873,18,102,120,224,34,3,84,76,536
8450,BOS,2014,Phil Pressey,22,75,11,1132,78,253,.308,28,106,.264,50,147,.340,.364,29,45,.644,20,85,105,241,68,5,87,97,213
8451,BOS,2014,Jerryd Bayless,25,41,14,1036,158,378,.418,51,129,.395,107,249,.430,.485,49,61,.803,14,72,86,128,40,4,60,89,416
8452,BOS,2014,Rajon Rondo,27,30,30,998,141,350,.403,26,90,.289,115,260,.442,.440,42,67,.627,22,142,164,294,40,2,99,65,350
8453,BOS,2014,Chris Johnson,23,40,0,789,85,214,.397,43,127,.339,42,87,.483,.498,37,43,.860,31,66,97,31,27,4,22,63,250
8454,BOS,2014,Courtney Lee,28,30,0,504,90,183,.492,23,52,.442,67,131,.511,.555,18,22,.818,8,41,49,32,20,9,25,37,221
8455,BOS,2014,Vítor Luiz Faverani,25,37,8,488,64,147,.435,12,40,.300,52,107,.486,.476,24,37,.649,42,86,128,16,14,27,41,74,164
8456,BOS,2014,Joel Anthony,31,21,0,149,10,26,.385,0,0,,10,26,.385,.385,2,6,.333,13,18,31,2,3,8,2,13,22
8457,BOS,2014,Chris Babb,23,14,0,132,8,30,.267,6,27,.222,2,3,.667,.367,0,0,,4,13,17,3,6,0,3,13,22
8458,BOS,2014,MarShon Brooks,25,10,0,73,9,24,.375,2,4,.500,7,20,.350,.417,11,14,.786,1,18,19,4,1,1,7,5,31
8459,BOS,2014,Keith Bogans,33,6,0,55,3,6,.500,3,6,.500,0,0,,.750,3,3,1.000,0,3,3,3,1,0,1,2,12
8460,BOS,2014,Vander Blue,21,3,0,15,2,4,.500,0,1,.000,2,3,.667,.500,1,5,.200,0,3,3,1,0,0,2,1,5
8461,BOS,2013,Paul Pierce,35,77,77,2575,476,1092,.436,145,382,.380,331,710,.466,.502,333,423,.787,45,442,487,370,84,30,214,210,1430
8462,BOS,2013,Jeff Green,26,81,17,2252,376,806,.467,70,182,.385,306,624,.490,.510,214,265,.808,55,263,318,128,56,68,132,175,1036
8463,BOS,2013,Brandon Bass,27,81,69,2239,286,589,.486,0,2,.000,286,587,.487,.486,129,150,.860,129,296,425,84,44,64,80,188,701
8464,BOS,2013,Jason Terry,35,79,24,2124,281,648,.434,123,331,.372,158,317,.498,.529,114,131,.870,19,140,159,198,66,11,102,110,799
8465,BOS,2013,Kevin Garnett,36,68,68,2022,422,850,.496,2,16,.125,420,834,.504,.498,158,201,.786,75,455,530,159,78,62,110,154,1004
8466,BOS,2013,Courtney Lee,27,78,39,1941,246,530,.464,58,156,.372,188,374,.503,.519,62,72,.861,31,159,190,143,89,21,84,139,612
8467,BOS,2013,Avery Bradley,22,50,50,1435,192,478,.402,40,126,.317,152,352,.432,.444,37,49,.755,30,81,111,104,64,19,72,129,461
8468,BOS,2013,Rajon Rondo,26,38,38,1423,225,465,.484,12,50,.240,213,415,.513,.497,60,93,.645,43,169,212,420,70,9,148,96,522
8469,BOS,2013,Jared Sullinger,20,45,5,892,111,225,.493,1,5,.200,110,220,.500,.496,47,63,.746,92,172,264,35,22,22,29,154,270
8470,BOS,2013,Chris Wilcox,30,61,7,830,110,153,.719,0,1,.000,110,152,.724,.719,39,58,.672,55,125,180,22,32,28,34,125,259
8471,BOS,2013,Jordan Crawford,24,27,2,582,90,217,.415,24,75,.320,66,142,.465,.470,42,53,.792,13,61,74,68,12,2,44,45,246
8472,BOS,2013,Leandro Barbosa,30,41,2,513,83,193,.430,18,47,.383,65,146,.445,.477,31,41,.756,8,38,46,58,17,6,21,51,215
8473,BOS,2013,Jason Collins,34,32,7,330,8,23,.348,0,0,,8,23,.348,.348,21,30,.700,21,31,52,6,10,6,16,74,37
8474,BOS,2013,Terrence Williams,25,24,0,318,48,97,.495,5,15,.333,43,82,.524,.521,9,21,.429,4,40,44,38,11,2,22,13,110
8475,BOS,2013,Shavlik Randolph,29,16,0,198,28,48,.583,0,0,,28,48,.583,.583,11,27,.407,28,42,70,4,8,7,10,38,67
8476,BOS,2013,D.J. White,26,12,0,86,12,23,.522,0,0,,12,23,.522,.522,5,9,.556,4,9,13,4,1,6,2,5,29
8477,BOS,2013,Fab Melo,22,6,0,36,3,6,.500,0,0,,3,6,.500,.500,1,4,.250,0,3,3,0,2,2,1,7,7
8478,BOS,2013,Kris Joseph,24,6,0,24,2,11,.182,0,2,.000,2,9,.222,.182,3,4,.750,1,4,5,1,0,0,2,2,7
8479,BOS,2013,Jarvis Varnado,24,5,0,18,2,4,.500,0,0,,2,4,.500,.500,2,4,.500,1,2,3,1,1,0,1,1,6
8480,BOS,2013,Darko Miličić,27,1,0,5,0,1,.000,0,0,,0,1,.000,.000,0,0,,0,1,1,0,0,0,2,1,0
8481,BOS,2012,Paul Pierce,34,61,61,2075,394,890,.443,100,273,.366,294,617,.476,.499,293,344,.852,37,280,317,274,70,26,173,147,1181
8482,BOS,2012,Rajon Rondo,25,53,53,1957,256,572,.448,10,42,.238,246,530,.464,.456,108,181,.597,62,195,257,620,95,3,193,99,630
8483,BOS,2012,Brandon Bass,26,59,39,1868,303,632,.479,0,0,,303,632,.479,.479,132,163,.810,95,270,365,55,34,54,65,135,738
8484,BOS,2012,Kevin Garnett,35,60,60,1864,391,777,.503,3,9,.333,388,768,.505,.505,162,189,.857,66,428,494,175,56,61,107,141,947
8485,BOS,2012,Ray Allen,36,46,42,1565,226,493,.458,106,234,.453,120,259,.463,.566,97,106,.915,14,128,142,109,49,8,68,83,655
8486,BOS,2012,Avery Bradley,21,64,28,1368,200,402,.498,22,54,.407,178,348,.511,.525,62,78,.795,34,81,115,87,43,12,75,109,484
8487,BOS,2012,Mickaël Piétrus,29,42,6,921,104,270,.385,61,182,.335,43,88,.489,.498,20,31,.645,18,112,130,25,21,10,33,81,289
8488,BOS,2012,Greg Stiemsma,26,55,3,766,66,121,.545,0,0,,66,121,.545,.545,29,41,.707,48,129,177,28,37,85,33,144,161
8489,BOS,2012,Keyon Dooling,31,46,2,662,66,163,.405,27,81,.333,39,82,.476,.488,23,31,.742,3,36,39,51,13,2,34,57,182
8490,BOS,2012,Jermaine O'Neal,33,25,24,570,52,120,.433,0,0,,52,120,.433,.433,21,31,.677,37,98,135,10,8,43,21,80,125
8491,BOS,2012,Sasha Pavlović,28,45,7,527,50,128,.391,17,58,.293,33,70,.471,.457,3,8,.375,4,68,72,18,20,15,20,54,120
8492,BOS,2012,Marquis Daniels,31,38,0,484,52,143,.364,0,10,.000,52,133,.391,.364,17,23,.739,16,50,66,47,21,9,28,36,121
8493,BOS,2012,Chris Wilcox,29,28,4,481,64,107,.598,0,0,,64,107,.598,.598,24,39,.615,38,84,122,12,11,9,30,64,152
8494,BOS,2012,E'Twaun Moore,22,38,0,331,43,113,.381,17,45,.378,26,68,.382,.456,7,7,1.000,4,29,33,34,11,3,21,33,110
8495,BOS,2012,JaJuan Johnson,22,36,0,298,54,121,.446,0,0,,54,121,.446,.446,6,9,.667,20,38,58,6,5,14,14,25,114
8496,BOS,2012,Ryan Hollins,27,15,1,160,18,28,.643,0,0,,18,28,.643,.643,6,20,.300,9,17,26,3,1,5,11,23,42
8497,BOS,2012,Sean Williams,25,3,0,42,2,6,.333,0,0,,2,6,.333,.333,7,7,1.000,4,8,12,3,3,3,3,4,11
8498,BOS,2011,Ray Allen,35,80,80,2890,480,978,.491,168,378,.444,312,600,.520,.577,193,219,.881,51,223,274,219,77,16,117,147,1321
8499,BOS,2011,Paul Pierce,33,80,80,2774,507,1021,.497,111,297,.374,396,724,.547,.551,386,449,.860,34,396,430,260,80,51,171,231,1511
8500,BOS,2011,Rajon Rondo,24,68,68,2527,318,670,.475,10,43,.233,308,627,.491,.482,75,132,.568,87,210,297,760,153,11,234,120,721
8501,BOS,2011,Glen Davis,25,78,13,2298,359,801,.448,2,15,.133,357,786,.454,.449,195,265,.736,101,324,425,92,78,30,85,231,915
8502,BOS,2011,Kevin Garnett,34,71,71,2220,434,822,.528,1,5,.200,433,817,.530,.529,187,217,.862,83,548,631,171,95,57,115,148,1056
8503,BOS,2011,Nate Robinson,26,55,11,983,146,361,.404,63,192,.328,83,169,.491,.492,33,40,.825,15,74,89,105,29,4,66,107,388
8504,BOS,2011,Marquis Daniels,30,49,0,938,114,232,.491,4,21,.190,110,211,.521,.500,39,57,.684,24,89,113,64,39,22,38,63,271
8505,BOS,2011,Shaquille O'Neal,38,37,36,752,134,201,.667,0,0,,134,201,.667,.667,73,131,.557,48,130,178,26,16,42,56,120,341
8506,BOS,2011,Jeff Green,24,26,2,612,98,202,.485,8,27,.296,90,175,.514,.505,50,63,.794,16,70,86,19,13,16,23,68,254
8507,BOS,2011,Von Wafer,25,58,2,553,67,159,.421,18,67,.269,49,92,.533,.478,32,38,.842,7,42,49,35,18,5,20,39,184
8508,BOS,2011,Nenad Krstić,27,24,20,553,79,147,.537,0,0,,79,147,.537,.537,60,80,.750,47,81,128,8,8,8,23,77,218
8509,BOS,2011,Semih Erden,24,37,7,531,58,97,.598,0,0,,58,97,.598,.598,34,54,.630,31,76,107,19,13,21,32,92,150
8510,BOS,2011,Delonte West,27,24,2,453,55,120,.458,12,33,.364,43,87,.494,.508,13,15,.867,6,31,37,64,20,10,30,29,135
8511,BOS,2011,Jermaine O'Neal,32,24,10,431,50,109,.459,0,1,.000,50,108,.463,.459,29,43,.674,25,63,88,12,2,30,27,65,129
8512,BOS,2011,Kendrick Perkins,26,12,7,313,32,59,.542,0,0,,32,59,.542,.542,23,40,.575,23,74,97,10,2,10,25,37,87
8513,BOS,2011,Luke Harangody,23,28,0,241,28,71,.394,2,10,.200,26,61,.426,.408,5,8,.625,17,38,55,10,4,7,5,36,63
8514,BOS,2011,Carlos Arroyo,31,15,1,190,11,35,.314,3,5,.600,8,30,.267,.357,11,12,.917,7,16,23,25,7,0,17,11,36
8515,BOS,2011,Troy Murphy,30,17,0,178,16,38,.421,1,10,.100,15,28,.536,.434,11,13,.846,11,27,38,6,8,1,7,19,44
8516,BOS,2011,Avery Bradley,20,31,0,162,23,67,.343,0,5,.000,23,62,.371,.343,6,12,.500,4,13,17,12,9,0,16,20,52
8517,BOS,2011,Sasha Pavlović,27,17,0,149,12,26,.462,5,10,.500,7,16,.438,.558,2,5,.400,1,13,14,3,5,0,6,15,31
8518,BOS,2011,Chris Johnson,25,4,0,32,2,3,.667,0,0,,2,3,.667,.667,2,2,1.000,1,4,5,1,0,3,2,3,6
8519,BOS,2010,Rajon Rondo,23,81,81,2963,459,904,.508,17,80,.213,442,824,.536,.517,175,282,.621,100,260,360,794,189,11,246,198,1110
8520,BOS,2010,Ray Allen,34,80,80,2819,464,973,.477,145,399,.363,319,574,.556,.551,231,253,.913,45,208,253,210,64,25,129,182,1304
8521,BOS,2010,Paul Pierce,32,71,71,2411,409,867,.472,109,263,.414,300,604,.497,.535,369,433,.852,39,271,310,218,84,31,166,196,1296
8522,BOS,2010,Kendrick Perkins,25,78,78,2154,314,522,.602,0,3,.000,314,519,.605,.602,163,280,.582,155,440,595,80,26,132,165,219,791
8523,BOS,2010,Kevin Garnett,33,69,69,2060,402,772,.521,1,5,.200,401,767,.523,.521,185,221,.837,78,428,506,185,68,57,101,170,990
8524,BOS,2010,Rasheed Wallace,35,79,13,1780,266,650,.409,82,290,.283,184,360,.511,.472,96,125,.768,42,283,325,80,80,70,63,222,710
8525,BOS,2010,Marquis Daniels,29,51,4,937,124,249,.498,6,28,.214,118,221,.534,.510,34,56,.607,27,68,95,66,27,6,42,91,288
8526,BOS,2010,Glen Davis,24,54,1,933,122,279,.437,0,4,.000,122,275,.444,.437,96,138,.696,101,104,205,35,21,14,53,132,340
8527,BOS,2010,Tony Allen,28,54,8,889,129,253,.510,0,5,.000,129,248,.520,.510,72,119,.605,52,93,145,72,59,19,66,109,330
8528,BOS,2010,Eddie House,31,50,0,846,129,322,.401,64,167,.383,65,155,.419,.500,36,40,.900,7,62,69,48,28,7,27,61,358
8529,BOS,2010,Shelden Williams,26,54,0,597,63,121,.521,0,1,.000,63,120,.525,.521,75,98,.765,47,99,146,21,13,21,30,85,201
8530,BOS,2010,Brian Scalabrine,31,52,3,472,29,85,.341,16,49,.327,13,36,.361,.435,4,6,.667,9,39,48,27,9,4,17,59,78
8531,BOS,2010,Nate Robinson,25,26,0,382,63,157,.401,36,87,.414,27,70,.386,.516,8,13,.615,5,33,38,51,22,0,20,50,170
8532,BOS,2010,Michael Finley,36,21,1,314,44,87,.506,19,41,.463,25,46,.543,.615,2,6,.333,1,32,33,24,4,2,8,21,109
8533,BOS,2010,J.R. Giddens,24,21,1,99,9,21,.429,0,2,.000,9,19,.474,.429,6,12,.500,4,16,20,6,4,1,7,10,24
8534,BOS,2010,Lester Hudson,25,16,0,70,7,18,.389,3,5,.600,4,13,.308,.472,5,6,.833,3,5,8,8,3,2,9,7,22
8535,BOS,2010,Henry Walker,22,8,0,29,3,6,.500,0,0,,3,6,.500,.500,2,2,1.000,0,5,5,3,0,0,2,4,8
8536,BOS,2010,Oliver Lafayette,25,1,0,22,3,6,.500,1,2,.500,2,4,.500,.583,0,0,,1,3,4,2,0,0,1,0,7
8537,BOS,2010,Marcus Landry,24,1,0,3,0,2,.000,0,2,.000,0,0,,.000,0,0,,0,0,0,0,0,0,0,0,0
8538,BOS,2009,Paul Pierce,31,81,81,3035,540,1181,.457,119,304,.391,421,877,.480,.508,459,553,.830,56,401,457,294,80,27,228,215,1658
8539,BOS,2009,Ray Allen,33,79,79,2876,499,1040,.480,199,486,.409,300,554,.542,.575,237,249,.952,66,212,278,218,69,13,134,157,1434
8540,BOS,2009,Rajon Rondo,22,80,80,2642,383,759,.505,15,48,.313,368,711,.518,.514,172,268,.642,100,316,416,659,149,11,209,193,953
8541,BOS,2009,Kendrick Perkins,24,76,76,2253,276,478,.577,0,2,.000,276,476,.580,.577,96,160,.600,204,415,619,96,22,150,165,253,648
8542,BOS,2009,Kevin Garnett,32,57,57,1772,393,740,.531,2,8,.250,391,732,.534,.532,111,132,.841,78,407,485,144,63,68,90,128,899
8543,BOS,2009,Glen Davis,23,76,16,1637,199,450,.442,2,5,.400,197,445,.443,.444,130,178,.730,121,180,301,69,53,19,71,230,530
8544,BOS,2009,Eddie House,30,81,0,1479,249,560,.445,151,340,.444,98,220,.445,.579,42,53,.792,11,146,157,92,61,7,55,113,691
8545,BOS,2009,Leon Powe,25,70,7,1227,177,338,.524,0,0,,177,338,.524,.524,184,267,.689,145,200,345,46,24,38,76,192,538
8546,BOS,2009,Tony Allen,27,46,2,887,137,284,.482,6,27,.222,131,257,.510,.493,79,109,.725,22,82,104,66,54,23,77,98,359
8547,BOS,2009,Brian Scalabrine,30,39,8,504,48,114,.421,24,61,.393,24,53,.453,.526,16,18,.889,7,43,50,18,7,10,12,73,136
8548,BOS,2009,Mikki Moore,33,24,0,456,51,85,.600,0,0,,51,85,.600,.600,14,19,.737,31,75,106,25,4,5,21,96,116
8549,BOS,2009,Stephon Marbury,31,23,4,414,38,111,.342,6,25,.240,32,86,.372,.369,6,13,.462,2,26,28,75,10,3,37,34,88
8550,BOS,2009,Gabe Pruitt,22,47,0,366,31,101,.307,14,48,.292,17,53,.321,.376,17,21,.810,9,34,43,39,15,3,19,34,93
8551,BOS,2009,Henry Walker,21,29,0,216,36,58,.621,0,1,.000,36,57,.632,.621,16,23,.696,8,21,29,13,6,2,18,51,88
8552,BOS,2009,Patrick O'Bryant,22,26,0,108,16,31,.516,0,0,,16,31,.516,.516,8,12,.667,7,27,34,8,3,8,17,29,40
8553,BOS,2009,J.R. Giddens,23,6,0,8,2,3,.667,0,0,,2,3,.667,.667,0,0,,2,1,3,0,1,0,1,1,4
8554,BOS,2008,Paul Pierce,30,80,80,2874,509,1098,.464,143,365,.392,366,733,.499,.529,409,485,.843,53,358,411,363,101,36,221,200,1570
8555,BOS,2008,Ray Allen,32,73,73,2624,439,986,.445,180,452,.398,259,534,.485,.537,215,237,.907,75,193,268,225,65,16,127,147,1273
8556,BOS,2008,Kevin Garnett,31,71,71,2328,534,990,.539,0,11,.000,534,979,.545,.539,269,336,.801,135,520,655,244,100,89,138,163,1337
8557,BOS,2008,Rajon Rondo,21,77,77,2306,351,713,.492,5,19,.263,346,694,.499,.496,107,175,.611,78,244,322,393,129,13,147,187,814
8558,BOS,2008,Kendrick Perkins,23,78,78,1912,214,348,.615,0,1,.000,214,347,.617,.615,114,183,.623,145,329,474,84,31,114,125,242,542
8559,BOS,2008,James Posey,31,74,2,1821,173,414,.418,106,279,.380,67,135,.496,.546,93,115,.809,30,292,322,114,72,19,65,182,545
8560,BOS,2008,Eddie House,29,78,2,1480,217,531,.409,117,298,.393,100,233,.429,.519,33,36,.917,19,148,167,152,59,10,76,114,584
8561,BOS,2008,Tony Allen,26,75,11,1373,169,389,.434,18,57,.316,151,332,.455,.458,138,181,.762,34,134,168,114,62,21,109,168,494
8562,BOS,2008,Glen Davis,22,69,1,940,107,221,.484,0,0,,107,221,.484,.484,99,150,.660,95,113,208,28,31,20,65,160,313
8563,BOS,2008,Leon Powe,24,56,5,809,154,269,.572,0,1,.000,154,268,.575,.572,137,193,.710,95,132,227,15,15,16,43,127,445
8564,BOS,2008,Brian Scalabrine,29,48,9,512,29,94,.309,15,46,.326,14,48,.292,.388,15,20,.750,22,57,79,40,9,8,26,63,88
8565,BOS,2008,Sam Cassell,38,17,1,299,50,130,.385,9,22,.409,41,108,.380,.419,21,25,.840,5,26,31,35,9,3,19,29,130
8566,BOS,2008,P.J. Brown,38,18,0,209,14,41,.341,0,1,.000,14,40,.350,.341,11,16,.688,29,39,68,10,5,8,10,29,39
8567,BOS,2008,Scot Pollard,32,22,0,173,12,23,.522,0,0,,12,23,.522,.522,15,22,.682,14,23,37,3,3,6,5,43,39
8568,BOS,2008,Gabe Pruitt,21,15,0,95,14,39,.359,3,12,.250,11,27,.407,.397,1,2,.500,1,7,8,13,5,0,5,10,32
8569,BOS,2007,Al Jefferson,22,69,60,2319,453,882,.514,0,1,.000,453,881,.514,.514,201,295,.681,237,519,756,88,48,106,136,232,1107
8570,BOS,2007,Ryan Gomes,24,73,60,2275,338,723,.467,16,42,.381,322,681,.473,.479,189,233,.811,125,282,407,119,48,13,105,169,881
8571,BOS,2007,Delonte West,23,69,47,2219,306,717,.427,65,178,.365,241,539,.447,.472,168,197,.853,32,176,208,304,74,34,140,152,845
8572,BOS,2007,Rajon Rondo,20,78,25,1831,188,450,.418,6,29,.207,182,421,.432,.424,119,184,.647,74,218,292,297,128,8,137,181,501
8573,BOS,2007,Gerald Green,21,81,26,1780,310,739,.419,95,258,.368,215,481,.447,.484,128,159,.805,68,140,208,83,41,24,120,198,843
8574,BOS,2007,Paul Pierce,29,47,46,1740,373,850,.439,107,275,.389,266,575,.463,.502,320,402,.796,39,238,277,194,48,13,152,122,1173
8575,BOS,2007,Sebastian Telfair,21,78,30,1578,176,474,.371,37,128,.289,139,346,.402,.410,90,110,.818,17,91,108,218,43,11,98,166,479
8576,BOS,2007,Kendrick Perkins,22,72,53,1576,132,269,.491,0,3,.000,132,266,.496,.491,60,100,.600,113,259,372,94,23,96,113,214,324
8577,BOS,2007,Brian Scalabrine,28,54,17,1027,77,191,.403,44,110,.400,33,81,.407,.518,18,23,.783,24,81,105,59,23,18,44,130,216
8578,BOS,2007,Wally Szczerbiak,29,32,19,900,161,388,.415,44,106,.415,117,282,.415,.472,113,126,.897,16,82,98,55,18,3,54,65,479
8579,BOS,2007,Tony Allen,25,33,18,805,133,259,.514,8,33,.242,125,226,.553,.529,105,134,.784,35,89,124,56,49,12,75,87,379
8580,BOS,2007,Leon Powe,23,63,2,720,79,177,.446,0,2,.000,79,175,.451,.446,106,144,.736,97,118,215,10,14,22,47,104,264
8581,BOS,2007,Allan Ray,22,47,5,710,100,259,.386,48,116,.414,52,143,.364,.479,42,55,.764,18,51,69,43,20,3,42,85,290
8582,BOS,2007,Michael Olowokandi,31,24,0,234,19,46,.413,0,0,,19,46,.413,.413,2,3,.667,14,34,48,5,8,13,17,48,40
8583,BOS,2007,Kevinn Pinkney,23,6,0,100,12,27,.444,1,2,.500,11,25,.440,.463,6,9,.667,7,8,15,5,3,3,4,12,31
8584,BOS,2007,Theo Ratliff,33,2,2,44,1,3,.333,0,0,,1,3,.333,.333,3,4,.750,2,5,7,0,1,3,1,6,5
8585,BOS,2006,Paul Pierce,28,79,79,3084,689,1462,.471,111,314,.354,578,1148,.503,.509,627,812,.772,77,453,530,375,107,34,273,223,2116
8586,BOS,2006,Delonte West,22,71,71,2418,333,684,.487,84,218,.385,249,466,.534,.548,86,101,.851,57,232,289,329,84,46,133,197,836
8587,BOS,2006,Raef LaFrentz,29,82,63,2033,238,552,.431,112,286,.392,126,266,.474,.533,51,75,.680,80,326,406,115,29,72,65,273,639
8588,BOS,2006,Ricky Davis,26,42,42,1747,329,709,.464,40,125,.320,289,584,.495,.492,129,164,.787,40,147,187,221,49,9,115,91,827
8589,BOS,2006,Ryan Gomes,23,61,33,1376,173,355,.487,3,9,.333,170,346,.491,.492,112,149,.752,102,196,298,58,35,5,55,83,461
8590,BOS,2006,Kendrick Perkins,21,68,40,1332,137,266,.515,0,2,.000,137,264,.519,.515,80,130,.615,140,264,404,69,21,105,107,199,354
8591,BOS,2006,Orien Greene,23,80,5,1235,100,253,.395,9,40,.225,91,213,.427,.413,45,68,.662,37,108,145,129,77,10,109,181,254
8592,BOS,2006,Wally Szczerbiak,28,32,31,1174,201,422,.476,44,112,.393,157,310,.506,.528,115,128,.898,41,82,123,101,19,4,50,60,561
8593,BOS,2006,Mark Blount,30,39,25,1083,194,380,.511,0,0,,194,380,.511,.511,97,127,.764,36,126,162,66,15,36,120,107,485
8594,BOS,2006,Al Jefferson,21,59,7,1062,189,379,.499,0,4,.000,189,375,.504,.499,86,134,.642,97,202,299,30,30,46,62,166,464
8595,BOS,2006,Tony Allen,24,51,9,978,129,274,.471,11,34,.324,118,240,.492,.491,100,134,.746,32,79,111,67,51,18,67,126,369
8596,BOS,2006,Brian Scalabrine,27,71,1,938,74,193,.383,31,87,.356,43,106,.406,.464,26,36,.722,27,87,114,51,21,19,50,127,205
8597,BOS,2006,Gerald Green,20,32,3,374,66,138,.478,6,20,.300,60,118,.508,.500,29,37,.784,10,31,41,18,13,4,22,41,167
8598,BOS,2006,Justin Reed,24,32,0,291,25,74,.338,0,0,,25,74,.338,.338,25,40,.625,13,16,29,7,5,4,15,45,75
8599,BOS,2006,Marcus Banks,24,18,1,269,33,80,.413,6,19,.316,27,61,.443,.450,27,30,.900,4,15,19,32,7,0,23,38,99
8600,BOS,2006,Dan Dickau,27,19,0,234,17,46,.370,10,20,.500,7,26,.269,.478,18,18,1.000,5,11,16,40,11,1,18,40,62
8601,BOS,2006,Michael Olowokandi,30,16,0,167,20,45,.444,0,0,,20,45,.444,.444,5,8,.625,5,36,41,6,3,6,14,22,45
8602,BOS,2006,Dwayne Jones,22,14,0,87,4,10,.400,0,0,,4,10,.400,.400,6,13,.462,10,21,31,2,1,3,3,14,14
8603,BOS,2005,Paul Pierce,27,82,82,2960,556,1223,.455,108,292,.370,448,931,.481,.499,549,668,.822,78,461,539,348,133,39,230,255,1769
8604,BOS,2005,Ricky Davis,25,82,11,2696,481,1041,.462,61,180,.339,420,861,.488,.491,286,351,.815,66,183,249,246,89,27,205,174,1309
8605,BOS,2005,Gary Payton,36,77,77,2541,339,725,.468,42,129,.326,297,596,.498,.497,153,201,.761,48,188,236,469,88,12,148,121,873
8606,BOS,2005,Raef LaFrentz,28,80,80,2196,341,688,.496,82,225,.364,259,463,.559,.555,120,148,.811,154,399,553,98,42,99,70,262,884
8607,BOS,2005,Mark Blount,29,82,57,2130,327,618,.529,0,1,.000,327,617,.530,.529,117,164,.713,143,254,397,129,33,64,158,229,771
8608,BOS,2005,Tony Allen,23,77,34,1262,184,387,.475,12,31,.387,172,356,.483,.491,112,152,.737,85,136,221,64,76,24,77,156,492
8609,BOS,2005,Marcus Banks,23,81,2,1145,115,286,.402,21,59,.356,94,227,.414,.439,121,163,.742,29,97,126,155,63,13,79,146,372
8610,BOS,2005,Jiří Welsch,25,55,32,1125,137,320,.428,32,99,.323,105,221,.475,.478,109,141,.773,20,119,139,84,39,5,58,105,415
8611,BOS,2005,Al Jefferson,20,71,1,1051,195,369,.528,0,3,.000,195,366,.533,.528,85,135,.630,119,193,312,24,22,55,66,195,475
8612,BOS,2005,Antoine Walker,28,24,24,827,161,364,.442,25,73,.342,136,291,.467,.477,44,79,.557,56,142,198,71,25,26,70,70,391
8613,BOS,2005,Walter McCarty,30,44,0,553,62,150,.413,30,90,.333,32,60,.533,.513,8,15,.533,21,56,77,26,15,9,17,85,162
8614,BOS,2005,Kendrick Perkins,20,60,3,548,56,119,.471,0,0,,56,119,.471,.471,37,58,.638,53,123,176,21,9,37,43,98,149
8615,BOS,2005,Delonte West,21,39,7,507,66,155,.426,24,67,.358,42,88,.477,.503,19,27,.704,14,51,65,53,21,8,24,69,175
8616,BOS,2005,Tom Gugliotta,35,20,0,218,11,37,.297,0,0,,11,37,.297,.297,4,6,.667,15,28,43,12,9,4,9,23,26
8617,BOS,2005,Justin Reed,23,23,0,121,15,29,.517,0,3,.000,15,26,.577,.517,11,15,.733,8,8,16,10,3,1,5,12,41
8618,BOS,2004,Paul Pierce,26,80,80,3099,602,1497,.402,115,384,.299,487,1113,.438,.441,517,631,.819,69,453,522,410,131,52,303,234,1836
8619,BOS,2004,Mark Blount,28,82,73,2402,342,604,.566,0,0,,342,604,.566,.566,159,221,.719,207,382,589,75,80,106,150,253,843
8620,BOS,2004,Jiří Welsch,24,81,68,2179,262,612,.428,69,181,.381,193,431,.448,.484,153,206,.743,60,236,296,183,101,7,129,176,746
8621,BOS,2004,Walter McCarty,29,77,23,1900,203,523,.388,137,366,.374,66,157,.420,.519,62,82,.756,28,211,239,124,72,22,91,179,605
8622,BOS,2004,Mike James,28,55,55,1684,213,510,.418,86,226,.381,127,284,.447,.502,76,95,.800,20,156,176,244,70,2,83,113,588
8623,BOS,2004,Ricky Davis,24,57,5,1678,312,639,.488,35,92,.380,277,547,.506,.516,145,198,.732,59,178,237,148,71,14,121,120,804
8624,BOS,2004,Marcus Banks,22,81,2,1385,177,442,.400,27,86,.314,150,356,.421,.431,99,131,.756,30,103,133,175,88,13,125,171,480
8625,BOS,2004,Vin Baker,32,37,33,1000,168,333,.505,0,1,.000,168,332,.506,.505,82,112,.732,76,134,210,54,22,23,52,98,418
8626,BOS,2004,Chris Mihm,24,54,16,939,127,254,.500,0,0,,127,254,.500,.500,76,118,.644,109,164,273,11,28,41,65,150,330
8627,BOS,2004,Chucky Atkins,29,24,24,793,104,249,.418,39,111,.351,65,138,.471,.496,42,54,.778,3,42,45,128,26,1,44,42,289
8628,BOS,2004,Eric Williams,31,21,0,513,77,177,.435,11,32,.344,66,145,.455,.466,78,109,.716,21,74,95,25,22,1,31,52,243
8629,BOS,2004,Tony Battie,27,23,6,501,56,117,.479,1,1,1.000,55,116,.474,.483,23,33,.697,39,79,118,21,8,20,24,55,136
8630,BOS,2004,Kedrick Brown,22,21,10,408,45,99,.455,12,32,.375,33,67,.493,.515,8,13,.615,18,50,68,25,17,2,12,38,110
8631,BOS,2004,Brandon Hunter,23,36,12,406,53,116,.457,0,3,.000,53,113,.469,.457,19,43,.442,50,68,118,19,13,1,22,40,125
8632,BOS,2004,Jumaine Jones,24,42,2,373,33,96,.344,13,44,.295,20,52,.385,.411,14,23,.609,24,44,68,14,12,9,19,48,93
8633,BOS,2004,Raef LaFrentz,27,17,1,328,57,124,.460,8,40,.200,49,84,.583,.492,10,13,.769,30,49,79,24,8,13,11,47,132
8634,BOS,2004,Michael Stewart,28,17,0,71,2,5,.400,0,0,,2,5,.400,.400,1,2,.500,3,8,11,0,1,2,2,13,5
8635,BOS,2004,Kendrick Perkins,19,10,0,35,8,15,.533,0,0,,8,15,.533,.533,6,9,.667,5,9,14,3,0,2,5,6,22
8636,BOS,2004,Dana Barros,36,1,0,11,2,3,.667,0,0,,2,3,.667,.667,2,2,1.000,0,0,0,0,0,0,0,2,6
8637,BOS,2003,Antoine Walker,26,78,78,3235,603,1554,.388,188,582,.323,415,972,.427,.449,176,286,.615,99,464,563,373,116,31,260,221,1570
8638,BOS,2003,Paul Pierce,25,79,79,3096,663,1592,.416,118,391,.302,545,1201,.454,.454,604,753,.802,106,472,578,349,139,62,288,227,2048
8639,BOS,2003,Eric Williams,30,82,79,2350,254,575,.442,37,110,.336,217,465,.467,.474,201,268,.750,143,239,382,140,86,19,97,234,746
8640,BOS,2003,Walter McCarty,28,82,8,1949,173,418,.414,91,248,.367,82,170,.482,.523,61,98,.622,64,224,288,106,78,28,67,188,498
8641,BOS,2003,Tony Delk,29,67,39,1873,233,560,.416,120,304,.395,113,256,.441,.523,68,87,.782,41,191,232,146,72,10,69,124,654
8642,BOS,2003,Tony Battie,26,67,62,1683,199,369,.539,1,5,.200,198,364,.544,.541,88,118,.746,148,285,433,49,33,81,48,197,487
8643,BOS,2003,J.R. Bremer,22,64,41,1503,171,464,.369,101,286,.353,70,178,.393,.477,85,111,.766,18,127,145,164,38,3,59,80,528
8644,BOS,2003,Shammond Williams,27,51,2,1169,134,338,.396,56,159,.352,78,179,.436,.479,48,57,.842,12,98,110,128,61,3,61,84,372
8645,BOS,2003,Vin Baker,31,52,9,942,99,207,.478,0,4,.000,99,203,.488,.478,72,107,.673,90,108,198,29,22,30,61,146,270
8646,BOS,2003,Kedrick Brown,21,51,5,666,61,171,.357,3,39,.077,58,132,.439,.365,20,32,.625,45,95,140,20,34,13,23,68,145
8647,BOS,2003,Mark Blount,27,27,7,518,45,80,.563,0,0,,45,80,.563,.563,30,40,.750,49,76,125,21,20,17,33,75,120
8648,BOS,2003,Grant Long,36,41,1,488,27,70,.386,0,3,.000,27,67,.403,.386,18,23,.783,24,59,83,25,9,1,19,62,72
8649,BOS,2003,Bimbo Coles,34,14,0,175,22,49,.449,0,7,.000,22,42,.524,.449,8,8,1.000,1,10,11,16,6,0,10,17,52
8650,BOS,2003,Bruno Šundov,22,26,0,138,14,56,.250,4,16,.250,10,40,.250,.286,0,2,.000,8,20,28,7,6,3,9,24,32
8651,BOS,2003,Rubén Wolkowyski,29,7,0,24,2,4,.500,0,1,.000,2,3,.667,.500,1,4,.250,0,1,1,1,0,0,1,3,5
8652,BOS,2003,Mikki Moore,27,3,0,12,0,1,.000,0,0,,0,1,.000,.000,0,0,,1,0,1,0,0,2,0,6,0
8653,BOS,2003,Mark Bryant,37,2,0,9,0,1,.000,0,0,,0,1,.000,.000,0,0,,0,2,2,1,0,0,0,2,0
8654,BOS,2002,Antoine Walker,25,81,81,3406,666,1689,.394,222,645,.344,444,1044,.425,.460,240,324,.741,150,564,714,407,122,38,251,237,1794
8655,BOS,2002,Paul Pierce,24,82,82,3302,707,1598,.442,210,520,.404,497,1078,.461,.508,520,643,.809,81,485,566,261,154,86,241,237,2144
8656,BOS,2002,Kenny Anderson,31,76,76,2430,312,716,.436,9,33,.273,303,683,.444,.442,98,132,.742,57,218,275,403,141,10,119,210,731
8657,BOS,2002,Tony Battie,25,74,73,1819,211,390,.541,0,2,.000,211,388,.544,.541,88,130,.677,184,297,481,35,60,67,51,219,510
8658,BOS,2002,Eric Williams,29,74,30,1747,144,385,.374,24,86,.279,120,299,.401,.405,160,219,.731,58,163,221,109,77,8,95,179,472
8659,BOS,2002,Erick Strickland,28,79,4,1643,190,488,.389,95,247,.385,95,241,.394,.487,131,155,.845,22,191,213,184,56,1,94,145,606
8660,BOS,2002,Vitaly Potapenko,26,79,9,1343,137,301,.455,0,0,,137,301,.455,.455,89,120,.742,167,180,347,30,37,18,63,174,363
8661,BOS,2002,Joe Johnson,20,48,33,1003,130,296,.439,24,88,.273,106,208,.510,.480,20,26,.769,40,99,139,74,33,9,28,59,304
8662,BOS,2002,Walter McCarty,27,56,0,718,80,180,.444,39,99,.394,41,81,.506,.553,13,19,.684,32,96,128,41,18,7,22,83,212
8663,BOS,2002,Rodney Rogers,30,27,1,626,107,222,.482,39,95,.411,68,127,.535,.570,35,50,.700,34,73,107,40,16,12,42,78,288
8664,BOS,2002,Tony Delk,28,22,16,570,60,172,.349,20,67,.299,40,105,.381,.407,22,30,.733,20,59,79,51,22,6,19,38,162
8665,BOS,2002,Milt Palacio,23,41,0,518,52,135,.385,12,34,.353,40,101,.396,.430,36,51,.706,8,42,50,54,21,3,24,38,152
8666,BOS,2002,Mark Blount,26,44,0,415,32,76,.421,0,0,,32,76,.421,.421,30,37,.811,26,59,85,10,16,19,23,59,94
8667,BOS,2002,Kedrick Brown,20,29,5,245,23,70,.329,5,27,.185,18,43,.419,.364,12,20,.600,11,39,50,15,18,7,7,18,63
8668,BOS,2002,Joseph Forte,20,8,0,39,1,12,.083,0,3,.000,1,9,.111,.083,4,4,1.000,1,5,6,6,2,0,3,1,6
8669,BOS,2002,Randy Brown,33,1,0,6,0,1,.000,0,0,,0,1,.000,.000,0,0,,0,0,0,2,0,1,0,1,0
8670,BOS,2001,Antoine Walker,24,81,81,3396,711,1720,.413,221,603,.367,490,1117,.439,.478,249,348,.716,151,568,719,445,138,49,301,251,1892
8671,BOS,2001,Paul Pierce,23,82,82,3120,687,1513,.454,147,384,.383,540,1129,.478,.503,550,738,.745,94,428,522,253,138,69,262,251,2071
8672,BOS,2001,Bryant Stith,30,78,74,2504,245,611,.401,91,242,.376,154,369,.417,.475,175,207,.845,65,219,284,168,93,14,90,182,756
8673,BOS,2001,Vitaly Potapenko,25,82,7,1901,248,521,.476,0,0,,248,521,.476,.476,115,158,.728,206,289,495,64,52,23,105,228,611
8674,BOS,2001,Eric Williams,28,81,11,1745,162,448,.362,46,139,.331,116,309,.375,.413,165,231,.714,64,143,207,112,64,13,76,179,535
8675,BOS,2001,Randy Brown,32,54,35,1238,100,237,.422,0,3,.000,100,234,.427,.422,23,40,.575,23,76,99,154,62,10,56,132,223
8676,BOS,2001,Milt Palacio,22,58,6,1141,126,267,.472,12,36,.333,114,231,.494,.494,78,92,.848,25,77,102,151,48,0,80,83,342
8677,BOS,2001,Mark Blount,25,64,50,1098,101,200,.505,0,0,,101,200,.505,.505,46,66,.697,97,134,231,32,39,76,62,183,248
8678,BOS,2001,Kenny Anderson,30,33,28,849,88,227,.388,11,33,.333,77,194,.397,.412,59,71,.831,16,57,73,134,44,2,52,62,246
8679,BOS,2001,Tony Battie,24,40,25,845,108,201,.537,0,3,.000,108,198,.545,.537,44,69,.638,73,160,233,16,27,60,37,126,260
8680,BOS,2001,Walter McCarty,26,60,3,478,45,126,.357,19,56,.339,26,70,.371,.433,22,28,.786,24,57,81,39,14,7,20,82,131
8681,BOS,2001,Chris Herren,25,25,7,408,29,96,.302,16,55,.291,13,41,.317,.385,9,12,.750,4,17,21,56,14,0,20,43,83
8682,BOS,2001,Adrian Griffin,26,44,0,377,33,97,.340,9,26,.346,24,71,.338,.387,18,24,.750,27,60,87,27,18,5,18,45,93
8683,BOS,2001,Chris Carr,26,35,0,309,53,112,.473,17,37,.459,36,75,.480,.549,46,60,.767,11,33,44,11,4,3,19,45,169
8684,BOS,2001,Doug Overton,31,7,1,144,15,44,.341,1,4,.250,14,40,.350,.352,7,11,.636,3,12,15,19,4,0,13,15,38
8685,BOS,2001,Rick Brunson,28,7,0,142,10,35,.286,2,11,.182,8,24,.333,.314,4,9,.444,2,7,9,24,7,1,9,16,26
8686,BOS,2001,Jérôme Moïso,22,24,0,135,12,30,.400,0,1,.000,12,29,.414,.400,11,26,.423,12,30,42,3,3,4,18,29,35
8687,BOS,2000,Antoine Walker,23,82,82,3003,648,1506,.430,73,285,.256,575,1221,.471,.455,311,445,.699,199,453,652,305,117,32,259,263,1680
8688,BOS,2000,Kenny Anderson,29,82,82,2593,434,986,.440,85,220,.386,349,766,.456,.483,196,253,.775,55,170,225,420,139,8,130,230,1149
8689,BOS,2000,Paul Pierce,22,73,72,2583,486,1099,.442,96,280,.343,390,819,.476,.486,359,450,.798,83,313,396,221,152,62,178,237,1427
8690,BOS,2000,Adrian Griffin,25,72,47,1927,175,413,.424,16,57,.281,159,356,.447,.443,119,158,.753,128,244,372,177,116,15,93,222,485
8691,BOS,2000,Vitaly Potapenko,24,79,72,1797,307,615,.499,0,1,.000,307,614,.500,.499,109,160,.681,182,317,499,77,41,29,145,239,723
8692,BOS,2000,Tony Battie,23,82,4,1505,219,459,.477,1,8,.125,218,451,.483,.478,102,151,.675,152,258,410,63,47,70,67,249,541
8693,BOS,2000,Eric Williams,27,68,17,1378,165,386,.427,25,72,.347,140,314,.446,.460,134,169,.793,55,101,156,93,44,16,66,165,489
8694,BOS,2000,Calbert Cheaney,28,67,19,1309,120,273,.440,18,54,.333,102,219,.466,.473,9,21,.429,23,115,138,80,44,14,46,158,267
8695,BOS,2000,Dana Barros,32,72,0,1139,196,435,.451,59,144,.410,137,291,.471,.518,66,76,.868,13,86,99,133,31,4,66,80,517
8696,BOS,2000,Walter McCarty,25,61,5,879,78,230,.339,34,110,.309,44,120,.367,.413,39,54,.722,33,77,110,70,24,23,67,83,229
8697,BOS,2000,Danny Fortson,23,55,5,856,140,265,.528,0,0,,140,265,.528,.528,139,189,.735,141,225,366,29,20,5,67,180,419
8698,BOS,2000,Doug Overton,30,48,0,432,61,154,.396,10,28,.357,51,126,.405,.429,20,21,.952,14,19,33,53,10,0,20,46,152
8699,BOS,2000,Pervis Ellison,32,30,5,269,19,43,.442,0,0,,19,43,.442,.442,15,21,.714,29,38,67,13,10,8,13,67,53
8700,BOS,2000,Wayne Turner,23,3,0,41,1,6,.167,0,0,,1,6,.167,.167,2,6,.333,1,2,3,5,0,0,3,4,4
8701,BOS,2000,Jamel Thomas,26,3,0,19,5,10,.500,0,1,.000,5,9,.556,.500,1,1,1.000,0,2,2,2,0,0,1,0,11
8702,BOS,1999,Paul Pierce,21,48,47,1632,284,647,.439,84,204,.412,200,443,.451,.504,139,195,.713,117,192,309,115,82,50,113,139,791
8703,BOS,1999,Ron Mercer,22,41,40,1551,305,707,.431,5,30,.167,300,677,.443,.435,83,105,.790,37,118,155,104,67,12,89,81,698
8704,BOS,1999,Antoine Walker,22,42,41,1549,303,735,.412,65,176,.369,238,559,.426,.456,113,202,.559,106,253,359,130,63,28,119,142,784
8705,BOS,1999,Dana Barros,31,50,16,1156,168,371,.453,64,160,.400,104,211,.493,.539,64,73,.877,16,89,105,208,52,5,88,64,464
8706,BOS,1999,Tony Battie,22,50,15,1121,147,283,.519,0,3,.000,147,280,.525,.519,41,61,.672,96,204,300,53,29,71,45,159,335
8707,BOS,1999,Kenny Anderson,28,34,33,1010,161,357,.451,6,24,.250,155,333,.465,.459,84,101,.832,24,79,103,193,33,2,71,78,412
8708,BOS,1999,Vitaly Potapenko,23,33,32,927,149,286,.521,0,0,,149,286,.521,.521,58,106,.547,91,147,238,59,24,20,72,116,356
8709,BOS,1999,Greg Minor,27,44,7,765,85,204,.417,8,28,.286,77,176,.438,.436,36,48,.750,31,86,117,50,20,6,38,69,214
8710,BOS,1999,Walter McCarty,24,32,4,659,64,177,.362,13,50,.260,51,127,.402,.398,40,57,.702,36,79,115,40,24,13,40,88,181
8711,BOS,1999,Bruce Bowen,27,30,1,494,26,93,.280,7,26,.269,19,67,.284,.317,11,24,.458,15,37,52,28,21,9,13,51,70
8712,BOS,1999,Eric Riley,28,35,11,337,28,54,.519,0,0,,28,54,.519,.519,22,31,.710,36,63,99,13,9,26,26,73,78
8713,BOS,1999,Andrew DeClercq,25,14,1,258,28,57,.491,0,0,,28,57,.491,.491,19,29,.655,33,30,63,10,13,9,22,51,75
8714,BOS,1999,Damon Jones,22,13,0,213,29,75,.387,15,33,.455,14,42,.333,.487,3,4,.750,4,27,31,29,6,0,12,16,76
8715,BOS,1999,Popeye Jones,28,18,2,206,20,51,.392,0,1,.000,20,50,.400,.392,14,17,.824,28,24,52,15,5,0,7,31,54
8716,BOS,1999,Marlon Garnett,23,24,0,205,15,51,.294,6,23,.261,9,28,.321,.353,15,20,.750,3,18,21,18,5,1,12,18,51
8717,BOS,1999,Dwayne Schintzius,30,16,0,67,4,16,.250,0,0,,4,16,.250,.250,3,4,.750,7,12,19,8,0,3,10,17,11
8718,BOS,1998,Antoine Walker,21,82,82,3268,722,1705,.423,91,292,.312,631,1413,.447,.450,305,473,.645,270,566,836,273,142,60,292,262,1840
8719,BOS,1998,Ron Mercer,21,80,62,2662,515,1145,.450,3,28,.107,512,1117,.458,.451,188,224,.839,109,171,280,176,125,17,132,213,1221
8720,BOS,1998,Walter McCarty,23,82,64,2340,295,730,.404,54,175,.309,241,555,.434,.441,144,194,.742,141,223,364,177,110,44,141,274,788
8721,BOS,1998,Dana Barros,30,80,15,1686,281,609,.461,100,246,.407,181,363,.499,.544,122,144,.847,28,125,153,286,83,6,107,124,784
8722,BOS,1998,Andrew DeClercq,24,81,49,1523,169,340,.497,0,1,.000,169,339,.499,.497,101,168,.601,180,212,392,59,85,49,84,277,439
8723,BOS,1998,Travis Knight,23,74,21,1503,193,438,.441,15,55,.273,178,383,.465,.458,81,103,.786,146,219,365,104,54,82,87,253,482
8724,BOS,1998,Bruce Bowen,26,61,9,1305,122,298,.409,20,59,.339,102,239,.427,.443,76,122,.623,79,95,174,81,87,29,52,174,340
8725,BOS,1998,Chauncey Billups,21,51,44,1296,177,454,.390,64,189,.339,113,265,.426,.460,147,180,.817,40,73,113,217,77,2,118,118,565
8726,BOS,1998,Greg Minor,26,69,16,1126,140,321,.436,6,31,.194,134,290,.462,.445,59,86,.686,55,95,150,88,53,11,43,100,345
8727,BOS,1998,Dee Brown,29,41,10,811,109,255,.427,43,113,.381,66,142,.465,.512,19,28,.679,10,52,62,53,44,6,32,76,280
8728,BOS,1998,Tyus Edney,24,52,7,623,93,216,.431,3,10,.300,90,206,.437,.438,88,111,.793,20,35,55,139,51,1,66,69,277
8729,BOS,1998,Pervis Ellison,30,33,8,447,40,70,.571,0,0,,40,70,.571,.571,20,34,.588,52,57,109,31,20,31,28,90,100
8730,BOS,1998,Kenny Anderson,27,16,16,386,64,147,.435,10,27,.370,54,120,.450,.469,41,49,.837,3,36,39,100,26,0,29,36,179
8731,BOS,1998,John Thomas,22,33,2,368,41,80,.513,0,0,,41,80,.513,.513,26,33,.788,32,38,70,13,19,9,33,65,108
8732,BOS,1998,Žan Tabak,27,18,5,232,26,55,.473,0,0,,26,55,.473,.473,7,13,.538,25,33,58,12,5,11,17,46,59
8733,BOS,1998,Dontae' Jones,22,15,0,91,19,57,.333,6,23,.261,13,34,.382,.386,0,0,,3,6,9,5,2,3,11,12,44
8734,BOS,1998,Roy Rogers,24,9,0,37,3,8,.375,0,0,,3,8,.375,.375,1,2,.500,0,5,5,1,2,4,1,6,7
8735,BOS,1998,Reggie Hanson,29,8,0,26,3,6,.500,0,0,,3,6,.500,.500,0,0,,3,3,6,1,2,1,3,8,6
8736,BOS,1997,David Wesley,26,74,73,2991,456,974,.468,103,286,.360,353,688,.513,.521,225,288,.781,67,197,264,537,162,13,211,221,1240
8737,BOS,1997,Antoine Walker,20,82,68,2970,576,1354,.425,52,159,.327,524,1195,.438,.445,231,366,.631,288,453,741,262,105,53,230,271,1435
8738,BOS,1997,Rick Fox,27,76,75,2650,433,950,.456,101,278,.363,332,672,.494,.509,207,263,.787,114,280,394,286,167,40,178,279,1174
8739,BOS,1997,Eric Williams,24,72,67,2435,374,820,.456,2,8,.250,372,812,.458,.457,328,436,.752,126,203,329,129,72,13,139,213,1078
8740,BOS,1997,Todd Day,27,81,27,2277,398,999,.398,126,348,.362,272,651,.418,.461,256,331,.773,109,221,330,117,108,48,127,208,1178
8741,BOS,1997,Marty Conlon,29,74,15,1614,214,454,.471,2,10,.200,212,444,.477,.474,144,171,.842,128,195,323,104,46,18,109,154,574
8742,BOS,1997,Dino Radja,29,25,25,874,149,339,.440,0,1,.000,149,338,.441,.440,51,71,.718,44,167,211,48,23,48,70,76,349
8743,BOS,1997,Dana Barros,29,24,8,708,110,253,.435,43,105,.410,67,148,.453,.520,37,43,.860,5,43,48,81,26,6,39,34,300
8744,BOS,1997,Brett Szabo,28,70,24,662,54,121,.446,0,1,.000,54,120,.450,.446,45,61,.738,56,109,165,17,16,32,41,119,153
8745,BOS,1997,Greg Minor,25,23,15,547,94,196,.480,1,8,.125,93,188,.495,.482,31,36,.861,30,50,80,34,15,2,22,45,220
8746,BOS,1997,Dee Brown,28,21,2,522,61,166,.367,20,65,.308,41,101,.406,.428,18,22,.818,8,40,48,67,31,7,24,45,160
8747,BOS,1997,Alton Lister,38,53,2,516,32,77,.416,0,0,,32,77,.416,.416,23,31,.742,66,102,168,13,8,14,30,95,87
8748,BOS,1997,Michael Hawkins,24,29,0,326,29,68,.426,10,31,.323,19,37,.514,.500,12,15,.800,9,22,31,64,16,1,28,40,80
8749,BOS,1997,Steve Hamer,23,35,3,268,30,57,.526,0,2,.000,30,55,.545,.526,16,29,.552,17,43,60,7,2,4,13,39,76
8750,BOS,1997,Frank Brickowski,37,17,2,255,32,73,.438,7,20,.350,25,53,.472,.486,10,14,.714,6,28,34,15,5,4,19,42,81
8751,BOS,1997,Nate Driggers,23,15,0,132,13,43,.302,0,9,.000,13,34,.382,.302,10,14,.714,12,10,22,6,3,2,6,10,36
8752,BOS,1997,Pervis Ellison,29,6,4,125,6,16,.375,0,0,,6,16,.375,.375,3,5,.600,9,17,26,4,5,9,7,21,15
8753,BOS,1997,Stacey King,30,5,0,33,5,7,.714,0,0,,5,7,.714,.714,2,3,.667,1,8,9,1,0,1,1,3,12
8754,BOS,1996,Rick Fox,26,81,81,2588,421,928,.454,99,272,.364,322,656,.491,.507,196,254,.772,158,292,450,369,113,41,216,290,1137
8755,BOS,1996,Dana Barros,28,80,25,2328,379,806,.470,150,368,.408,229,438,.523,.563,130,147,.884,21,171,192,306,58,3,120,116,1038
8756,BOS,1996,David Wesley,25,82,53,2104,338,736,.459,116,272,.426,222,464,.478,.538,217,288,.753,68,196,264,390,100,11,159,207,1009
8757,BOS,1996,Dino Radja,28,53,52,1984,426,852,.500,0,0,,426,852,.500,.500,191,275,.695,113,409,522,83,48,81,117,161,1043
8758,BOS,1996,Greg Minor,24,78,47,1761,320,640,.500,7,27,.259,313,613,.511,.505,99,130,.762,93,164,257,146,36,11,78,161,746
8759,BOS,1996,Todd Day,26,71,12,1636,277,746,.371,95,277,.343,182,469,.388,.435,200,261,.766,62,140,202,102,77,48,98,198,849
8760,BOS,1996,Dee Brown,27,65,23,1591,246,616,.399,68,220,.309,178,396,.449,.455,135,158,.854,36,100,136,146,80,12,74,119,695
8761,BOS,1996,Eric Williams,23,64,6,1470,241,546,.441,3,10,.300,238,536,.444,.444,200,298,.671,92,125,217,70,56,11,88,147,685
8762,BOS,1996,Eric Montross,24,61,59,1432,196,346,.566,0,0,,196,346,.566,.566,50,133,.376,119,233,352,43,19,29,83,181,442
8763,BOS,1996,Pervis Ellison,28,69,29,1431,145,295,.492,0,0,,145,295,.492,.492,75,117,.641,151,300,451,62,39,99,84,207,365
8764,BOS,1996,Alton Lister,37,57,14,647,47,96,.490,0,0,,47,96,.490,.490,39,62,.629,60,191,251,15,6,39,44,121,133
8765,BOS,1996,Junior Burrough,23,61,3,495,64,170,.376,0,0,,64,170,.376,.376,61,93,.656,45,64,109,15,15,10,40,74,189
8766,BOS,1996,Sherman Douglas,29,10,4,234,36,84,.429,1,7,.143,35,77,.455,.435,25,40,.625,6,17,23,39,2,0,29,16,98
8767,BOS,1996,Doug Smith,26,17,2,92,14,39,.359,0,0,,14,39,.359,.359,5,8,.625,12,10,22,4,3,0,11,21,33
8768,BOS,1996,Thomas Hamilton,20,11,0,70,9,31,.290,0,0,,9,31,.290,.290,7,18,.389,10,12,22,1,0,9,9,12,25
8769,BOS,1996,Todd Mundt,25,9,0,33,3,9,.333,0,0,,3,9,.333,.333,0,0,,1,2,3,1,1,1,0,6,6
8770,BOS,1996,Charles Claxton,25,3,0,7,1,2,.500,0,0,,1,2,.500,.500,0,2,.000,2,0,2,0,0,1,1,4,2
8771,BOS,1996,Larry Sykes,22,1,0,2,0,0,,0,0,,0,0,,,0,0,,1,1,2,0,0,0,1,0,0
8772,BOS,1995,Dee Brown,26,79,69,2792,437,977,.447,126,327,.385,311,650,.478,.512,236,277,.852,63,186,249,301,110,49,146,181,1236
8773,BOS,1995,Dominique Wilkins,35,77,64,2423,496,1169,.424,112,289,.388,384,880,.436,.472,266,340,.782,157,244,401,166,61,14,173,130,1370
8774,BOS,1995,Eric Montross,23,78,75,2315,307,575,.534,0,1,.000,307,574,.535,.534,167,263,.635,196,370,566,36,29,61,112,299,781
8775,BOS,1995,Dino Radja,27,66,48,2147,450,919,.490,0,1,.000,450,918,.490,.490,233,307,.759,149,424,573,111,60,86,159,232,1133
8776,BOS,1995,Sherman Douglas,28,65,43,2048,365,769,.475,20,82,.244,345,687,.502,.488,204,296,.689,48,122,170,446,80,2,162,152,954
8777,BOS,1995,Xavier McDaniel,31,68,15,1430,246,546,.451,6,21,.286,240,525,.457,.456,89,125,.712,94,206,300,108,30,20,89,146,587
8778,BOS,1995,David Wesley,24,51,36,1380,128,313,.409,51,119,.429,77,194,.397,.490,71,94,.755,31,86,117,266,82,9,87,144,378
8779,BOS,1995,Derek Strong,26,70,24,1344,149,329,.453,2,7,.286,147,322,.457,.456,141,172,.820,136,239,375,44,24,13,79,143,441
8780,BOS,1995,Pervis Ellison,27,55,11,1083,152,300,.507,0,2,.000,152,298,.510,.507,71,99,.717,124,185,309,34,22,54,76,179,375
8781,BOS,1995,Rick Fox,25,53,7,1039,169,351,.481,31,75,.413,138,276,.500,.526,95,123,.772,61,94,155,139,52,19,78,154,464
8782,BOS,1995,Greg Minor,23,63,8,945,155,301,.515,2,12,.167,153,289,.529,.518,65,78,.833,49,88,137,66,32,16,44,89,377
8783,BOS,1995,Blue Edwards,29,31,7,507,83,195,.426,11,43,.256,72,152,.474,.454,43,48,.896,25,40,65,47,19,10,39,64,220
8784,BOS,1995,Acie Earl,24,30,3,208,26,68,.382,0,0,,26,68,.382,.382,14,29,.483,19,26,45,2,6,8,14,39,66
8785,BOS,1995,James Blackwell,26,9,0,61,6,10,.600,0,0,,6,10,.600,.600,2,3,.667,2,6,8,6,3,0,3,7,14
8786,BOS,1995,Jay Humphries,32,6,0,52,4,9,.444,0,1,.000,4,8,.500,.444,2,4,.500,2,1,3,10,2,0,5,10,10
8787,BOS,1995,Tony Harris,27,3,0,18,3,8,.375,0,1,.000,3,7,.429,.375,8,9,.889,0,0,0,0,0,0,1,2,14
8788,BOS,1995,Tony Dawson,27,2,0,13,3,8,.375,1,3,.333,2,5,.400,.438,1,1,1.000,0,3,3,1,0,0,2,4,8
8789,BOS,1994,Dee Brown,25,77,76,2867,490,1021,.480,30,96,.313,460,925,.497,.495,182,219,.831,63,237,300,347,156,47,126,207,1192
8790,BOS,1994,Sherman Douglas,27,78,78,2789,425,919,.462,13,56,.232,412,863,.477,.470,177,276,.641,70,123,193,683,89,11,233,171,1040
8791,BOS,1994,Dino Radja,26,80,47,2303,491,942,.521,0,1,.000,491,941,.522,.521,226,301,.751,191,386,577,114,70,67,149,276,1208
8792,BOS,1994,Rick Fox,24,82,53,2096,340,728,.467,33,100,.330,307,628,.489,.490,174,230,.757,105,250,355,217,81,52,158,244,887
8793,BOS,1994,Robert Parish,40,74,74,1987,356,725,.491,0,0,,356,725,.491,.491,154,208,.740,141,401,542,82,42,96,108,190,866
8794,BOS,1994,Xavier McDaniel,30,82,5,1971,387,839,.461,10,41,.244,377,798,.472,.467,144,213,.676,142,258,400,126,48,39,116,193,928
8795,BOS,1994,Kevin Gamble,28,75,28,1880,368,804,.458,25,103,.243,343,701,.489,.473,103,126,.817,41,118,159,149,57,22,77,134,864
8796,BOS,1994,Ed Pinckney,30,76,35,1524,151,289,.522,0,0,,151,289,.522,.522,92,125,.736,160,318,478,62,58,44,62,131,394
8797,BOS,1994,Acie Earl,23,74,8,1149,151,372,.406,0,1,.000,151,371,.407,.406,108,160,.675,85,162,247,12,24,53,72,178,410
8798,BOS,1994,Jimmy Oliver,24,44,6,540,89,214,.416,13,32,.406,76,182,.418,.446,25,33,.758,8,38,46,33,16,1,21,39,216
8799,BOS,1994,Chris Corchiani,25,51,0,467,40,94,.426,11,38,.289,29,56,.518,.484,26,38,.684,8,36,44,86,22,2,38,47,117
8800,BOS,1994,Alaa Abdelnaby,25,13,0,159,24,55,.436,0,0,,24,55,.436,.436,16,25,.640,12,34,46,3,2,3,17,20,64
8801,BOS,1994,Tony Harris,26,5,0,88,9,31,.290,3,9,.333,6,22,.273,.339,23,25,.920,3,7,10,8,4,0,6,8,44
8802,BOS,1994,Todd Lichti,27,4,0,48,6,14,.429,0,0,,6,14,.429,.429,7,14,.500,2,6,8,6,5,1,3,4,19
8803,BOS,1994,Matt Wenstrom,23,11,0,37,6,10,.600,0,0,,6,10,.600,.600,6,10,.600,6,6,12,0,0,2,4,7,18
8804,BOS,1993,Reggie Lewis,27,80,80,3144,663,1410,.470,14,60,.233,649,1350,.481,.475,326,376,.867,88,259,347,298,118,77,133,248,1666
8805,BOS,1993,Kevin Gamble,27,82,58,2541,459,906,.507,52,139,.374,407,767,.531,.535,123,149,.826,46,200,246,226,86,37,81,185,1093
8806,BOS,1993,Dee Brown,24,80,48,2254,328,701,.468,26,82,.317,302,619,.488,.486,192,242,.793,45,201,246,461,138,32,136,203,874
8807,BOS,1993,Xavier McDaniel,29,82,27,2215,457,924,.495,6,22,.273,451,902,.500,.498,191,241,.793,168,321,489,163,72,51,171,249,1111
8808,BOS,1993,Robert Parish,39,79,79,2146,416,777,.535,0,0,,416,777,.535,.535,162,235,.689,246,494,740,61,57,107,120,201,994
8809,BOS,1993,Sherman Douglas,26,79,36,1932,264,530,.498,6,29,.207,258,501,.515,.504,84,150,.560,65,97,162,508,49,10,161,166,618
8810,BOS,1993,Kevin McHale,35,71,0,1656,298,649,.459,2,18,.111,296,631,.469,.461,164,195,.841,95,263,358,73,16,59,92,126,762
8811,BOS,1993,Alaa Abdelnaby,24,63,52,1152,219,417,.525,0,0,,219,417,.525,.525,76,100,.760,114,186,300,17,19,22,84,165,514
8812,BOS,1993,Joe Kleine,31,78,3,1129,108,267,.404,0,6,.000,108,261,.414,.404,41,58,.707,113,233,346,39,17,17,37,123,257
8813,BOS,1993,Rick Fox,23,71,14,1082,184,380,.484,4,23,.174,180,357,.504,.489,81,101,.802,55,104,159,113,61,21,77,133,453
8814,BOS,1993,Lorenzo Williams,23,22,7,151,16,31,.516,0,0,,16,31,.516,.516,2,7,.286,13,31,44,5,4,14,6,23,34
8815,BOS,1993,Ed Pinckney,29,7,5,151,10,24,.417,0,0,,10,24,.417,.417,12,13,.923,14,29,43,1,4,7,8,13,32
8816,BOS,1993,John Bagley,32,10,0,97,9,25,.360,0,1,.000,9,24,.375,.360,5,6,.833,1,6,7,20,2,0,17,11,23
8817,BOS,1993,Marcus Webb,22,9,0,51,13,25,.520,0,1,.000,13,24,.542,.520,13,21,.619,5,5,10,2,1,2,5,11,39
8818,BOS,1993,Bart Kofoed,28,7,0,41,3,13,.231,0,1,.000,3,12,.250,.231,11,14,.786,0,1,1,10,2,1,3,1,17
8819,BOS,1993,Kenny Battle,28,3,1,29,6,13,.462,0,1,.000,6,12,.500,.462,2,2,1.000,7,4,11,2,1,0,2,2,14
8820,BOS,1993,Joe Wolf,28,2,0,9,0,1,.000,0,0,,0,1,.000,.000,1,2,.500,1,2,3,0,0,1,2,2,1
8821,BOS,1992,Reggie Lewis,26,82,82,3070,703,1397,.503,5,21,.238,698,1376,.507,.505,292,343,.851,117,277,394,185,125,105,136,258,1703
8822,BOS,1992,Kevin Gamble,26,82,77,2496,480,908,.529,9,31,.290,471,877,.537,.534,139,157,.885,80,206,286,219,75,37,97,200,1108
8823,BOS,1992,Robert Parish,38,79,79,2285,468,874,.535,0,0,,468,874,.535,.535,179,232,.772,219,486,705,70,68,97,131,172,1115
8824,BOS,1992,Ed Pinckney,28,81,36,1917,203,378,.537,0,1,.000,203,377,.538,.537,207,255,.812,252,312,564,62,70,56,73,158,613
8825,BOS,1992,John Bagley,31,73,59,1742,223,506,.441,10,42,.238,213,464,.459,.451,68,95,.716,38,123,161,480,57,4,148,123,524
8826,BOS,1992,Larry Bird,35,45,45,1662,353,758,.466,52,128,.406,301,630,.478,.500,150,162,.926,46,388,434,306,42,33,125,82,908
8827,BOS,1992,Rick Fox,22,81,5,1535,241,525,.459,23,70,.329,218,455,.479,.481,139,184,.755,73,147,220,126,78,30,123,230,644
8828,BOS,1992,Kevin McHale,34,56,1,1398,323,634,.509,0,13,.000,323,621,.520,.509,134,163,.822,119,211,330,82,11,59,82,112,780
8829,BOS,1992,Joe Kleine,30,70,3,991,144,293,.491,4,8,.500,140,285,.491,.498,34,48,.708,94,202,296,32,23,14,27,99,326
8830,BOS,1992,Dee Brown,23,31,20,883,149,350,.426,5,22,.227,144,328,.439,.433,60,78,.769,15,64,79,164,33,7,59,74,363
8831,BOS,1992,Sherman Douglas,25,37,0,654,101,222,.455,1,9,.111,100,213,.469,.457,68,100,.680,12,45,57,153,21,9,60,68,271
8832,BOS,1992,Brian Shaw,25,17,3,436,70,164,.427,0,7,.000,70,157,.446,.427,35,40,.875,11,58,69,89,12,10,32,29,175
8833,BOS,1992,Rickey Green,37,26,0,367,46,103,.447,1,4,.250,45,99,.455,.451,13,18,.722,3,21,24,68,17,1,18,28,106
8834,BOS,1992,Kevin Pritchard,24,11,0,136,16,34,.471,0,3,.000,16,31,.516,.471,14,18,.778,1,10,11,30,3,4,11,17,46
8835,BOS,1992,Stojko Vranković,28,19,0,110,15,32,.469,0,0,,15,32,.469,.469,7,12,.583,8,20,28,5,0,17,10,22,37
8836,BOS,1992,Tony Massenburg,24,7,0,46,4,9,.444,0,0,,4,9,.444,.444,2,4,.500,2,7,9,0,0,1,2,7,10
8837,BOS,1992,Kenny Battle,27,8,0,46,3,4,.750,0,0,,3,4,.750,.750,8,8,1.000,3,6,9,0,1,0,2,4,14
8838,BOS,1992,Larry Robinson,24,1,0,6,1,5,.200,0,0,,1,5,.200,.200,0,0,,2,0,2,1,0,0,1,3,2
8839,BOS,1991,Reggie Lewis,25,79,79,2878,598,1219,.491,1,13,.077,597,1206,.495,.491,281,340,.826,119,291,410,201,98,85,147,234,1478
8840,BOS,1991,Brian Shaw,24,79,79,2772,442,942,.469,3,27,.111,439,915,.480,.471,204,249,.819,104,266,370,602,105,34,223,206,1091
8841,BOS,1991,Kevin Gamble,25,82,76,2706,548,933,.587,0,7,.000,548,926,.592,.587,185,227,.815,85,182,267,256,100,34,148,237,1281
8842,BOS,1991,Robert Parish,37,81,81,2441,485,811,.598,0,1,.000,485,810,.599,.598,237,309,.767,271,585,856,66,66,103,153,197,1207
8843,BOS,1991,Larry Bird,34,60,60,2277,462,1017,.454,77,198,.389,385,819,.470,.492,163,183,.891,53,456,509,431,108,58,187,118,1164
8844,BOS,1991,Kevin McHale,33,68,10,2067,504,912,.553,15,37,.405,489,875,.559,.561,228,275,.829,145,335,480,126,25,146,140,194,1251
8845,BOS,1991,Dee Brown,22,82,5,1945,284,612,.464,7,34,.206,277,578,.479,.470,137,157,.873,41,141,182,344,83,14,137,161,712
8846,BOS,1991,Ed Pinckney,27,70,16,1165,131,243,.539,0,1,.000,131,242,.541,.539,104,116,.897,155,186,341,45,61,43,45,147,366
8847,BOS,1991,Joe Kleine,29,72,1,850,102,218,.468,0,2,.000,102,216,.472,.468,54,69,.783,71,173,244,21,15,14,53,108,258
8848,BOS,1991,Michael Smith,25,47,3,389,95,200,.475,6,24,.250,89,176,.506,.490,22,27,.815,21,35,56,43,6,2,37,27,218
8849,BOS,1991,Stojko Vranković,27,31,0,166,24,52,.462,0,0,,24,52,.462,.462,10,18,.556,15,36,51,4,1,29,24,43,58
8850,BOS,1991,Dave Popson,26,19,0,64,13,32,.406,0,0,,13,32,.406,.406,9,10,.900,7,7,14,2,1,2,6,12,35
8851,BOS,1991,A.J. Wynder,26,6,0,39,3,12,.250,0,1,.000,3,11,.273,.250,6,8,.750,1,2,3,8,1,0,4,1,12
8852,BOS,1991,Charles Smith,23,5,0,30,3,7,.429,0,0,,3,7,.429,.429,3,5,.600,0,2,2,6,1,0,3,7,9
8853,BOS,1991,Derek Smith,29,2,0,16,1,4,.250,0,1,.000,1,3,.333,.250,3,4,.750,0,0,0,5,1,1,1,3,5
8854,BOS,1990,Larry Bird,33,75,75,2944,718,1517,.473,65,195,.333,653,1322,.494,.495,319,343,.930,90,622,712,562,106,61,243,173,1820
8855,BOS,1990,Kevin McHale,32,82,25,2722,648,1181,.549,23,69,.333,625,1112,.562,.558,393,440,.893,201,476,677,172,30,157,183,250,1712
8856,BOS,1990,Reggie Lewis,24,79,54,2522,540,1089,.496,4,15,.267,536,1074,.499,.498,256,317,.808,109,238,347,225,88,63,120,216,1340
8857,BOS,1990,Robert Parish,36,79,78,2396,505,871,.580,0,0,,505,871,.580,.580,233,312,.747,259,537,796,103,38,69,169,189,1243
8858,BOS,1990,Dennis Johnson,35,75,65,2036,206,475,.434,1,24,.042,205,451,.455,.435,118,140,.843,48,153,201,485,81,14,117,179,531
8859,BOS,1990,Joe Kleine,28,81,4,1365,176,367,.480,0,4,.000,176,363,.485,.480,83,100,.830,117,238,355,46,15,27,64,170,435
8860,BOS,1990,Jim Paxson,32,72,25,1283,191,422,.453,5,20,.250,186,402,.463,.459,73,90,.811,24,53,77,137,33,5,54,115,460
8861,BOS,1990,John Bagley,29,54,17,1095,100,218,.459,1,18,.056,99,200,.495,.461,29,39,.744,26,63,89,296,40,4,90,77,230
8862,BOS,1990,Ed Pinckney,26,77,50,1082,135,249,.542,0,1,.000,135,248,.544,.542,92,119,.773,93,132,225,68,34,42,56,126,362
8863,BOS,1990,Kevin Gamble,24,71,10,990,137,301,.455,3,18,.167,134,283,.473,.460,85,107,.794,42,70,112,119,28,8,44,77,362
8864,BOS,1990,Michael Smith,24,65,7,620,136,286,.476,2,28,.071,134,258,.519,.479,53,64,.828,40,60,100,79,9,1,54,51,327
8865,BOS,1990,Charles Smith,22,60,0,519,59,133,.444,0,7,.000,59,126,.468,.444,53,76,.697,14,55,69,103,35,3,36,75,171
8866,BOS,1990,Kelvin Upshaw,27,14,0,131,12,39,.308,2,5,.400,10,34,.294,.333,4,6,.667,3,10,13,28,2,1,12,19,30
8867,BOS,1989,Kevin McHale,31,78,74,2876,661,1211,.546,0,4,.000,661,1207,.548,.546,436,533,.818,223,414,637,172,26,97,196,223,1758
8868,BOS,1989,Robert Parish,35,80,80,2840,596,1045,.570,0,0,,596,1045,.570,.570,294,409,.719,342,654,996,175,79,116,200,209,1486
8869,BOS,1989,Reggie Lewis,23,81,57,2657,604,1242,.486,3,22,.136,601,1220,.493,.488,284,361,.787,116,261,377,218,124,72,142,258,1495
8870,BOS,1989,Dennis Johnson,34,72,72,2309,277,638,.434,7,50,.140,270,588,.459,.440,160,195,.821,31,159,190,472,94,21,175,211,721
8871,BOS,1989,Brian Shaw,22,82,54,2301,297,686,.433,0,13,.000,297,673,.441,.433,109,132,.826,119,257,376,472,78,27,188,211,703
8872,BOS,1989,Danny Ainge,29,45,28,1349,271,589,.460,58,155,.374,213,434,.491,.509,114,128,.891,37,117,154,215,52,1,82,108,714
8873,BOS,1989,Jim Paxson,31,57,7,1138,202,445,.454,4,24,.167,198,421,.470,.458,84,103,.816,18,56,74,107,38,8,57,96,492
8874,BOS,1989,Brad Lohaus,24,48,15,738,117,270,.433,0,4,.000,117,266,.440,.433,35,46,.761,47,95,142,49,21,26,49,101,269
8875,BOS,1989,Ed Pinckney,25,29,9,678,95,176,.540,0,0,,95,176,.540,.540,103,129,.798,60,88,148,44,29,23,38,77,293
8876,BOS,1989,Mark Acres,26,62,0,632,55,114,.482,1,1,1.000,54,113,.478,.487,26,48,.542,59,87,146,19,19,6,23,94,137
8877,BOS,1989,Ron Grandison,24,72,0,528,59,142,.415,0,10,.000,59,132,.447,.415,59,80,.738,47,45,92,42,18,3,36,71,177
8878,BOS,1989,Joe Kleine,27,28,2,498,59,129,.457,0,1,.000,59,128,.461,.457,53,64,.828,49,88,137,32,15,5,37,66,171
8879,BOS,1989,Kelvin Upshaw,26,23,0,473,73,149,.490,2,10,.200,71,139,.511,.497,14,20,.700,6,30,36,97,19,3,42,62,162
8880,BOS,1989,Kevin Gamble,23,44,6,375,75,136,.551,2,11,.182,73,125,.584,.559,35,55,.636,11,31,42,34,14,3,19,40,187
8881,BOS,1989,Larry Bird,32,6,6,189,49,104,.471,0,0,,49,104,.471,.471,18,19,.947,1,36,37,29,6,5,11,18,116
8882,BOS,1989,Otis Birdsong,33,13,0,108,18,36,.500,1,3,.333,17,33,.515,.514,0,2,.000,4,9,13,9,3,1,12,10,37
8883,BOS,1989,Ramón Rivas,22,28,0,91,12,31,.387,0,1,.000,12,30,.400,.387,16,25,.640,9,15,24,3,4,1,9,21,40
8884,BOS,1988,Danny Ainge,28,81,81,3018,482,982,.491,148,357,.415,334,625,.534,.566,158,180,.878,59,190,249,503,115,17,153,203,1270
8885,BOS,1988,Larry Bird,31,76,75,2965,881,1672,.527,98,237,.414,783,1435,.546,.556,415,453,.916,108,595,703,467,125,57,213,157,2275
8886,BOS,1988,Dennis Johnson,33,77,74,2670,352,803,.438,12,46,.261,340,757,.449,.446,255,298,.856,62,178,240,598,93,29,195,204,971
8887,BOS,1988,Kevin McHale,30,64,63,2390,550,911,.604,0,0,,550,911,.604,.604,346,434,.797,159,377,536,171,27,92,141,179,1446
8888,BOS,1988,Robert Parish,34,74,73,2312,442,750,.589,0,1,.000,442,749,.590,.589,177,241,.734,173,455,628,115,55,84,154,198,1061
8889,BOS,1988,Mark Acres,25,79,5,1151,108,203,.532,0,0,,108,203,.532,.532,71,111,.640,105,165,270,42,29,27,54,198,287
8890,BOS,1988,Fred Roberts,27,74,14,1032,161,330,.488,0,6,.000,161,324,.497,.488,128,165,.776,60,102,162,81,16,15,68,118,450
8891,BOS,1988,Dirk Minniefield,27,61,6,868,83,173,.480,3,11,.273,80,162,.494,.488,27,32,.844,22,53,75,190,44,3,77,107,196
8892,BOS,1988,Brad Lohaus,23,70,4,718,122,246,.496,3,13,.231,119,233,.511,.502,50,62,.806,46,92,138,49,20,41,59,123,297
8893,BOS,1988,Darren Daye,27,47,8,655,112,217,.516,0,1,.000,112,216,.519,.516,59,87,.678,30,46,76,71,29,4,44,68,283
8894,BOS,1988,Jim Paxson,30,28,2,538,94,191,.492,2,13,.154,92,178,.517,.497,54,61,.885,7,20,27,49,23,4,28,44,244
8895,BOS,1988,Artis Gilmore,38,47,4,521,58,101,.574,0,0,,58,101,.574,.574,48,91,.527,54,94,148,12,10,18,39,94,164
8896,BOS,1988,Reggie Lewis,22,49,0,405,90,193,.466,0,4,.000,90,189,.476,.466,40,57,.702,28,35,63,26,16,15,30,54,220
8897,BOS,1988,Jerry Sichting,31,24,1,370,44,82,.537,2,8,.250,42,74,.568,.549,8,12,.667,5,16,21,60,14,0,14,30,98
8898,BOS,1988,Greg Kite,26,13,0,86,9,23,.391,0,0,,9,23,.391,.391,1,6,.167,10,14,24,2,3,8,9,16,19
8899,BOS,1988,Conner Henry,24,10,0,81,11,28,.393,3,8,.375,8,20,.400,.446,9,10,.900,2,8,10,12,1,1,9,11,34
8900,BOS,1987,Kevin McHale,29,77,77,3060,790,1307,.604,0,4,.000,790,1303,.606,.604,428,512,.836,247,516,763,198,38,172,197,240,2008
8901,BOS,1987,Larry Bird,30,74,73,3005,786,1497,.525,90,225,.400,696,1272,.547,.555,414,455,.910,124,558,682,566,135,70,240,185,2076
8902,BOS,1987,Robert Parish,33,80,80,2995,588,1057,.556,0,1,.000,588,1056,.557,.556,227,309,.735,254,597,851,173,64,144,191,266,1403
8903,BOS,1987,Dennis Johnson,32,79,78,2933,423,953,.444,7,62,.113,416,891,.467,.448,209,251,.833,45,216,261,594,87,38,177,201,1062
8904,BOS,1987,Danny Ainge,27,71,66,2499,410,844,.486,85,192,.443,325,652,.498,.536,148,165,.897,49,193,242,400,101,14,141,189,1053
8905,BOS,1987,Jerry Sichting,30,78,15,1566,202,398,.508,7,26,.269,195,372,.524,.516,37,42,.881,22,69,91,187,40,1,61,124,448
8906,BOS,1987,Fred Roberts,26,73,11,1079,139,270,.515,0,3,.000,139,267,.521,.515,124,153,.810,54,136,190,62,22,20,89,129,402
8907,BOS,1987,Greg Kite,25,74,1,745,47,110,.427,0,1,.000,47,109,.431,.427,29,76,.382,61,108,169,27,17,46,34,148,123
8908,BOS,1987,Darren Daye,26,61,2,724,101,202,.500,0,0,,101,202,.500,.500,34,65,.523,37,87,124,75,25,7,56,98,236
8909,BOS,1987,Sam Vincent,23,46,5,374,60,136,.441,0,0,,60,136,.441,.441,51,55,.927,5,22,27,59,13,1,33,33,171
8910,BOS,1987,Rick Carlisle,27,42,0,297,30,92,.326,5,16,.313,25,76,.329,.353,15,20,.750,8,22,30,35,8,0,25,28,80
8911,BOS,1987,Conner Henry,23,36,0,231,38,103,.369,12,31,.387,26,72,.361,.427,10,17,.588,7,20,27,27,6,1,17,27,98
8912,BOS,1987,Bill Walton,34,10,0,112,10,26,.385,0,0,,10,26,.385,.385,8,15,.533,11,20,31,9,1,10,15,23,28
8913,BOS,1987,David Thirdkill,26,17,0,89,10,24,.417,0,1,.000,10,23,.435,.417,5,16,.313,5,14,19,2,2,0,5,12,25
8914,BOS,1987,Scott Wedman,34,6,2,78,9,27,.333,1,2,.500,8,25,.320,.352,1,2,.500,3,6,9,6,2,2,3,6,20
8915,BOS,1987,Andre Turner,22,3,0,18,2,5,.400,0,1,.000,2,4,.500,.400,0,0,,1,1,2,1,0,0,5,1,4
8916,BOS,1986,Larry Bird,29,82,81,3113,796,1606,.496,82,194,.423,714,1412,.506,.521,441,492,.896,190,615,805,557,166,51,266,182,2115
8917,BOS,1986,Dennis Johnson,31,78,78,2732,482,1060,.455,6,42,.143,476,1018,.468,.458,243,297,.818,69,199,268,456,110,35,173,206,1213
8918,BOS,1986,Robert Parish,32,81,80,2567,530,966,.549,0,0,,530,966,.549,.549,245,335,.731,246,524,770,145,65,116,187,215,1305
8919,BOS,1986,Danny Ainge,26,80,78,2407,353,701,.504,26,73,.356,327,628,.521,.522,123,136,.904,47,188,235,405,94,7,129,204,855
8920,BOS,1986,Kevin McHale,28,68,62,2397,561,978,.574,0,0,,561,978,.574,.574,326,420,.776,171,380,551,181,29,134,149,192,1448
8921,BOS,1986,Jerry Sichting,29,82,7,1596,235,412,.570,6,16,.375,229,396,.578,.578,61,66,.924,27,77,104,188,50,0,73,118,537
8922,BOS,1986,Bill Walton,33,80,2,1546,231,411,.562,0,0,,231,411,.562,.562,144,202,.713,136,408,544,165,38,106,151,210,606
8923,BOS,1986,Scott Wedman,33,79,19,1402,286,605,.473,17,48,.354,269,557,.483,.487,45,68,.662,66,126,192,83,38,22,54,127,634
8924,BOS,1986,Rick Carlisle,26,77,1,760,92,189,.487,0,10,.000,92,179,.514,.487,15,23,.652,22,55,77,104,19,4,50,92,199
8925,BOS,1986,Greg Kite,24,64,2,464,34,91,.374,0,1,.000,34,90,.378,.374,15,39,.385,35,93,128,17,3,28,32,81,83
8926,BOS,1986,Sam Vincent,22,57,0,432,59,162,.364,1,4,.250,58,158,.367,.367,65,70,.929,11,37,48,69,17,4,49,59,184
8927,BOS,1986,David Thirdkill,25,49,0,385,54,110,.491,0,1,.000,54,109,.495,.491,55,88,.625,27,43,70,15,11,3,19,55,163
8928,BOS,1986,Sly Williams,28,6,0,54,5,21,.238,0,4,.000,5,17,.294,.238,7,12,.583,7,8,15,2,1,1,7,15,17
8929,BOS,1985,Larry Bird,28,80,77,3161,918,1760,.522,56,131,.427,862,1629,.529,.538,403,457,.882,164,678,842,531,129,98,248,208,2295
8930,BOS,1985,Dennis Johnson,30,80,77,2976,493,1066,.462,7,26,.269,486,1040,.467,.466,261,306,.853,91,226,317,543,96,39,212,224,1254
8931,BOS,1985,Robert Parish,31,79,78,2850,551,1016,.542,0,0,,551,1016,.542,.542,292,393,.743,263,577,840,125,56,101,186,223,1394
8932,BOS,1985,Kevin McHale,27,79,31,2653,605,1062,.570,0,6,.000,605,1056,.573,.570,355,467,.760,229,483,712,141,28,120,157,234,1565
8933,BOS,1985,Danny Ainge,25,75,73,2564,419,792,.529,15,56,.268,404,736,.549,.539,118,136,.868,76,192,268,399,122,6,149,228,971
8934,BOS,1985,Cedric Maxwell,29,57,51,1495,201,377,.533,0,2,.000,201,375,.536,.533,231,278,.831,98,144,242,102,36,15,98,140,633
8935,BOS,1985,Scott Wedman,32,78,5,1127,220,460,.478,17,34,.500,203,426,.477,.497,42,55,.764,57,102,159,94,23,10,47,111,499
8936,BOS,1985,Quinn Buckner,30,75,6,858,74,193,.383,0,1,.000,74,192,.385,.383,32,50,.640,26,61,87,148,63,2,67,142,180
8937,BOS,1985,Carlos Clark,24,62,3,562,64,152,.421,0,5,.000,64,147,.435,.421,41,53,.774,29,40,69,48,35,2,42,66,169
8938,BOS,1985,Ray Williams,30,23,5,459,55,143,.385,6,23,.261,49,120,.408,.406,31,46,.674,16,41,57,90,30,5,42,56,147
8939,BOS,1985,Greg Kite,23,55,4,424,33,88,.375,0,0,,33,88,.375,.375,22,32,.688,38,51,89,17,3,10,29,84,88
8940,BOS,1985,M.L. Carr,34,47,0,397,62,149,.416,9,23,.391,53,126,.421,.446,17,17,1.000,21,22,43,24,21,6,24,44,150
8941,BOS,1985,Rick Carlisle,25,38,0,179,26,67,.388,0,2,.000,26,65,.400,.388,15,17,.882,8,13,21,25,3,0,19,21,67
8942,BOS,1984,Larry Bird,27,79,77,3028,758,1542,.492,18,73,.247,740,1469,.504,.497,374,421,.888,181,615,796,520,144,69,237,197,1908
8943,BOS,1984,Robert Parish,30,80,79,2867,623,1140,.546,0,0,,623,1140,.546,.546,274,368,.745,243,614,857,139,55,116,184,266,1520
8944,BOS,1984,Dennis Johnson,29,80,78,2665,384,878,.437,4,32,.125,380,846,.449,.440,281,330,.852,87,193,280,338,93,57,172,251,1053
8945,BOS,1984,Kevin McHale,26,82,10,2577,587,1055,.556,1,3,.333,586,1052,.557,.557,336,439,.765,208,402,610,104,23,126,150,243,1511
8946,BOS,1984,Cedric Maxwell,28,80,78,2502,317,596,.532,1,6,.167,316,590,.536,.533,320,425,.753,201,260,461,205,63,24,203,224,955
8947,BOS,1984,Gerald Henderson,28,78,78,2088,376,718,.524,20,57,.351,356,661,.539,.538,136,177,.768,68,79,147,300,117,14,161,209,908
8948,BOS,1984,Quinn Buckner,29,79,0,1249,138,323,.427,0,6,.000,138,317,.435,.427,48,74,.649,41,96,137,214,84,3,100,187,324
8949,BOS,1984,Danny Ainge,24,71,3,1154,166,361,.460,6,22,.273,160,339,.472,.468,46,56,.821,29,87,116,162,41,4,70,143,384
8950,BOS,1984,Scott Wedman,31,68,5,916,148,333,.444,2,13,.154,146,320,.456,.447,29,35,.829,41,98,139,67,27,7,43,107,327
8951,BOS,1984,M.L. Carr,33,60,1,585,70,171,.409,3,15,.200,67,156,.429,.418,42,48,.875,26,49,75,49,17,4,46,67,185
8952,BOS,1984,Greg Kite,22,35,1,197,30,66,.455,0,0,,30,66,.455,.455,5,16,.313,27,35,62,7,1,5,20,42,65
8953,BOS,1984,Carlos Clark,23,31,0,127,19,52,.365,0,2,.000,19,50,.380,.365,16,18,.889,7,10,17,17,8,1,12,13,54
8954,BOS,1983,Larry Bird,26,79,79,2982,747,1481,.504,22,77,.286,725,1404,.516,.512,351,418,.840,193,677,870,458,148,71,240,197,1867
8955,BOS,1983,Robert Parish,29,78,76,2459,619,1125,.550,0,1,.000,619,1124,.551,.550,271,388,.698,260,567,827,141,79,148,185,222,1509
8956,BOS,1983,Kevin McHale,25,82,13,2345,483,893,.541,0,1,.000,483,892,.541,.541,193,269,.717,215,338,553,104,34,192,159,241,1159
8957,BOS,1983,Cedric Maxwell,27,79,71,2252,331,663,.499,0,1,.000,331,662,.500,.499,280,345,.812,185,237,422,186,65,39,165,202,942
8958,BOS,1983,Danny Ainge,23,80,76,2048,357,720,.496,5,29,.172,352,691,.509,.499,72,97,.742,83,131,214,251,109,6,98,259,791
8959,BOS,1983,Tiny Archibald,34,66,19,1811,235,553,.425,5,24,.208,230,529,.435,.429,220,296,.743,25,66,91,409,38,4,163,110,695
8960,BOS,1983,Quinn Buckner,28,72,56,1565,248,561,.442,0,4,.000,248,557,.445,.442,74,117,.632,62,125,187,275,108,5,159,195,570
8961,BOS,1983,Gerald Henderson,27,82,9,1551,286,618,.463,3,16,.188,283,602,.470,.465,96,133,.722,57,67,124,195,95,3,128,190,671
8962,BOS,1983,M.L. Carr,32,77,0,883,135,315,.429,3,19,.158,132,296,.446,.433,60,81,.741,51,86,137,71,48,10,79,140,333
8963,BOS,1983,Rick Robey,27,59,6,855,100,214,.467,0,0,,100,214,.467,.467,45,78,.577,79,140,219,65,13,8,72,131,245
8964,BOS,1983,Charles Bradley,23,51,5,532,69,176,.392,0,3,.000,69,173,.399,.392,46,90,.511,30,48,78,28,32,27,42,84,184
8965,BOS,1983,Scott Wedman,30,40,0,503,94,205,.459,1,10,.100,93,195,.477,.461,20,30,.667,29,45,74,31,20,6,32,83,209
8966,BOS,1983,Darren Tillis,22,15,0,44,7,23,.304,0,1,.000,7,22,.318,.304,2,6,.333,4,5,9,2,0,2,4,8,16
8967,BOS,1982,Larry Bird,25,77,58,2923,711,1414,.503,11,52,.212,700,1362,.514,.507,328,380,.863,200,637,837,447,143,66,254,244,1761
8968,BOS,1982,Cedric Maxwell,26,78,73,2590,397,724,.548,0,3,.000,397,721,.551,.548,357,478,.747,218,281,499,183,79,49,174,263,1151
8969,BOS,1982,Robert Parish,28,80,78,2534,669,1235,.542,0,0,,669,1235,.542,.542,252,355,.710,288,578,866,140,68,192,221,267,1590
8970,BOS,1982,Kevin McHale,24,82,33,2332,465,875,.531,0,0,,465,875,.531,.531,187,248,.754,191,365,556,91,30,185,137,264,1117
8971,BOS,1982,Tiny Archibald,33,68,51,2167,308,652,.472,6,16,.375,302,636,.475,.477,236,316,.747,25,91,116,541,52,3,178,131,858
8972,BOS,1982,Gerald Henderson,26,82,31,1844,353,705,.501,2,12,.167,351,693,.506,.502,125,172,.727,47,105,152,252,82,11,150,199,833
8973,BOS,1982,Chris Ford,33,76,53,1591,188,450,.418,20,63,.317,168,387,.434,.440,39,56,.696,52,56,108,142,42,10,52,143,435
8974,BOS,1982,M.L. Carr,31,56,27,1296,184,409,.450,5,17,.294,179,392,.457,.456,82,116,.707,56,94,150,128,67,21,63,136,455
8975,BOS,1982,Rick Robey,26,80,4,1186,185,375,.493,0,2,.000,185,373,.496,.493,84,157,.535,114,181,295,68,27,14,92,183,454
8976,BOS,1982,Danny Ainge,22,53,1,564,79,221,.357,5,17,.294,74,204,.363,.369,56,65,.862,25,31,56,87,37,3,53,86,219
8977,BOS,1982,Charles Bradley,22,51,1,339,55,122,.451,0,1,.000,55,121,.455,.451,42,62,.677,12,26,38,22,14,6,37,61,152
8978,BOS,1982,Eric Fernsten,28,43,0,202,19,49,.388,0,0,,19,49,.388,.388,19,30,.633,12,30,42,8,5,7,13,23,57
8979,BOS,1982,Terry Duerod,25,21,0,146,34,77,.442,0,1,.000,34,76,.447,.442,4,12,.333,6,9,15,12,3,1,2,9,72
8980,BOS,1982,Tracy Jackson,22,11,0,66,10,26,.385,0,0,,10,26,.385,.385,6,10,.600,7,5,12,5,3,0,6,5,26
8981,BOS,1981,Larry Bird,24,82,82,3239,719,1503,.478,20,74,.270,699,1429,.489,.485,283,328,.863,191,704,895,451,161,63,289,239,1741
8982,BOS,1981,Tiny Archibald,32,80,72,2820,382,766,.499,0,9,.000,382,757,.505,.499,342,419,.816,36,140,176,618,75,18,265,201,1106
8983,BOS,1981,Cedric Maxwell,25,81,81,2730,441,750,.588,0,1,.000,441,749,.589,.588,352,450,.782,222,303,525,219,79,68,180,256,1234
8984,BOS,1981,Chris Ford,32,82,75,2723,314,707,.444,36,109,.330,278,598,.465,.470,64,87,.736,72,91,163,295,100,23,127,212,728
8985,BOS,1981,Robert Parish,27,82,82,2298,635,1166,.545,0,1,.000,635,1165,.545,.545,282,397,.710,245,532,777,144,81,214,191,310,1552
8986,BOS,1981,Kevin McHale,23,82,1,1645,355,666,.533,0,2,.000,355,664,.535,.533,108,159,.679,155,204,359,55,27,151,110,260,818
8987,BOS,1981,Gerald Henderson,25,82,10,1608,261,579,.451,1,16,.063,260,563,.462,.452,113,157,.720,43,89,132,213,79,12,160,177,636
8988,BOS,1981,Rick Robey,25,82,4,1569,298,547,.545,0,1,.000,298,546,.546,.545,144,251,.574,132,258,390,126,38,19,141,204,740
8989,BOS,1981,M.L. Carr,30,41,7,655,97,216,.449,1,14,.071,96,202,.475,.451,53,67,.791,26,57,83,56,30,18,47,74,248
8990,BOS,1981,Eric Fernsten,27,45,0,279,38,79,.481,0,0,,38,79,.481,.481,20,30,.667,29,33,62,10,6,7,20,29,96
8991,BOS,1981,Terry Duerod,24,32,0,114,30,73,.411,6,10,.600,24,63,.381,.452,13,14,.929,2,3,5,6,5,0,10,8,79
8992,BOS,1981,Wayne Kreklow,24,25,0,100,11,47,.234,1,4,.250,10,43,.233,.245,7,10,.700,2,10,12,9,2,1,10,20,30
8993,BOS,1980,Larry Bird,23,82,82,2955,693,1463,.474,58,143,.406,635,1320,.481,.494,301,360,.836,216,636,852,370,143,53,263,279,1745
8994,BOS,1980,Tiny Archibald,31,80,80,2864,383,794,.482,4,18,.222,379,776,.488,.485,361,435,.830,59,138,197,671,106,10,242,218,1131
8995,BOS,1980,Cedric Maxwell,24,80,80,2744,457,750,.609,0,0,,457,750,.609,.609,436,554,.787,284,420,704,199,76,61,230,266,1350
8996,BOS,1980,Dave Cowens,31,66,55,2159,422,932,.453,1,12,.083,421,920,.458,.453,95,122,.779,126,408,534,206,69,61,108,216,940
8997,BOS,1980,Chris Ford,31,73,73,2115,330,709,.465,70,164,.427,260,545,.477,.515,86,114,.754,77,104,181,215,111,27,105,178,816
8998,BOS,1980,M.L. Carr,29,82,7,1994,362,763,.474,12,41,.293,350,722,.485,.482,178,241,.739,106,224,330,156,120,36,143,214,914
8999,BOS,1980,Rick Robey,24,82,27,1918,379,727,.521,0,1,.000,379,726,.522,.521,184,269,.684,209,321,530,92,53,15,151,244,942
9000,BOS,1980,Gerald Henderson,24,76,2,1061,191,382,.500,2,6,.333,189,376,.503,.503,89,129,.690,37,46,83,147,45,15,109,96,473
9001,BOS,1980,Jeff Judkins,23,65,0,674,139,276,.504,11,27,.407,128,249,.514,.524,62,76,.816,32,34,66,47,29,5,49,91,351
9002,BOS,1980,Don Chaney,33,60,0,523,67,189,.354,1,6,.167,66,183,.361,.357,32,42,.762,31,42,73,38,31,11,33,80,167
9003,BOS,1980,Pete Maravich,32,26,4,442,123,249,.494,3,4,.750,120,245,.490,.500,50,55,.909,10,28,38,29,9,2,37,49,299
9004,BOS,1980,Eric Fernsten,26,56,0,431,71,153,.464,0,0,,71,153,.464,.464,33,52,.635,40,56,96,28,17,12,20,43,175
9005,BRK,2024,Mikal Bridges,27,82,82,2854,564,1294,.436,220,592,.372,344,702,.490,.521,258,317,.814,68,304,372,299,81,30,164,116,1606
9006,BRK,2024,Nic Claxton,24,71,71,2116,366,582,.629,1,5,.200,365,577,.633,.630,108,196,.551,193,513,706,147,46,146,93,175,841
9007,BRK,2024,Cam Thomas,22,66,51,2075,526,1190,.442,144,396,.364,382,794,.481,.503,286,334,.856,28,186,214,192,45,16,124,138,1482
9008,BRK,2024,Dorian Finney-Smith,30,68,56,1934,215,511,.421,117,336,.348,98,175,.560,.535,33,46,.717,109,208,317,107,56,38,59,150,580
9009,BRK,2024,Cameron Johnson,27,58,47,1599,276,619,.446,138,353,.391,138,266,.519,.557,86,109,.789,55,196,251,138,49,15,57,105,776
9010,BRK,2024,Spencer Dinwiddie,30,48,48,1474,195,499,.391,89,278,.320,106,221,.480,.480,125,160,.781,26,132,158,288,38,9,62,86,604
9011,BRK,2024,Royce O'Neale,30,49,6,1202,126,325,.388,97,265,.366,29,60,.483,.537,15,22,.682,38,183,221,137,32,29,51,120,364
9012,BRK,2024,Dennis Smith Jr.,26,56,2,1059,147,338,.435,32,109,.294,115,229,.502,.482,43,58,.741,50,114,164,203,68,12,68,121,369
9013,BRK,2024,Lonnie Walker IV,25,58,0,1011,208,492,.423,104,271,.384,104,221,.471,.528,45,59,.763,13,114,127,74,32,20,51,71,565
9014,BRK,2024,Dennis Schröder,30,29,25,927,156,368,.424,61,148,.412,95,220,.432,.507,51,64,.797,17,85,102,175,17,9,70,59,424
9015,BRK,2024,Day'Ron Sharpe,22,61,1,921,168,294,.571,4,15,.267,164,279,.588,.578,75,123,.610,161,228,389,85,24,44,70,131,415
9016,BRK,2024,Trendon Watford,23,63,2,856,164,311,.527,27,68,.397,137,243,.564,.571,77,97,.794,52,142,194,81,23,19,63,106,432
9017,BRK,2024,Jalen Wilson,23,43,3,664,76,179,.425,24,74,.324,52,105,.495,.492,38,46,.826,47,84,131,45,11,4,19,48,214
9018,BRK,2024,Noah Clowney,19,23,4,370,50,93,.538,12,33,.364,38,60,.633,.602,21,30,.700,26,55,81,18,8,16,15,25,133
9019,BRK,2024,Ben Simmons,27,15,12,359,43,74,.581,0,0,,43,74,.581,.581,6,15,.400,31,88,119,86,12,9,27,36,92
9020,BRK,2024,Armoni Brooks,25,10,0,104,15,46,.326,11,32,.344,4,14,.286,.446,1,2,.500,7,11,18,5,1,1,3,3,42
9021,BRK,2024,Harry Giles,25,16,0,81,22,44,.500,3,11,.273,19,33,.576,.534,7,13,.538,12,14,26,6,1,3,6,15,54
9022,BRK,2024,Keita Bates-Diop,28,14,0,68,8,16,.500,1,5,.200,7,11,.636,.531,6,6,1.000,1,8,9,4,3,2,2,2,23
9023,BRK,2024,Keon Johnson,21,5,0,61,8,21,.381,4,10,.400,4,11,.364,.476,11,12,.917,3,4,7,3,3,1,5,5,31
9024,BRK,2024,Jacob Gilyard,25,4,0,45,0,6,.000,0,6,.000,0,0,,.000,0,0,,1,2,3,6,6,0,1,4,0
9025,BRK,2024,Dariq Whitehead,19,2,0,24,1,5,.200,0,3,.000,1,2,.500,.200,1,2,.500,0,4,4,3,0,1,0,0,3
9026,BRK,2023,Royce O'Neale,29,76,53,2409,229,593,.386,163,419,.389,66,174,.379,.524,50,69,.725,55,329,384,283,65,49,114,239,671
9027,BRK,2023,Nic Claxton,23,76,76,2271,414,587,.705,0,2,.000,414,585,.708,.705,133,246,.541,184,518,702,144,65,189,96,212,961
9028,BRK,2023,Joe Harris,31,74,33,1527,201,440,.457,142,333,.426,59,107,.551,.618,18,28,.643,23,141,164,101,34,13,41,140,562
9029,BRK,2023,Kyrie Irving,30,40,40,1478,398,819,.486,130,348,.374,268,471,.569,.565,158,179,.883,38,166,204,211,41,33,91,109,1084
9030,BRK,2023,Kevin Durant,34,39,39,1403,410,734,.559,71,189,.376,339,545,.622,.607,267,286,.934,14,248,262,207,32,57,136,92,1158
9031,BRK,2023,Seth Curry,32,61,7,1211,208,449,.463,94,232,.405,114,217,.525,.568,51,55,.927,13,87,100,99,36,7,51,96,561
9032,BRK,2023,Ben Simmons,26,42,33,1105,133,235,.566,0,2,.000,133,233,.571,.566,25,57,.439,40,223,263,256,54,24,97,139,291
9033,BRK,2023,Cam Thomas,21,57,4,948,201,456,.441,51,133,.383,150,323,.464,.497,151,174,.868,8,87,95,78,20,7,63,55,604
9034,BRK,2023,Yuta Watanabe,28,58,1,928,114,232,.491,60,135,.444,54,97,.557,.621,34,47,.723,30,111,141,48,25,17,22,80,322
9035,BRK,2023,Mikal Bridges,26,27,27,923,239,503,.475,68,181,.376,171,322,.531,.543,160,179,.894,23,98,121,72,26,16,49,44,706
9036,BRK,2023,Spencer Dinwiddie,29,26,26,917,144,356,.404,43,149,.289,101,207,.488,.465,98,123,.797,9,98,107,236,28,8,55,63,429
9037,BRK,2023,Cameron Johnson,26,25,25,770,141,301,.468,58,156,.372,83,145,.572,.565,74,87,.851,20,100,120,52,35,8,27,54,414
9038,BRK,2023,Edmond Sumner,27,53,12,736,124,269,.461,31,87,.356,93,182,.511,.519,99,108,.917,13,66,79,68,31,10,50,83,378
9039,BRK,2023,Dorian Finney-Smith,29,26,26,721,67,191,.351,37,121,.306,30,70,.429,.448,15,19,.789,47,81,128,41,17,16,26,64,186
9040,BRK,2023,Patty Mills,34,40,2,567,86,209,.411,49,134,.366,37,75,.493,.529,25,30,.833,8,36,44,56,15,3,30,32,246
9041,BRK,2023,Day'Ron Sharpe,21,48,3,552,93,171,.544,6,11,.545,87,160,.544,.561,35,55,.636,99,101,200,37,15,32,42,89,227
9042,BRK,2023,T.J. Warren,29,26,0,490,102,200,.510,16,48,.333,86,152,.566,.550,27,33,.818,13,59,72,29,15,7,17,45,247
9043,BRK,2023,Markieff Morris,33,27,1,285,33,82,.402,20,49,.408,13,33,.394,.524,10,10,1.000,13,46,59,25,8,5,14,33,96
9044,BRK,2023,David Duke Jr.,23,23,0,228,36,78,.462,1,12,.083,35,66,.530,.468,12,17,.706,11,18,29,21,10,1,18,31,85
9045,BRK,2023,Dru Smith,25,10,0,91,13,31,.419,4,13,.308,9,18,.500,.484,3,3,1.000,1,14,15,17,6,1,2,13,33
9046,BRK,2023,Kessler Edwards,22,14,1,79,6,24,.250,2,12,.167,4,12,.333,.292,1,2,.500,6,8,14,2,3,1,4,3,15
9047,BRK,2023,Nerlens Noel,28,3,1,43,1,6,.167,0,0,,1,6,.167,.167,1,2,.500,3,6,9,3,3,1,5,7,3
9048,BRK,2023,RaiQuan Gray,23,1,0,35,6,12,.500,2,5,.400,4,7,.571,.583,2,2,1.000,3,6,9,7,0,1,4,5,16
9049,BRK,2023,Moses Brown,23,2,0,6,0,0,,0,0,,0,0,,,0,0,,0,0,0,0,1,0,1,1,0
9050,BRK,2023,Alondes Williams,23,1,0,5,0,0,,0,0,,0,0,,,0,0,,0,1,1,0,0,0,2,1,0
9051,BRK,2022,Patty Mills,33,81,48,2346,324,794,.408,227,568,.400,97,226,.429,.551,48,59,.814,18,138,156,183,51,17,73,112,923
9052,BRK,2022,Kevin Durant,33,55,55,2047,578,1115,.518,115,300,.383,463,815,.568,.570,372,409,.910,29,378,407,351,48,52,191,113,1643
9053,BRK,2022,Bruce Brown,25,72,45,1774,256,506,.506,38,94,.404,218,412,.529,.543,97,128,.758,100,245,345,148,77,52,56,176,647
9054,BRK,2022,James Harden,32,44,44,1627,292,706,.414,102,307,.332,190,399,.476,.486,304,350,.869,42,309,351,447,56,31,212,105,990
9055,BRK,2022,James Johnson,34,62,10,1191,144,307,.469,23,85,.271,121,222,.545,.507,29,55,.527,51,164,215,130,30,34,48,162,340
9056,BRK,2022,Cam Thomas,20,67,2,1176,218,503,.433,47,174,.270,171,329,.520,.480,87,105,.829,16,145,161,78,33,8,55,66,570
9057,BRK,2022,Kyrie Irving,29,29,29,1091,289,616,.469,100,239,.418,189,377,.501,.550,118,129,.915,16,111,127,167,41,17,73,81,796
9058,BRK,2022,LaMarcus Aldridge,36,47,12,1050,252,458,.550,14,46,.304,238,412,.578,.566,89,102,.873,73,185,258,42,14,47,44,78,607
9059,BRK,2022,Kessler Edwards,21,48,23,987,110,267,.412,48,136,.353,62,131,.473,.502,16,19,.842,44,128,172,31,29,24,42,85,284
9060,BRK,2022,Nic Claxton,22,47,19,974,178,264,.674,0,0,,178,264,.674,.674,54,93,.581,91,173,264,43,24,51,38,110,410
9061,BRK,2022,Blake Griffin,32,56,24,958,133,313,.425,38,145,.262,95,168,.565,.486,55,76,.724,60,168,228,105,27,14,31,95,359
9062,BRK,2022,DeAndre' Bembry,27,48,20,949,121,213,.568,15,36,.417,106,177,.599,.603,21,35,.600,38,114,152,60,47,25,30,104,278
9063,BRK,2022,Seth Curry,31,19,19,569,104,211,.493,58,124,.468,46,87,.529,.630,18,21,.857,4,45,49,49,17,3,25,47,284
9064,BRK,2022,Jevon Carter,26,46,1,552,58,174,.333,42,127,.331,16,47,.340,.454,7,10,.700,9,58,67,46,14,10,26,45,165
9065,BRK,2022,Andre Drummond,28,24,24,535,119,195,.610,0,1,.000,119,194,.613,.610,44,82,.537,93,154,247,34,22,23,36,71,282
9066,BRK,2022,Joe Harris,30,14,14,423,56,124,.452,41,88,.466,15,36,.417,.617,5,6,.833,5,51,56,14,7,2,16,31,158
9067,BRK,2022,Goran Dragić,35,16,6,408,44,117,.376,12,49,.245,32,68,.471,.427,17,23,.739,11,40,51,77,14,3,33,37,117
9068,BRK,2022,Day'Ron Sharpe,20,32,8,391,86,149,.577,2,7,.286,84,142,.592,.584,24,41,.585,81,79,160,17,10,15,30,60,198
9069,BRK,2022,David Duke Jr.,22,22,7,341,39,108,.361,9,37,.243,30,71,.423,.403,17,21,.810,30,37,67,17,14,7,9,36,104
9070,BRK,2022,Paul Millsap,36,24,0,270,32,85,.376,6,27,.222,26,58,.448,.412,12,17,.706,29,60,89,24,5,11,11,48,82
9071,BRK,2022,Langston Galloway,30,4,0,58,5,13,.385,2,8,.250,3,5,.600,.462,0,0,,1,7,8,5,0,0,5,5,12
9072,BRK,2022,Shaquille Harrison,28,2,0,23,2,6,.333,0,2,.000,2,4,.500,.333,0,0,,1,3,4,3,1,1,2,3,4
9073,BRK,2022,James Ennis III,31,2,0,14,2,7,.286,1,2,.500,1,5,.200,.357,0,0,,2,3,5,0,1,1,0,0,5
9074,BRK,2022,Wenyen Gabriel,24,1,0,1,0,0,,0,0,,0,0,,,0,0,,0,1,1,0,0,0,0,0,0
9075,BRK,2021,Joe Harris,29,69,65,2141,357,707,.505,211,444,.475,146,263,.555,.654,49,63,.778,43,205,248,130,46,14,62,141,974
9076,BRK,2021,Kyrie Irving,28,54,54,1886,549,1086,.506,152,378,.402,397,708,.561,.576,201,218,.922,52,205,257,324,76,37,130,140,1451
9077,BRK,2021,Jeff Green,34,68,38,1835,261,530,.492,103,250,.412,158,280,.564,.590,125,161,.776,34,229,263,108,36,27,54,122,750
9078,BRK,2021,Bruce Brown,24,65,37,1451,235,423,.556,17,59,.288,218,364,.599,.576,86,117,.735,111,238,349,104,58,28,54,145,573
9079,BRK,2021,Landry Shamet,23,61,12,1403,186,456,.408,129,333,.387,57,123,.463,.549,66,78,.846,11,101,112,99,31,10,48,93,567
9080,BRK,2021,James Harden,31,36,35,1319,282,599,.471,96,262,.366,186,337,.552,.551,225,263,.856,30,277,307,392,46,27,143,85,885
9081,BRK,2021,DeAndre Jordan,32,57,43,1246,190,249,.763,0,1,.000,190,248,.766,.763,46,92,.500,117,310,427,93,17,65,85,116,426
9082,BRK,2021,Kevin Durant,32,35,32,1157,324,603,.537,85,189,.450,239,414,.577,.608,210,238,.882,13,234,247,195,25,45,120,70,943
9083,BRK,2021,Timothé Luwawu-Cabarrot,25,58,7,1050,130,356,.365,75,239,.314,55,117,.470,.471,35,43,.814,28,101,129,69,33,6,43,99,370
9084,BRK,2021,Tyler Johnson,28,39,3,684,72,183,.393,48,132,.364,24,51,.471,.525,18,21,.857,6,71,77,47,14,0,17,43,210
9085,BRK,2021,Nic Claxton,21,32,1,594,90,145,.621,1,5,.200,89,140,.636,.624,31,64,.484,43,123,166,28,23,40,18,68,212
9086,BRK,2021,Blake Griffin,31,26,10,560,93,189,.492,31,81,.383,62,108,.574,.574,43,55,.782,28,93,121,63,18,13,30,69,260
9087,BRK,2021,Caris LeVert,26,12,4,334,87,200,.435,22,63,.349,65,137,.474,.490,26,34,.765,10,42,52,72,13,6,26,20,222
9088,BRK,2021,Jarrett Allen,22,12,5,320,44,65,.677,0,0,,44,65,.677,.677,46,61,.754,38,87,125,20,7,19,22,21,134
9089,BRK,2021,Mike James,30,13,1,236,34,92,.370,11,31,.355,23,61,.377,.429,21,27,.778,3,29,32,54,6,1,20,10,100
9090,BRK,2021,Chris Chiozza,25,22,1,232,31,88,.352,13,42,.310,18,46,.391,.426,13,17,.765,3,21,24,65,7,6,16,19,88
9091,BRK,2021,Taurean Prince,26,12,4,218,30,74,.405,13,37,.351,17,37,.459,.493,24,27,.889,2,32,34,7,8,8,11,21,97
9092,BRK,2021,Reggie Perry,20,26,0,211,32,78,.410,4,21,.190,28,57,.491,.436,10,13,.769,27,46,73,14,6,6,15,40,78
9093,BRK,2021,Alize Johnson,24,18,0,189,40,68,.588,1,6,.167,39,62,.629,.596,13,13,1.000,27,63,90,14,5,5,9,16,94
9094,BRK,2021,LaMarcus Aldridge,35,5,5,130,25,48,.521,4,5,.800,21,43,.488,.563,10,10,1.000,2,22,24,13,3,11,7,11,64
9095,BRK,2021,Spencer Dinwiddie,27,3,3,64,6,16,.375,2,7,.286,4,9,.444,.438,6,6,1.000,0,13,13,9,2,1,5,4,20
9096,BRK,2021,Andre Roberson,29,5,0,63,2,14,.143,1,8,.125,1,6,.167,.179,1,2,.500,7,8,15,4,3,1,2,4,6
9097,BRK,2021,Norvel Pelle,27,3,0,28,3,7,.429,0,0,,3,7,.429,.429,0,0,,3,4,7,0,0,3,3,9,6
9098,BRK,2021,Tyler Cook,23,4,0,17,1,3,.333,0,0,,1,3,.333,.333,0,0,,1,1,2,2,0,0,1,2,2
9099,BRK,2021,Rodions Kurucs,22,5,0,16,1,3,.333,1,2,.500,0,1,.000,.500,0,0,,0,3,3,2,0,0,0,1,3
9100,BRK,2021,Iman Shumpert,30,2,0,11,1,4,.250,0,3,.000,1,1,1.000,.250,0,0,,1,0,1,0,1,0,1,0,2
9101,BRK,2021,Noah Vonleh,25,4,0,11,0,3,.000,0,2,.000,0,1,.000,.000,0,0,,0,1,1,1,0,0,2,2,0
9102,BRK,2020,Joe Harris,28,69,69,2123,381,784,.486,172,406,.424,209,378,.553,.596,64,89,.719,64,234,298,144,41,17,104,159,998
9103,BRK,2020,Spencer Dinwiddie,26,64,49,1994,424,1021,.415,123,400,.308,301,621,.485,.476,347,446,.778,32,189,221,432,40,21,174,180,1318
9104,BRK,2020,Taurean Prince,25,64,61,1857,278,739,.376,146,431,.339,132,308,.429,.475,71,89,.798,50,331,381,116,57,25,127,159,773
9105,BRK,2020,Jarrett Allen,21,70,64,1852,302,465,.649,0,6,.000,302,459,.658,.649,171,270,.633,216,455,671,110,40,92,77,162,775
9106,BRK,2020,Garrett Temple,33,62,35,1730,222,587,.378,127,386,.329,95,201,.473,.486,70,87,.805,29,189,218,156,49,29,62,108,641
9107,BRK,2020,Caris LeVert,25,45,31,1330,311,732,.425,80,220,.364,231,512,.451,.480,140,197,.711,49,140,189,199,53,10,118,81,842
9108,BRK,2020,DeAndre Jordan,31,56,6,1234,191,287,.666,0,0,,191,287,.666,.666,83,122,.680,141,420,561,105,18,52,74,114,465
9109,BRK,2020,Timothé Luwawu-Cabarrot,24,47,2,853,117,269,.435,62,160,.388,55,109,.505,.550,69,81,.852,29,98,127,29,18,7,37,106,365
9110,BRK,2020,Wilson Chandler,32,35,3,734,74,183,.404,37,121,.306,37,62,.597,.505,20,23,.870,11,134,145,39,16,12,34,79,205
9111,BRK,2020,Rodions Kurucs,21,47,9,684,79,177,.446,33,90,.367,46,87,.529,.540,24,38,.632,25,112,137,51,25,5,46,90,215
9112,BRK,2020,Kyrie Irving,27,20,20,658,199,416,.478,56,142,.394,143,274,.522,.546,94,102,.922,22,81,103,128,27,10,52,53,548
9113,BRK,2020,Džanan Musa,20,40,0,487,64,172,.372,19,78,.244,45,94,.479,.427,45,60,.750,21,65,86,43,15,1,36,30,192
9114,BRK,2020,Theo Pinson,24,33,0,365,45,155,.290,15,80,.188,30,75,.400,.339,15,16,.938,10,44,54,56,17,4,33,35,120
9115,BRK,2020,Chris Chiozza,24,18,2,278,45,106,.425,20,56,.357,25,50,.500,.519,5,5,1.000,9,29,38,55,11,2,23,25,115
9116,BRK,2020,David Nwaba,27,20,0,268,37,71,.521,12,28,.429,25,43,.581,.606,18,27,.667,8,37,45,8,11,12,8,32,104
9117,BRK,2020,Iman Shumpert,29,13,0,241,21,64,.328,8,33,.242,13,31,.419,.391,4,7,.571,9,25,34,12,12,2,10,21,54
9118,BRK,2020,Tyler Johnson,27,8,4,194,32,79,.405,14,36,.389,18,43,.419,.494,18,18,1.000,8,16,24,24,4,1,5,15,96
9119,BRK,2020,Nic Claxton,20,15,0,187,27,48,.563,1,7,.143,26,41,.634,.573,11,21,.524,19,25,44,16,1,8,9,14,66
9120,BRK,2020,Justin Anderson,26,10,1,107,10,38,.263,6,29,.207,4,9,.444,.342,2,4,.500,1,20,21,8,0,6,4,13,28
9121,BRK,2020,Jeremiah Martin,23,9,0,99,24,53,.453,5,18,.278,19,35,.543,.500,11,14,.786,1,9,10,18,7,2,4,7,64
9122,BRK,2020,Lance Thomas,31,7,4,98,8,23,.348,4,13,.308,4,10,.400,.435,4,4,1.000,2,11,13,6,0,0,6,11,24
9123,BRK,2020,Donta Hall,22,5,0,85,14,18,.778,0,0,,14,18,.778,.778,5,12,.417,8,15,23,2,2,5,3,14,33
9124,BRK,2020,Henry Ellenson,23,5,0,15,1,7,.143,0,4,.000,1,3,.333,.143,0,0,,2,4,6,1,0,0,0,1,2
9125,BRK,2020,Jamal Crawford,39,1,0,6,2,4,.500,1,2,.500,1,2,.500,.625,0,0,,0,0,0,3,0,0,0,1,5
9126,BRK,2019,D'Angelo Russell,22,81,81,2448,659,1517,.434,234,635,.369,425,882,.482,.512,160,205,.780,53,262,315,563,100,20,253,141,1712
9127,BRK,2019,Joe Harris,27,76,76,2293,374,748,.500,183,386,.474,191,362,.528,.622,110,133,.827,52,239,291,181,38,17,121,182,1041
9128,BRK,2019,Jarrett Allen,20,80,80,2096,335,568,.590,6,45,.133,329,523,.629,.595,197,278,.709,191,481,672,110,43,120,103,184,873
9129,BRK,2019,Spencer Dinwiddie,25,68,4,1914,366,828,.442,124,370,.335,242,458,.528,.517,287,356,.806,26,140,166,311,40,17,152,187,1143
9130,BRK,2019,DeMarre Carroll,32,67,8,1703,227,575,.395,106,310,.342,121,265,.457,.487,184,242,.760,68,281,349,85,31,10,73,114,744
9131,BRK,2019,Ed Davis,29,81,1,1446,186,302,.616,0,2,.000,186,300,.620,.616,100,162,.617,216,478,694,61,35,33,64,226,472
9132,BRK,2019,Rodions Kurucs,20,63,46,1294,202,449,.450,58,184,.315,144,265,.543,.514,72,92,.783,56,190,246,52,41,25,77,146,534
9133,BRK,2019,Rondae Hollis-Jefferson,24,59,21,1234,200,487,.411,9,49,.184,191,438,.436,.420,118,183,.645,83,227,310,96,44,27,68,107,527
9134,BRK,2019,Jared Dudley,33,59,25,1220,101,239,.423,53,151,.351,48,88,.545,.533,32,46,.696,34,121,155,83,36,16,43,131,287
9135,BRK,2019,Allen Crabbe,26,43,20,1133,137,373,.367,98,259,.378,39,114,.342,.499,41,56,.732,16,132,148,46,23,13,46,102,413
9136,BRK,2019,Caris LeVert,24,40,25,1063,207,483,.429,48,154,.312,159,329,.483,.478,85,123,.691,35,116,151,156,42,14,69,77,547
9137,BRK,2019,Shabazz Napier,27,56,2,983,169,435,.389,76,228,.333,93,207,.449,.476,115,138,.833,18,82,100,143,41,16,66,67,529
9138,BRK,2019,Treveon Graham,25,35,21,715,64,191,.335,38,128,.297,26,63,.413,.435,18,22,.818,23,84,107,34,13,7,17,68,184
9139,BRK,2019,Theo Pinson,23,18,0,211,25,73,.342,12,46,.261,13,27,.481,.425,19,22,.864,4,32,36,21,6,0,18,15,81
9140,BRK,2019,Kenneth Faried,29,12,0,118,25,42,.595,1,5,.200,24,37,.649,.607,10,16,.625,15,29,44,2,2,4,6,8,61
9141,BRK,2019,Džanan Musa,19,9,0,39,9,22,.409,1,10,.100,8,12,.667,.432,0,2,.000,1,4,5,2,2,0,4,1,19
9142,BRK,2019,Mitch Creek,26,4,0,36,5,10,.500,0,1,.000,5,9,.556,.500,5,7,.714,5,5,10,5,1,0,0,3,15
9143,BRK,2019,Alan Williams,26,5,0,26,8,13,.615,0,1,.000,8,12,.667,.615,2,4,.500,4,15,19,3,1,0,1,2,18
9144,BRK,2019,Tahjere McCall,24,1,0,8,2,3,.667,0,1,.000,2,2,1.000,.667,0,1,.000,0,1,1,0,0,0,0,2,4
9145,BRK,2018,Spencer Dinwiddie,24,80,58,2306,324,838,.387,141,433,.326,183,405,.452,.471,218,268,.813,40,219,259,524,68,23,128,186,1007
9146,BRK,2018,Allen Crabbe,25,75,68,2197,337,827,.407,201,532,.378,136,295,.461,.529,115,135,.852,28,296,324,117,47,35,78,168,990
9147,BRK,2018,DeMarre Carroll,31,73,73,2180,325,785,.414,145,391,.371,180,394,.457,.506,188,246,.764,105,374,479,147,59,30,103,165,983
9148,BRK,2018,Joe Harris,26,78,14,1975,305,621,.491,150,358,.419,155,263,.589,.612,86,104,.827,51,209,260,128,35,20,91,153,846
9149,BRK,2018,Rondae Hollis-Jefferson,23,68,59,1920,342,724,.472,13,54,.241,329,670,.491,.481,249,316,.788,101,358,459,167,65,48,121,145,946
9150,BRK,2018,Caris LeVert,23,71,10,1864,320,735,.435,85,245,.347,235,490,.480,.493,133,187,.711,53,207,260,299,82,22,153,159,858
9151,BRK,2018,Jarrett Allen,19,72,31,1441,234,397,.589,5,15,.333,229,382,.599,.596,114,147,.776,144,244,388,49,28,88,82,147,587
9152,BRK,2018,Quincy Acy,27,70,8,1359,130,365,.356,102,292,.349,28,73,.384,.496,49,60,.817,40,217,257,57,33,29,60,149,411
9153,BRK,2018,D'Angelo Russell,21,48,35,1234,278,672,.414,90,278,.324,188,394,.477,.481,97,131,.740,30,159,189,249,36,17,147,93,743
9154,BRK,2018,Tyler Zeller,28,42,33,703,125,229,.546,10,26,.385,115,203,.567,.568,40,60,.667,63,131,194,28,8,21,35,78,300
9155,BRK,2018,Nik Stauskas,24,35,0,478,59,150,.393,40,99,.404,19,51,.373,.527,19,27,.704,4,59,63,38,5,4,22,21,177
9156,BRK,2018,Dante Cunningham,30,22,1,447,65,139,.468,23,60,.383,42,79,.532,.550,11,16,.688,28,77,105,22,12,14,17,36,164
9157,BRK,2018,Trevor Booker,30,18,6,395,77,150,.513,3,12,.250,74,138,.536,.523,24,43,.558,38,81,119,38,8,5,30,43,181
9158,BRK,2018,Timofey Mozgov,31,31,13,359,52,93,.559,4,18,.222,48,75,.640,.581,23,30,.767,32,66,98,11,5,13,33,39,131
9159,BRK,2018,Jahlil Okafor,22,26,0,328,73,129,.566,1,4,.250,72,125,.576,.570,19,25,.760,17,59,76,11,3,16,18,44,166
9160,BRK,2018,Sean Kilpatrick,28,16,0,183,25,87,.287,11,43,.256,14,44,.318,.351,18,19,.947,1,34,35,15,2,1,16,8,79
9161,BRK,2018,Isaiah Whitehead,22,16,0,180,40,86,.465,7,18,.389,33,68,.485,.506,13,19,.684,4,22,26,20,8,2,24,23,100
9162,BRK,2018,Milton Doyle,24,10,0,125,13,47,.277,4,23,.174,9,24,.375,.319,4,8,.500,3,15,18,10,6,2,2,13,34
9163,BRK,2018,James Webb III,24,10,0,120,6,24,.250,4,19,.211,2,5,.400,.333,0,0,,8,16,24,4,1,0,4,10,16
9164,BRK,2018,Jacob Wiley,23,5,0,33,1,4,.250,1,2,.500,0,2,.000,.375,1,2,.500,2,9,11,2,1,0,0,4,4
9165,BRK,2018,Jeremy Lin,29,1,1,25,5,12,.417,1,2,.500,4,10,.400,.458,7,7,1.000,0,0,0,4,0,0,3,3,18
9166,BRK,2018,Rashad Vaughn,21,1,0,4,0,0,,0,0,,0,0,,,0,0,,0,0,0,1,0,0,0,1,0
9167,BRK,2017,Brook Lopez,28,75,75,2222,555,1172,.474,134,387,.346,421,785,.536,.531,295,364,.810,121,282,403,176,38,124,184,192,1539
9168,BRK,2017,Rondae Hollis-Jefferson,22,78,50,1761,235,542,.434,15,67,.224,220,475,.463,.447,190,253,.751,96,356,452,154,82,44,116,177,675
9169,BRK,2017,Sean Kilpatrick,27,70,24,1754,305,735,.415,105,308,.341,200,427,.468,.486,204,242,.843,22,258,280,157,45,6,135,118,919
9170,BRK,2017,Trevor Booker,29,71,43,1754,305,591,.516,25,78,.321,280,513,.546,.537,74,110,.673,143,428,571,138,75,28,127,152,709
9171,BRK,2017,Isaiah Whitehead,21,73,26,1643,204,508,.402,44,149,.295,160,359,.446,.445,91,113,.805,32,152,184,192,42,36,142,175,543
9172,BRK,2017,Bojan Bogdanović,27,55,54,1482,269,611,.440,99,277,.357,170,334,.509,.521,146,167,.874,23,174,197,90,24,3,93,99,783
9173,BRK,2017,Spencer Dinwiddie,23,59,18,1334,134,302,.444,38,101,.376,96,201,.478,.507,126,159,.792,27,137,164,185,44,23,66,119,432
9174,BRK,2017,Randy Foye,33,69,40,1284,118,325,.363,67,203,.330,51,122,.418,.466,54,63,.857,9,146,155,135,35,9,80,99,357
9175,BRK,2017,Caris LeVert,22,57,26,1237,171,380,.450,59,184,.321,112,196,.571,.528,67,93,.720,23,165,188,110,49,8,59,91,468
9176,BRK,2017,Justin Hamilton,26,64,7,1177,174,379,.459,55,180,.306,119,199,.598,.532,39,52,.750,71,191,262,55,29,43,43,91,442
9177,BRK,2017,Joe Harris,25,52,11,1138,154,362,.425,85,221,.385,69,141,.489,.543,35,49,.714,16,131,147,54,30,8,55,121,428
9178,BRK,2017,Jeremy Lin,28,36,33,883,175,400,.438,58,156,.372,117,244,.480,.510,115,141,.816,11,124,135,184,42,14,86,79,523
9179,BRK,2017,Quincy Acy,26,32,1,510,65,153,.425,36,83,.434,29,70,.414,.542,43,57,.754,18,89,107,18,14,15,19,58,209
9180,BRK,2017,Luis Scola,36,36,1,461,71,151,.470,17,50,.340,54,101,.535,.526,25,37,.676,51,88,139,37,14,4,34,63,184
9181,BRK,2017,K.J. McDaniels,23,20,0,293,46,101,.455,11,39,.282,35,62,.565,.510,23,28,.821,9,43,52,9,12,10,19,25,126
9182,BRK,2017,Anthony Bennett,23,23,1,264,38,92,.413,13,48,.271,25,44,.568,.484,26,36,.722,25,53,78,12,5,3,12,18,115
9183,BRK,2017,Archie Goodwin,22,12,0,184,34,61,.557,4,13,.308,30,48,.625,.590,23,32,.719,7,21,28,23,4,4,14,7,95
9184,BRK,2017,Yogi Ferrell,23,10,0,151,18,49,.367,8,27,.296,10,22,.455,.449,10,16,.625,4,8,12,17,2,2,14,11,54
9185,BRK,2017,Andrew Nicholson,27,10,0,111,13,34,.382,2,11,.182,11,23,.478,.412,2,2,1.000,4,23,27,3,5,0,6,18,30
9186,BRK,2017,Chris McCullough,21,14,0,72,16,31,.516,1,6,.167,15,25,.600,.532,2,3,.667,9,8,17,2,1,2,2,7,35
9187,BRK,2017,Greivis Vásquez,30,3,0,39,2,8,.250,1,3,.333,1,5,.200,.313,2,3,.667,0,2,2,5,1,1,1,6,7
9188,BRK,2016,Brook Lopez,27,73,73,2457,591,1157,.511,2,14,.143,589,1143,.515,.512,317,403,.787,204,369,573,147,58,124,175,215,1501
9189,BRK,2016,Thaddeus Young,27,73,73,2407,495,963,.514,7,30,.233,488,933,.523,.518,105,163,.644,176,484,660,136,112,37,136,182,1102
9190,BRK,2016,Bojan Bogdanović,26,79,39,2115,324,749,.433,129,338,.382,195,411,.474,.519,110,132,.833,36,219,255,99,29,5,115,119,887
9191,BRK,2016,Joe Johnson,34,57,57,1934,247,608,.406,85,229,.371,162,379,.427,.476,92,108,.852,34,190,224,232,40,2,116,100,671
9192,BRK,2016,Shane Larkin,23,78,17,1751,222,502,.442,39,108,.361,183,394,.464,.481,83,107,.776,28,152,180,342,95,12,146,121,566
9193,BRK,2016,Wayne Ellington,28,76,41,1615,218,561,.389,96,268,.358,122,293,.416,.474,54,63,.857,20,154,174,83,48,5,45,82,586
9194,BRK,2016,Donald Sloan,28,61,33,1318,154,350,.440,38,99,.384,116,251,.462,.494,78,104,.750,17,156,173,268,32,4,80,73,424
9195,BRK,2016,Jarrett Jack,32,32,32,1027,140,358,.391,31,102,.304,109,256,.426,.434,100,112,.893,9,127,136,236,34,7,94,77,411
9196,BRK,2016,Markel Brown,24,62,6,982,127,322,.394,38,121,.314,89,201,.443,.453,71,94,.755,23,99,122,91,38,15,54,94,363
9197,BRK,2016,Thomas Robinson,24,71,7,917,130,291,.447,0,1,.000,130,290,.448,.447,47,109,.431,136,223,359,46,39,36,69,111,307
9198,BRK,2016,Andrea Bargnani,30,46,0,634,127,279,.455,3,16,.188,124,263,.471,.461,47,57,.825,28,69,97,18,4,9,26,61,304
9199,BRK,2016,Rondae Hollis-Jefferson,21,29,17,615,63,138,.457,4,14,.286,59,124,.476,.471,37,52,.712,39,115,154,43,39,16,26,61,167
9200,BRK,2016,Sean Kilpatrick,26,23,0,534,115,249,.462,35,97,.361,80,152,.526,.532,53,59,.898,10,40,50,26,10,2,27,30,318
9201,BRK,2016,Willie Reed,25,39,2,426,76,133,.571,0,0,,76,133,.571,.571,30,55,.545,49,73,122,10,6,30,16,47,182
9202,BRK,2016,Sergey Karasev,22,40,5,399,30,74,.405,11,37,.297,19,37,.514,.480,26,28,.929,8,50,58,35,6,2,22,27,97
9203,BRK,2016,Chris McCullough,20,24,4,362,44,109,.404,13,34,.382,31,75,.413,.463,11,23,.478,25,43,68,9,28,12,15,39,112
9204,BRK,2016,Henry Sims,25,14,4,263,33,77,.429,0,0,,33,77,.429,.429,25,30,.833,21,51,72,9,9,14,12,37,91
9205,BRK,2015,Joe Johnson,33,80,80,2791,446,1025,.435,121,337,.359,325,688,.472,.494,141,176,.801,53,331,384,292,59,14,137,120,1154
9206,BRK,2015,Jarrett Jack,31,80,27,2241,359,817,.439,39,146,.267,320,671,.477,.463,200,227,.881,19,226,245,373,75,13,191,143,957
9207,BRK,2015,Deron Williams,30,68,55,2114,298,771,.387,87,237,.367,211,534,.395,.443,201,241,.834,29,208,237,448,64,17,154,157,884
9208,BRK,2015,Brook Lopez,26,72,44,2100,506,987,.513,1,10,.100,505,977,.517,.513,223,274,.814,214,321,535,50,43,126,104,206,1236
9209,BRK,2015,Bojan Bogdanović,25,78,28,1854,261,576,.453,91,256,.355,170,320,.531,.532,87,106,.821,50,163,213,68,34,9,78,104,700
9210,BRK,2015,Alan Anderson,32,74,19,1744,195,440,.443,73,210,.348,122,230,.530,.526,82,101,.812,31,173,204,83,56,5,60,148,545
9211,BRK,2015,Mason Plumlee,24,82,45,1743,280,489,.573,0,3,.000,280,486,.576,.573,157,317,.495,175,337,512,74,65,63,106,207,717
9212,BRK,2015,Mirza Teletović,29,40,4,892,122,319,.382,62,193,.321,60,126,.476,.480,33,46,.717,27,167,194,46,14,16,53,74,339
9213,BRK,2015,Kevin Garnett,38,42,42,854,125,275,.455,1,6,.167,124,269,.461,.456,34,41,.829,46,239,285,69,41,13,45,96,285
9214,BRK,2015,Thaddeus Young,26,28,20,829,162,327,.495,19,50,.380,143,277,.516,.524,43,71,.606,52,114,166,38,38,8,42,56,386
9215,BRK,2015,Markel Brown,23,47,29,781,76,210,.362,17,64,.266,59,146,.404,.402,47,57,.825,16,91,107,39,31,12,27,57,216
9216,BRK,2015,Sergey Karasev,21,33,16,555,54,134,.403,16,54,.296,38,80,.475,.463,29,38,.763,22,44,66,46,23,1,24,45,153
9217,BRK,2015,Cory Jefferson,24,50,1,531,75,167,.449,2,15,.133,73,152,.480,.455,31,54,.574,47,98,145,16,10,21,20,61,183
9218,BRK,2015,Jerome Jordan,28,44,0,383,50,94,.532,0,0,,50,94,.532,.532,38,44,.864,52,53,105,13,8,15,22,58,138
9219,BRK,2015,Darius Morris,24,38,0,299,36,106,.340,7,33,.212,29,73,.397,.373,4,9,.444,7,20,27,48,9,0,21,20,83
9220,BRK,2015,Earl Clark,27,10,0,93,11,30,.367,4,14,.286,7,16,.438,.433,1,4,.250,1,22,23,3,3,4,6,12,27
9221,BRK,2015,Jorge Gutiérrez,26,10,0,44,7,14,.500,0,1,.000,7,13,.538,.500,2,3,.667,0,7,7,7,1,0,3,9,16
9222,BRK,2015,Brandon Davies,23,7,0,44,6,18,.333,1,4,.250,5,14,.357,.361,3,4,.750,3,7,10,2,1,3,4,5,16
9223,BRK,2015,Andrei Kirilenko,33,7,0,36,0,5,.000,0,0,,0,5,.000,.000,3,4,.750,2,6,8,1,1,0,1,1,3
9224,BRK,2014,Joe Johnson,32,79,79,2575,462,1018,.454,162,404,.401,300,614,.489,.533,159,195,.815,48,222,270,216,47,10,120,129,1245
9225,BRK,2014,Paul Pierce,36,75,68,2098,321,712,.451,112,300,.373,209,412,.507,.529,256,310,.826,26,322,348,178,86,31,153,190,1010
9226,BRK,2014,Deron Williams,29,64,58,2059,322,716,.450,98,268,.366,224,448,.500,.518,173,216,.801,15,153,168,392,93,13,143,148,915
9227,BRK,2014,Shaun Livingston,28,76,54,1974,235,487,.483,1,6,.167,234,481,.486,.484,158,191,.827,67,179,246,245,93,31,105,172,629
9228,BRK,2014,Alan Anderson,31,78,26,1773,194,485,.400,84,248,.339,110,237,.464,.487,92,118,.780,40,135,175,81,48,11,62,147,564
9229,BRK,2014,Andray Blatche,27,73,7,1618,321,674,.476,15,54,.278,306,620,.494,.487,164,221,.742,120,270,390,112,75,38,110,166,821
9230,BRK,2014,Mirza Teletović,28,72,7,1396,221,529,.418,136,349,.390,85,180,.472,.546,44,62,.710,60,206,266,57,29,23,54,143,622
9231,BRK,2014,Mason Plumlee,23,70,22,1275,199,302,.659,0,3,.000,199,299,.666,.659,122,195,.626,99,209,308,60,49,55,77,171,520
9232,BRK,2014,Kevin Garnett,37,54,54,1109,157,356,.441,0,3,.000,157,353,.445,.441,38,47,.809,60,298,358,82,43,40,69,123,352
9233,BRK,2014,Andrei Kirilenko,32,45,4,857,82,160,.513,1,5,.200,81,155,.523,.516,61,119,.513,55,91,146,72,40,19,54,65,226
9234,BRK,2014,Marcus Thornton,26,26,1,620,110,266,.414,52,137,.380,58,129,.450,.511,48,60,.800,18,56,74,30,27,3,29,36,320
9235,BRK,2014,Jason Terry,36,35,0,570,55,152,.362,39,103,.379,16,49,.327,.490,10,15,.667,4,33,37,56,13,0,27,48,159
9236,BRK,2014,Brook Lopez,25,17,17,533,129,229,.563,0,1,.000,129,228,.566,.563,94,115,.817,39,63,102,16,9,30,28,52,352
9237,BRK,2014,Reggie Evans,33,30,6,399,23,59,.390,0,0,,23,59,.390,.390,35,65,.538,53,96,149,5,13,2,28,54,81
9238,BRK,2014,Tyshawn Taylor,23,23,3,270,31,91,.341,3,12,.250,28,79,.354,.357,24,30,.800,3,12,15,36,12,1,31,29,89
9239,BRK,2014,Jorge Gutiérrez,25,15,2,244,25,54,.463,3,12,.250,22,42,.524,.491,9,12,.750,3,19,22,30,10,1,14,37,62
9240,BRK,2014,Marquis Teague,20,21,1,201,22,53,.415,3,8,.375,19,45,.422,.443,15,19,.789,0,21,21,30,8,1,22,21,62
9241,BRK,2014,Jason Collins,35,22,1,172,11,24,.458,0,3,.000,11,21,.524,.458,3,4,.750,7,12,19,4,8,1,7,30,25
9242,BRK,2014,Tornike Shengelia,22,17,0,137,11,24,.458,0,6,.000,11,18,.611,.458,3,8,.375,4,10,14,12,2,1,11,16,25
9243,BRK,2013,Deron Williams,28,78,78,2842,495,1124,.440,169,447,.378,326,677,.482,.516,317,369,.859,29,203,232,604,75,30,218,194,1476
9244,BRK,2013,Joe Johnson,31,72,72,2642,445,1052,.423,148,395,.375,297,657,.452,.493,132,161,.820,53,165,218,253,49,14,123,99,1170
9245,BRK,2013,Brook Lopez,24,74,74,2253,570,1094,.521,0,1,.000,570,1093,.522,.521,297,392,.758,208,304,512,70,33,154,131,152,1437
9246,BRK,2013,Gerald Wallace,30,69,68,2076,182,458,.397,46,163,.282,136,295,.461,.448,121,190,.637,69,250,319,181,97,46,110,118,531
9247,BRK,2013,Reggie Evans,32,80,56,1967,125,261,.479,0,0,,125,261,.479,.479,113,222,.509,260,628,888,43,74,13,111,199,363
9248,BRK,2013,Andray Blatche,26,82,8,1555,346,676,.512,3,22,.136,343,654,.524,.514,148,216,.685,161,256,417,85,86,54,123,163,843
9249,BRK,2013,C.J. Watson,28,80,8,1521,192,459,.418,88,214,.411,104,245,.424,.514,71,91,.780,38,107,145,161,66,12,69,123,543
9250,BRK,2013,Keith Bogans,32,74,23,1408,108,284,.380,84,245,.343,24,39,.615,.528,11,17,.647,16,104,120,76,28,4,49,108,311
9251,BRK,2013,Kris Humphries,27,65,21,1191,139,310,.448,0,2,.000,139,308,.451,.448,97,123,.789,126,239,365,32,16,33,57,127,375
9252,BRK,2013,MarShon Brooks,24,73,2,912,155,335,.463,15,55,.273,140,280,.500,.485,69,94,.734,32,72,104,76,34,16,69,93,394
9253,BRK,2013,Jerry Stackhouse,38,37,0,544,66,172,.384,30,89,.337,36,83,.434,.471,20,23,.870,5,28,33,35,7,4,24,31,182
9254,BRK,2013,Mirza Teletović,27,53,0,499,71,185,.384,37,108,.343,34,77,.442,.484,9,11,.818,33,62,95,23,13,8,20,53,188
9255,BRK,2013,Tyshawn Taylor,22,38,0,221,32,87,.368,6,13,.462,26,74,.351,.402,15,27,.556,2,16,18,21,13,0,25,25,85
9256,BRK,2013,Josh Childress,29,14,0,100,6,21,.286,1,3,.333,5,18,.278,.310,1,2,.500,6,9,15,5,2,2,0,3,14
9257,BRK,2013,Tornike Shengelia,21,19,0,93,10,23,.435,1,2,.500,9,21,.429,.457,9,16,.563,9,14,23,3,3,1,11,11,30
9258,BRK,2013,Kris Joseph,24,4,0,30,0,3,.000,0,1,.000,0,2,.000,.000,2,4,.500,0,2,2,0,3,0,0,1,2
9259,BRK,2013,Damion James,25,2,0,0,0,0,,0,0,,0,0,,,0,0,,0,1,1,0,0,0,0,0,0
9260,NJN,2012,Kris Humphries,26,62,62,2162,323,671,.481,0,0,,323,671,.481,.481,209,278,.752,233,448,681,90,50,74,119,173,855
9261,NJN,2012,Deron Williams,27,55,55,1999,391,961,.407,115,342,.336,276,619,.446,.467,257,305,.843,23,160,183,481,67,20,219,121,1154
9262,NJN,2012,MarShon Brooks,23,56,47,1648,274,640,.428,47,150,.313,227,490,.463,.465,113,148,.764,70,130,200,131,52,15,118,116,708
9263,NJN,2012,Anthony Morrow,26,62,18,1636,272,658,.413,106,286,.371,166,372,.446,.494,97,104,.933,31,96,127,61,46,9,70,86,747
9264,NJN,2012,Shelden Williams,28,58,35,1276,96,201,.478,0,0,,96,201,.478,.478,76,104,.731,141,209,350,35,47,39,66,149,268
9265,NJN,2012,DeShawn Stevenson,30,51,30,960,49,172,.285,41,145,.283,8,27,.296,.404,9,16,.563,7,94,101,41,19,4,19,59,148
9266,NJN,2012,Johan Petro,26,59,10,920,109,260,.419,1,1,1.000,108,259,.417,.421,31,37,.838,68,156,224,45,21,23,38,122,250
9267,NJN,2012,Jordan Farmar,25,39,5,831,147,315,.467,55,125,.440,92,190,.484,.554,57,63,.905,7,54,61,129,24,2,68,49,406
9268,NJN,2012,Sundiata Gaines,25,57,12,793,102,271,.376,28,82,.341,74,189,.392,.428,59,96,.615,27,81,108,126,55,2,52,58,291
9269,NJN,2012,Gerald Green,26,31,2,781,154,320,.481,43,110,.391,111,210,.529,.548,49,65,.754,15,93,108,34,28,17,55,80,400
9270,NJN,2012,Jordan Williams,21,43,5,635,77,152,.507,0,0,,77,152,.507,.507,43,66,.652,66,90,156,11,21,15,23,61,197
9271,NJN,2012,Gerald Wallace,29,16,16,573,84,202,.416,20,52,.385,64,150,.427,.465,55,64,.859,24,85,109,49,23,11,27,38,243
9272,NJN,2012,Shawne Williams,25,25,6,514,42,147,.286,21,87,.241,21,60,.350,.357,8,11,.727,20,48,68,16,10,11,13,44,113
9273,NJN,2012,Mehmet Okur,32,17,14,454,52,139,.374,23,72,.319,29,67,.433,.457,3,5,.600,22,59,81,30,9,5,25,45,130
9274,NJN,2012,Damion James,24,7,7,170,13,35,.371,0,1,.000,13,34,.382,.371,8,12,.667,7,26,33,3,7,7,12,17,34
9275,NJN,2012,Brook Lopez,23,5,5,136,38,77,.494,0,0,,38,77,.494,.494,20,32,.625,8,10,18,6,1,4,6,8,96
9276,NJN,2012,Armon Johnson,22,8,0,119,19,42,.452,1,3,.333,18,39,.462,.464,6,6,1.000,1,11,12,11,4,0,5,9,45
9277,NJN,2012,Keith Bogans,31,5,1,94,8,21,.381,3,12,.250,5,9,.556,.452,2,5,.400,5,6,11,3,2,0,3,15,21
9278,NJN,2012,Larry Owens,29,7,0,75,4,11,.364,2,5,.400,2,6,.333,.455,3,4,.750,2,11,13,4,0,1,2,10,13
9279,NJN,2012,Jerry Smith,24,5,0,46,3,14,.214,1,6,.167,2,8,.250,.250,0,0,,2,5,7,4,5,0,0,5,7
9280,NJN,2012,Andre Emmett,29,6,0,45,4,7,.571,0,1,.000,4,6,.667,.571,5,8,.625,2,4,6,1,2,1,2,2,13
9281,NJN,2012,Dennis Horner,23,8,0,22,1,4,.250,0,1,.000,1,3,.333,.250,3,4,.750,2,3,5,0,0,0,1,1,5
9282,NJN,2011,Brook Lopez,22,82,82,2889,644,1309,.492,0,1,.000,644,1308,.492,.492,385,489,.787,197,291,488,129,47,120,176,240,1673
9283,NJN,2011,Travis Outlaw,26,82,55,2358,274,731,.375,76,252,.302,198,479,.413,.427,132,171,.772,54,271,325,84,34,36,71,148,756
9284,NJN,2011,Kris Humphries,25,74,44,2061,307,583,.527,0,1,.000,307,582,.527,.527,127,191,.665,225,546,771,84,33,80,103,168,741
9285,NJN,2011,Anthony Morrow,25,58,47,1856,279,620,.450,110,260,.423,169,360,.469,.539,96,107,.897,37,135,172,68,19,7,54,135,764
9286,NJN,2011,Jordan Farmar,24,73,18,1796,255,651,.392,109,304,.359,146,347,.421,.475,82,100,.820,24,149,173,368,62,6,139,128,701
9287,NJN,2011,Devin Harris,27,54,54,1724,260,612,.425,33,110,.300,227,502,.452,.452,258,307,.840,11,118,129,411,57,5,158,130,811
9288,NJN,2011,Sasha Vujačić,26,56,17,1594,231,572,.404,94,255,.369,137,317,.432,.486,80,94,.851,29,153,182,127,53,5,61,129,636
9289,NJN,2011,Derrick Favors,19,56,23,1091,141,276,.511,0,0,,141,276,.511,.511,71,116,.612,126,171,297,21,18,41,56,183,353
9290,NJN,2011,Stephen Graham,28,59,28,959,81,200,.405,5,21,.238,76,179,.425,.418,31,38,.816,17,106,123,40,14,1,38,106,198
9291,NJN,2011,Johan Petro,25,77,1,893,129,290,.445,0,4,.000,129,286,.451,.445,15,28,.536,62,150,212,44,34,34,46,178,273
9292,NJN,2011,Deron Williams,26,12,12,456,59,169,.349,16,59,.271,43,110,.391,.396,46,58,.793,8,47,55,153,15,3,43,38,180
9293,NJN,2011,Ben Uzoh,22,42,0,438,61,144,.424,3,8,.375,58,136,.426,.434,33,56,.589,30,31,61,69,13,8,25,29,158
9294,NJN,2011,Damion James,23,25,9,403,46,103,.447,0,3,.000,46,100,.460,.447,18,28,.643,17,68,85,20,16,12,25,36,110
9295,NJN,2011,Quinton Ross,29,36,4,353,26,59,.441,0,3,.000,26,56,.464,.441,5,14,.357,10,20,30,10,3,6,7,40,57
9296,NJN,2011,Troy Murphy,30,18,4,288,26,76,.342,4,23,.174,22,53,.415,.368,9,17,.529,11,64,75,17,7,2,13,28,65
9297,NJN,2011,Terrence Williams,23,10,0,206,29,73,.397,4,12,.333,25,61,.410,.425,5,10,.500,3,33,36,31,5,0,25,21,67
9298,NJN,2011,Brandan Wright,23,16,1,184,22,54,.407,0,0,,22,54,.407,.407,14,17,.824,17,31,48,7,8,7,4,15,58
9299,NJN,2011,Dan Gadzuric,32,14,5,166,17,41,.415,0,0,,17,41,.415,.415,5,13,.385,18,31,49,3,3,11,8,28,39
9300,NJN,2011,Sundiata Gaines,24,10,0,146,20,48,.417,4,17,.235,16,31,.516,.458,11,20,.550,10,14,24,25,9,0,13,11,55
9301,NJN,2011,Mario West,26,6,3,116,9,21,.429,1,4,.250,8,17,.471,.452,3,5,.600,2,9,11,10,7,0,2,13,22
9302,NJN,2011,Joe Smith,35,4,3,25,1,4,.250,0,0,,1,4,.250,.250,0,0,,1,2,3,1,0,0,2,3,2
9303,NJN,2011,Orien Greene,28,3,0,5,1,2,.500,0,0,,1,2,.500,.500,1,2,.500,0,0,0,1,1,0,0,0,3
9304,NJN,2010,Brook Lopez,21,82,82,3027,563,1129,.499,0,2,.000,563,1127,.500,.499,416,509,.817,270,439,709,187,55,139,204,251,1542
9305,NJN,2010,Courtney Lee,24,71,66,2375,338,775,.436,76,225,.338,262,550,.476,.485,133,153,.869,60,192,252,121,93,20,76,130,885
9306,NJN,2010,Devin Harris,26,64,61,2221,356,884,.403,60,217,.276,296,667,.444,.437,308,386,.798,24,179,203,423,79,18,181,178,1080
9307,NJN,2010,Terrence Williams,22,78,9,1764,261,651,.401,31,100,.310,230,551,.417,.425,103,144,.715,46,302,348,223,43,10,124,126,656
9308,NJN,2010,Chris Douglas-Roberts,23,67,38,1730,255,573,.445,14,54,.259,241,519,.464,.457,133,157,.847,45,153,198,93,55,19,97,101,657
9309,NJN,2010,Yi Jianlian,22,52,51,1655,227,563,.403,15,41,.366,212,522,.406,.417,154,193,.798,115,257,372,47,37,52,77,170,623
9310,NJN,2010,Trenton Hassell,30,52,31,1106,90,219,.411,0,5,.000,90,214,.421,.411,52,69,.754,56,96,152,50,17,9,47,91,232
9311,NJN,2010,Josh Boone,25,63,28,1045,117,223,.525,0,0,,117,223,.525,.525,19,58,.328,124,191,315,29,30,48,37,111,253
9312,NJN,2010,Jarvis Hayes,28,45,19,1033,138,328,.421,60,179,.335,78,149,.523,.512,14,18,.778,9,99,108,40,29,9,28,91,350
9313,NJN,2010,Keyon Dooling,29,53,8,971,129,324,.398,59,157,.376,70,167,.419,.489,47,61,.770,8,46,54,135,34,0,59,82,364
9314,NJN,2010,Kris Humphries,24,44,0,906,127,293,.433,0,1,.000,127,292,.435,.433,102,146,.699,82,201,283,25,29,37,53,102,356
9315,NJN,2010,Rafer Alston,33,27,13,766,95,277,.343,28,87,.322,67,190,.353,.394,44,54,.815,9,66,75,104,27,5,61,50,262
9316,NJN,2010,Bobby Simmons,29,23,2,395,42,117,.359,20,63,.317,22,54,.407,.444,18,20,.900,11,52,63,15,15,3,19,52,122
9317,NJN,2010,Sean Williams,23,20,0,227,21,49,.429,0,1,.000,21,48,.438,.429,10,19,.526,21,25,46,1,8,19,20,41,52
9318,NJN,2010,Chris Quinn,26,25,0,223,20,56,.357,10,32,.313,10,24,.417,.446,6,6,1.000,1,15,16,29,9,1,10,15,56
9319,NJN,2010,Eduardo Nájera,33,13,2,204,20,53,.377,3,17,.176,17,36,.472,.406,6,12,.500,12,26,38,15,9,2,12,33,49
9320,NJN,2010,Tony Battie,33,15,0,134,14,40,.350,1,4,.250,13,36,.361,.363,7,10,.700,4,19,23,3,4,2,3,19,36
9321,NJN,2009,Vince Carter,32,80,80,2946,588,1345,.437,151,392,.385,437,953,.459,.493,335,410,.817,74,336,410,376,82,38,166,234,1662
9322,NJN,2009,Brook Lopez,20,82,75,2501,448,844,.531,0,2,.000,448,842,.532,.531,172,217,.793,225,440,665,86,44,151,147,257,1068
9323,NJN,2009,Devin Harris,25,69,69,2494,455,1039,.438,64,220,.291,391,819,.477,.469,496,605,.820,30,201,231,476,114,13,212,164,1470
9324,NJN,2009,Keyon Dooling,28,77,18,2074,261,598,.436,99,235,.421,162,363,.446,.519,127,154,.825,24,131,155,270,71,8,105,135,748
9325,NJN,2009,Jarvis Hayes,27,74,1,1832,257,577,.445,94,244,.385,163,333,.489,.527,36,52,.692,27,240,267,54,52,7,49,162,644
9326,NJN,2009,Bobby Simmons,28,71,44,1729,198,441,.449,117,262,.447,81,179,.453,.582,43,58,.741,72,205,277,92,50,10,62,186,556
9327,NJN,2009,Yi Jianlian,21,61,52,1421,191,500,.382,48,140,.343,143,360,.397,.430,95,123,.772,67,259,326,60,29,36,70,157,525
9328,NJN,2009,Ryan Anderson,20,66,30,1312,160,407,.393,69,189,.365,91,218,.417,.478,98,116,.845,104,207,311,52,44,20,63,157,487
9329,NJN,2009,Trenton Hassell,29,53,31,1094,86,191,.450,2,8,.250,84,183,.459,.455,20,25,.800,50,96,146,51,21,16,30,92,194
9330,NJN,2009,Josh Boone,24,62,7,995,113,214,.528,0,0,,113,214,.528,.528,32,85,.376,104,154,258,31,22,48,31,106,258
9331,NJN,2009,Chris Douglas-Roberts,22,44,3,585,81,176,.460,3,12,.250,78,164,.476,.469,51,62,.823,14,36,50,52,12,7,31,34,216
9332,NJN,2009,Sean Williams,22,33,0,366,30,72,.417,0,0,,30,72,.417,.417,20,32,.625,34,45,79,13,7,29,20,72,80
9333,NJN,2009,Eduardo Nájera,32,27,0,319,33,74,.446,5,25,.200,28,49,.571,.480,8,22,.364,17,50,67,19,10,4,18,50,79
9334,NJN,2009,Maurice Ager,24,20,0,97,15,43,.349,0,6,.000,15,37,.405,.349,4,8,.500,3,7,10,3,1,2,4,17,34
9335,NJN,2009,Stromile Swift,29,6,0,64,9,15,.600,0,0,,9,15,.600,.600,5,11,.455,5,8,13,1,0,2,7,15,23
9336,NJN,2008,Richard Jefferson,27,82,82,3200,619,1328,.466,77,213,.362,542,1115,.486,.495,542,679,.798,93,249,342,252,76,21,199,225,1857
9337,NJN,2008,Vince Carter,31,76,72,2959,587,1287,.456,98,273,.359,489,1014,.482,.494,350,429,.816,112,341,453,389,93,33,181,241,1622
9338,NJN,2008,Jason Kidd,34,51,51,1895,201,549,.366,84,236,.356,117,313,.374,.443,91,111,.820,58,354,412,530,74,15,185,90,577
9339,NJN,2008,Josh Boone,23,70,53,1773,238,434,.548,0,0,,238,434,.548,.548,99,217,.456,192,317,509,55,36,61,68,155,575
9340,NJN,2008,Boštjan Nachbar,27,75,1,1660,245,609,.402,94,262,.359,151,347,.435,.479,154,196,.786,56,204,260,88,44,21,85,182,738
9341,NJN,2008,Sean Williams,21,73,29,1278,164,305,.538,0,0,,164,305,.538,.538,81,133,.609,115,207,322,28,28,106,70,193,409
9342,NJN,2008,Antoine Wright,23,41,10,1056,115,287,.401,27,101,.267,88,186,.473,.448,41,58,.707,35,90,125,67,26,17,39,105,298
9343,NJN,2008,Marcus Williams,22,53,7,854,111,293,.379,54,142,.380,57,151,.377,.471,37,47,.787,14,87,101,140,25,3,75,52,313
9344,NJN,2008,Devin Harris,24,25,22,838,134,306,.438,31,97,.320,103,209,.493,.489,87,105,.829,11,71,82,163,34,8,68,63,386
9345,NJN,2008,Nenad Krstić,24,45,38,812,123,300,.410,0,2,.000,123,298,.413,.410,52,69,.754,35,165,200,27,9,17,41,111,298
9346,NJN,2008,Malik Allen,29,48,12,763,124,261,.475,1,2,.500,123,259,.475,.477,12,13,.923,42,86,128,29,15,21,32,89,261
9347,NJN,2008,Jason Collins,29,43,23,684,23,54,.426,0,0,,23,54,.426,.426,14,36,.389,35,54,89,19,11,8,23,110,60
9348,NJN,2008,Darrell Armstrong,39,50,2,549,40,110,.364,23,69,.333,17,41,.415,.468,20,30,.667,17,50,67,73,28,2,41,53,123
9349,NJN,2008,DeSagana Diop,26,27,5,401,27,65,.415,0,0,,27,65,.415,.415,14,30,.467,49,73,122,14,6,25,16,46,68
9350,NJN,2008,Trenton Hassell,28,26,0,310,20,55,.364,1,5,.200,19,50,.380,.373,6,8,.750,9,30,39,15,4,2,8,35,47
9351,NJN,2008,Stromile Swift,28,21,0,295,42,88,.477,0,0,,42,88,.477,.477,21,28,.750,18,52,70,4,5,18,12,39,105
9352,NJN,2008,Jamaal Magloire,29,24,2,259,15,49,.306,0,0,,15,49,.306,.306,14,31,.452,18,63,81,7,0,10,23,42,44
9353,NJN,2008,Eddie Gill,29,13,1,149,12,29,.414,5,14,.357,7,15,.467,.500,9,9,1.000,1,21,22,21,7,2,8,18,38
9354,NJN,2008,Maurice Ager,23,14,0,88,16,38,.421,3,11,.273,13,27,.481,.461,1,6,.167,3,6,9,4,0,0,3,6,36
9355,NJN,2008,Billy Thomas,32,4,0,8,0,3,.000,0,3,.000,0,0,,.000,2,2,1.000,0,0,0,0,0,0,1,0,2
9356,NJN,2007,Vince Carter,30,82,82,3126,726,1598,.454,156,437,.357,570,1161,.491,.503,462,576,.802,114,378,492,393,82,30,217,266,2070
9357,NJN,2007,Jason Kidd,33,80,80,2933,369,908,.406,124,361,.343,245,547,.448,.475,179,230,.778,135,520,655,736,127,23,213,146,1041
9358,NJN,2007,Mikki Moore,31,79,55,2082,308,506,.609,0,1,.000,308,505,.610,.609,160,235,.681,145,258,403,74,46,60,113,261,776
9359,NJN,2007,Richard Jefferson,26,55,53,1956,303,665,.456,52,145,.359,251,520,.483,.495,239,326,.733,48,192,240,148,34,8,120,123,897
9360,NJN,2007,Jason Collins,28,80,78,1844,55,151,.364,0,2,.000,55,149,.369,.364,59,127,.465,90,226,316,46,40,38,73,273,169
9361,NJN,2007,Boštjan Nachbar,26,76,1,1532,226,495,.457,112,265,.423,114,230,.496,.570,132,164,.805,27,226,253,61,30,26,69,183,696
9362,NJN,2007,Marcus Williams,21,79,2,1315,208,526,.395,46,163,.282,162,363,.446,.439,72,85,.847,29,134,163,260,29,2,142,96,534
9363,NJN,2007,Antoine Wright,22,63,23,1137,110,251,.438,19,59,.322,91,192,.474,.476,44,73,.603,38,137,175,55,30,10,43,120,283
9364,NJN,2007,Clifford Robinson,40,50,1,955,81,218,.372,25,66,.379,56,152,.368,.429,16,36,.444,31,91,122,51,12,23,30,98,203
9365,NJN,2007,Eddie House,28,56,1,946,180,421,.428,75,175,.429,105,246,.427,.517,33,36,.917,14,78,92,67,27,3,27,69,468
9366,NJN,2007,Nenad Krstić,23,26,26,848,170,323,.526,0,1,.000,170,322,.528,.526,86,121,.711,51,125,176,46,10,24,52,88,426
9367,NJN,2007,Josh Boone,22,61,0,669,99,171,.579,0,0,,99,171,.579,.579,56,103,.544,64,112,176,10,11,21,33,94,254
9368,NJN,2007,Hassan Adams,22,61,8,495,75,135,.556,0,1,.000,75,134,.560,.556,24,36,.667,35,42,77,13,17,4,22,47,174
9369,NJN,2007,Bernard Robinson,26,10,0,37,3,8,.375,0,0,,3,8,.375,.375,4,5,.800,1,5,6,2,4,1,0,4,10
9370,NJN,2007,Mile Ilić,22,5,0,6,0,3,.000,0,0,,0,3,.000,.000,0,0,,0,1,1,0,0,0,3,1,0
9371,NJN,2006,Richard Jefferson,25,78,78,3059,495,1005,.493,60,188,.319,435,817,.532,.522,471,580,.812,95,439,534,297,59,17,174,193,1521
9372,NJN,2006,Jason Kidd,32,80,80,2975,366,905,.404,139,395,.352,227,510,.445,.481,194,244,.795,86,494,580,672,150,29,192,157,1065
9373,NJN,2006,Vince Carter,29,79,79,2906,653,1518,.430,125,367,.341,528,1151,.459,.471,480,601,.799,135,327,462,338,94,53,213,235,1911
9374,NJN,2006,Nenad Krstić,22,80,80,2469,447,881,.507,1,4,.250,446,877,.509,.508,185,265,.698,182,331,513,88,32,63,133,297,1080
9375,NJN,2006,Jason Collins,27,71,70,1895,104,262,.397,3,12,.250,101,250,.404,.403,44,86,.512,93,249,342,70,46,40,61,251,255
9376,NJN,2006,Clifford Robinson,39,80,13,1863,219,513,.427,60,175,.343,159,338,.470,.485,52,79,.658,55,212,267,89,44,40,62,206,550
9377,NJN,2006,Jacque Vaughn,30,80,6,1234,107,245,.437,1,6,.167,106,239,.444,.439,59,81,.728,16,75,91,123,42,1,52,140,274
9378,NJN,2006,Scott Padgett,29,62,1,718,71,201,.353,42,121,.347,29,80,.363,.458,27,34,.794,56,109,165,41,28,12,21,90,211
9379,NJN,2006,Zoran Planinić,23,56,1,596,66,183,.361,13,56,.232,53,127,.417,.396,46,66,.697,14,60,74,53,20,4,43,91,191
9380,NJN,2006,Lamond Murray,32,57,1,576,72,181,.398,27,78,.346,45,103,.437,.472,25,40,.625,29,103,132,13,17,7,22,66,196
9381,NJN,2006,Jeff McInnis,31,28,1,486,63,143,.441,3,16,.188,60,127,.472,.451,20,29,.690,11,39,50,52,11,2,29,37,149
9382,NJN,2006,Marc Jackson,31,37,0,433,66,148,.446,0,0,,66,148,.446,.446,38,48,.792,30,59,89,22,5,6,28,70,170
9383,NJN,2006,Antoine Wright,21,39,0,370,29,81,.358,1,15,.067,28,66,.424,.364,11,22,.500,8,22,30,12,4,3,21,42,70
9384,NJN,2006,Boštjan Nachbar,25,11,0,97,12,32,.375,2,14,.143,10,18,.556,.406,5,8,.625,4,7,11,5,3,0,4,13,31
9385,NJN,2006,John Thomas,30,2,0,36,1,6,.167,0,0,,1,6,.167,.167,0,0,,7,3,10,0,1,1,2,4,2
9386,NJN,2006,Linton Johnson,25,9,0,35,5,10,.500,0,0,,5,10,.500,.500,1,4,.250,0,7,7,2,2,0,4,7,11
9387,NJN,2006,Derrick Zimmerman,24,2,0,32,2,3,.667,0,0,,2,3,.667,.667,0,0,,1,3,4,7,0,0,4,4,4
9388,NJN,2005,Jason Collins,26,80,80,2542,186,451,.412,2,6,.333,184,445,.413,.415,137,209,.656,153,335,488,105,71,71,91,322,511
9389,NJN,2005,Jason Kidd,31,66,65,2435,340,855,.398,129,358,.360,211,497,.425,.473,142,192,.740,94,394,488,545,123,9,167,110,951
9390,NJN,2005,Vince Carter,28,57,56,2220,572,1239,.462,108,254,.425,464,985,.471,.505,317,388,.817,78,257,335,266,84,33,146,187,1569
9391,NJN,2005,Nenad Krstić,21,75,57,1965,281,570,.493,0,2,.000,281,568,.495,.493,185,255,.725,161,240,401,77,32,63,112,280,747
9392,NJN,2005,Travis Best,32,76,6,1461,190,452,.420,26,85,.306,164,367,.447,.449,108,122,.885,19,88,107,143,66,9,67,148,514
9393,NJN,2005,Jacque Vaughn,29,71,34,1410,146,325,.449,5,15,.333,141,310,.455,.457,76,91,.835,17,90,107,135,41,1,62,138,373
9394,NJN,2005,Richard Jefferson,24,33,33,1355,238,564,.422,30,89,.337,208,475,.438,.449,227,269,.844,49,191,240,133,33,17,132,109,733
9395,NJN,2005,Rodney Buford,27,64,17,1313,187,489,.382,34,108,.315,153,381,.402,.417,37,45,.822,33,156,189,63,40,4,35,101,445
9396,NJN,2005,Brian Scalabrine,26,54,14,1167,132,332,.398,22,68,.324,110,264,.417,.431,53,69,.768,83,161,244,88,34,18,66,111,339
9397,NJN,2005,Eric Williams,32,21,21,739,87,185,.470,17,40,.425,70,145,.483,.516,74,108,.685,28,67,95,42,16,2,34,80,265
9398,NJN,2005,Jabari Smith,27,45,2,648,62,148,.419,1,2,.500,61,146,.418,.422,41,55,.745,29,82,111,38,25,14,39,103,166
9399,NJN,2005,Clifford Robinson,38,29,0,599,61,169,.361,25,66,.379,36,103,.350,.435,27,39,.692,23,72,95,30,18,14,25,74,174
9400,NJN,2005,Zoran Planinić,22,43,8,515,78,174,.448,15,40,.375,63,134,.470,.491,46,66,.697,19,50,69,44,25,0,41,76,217
9401,NJN,2005,Alonzo Mourning,34,18,14,457,68,150,.453,0,0,,68,150,.453,.453,51,86,.593,31,96,127,14,5,41,45,50,187
9402,NJN,2005,Ron Mercer,28,18,3,390,65,158,.411,0,3,.000,65,155,.419,.411,7,10,.700,9,31,40,20,16,2,14,20,137
9403,NJN,2005,Billy Thomas,29,25,0,356,34,94,.362,17,56,.304,17,38,.447,.452,7,9,.778,7,29,36,17,14,1,9,29,92
9404,NJN,2005,Aaron Williams,33,19,0,150,14,27,.519,0,0,,14,27,.519,.519,9,10,.900,7,24,31,6,4,5,11,25,37
9405,NJN,2005,Kaniel Dickens,26,11,0,61,4,14,.286,3,9,.333,1,5,.200,.393,2,2,1.000,3,6,9,1,2,1,2,5,13
9406,NJN,2005,Elden Campbell,36,10,0,50,0,7,.000,0,0,,0,7,.000,.000,2,4,.500,3,8,11,3,0,1,1,10,2
9407,NJN,2005,Awvee Storey,27,9,0,32,3,10,.300,1,2,.500,2,8,.250,.350,1,2,.500,4,1,5,1,0,0,0,3,8
9408,NJN,2005,Jérôme Moïso,26,8,0,24,3,4,.750,0,0,,3,4,.750,.750,2,4,.500,3,4,7,0,0,1,1,2,8
9409,NJN,2005,Donnell Harvey,24,3,0,16,2,2,1.000,0,0,,2,2,1.000,1.000,4,4,1.000,2,5,7,1,1,1,1,2,8
9410,NJN,2004,Richard Jefferson,23,82,82,3133,555,1115,.498,48,132,.364,507,983,.516,.519,357,468,.763,109,355,464,315,92,28,198,224,1515
9411,NJN,2004,Kerry Kittles,29,82,82,2842,434,959,.453,97,276,.351,337,683,.493,.503,107,136,.787,56,271,327,206,125,40,95,144,1072
9412,NJN,2004,Jason Kidd,30,67,66,2450,368,959,.384,94,293,.321,274,666,.411,.433,206,249,.827,85,343,428,618,122,14,214,110,1036
9413,NJN,2004,Kenyon Martin,26,65,62,2252,439,900,.488,7,25,.280,432,875,.494,.492,201,294,.684,133,484,617,160,95,82,168,230,1086
9414,NJN,2004,Jason Collins,25,78,78,2220,163,384,.424,0,2,.000,163,382,.427,.424,136,184,.739,143,257,400,153,67,56,97,251,462
9415,NJN,2004,Lucious Harris,33,69,15,1504,187,463,.404,38,101,.376,149,362,.412,.445,66,78,.846,39,101,140,135,41,2,53,74,478
9416,NJN,2004,Rodney Rogers,32,69,15,1409,207,505,.410,50,152,.329,157,353,.445,.459,75,98,.765,100,207,307,137,59,27,98,183,539
9417,NJN,2004,Aaron Williams,32,72,7,1337,172,342,.503,1,3,.333,171,339,.504,.504,105,155,.677,101,193,294,81,34,46,89,187,450
9418,NJN,2004,Brian Scalabrine,25,69,2,928,86,218,.394,10,41,.244,76,177,.429,.417,58,70,.829,42,131,173,65,21,14,42,113,240
9419,NJN,2004,Zoran Planinić,21,49,1,473,53,129,.411,9,32,.281,44,97,.454,.446,38,60,.633,14,41,55,68,13,3,36,70,153
9420,NJN,2004,Brandon Armstrong,23,56,0,434,65,175,.371,19,52,.365,46,123,.374,.426,2,4,.500,12,31,43,14,12,2,24,49,151
9421,NJN,2004,Robert Pack,34,26,0,220,22,52,.423,0,0,,22,52,.423,.423,5,6,.833,4,14,18,27,12,1,16,20,49
9422,NJN,2004,Alonzo Mourning,33,12,0,215,33,71,.465,0,0,,33,71,.465,.465,30,34,.882,8,19,27,8,2,6,10,32,96
9423,NJN,2004,Tamar Slay,23,22,0,165,21,60,.350,4,12,.333,17,48,.354,.383,7,14,.500,10,15,25,14,7,1,11,20,53
9424,NJN,2004,Hubert Davis,33,14,0,55,1,9,.111,0,0,,1,9,.111,.111,2,2,1.000,2,6,8,3,2,0,2,8,4
9425,NJN,2004,Doug Overton,34,6,0,22,3,8,.375,0,0,,3,8,.375,.375,2,2,1.000,0,1,1,4,1,0,2,4,8
9426,NJN,2004,Anthony Goldwire,32,6,0,19,2,8,.250,0,2,.000,2,6,.333,.250,0,0,,0,1,1,1,2,0,1,0,4
9427,NJN,2004,Damone Brown,24,3,0,17,1,10,.100,0,0,,1,10,.100,.100,1,2,.500,3,2,5,0,2,0,1,2,3
9428,NJN,2004,Mikki Moore,28,4,0,10,1,5,.200,0,0,,1,5,.200,.200,0,0,,1,1,2,0,0,0,0,1,2
9429,NJN,2003,Jason Kidd,29,80,80,2989,515,1244,.414,126,370,.341,389,874,.445,.465,339,403,.841,110,394,504,711,179,25,296,127,1495
9430,NJN,2003,Richard Jefferson,22,80,80,2879,456,911,.501,6,24,.250,450,887,.507,.504,324,436,.743,150,364,514,201,80,44,156,216,1242
9431,NJN,2003,Kenyon Martin,25,77,77,2628,509,1082,.470,9,43,.209,500,1039,.481,.475,256,392,.653,164,476,640,185,98,70,192,294,1283
9432,NJN,2003,Lucious Harris,32,77,25,1973,298,721,.413,47,136,.346,251,585,.429,.446,152,189,.804,63,169,232,155,53,8,71,95,795
9433,NJN,2003,Kerry Kittles,28,65,57,1951,332,711,.467,78,219,.356,254,492,.516,.522,106,135,.785,52,200,252,170,101,30,55,110,848
9434,NJN,2003,Jason Collins,24,81,66,1900,140,338,.414,0,4,.000,140,334,.419,.414,180,236,.763,136,232,368,87,47,44,85,252,460
9435,NJN,2003,Aaron Williams,31,81,0,1597,199,439,.453,0,1,.000,199,438,.454,.453,102,130,.785,137,194,331,88,27,57,85,206,500
9436,NJN,2003,Rodney Rogers,31,68,0,1303,183,455,.402,44,132,.333,139,323,.430,.451,68,90,.756,61,202,263,107,50,31,91,192,478
9437,NJN,2003,Anthony Johnson,28,66,2,842,103,231,.446,13,35,.371,90,196,.459,.474,51,74,.689,13,65,78,86,37,5,41,93,270
9438,NJN,2003,Brian Scalabrine,24,59,7,724,68,169,.402,14,39,.359,54,130,.415,.444,30,36,.833,40,101,141,46,16,18,46,77,180
9439,NJN,2003,Dikembe Mutombo,36,24,16,514,49,131,.374,0,0,,49,131,.374,.374,40,55,.727,54,99,153,19,4,37,34,54,138
9440,NJN,2003,Tamar Slay,22,36,0,274,39,103,.379,7,25,.280,32,78,.410,.413,7,10,.700,8,23,31,14,14,3,20,31,92
9441,NJN,2003,Chris Childs,35,12,0,106,6,20,.300,1,6,.167,5,14,.357,.325,2,3,.667,3,2,5,16,8,1,6,17,15
9442,NJN,2003,Brandon Armstrong,22,17,0,69,9,27,.333,1,6,.167,8,21,.381,.352,5,6,.833,0,4,4,2,3,1,5,8,24
9443,NJN,2003,Donny Marshall,30,3,0,6,0,3,.000,0,1,.000,0,2,.000,.000,0,0,,0,3,3,0,0,0,1,0,0
9444,NJN,2002,Jason Kidd,28,82,82,3056,445,1138,.391,117,364,.321,328,774,.424,.442,201,247,.814,130,465,595,808,175,20,286,136,1208
9445,NJN,2002,Kerry Kittles,27,82,82,2601,438,940,.466,98,242,.405,340,698,.487,.518,128,172,.744,68,207,275,216,130,31,109,108,1102
9446,NJN,2002,Kenyon Martin,24,73,73,2504,445,962,.463,15,67,.224,430,895,.480,.470,181,267,.678,113,275,388,192,90,121,172,261,1086
9447,NJN,2002,Keith Van Horn,26,81,81,2465,471,1089,.433,101,293,.345,370,796,.465,.479,156,195,.800,137,472,609,164,63,42,146,221,1199
9448,NJN,2002,Richard Jefferson,21,79,9,1917,270,591,.457,13,56,.232,257,535,.480,.468,189,265,.713,85,208,293,140,64,48,107,211,742
9449,NJN,2002,Lucious Harris,31,74,0,1553,249,537,.464,44,118,.373,205,419,.489,.505,133,158,.842,49,158,207,116,53,6,61,99,675
9450,NJN,2002,Aaron Williams,30,82,13,1546,231,439,.526,0,2,.000,231,437,.529,.526,130,186,.699,115,224,339,77,29,76,79,212,592
9451,NJN,2002,Todd MacCulloch,26,62,61,1502,247,465,.531,0,0,,247,465,.531,.531,110,164,.671,157,221,378,78,24,89,66,181,604
9452,NJN,2002,Jason Collins,23,77,9,1407,117,278,.421,1,2,.500,116,276,.420,.423,115,164,.701,132,169,301,81,29,47,72,173,350
9453,NJN,2002,Anthony Johnson,27,34,0,366,37,90,.411,4,12,.333,33,78,.423,.433,16,25,.640,10,19,29,48,31,1,20,30,94
9454,NJN,2002,Brian Scalabrine,23,28,0,290,23,67,.343,3,10,.300,20,57,.351,.366,11,15,.733,12,39,51,21,9,2,24,39,60
9455,NJN,2002,Derrick Dial,26,25,0,249,30,94,.319,0,7,.000,30,87,.345,.319,13,18,.722,12,33,45,31,8,4,13,12,73
9456,NJN,2002,Brandon Armstrong,21,35,0,196,27,85,.318,5,17,.294,22,68,.324,.347,5,10,.500,10,6,16,8,7,1,8,26,64
9457,NJN,2002,Donny Marshall,29,20,0,118,8,29,.276,2,4,.500,6,25,.240,.310,12,18,.667,8,13,21,5,3,0,2,14,30
9458,NJN,2002,Steve Goodrich,25,9,0,50,2,10,.200,0,0,,2,10,.200,.200,1,2,.500,1,4,5,5,1,2,3,10,5
9459,NJN,2002,Reggie Slater,31,4,0,10,2,2,1.000,0,0,,2,2,1.000,1.000,1,1,1.000,0,2,2,0,0,0,1,1,5
9460,NJN,2001,Stephon Marbury,23,67,67,2557,563,1277,.441,110,335,.328,453,942,.481,.484,362,458,.790,53,152,205,506,79,5,197,150,1598
9461,NJN,2001,Aaron Williams,29,82,25,2336,297,650,.457,0,2,.000,297,648,.458,.457,244,310,.787,211,379,590,88,59,113,132,319,838
9462,NJN,2001,Kenyon Martin,23,68,68,2272,346,777,.445,1,11,.091,345,766,.450,.446,121,192,.630,137,365,502,131,78,113,138,281,814
9463,NJN,2001,Lucious Harris,30,73,50,2071,265,624,.425,46,132,.348,219,492,.445,.462,107,139,.770,71,217,288,135,74,16,64,127,683
9464,NJN,2001,Johnny Newman,37,82,17,2049,291,695,.419,59,176,.335,232,519,.447,.461,254,297,.855,34,142,176,115,63,10,106,229,895
9465,NJN,2001,Keith Van Horn,25,49,47,1733,308,708,.435,65,170,.382,243,538,.452,.481,150,186,.806,78,269,347,82,40,20,103,150,831
9466,NJN,2001,Stephen Jackson,22,77,40,1660,243,572,.425,52,155,.335,191,417,.458,.470,97,135,.719,41,167,208,140,86,14,130,166,635
9467,NJN,2001,Evan Eschmeyer,25,74,51,1331,92,200,.460,0,0,,92,200,.460,.460,67,102,.657,135,231,366,40,41,58,53,220,251
9468,NJN,2001,Sherman Douglas,34,59,7,1094,122,303,.403,8,40,.200,114,263,.433,.416,86,115,.748,21,53,74,144,36,4,79,93,338
9469,NJN,2001,Kendall Gill,32,31,26,892,107,323,.331,4,14,.286,103,309,.333,.337,65,90,.722,32,99,131,87,47,7,48,64,283
9470,NJN,2001,Doug Overton,31,12,9,316,35,93,.376,10,32,.313,25,61,.410,.430,3,5,.600,1,23,24,53,3,0,15,20,83
9471,NJN,2001,Vladimir Stepania,24,29,0,280,28,88,.318,1,4,.250,27,84,.321,.324,25,34,.735,35,74,109,16,10,11,19,47,82
9472,NJN,2001,Soumaila Samake,22,34,0,226,18,48,.375,0,0,,18,48,.375,.375,10,24,.417,22,31,53,1,2,14,4,23,46
9473,NJN,2001,Mark Strickland,30,9,0,202,21,54,.389,1,1,1.000,20,53,.377,.398,8,11,.727,11,30,41,7,4,3,10,14,51
9474,NJN,2001,Jim McIlvaine,28,18,3,193,10,28,.357,0,0,,10,28,.357,.357,8,12,.667,8,27,35,4,7,15,9,35,28
9475,NJN,2001,Kevin Ollie,28,19,0,161,5,27,.185,0,0,,5,27,.185,.185,12,19,.632,3,20,23,25,5,0,9,14,22
9476,NJN,2001,Eddie Gill,22,8,0,152,16,41,.390,3,9,.333,13,32,.406,.427,4,5,.800,0,9,9,24,4,1,10,9,39
9477,NJN,2001,Jamie Feick,26,6,0,149,8,23,.348,0,0,,8,23,.348,.348,6,12,.500,12,44,56,5,8,3,7,15,22
9478,NJN,2001,Jamel Thomas,27,5,0,56,6,19,.316,1,3,.333,5,16,.313,.342,0,0,,4,5,9,0,3,0,6,6,13
9479,NJN,2000,Stephon Marbury,22,74,74,2881,569,1317,.432,66,233,.283,503,1084,.464,.457,436,536,.813,61,179,240,622,112,15,270,195,1640
9480,NJN,2000,Keith Van Horn,24,80,80,2782,559,1257,.445,84,228,.368,475,1029,.462,.478,333,393,.847,200,476,676,158,64,60,245,258,1535
9481,NJN,2000,Kendall Gill,31,76,75,2355,396,956,.414,20,78,.256,376,878,.428,.425,181,255,.710,82,201,283,210,139,41,89,211,993
9482,NJN,2000,Jamie Feick,25,81,17,2241,181,423,.428,3,3,1.000,178,420,.424,.431,94,133,.707,264,491,755,68,43,38,59,206,459
9483,NJN,2000,Kerry Kittles,25,62,61,1896,305,698,.437,96,240,.400,209,458,.456,.506,101,127,.795,46,179,225,142,79,19,56,120,807
9484,NJN,2000,Johnny Newman,36,82,9,1763,278,623,.446,72,190,.379,206,433,.476,.504,192,229,.838,39,115,154,65,53,11,89,207,820
9485,NJN,2000,Lucious Harris,29,77,11,1510,198,463,.428,38,115,.330,160,348,.460,.469,79,99,.798,53,134,187,100,65,6,42,98,513
9486,NJN,2000,Scott Burrell,29,74,9,1336,165,419,.394,82,232,.353,83,187,.444,.492,39,50,.780,65,191,256,72,67,44,38,173,451
9487,NJN,2000,Jim McIlvaine,27,66,53,1048,64,154,.416,0,0,,64,154,.416,.416,29,56,.518,106,124,230,36,26,117,38,205,157
9488,NJN,2000,Elliot Perry,30,60,5,803,128,294,.435,11,39,.282,117,255,.459,.454,50,62,.806,13,48,61,139,39,1,60,47,317
9489,NJN,2000,Evan Eschmeyer,24,31,5,373,38,72,.528,0,0,,38,72,.528,.528,15,30,.500,40,68,108,21,8,21,21,84,91
9490,NJN,2000,Sherman Douglas,33,20,2,309,45,90,.500,5,16,.313,40,74,.541,.528,25,28,.893,13,16,29,34,17,0,24,26,120
9491,NJN,2000,Gheorghe Mureșan,28,30,2,267,41,90,.456,0,0,,41,90,.456,.456,23,38,.605,24,44,68,9,0,12,16,52,105
9492,NJN,2000,Michael Cage,38,20,7,242,12,24,.500,0,0,,12,24,.500,.500,3,3,1.000,33,48,81,9,8,8,4,30,27
9493,NJN,2000,Mark Hendrickson,25,5,0,24,0,1,.000,0,0,,0,1,.000,.000,1,2,.500,1,1,2,3,0,0,0,1,1
9494,NJN,1999,Kendall Gill,30,50,47,1606,236,593,.398,2,17,.118,234,576,.406,.400,114,167,.683,61,183,244,123,134,26,71,162,588
9495,NJN,1999,Keith Van Horn,23,42,42,1576,322,752,.428,16,53,.302,306,699,.438,.439,256,298,.859,114,244,358,65,43,53,133,134,916
9496,NJN,1999,Kerry Kittles,24,46,40,1570,227,613,.370,50,158,.316,177,455,.389,.411,88,114,.772,52,139,191,116,79,26,66,82,592
9497,NJN,1999,Stephon Marbury,21,31,31,1234,254,579,.439,58,158,.367,196,421,.466,.489,159,191,.832,20,60,80,270,30,3,109,81,725
9498,NJN,1999,Jayson Williams,30,30,30,1020,97,218,.445,0,2,.000,97,216,.449,.445,48,85,.565,147,213,360,33,24,60,46,126,242
9499,NJN,1999,Jamie Feick,24,26,16,849,67,133,.504,0,0,,67,133,.504,.504,43,60,.717,112,174,286,24,25,18,34,73,177
9500,NJN,1999,Scott Burrell,28,32,10,706,75,208,.361,28,72,.389,47,136,.346,.428,34,42,.810,32,87,119,45,40,11,23,82,212
9501,NJN,1999,Lucious Harris,28,36,5,602,73,181,.403,11,50,.220,62,131,.473,.434,36,48,.750,21,46,67,31,18,7,18,52,193
9502,NJN,1999,Eric Murdock,30,15,8,401,45,114,.395,8,22,.364,37,92,.402,.430,21,26,.808,3,32,35,66,22,2,29,35,119
9503,NJN,1999,Mark Hendrickson,24,22,6,399,39,88,.443,0,1,.000,39,87,.448,.443,42,50,.840,27,41,68,13,12,1,15,39,120
9504,NJN,1999,Chris Carr,24,28,2,364,67,179,.374,25,66,.379,42,113,.372,.444,25,36,.694,23,36,59,16,7,1,24,36,184
9505,NJN,1999,Chris Gatling,31,18,2,281,36,97,.371,0,1,.000,36,96,.375,.371,12,24,.500,21,44,65,12,8,4,29,40,84
9506,NJN,1999,Jim McIlvaine,26,22,1,269,22,51,.431,0,0,,22,51,.431,.431,4,6,.667,31,23,54,2,9,32,13,59,48
9507,NJN,1999,Elliot Perry,29,30,0,243,30,86,.349,9,23,.391,21,63,.333,.401,9,12,.750,6,20,26,35,16,0,32,22,78
9508,NJN,1999,Doug Overton,29,8,1,174,25,57,.439,2,4,.500,23,53,.434,.456,12,14,.857,6,11,17,16,3,1,15,14,64
9509,NJN,1999,William Cunningham,24,15,6,161,3,18,.167,0,0,,3,18,.167,.167,0,2,.000,13,15,28,1,1,11,5,30,6
9510,NJN,1999,Damon Jones,22,11,0,131,14,44,.318,10,29,.345,4,15,.267,.432,11,13,.846,2,11,13,13,7,0,5,7,49
9511,NJN,1999,Brian Evans,25,11,0,121,11,34,.324,4,11,.364,7,23,.304,.382,4,4,1.000,4,13,17,14,3,3,2,7,30
9512,NJN,1999,David Vaughn,25,10,0,103,13,24,.542,0,0,,13,24,.542,.542,8,10,.800,13,21,34,1,2,8,11,22,34
9513,NJN,1999,Sam Cassell,29,4,3,100,21,49,.429,1,7,.143,20,42,.476,.439,29,31,.935,1,5,6,19,3,0,12,13,72
9514,NJN,1999,Rony Seikaly,33,9,0,88,4,20,.200,0,0,,4,20,.200,.200,7,18,.389,5,16,21,2,4,6,10,15,15
9515,NJN,1999,Earl Boykins,22,5,0,51,10,21,.476,1,5,.200,9,16,.563,.500,0,0,,1,3,4,6,1,0,7,3,21
9516,NJN,1999,Gheorghe Mureșan,27,1,0,1,0,1,.000,0,0,,0,1,.000,.000,0,0,,0,0,0,0,0,0,1,0,0
9517,NJN,1998,Kerry Kittles,23,77,76,2814,508,1154,.440,110,263,.418,398,891,.447,.488,202,250,.808,132,230,362,176,132,37,106,152,1328
9518,NJN,1998,Kendall Gill,29,81,81,2733,418,974,.429,26,101,.257,392,873,.449,.443,225,327,.688,112,279,391,200,156,64,124,268,1087
9519,NJN,1998,Sam Cassell,28,75,72,2606,510,1156,.441,15,80,.188,495,1076,.460,.448,436,507,.860,73,155,228,603,121,20,269,262,1471
9520,NJN,1998,Jayson Williams,29,65,65,2343,321,645,.498,0,4,.000,321,641,.501,.498,195,293,.666,443,440,883,67,45,49,95,236,837
9521,NJN,1998,Keith Van Horn,22,62,62,2325,446,1047,.426,69,224,.308,377,823,.458,.459,258,305,.846,142,266,408,106,64,25,164,216,1219
9522,NJN,1998,Sherman Douglas,31,80,11,1699,255,515,.495,14,46,.304,241,469,.514,.509,115,172,.669,52,83,135,319,55,7,110,156,639
9523,NJN,1998,Chris Gatling,30,57,16,1359,248,545,.455,1,4,.250,247,541,.457,.456,159,265,.600,118,216,334,53,52,29,99,152,656
9524,NJN,1998,Michael Cage,36,79,17,1201,43,84,.512,0,1,.000,43,83,.518,.512,20,36,.556,115,193,308,32,45,44,23,105,106
9525,NJN,1998,David Benoit,29,53,0,799,102,269,.379,41,119,.345,61,150,.407,.455,37,44,.841,42,99,141,17,26,16,39,120,282
9526,NJN,1998,Lucious Harris,27,50,0,671,69,177,.390,12,39,.308,57,138,.413,.424,41,55,.745,21,31,52,42,42,5,21,77,191
9527,NJN,1998,Kevin Edwards,32,27,5,352,37,106,.349,4,11,.364,33,95,.347,.368,13,15,.867,11,23,34,26,21,0,20,20,91
9528,NJN,1998,Brian Evans,24,28,1,332,46,106,.434,17,42,.405,29,64,.453,.514,6,9,.667,18,34,52,24,7,5,14,44,115
9529,NJN,1998,Xavier McDaniel,34,20,0,180,10,30,.333,0,0,,10,30,.333,.333,5,8,.625,12,19,31,9,3,2,8,23,25
9530,NJN,1998,David Vaughn,24,15,2,161,19,33,.576,0,0,,19,33,.576,.576,6,9,.667,19,30,49,2,5,4,9,34,44
9531,NJN,1998,Rony Seikaly,32,9,2,152,13,41,.317,0,0,,13,41,.317,.317,16,27,.593,16,20,36,8,3,4,12,27,42
9532,NJN,1998,Yinka Dare,25,10,0,60,4,18,.222,0,0,,4,18,.222,.222,4,8,.500,10,7,17,1,0,2,2,9,12
9533,NJN,1998,Jack Haley,34,16,0,51,5,18,.278,0,1,.000,5,17,.294,.278,12,21,.571,5,10,15,0,0,1,4,9,22
9534,NJN,1998,Don MacLean,28,9,0,42,1,10,.100,1,2,.500,0,8,.000,.150,0,0,,3,2,5,0,0,0,2,7,3
9535,NJN,1997,Kendall Gill,28,82,81,3199,644,1453,.443,74,220,.336,570,1233,.462,.469,427,536,.797,183,316,499,326,154,46,218,225,1789
9536,NJN,1997,Kerry Kittles,22,82,57,3012,507,1189,.426,158,419,.377,349,770,.453,.493,175,227,.771,106,213,319,249,157,35,127,165,1347
9537,NJN,1997,Tony Massenburg,29,79,49,1954,219,452,.485,0,1,.000,219,451,.486,.485,130,206,.631,222,295,517,23,38,50,91,217,568
9538,NJN,1997,Jayson Williams,28,41,40,1432,221,540,.409,0,4,.000,221,536,.412,.409,108,183,.590,242,311,553,51,24,36,82,158,550
9539,NJN,1997,Shawn Bradley,24,40,38,1228,199,456,.436,0,5,.000,199,451,.441,.436,81,122,.664,118,207,325,20,23,160,64,122,479
9540,NJN,1997,Robert Pack,27,34,31,1185,193,474,.407,22,74,.297,171,400,.428,.430,134,170,.788,15,71,86,325,59,3,150,83,542
9541,NJN,1997,Xavier McDaniel,33,62,5,1170,138,355,.389,5,25,.200,133,330,.403,.396,65,89,.730,124,194,318,65,36,17,70,144,346
9542,NJN,1997,Jim Jackson,26,31,31,1155,184,441,.417,40,108,.370,144,333,.432,.463,104,122,.852,51,133,184,160,29,17,101,81,512
9543,NJN,1997,Khalid Reeves,24,50,18,1048,141,359,.393,76,192,.396,65,167,.389,.499,56,75,.747,22,66,88,170,23,7,82,119,414
9544,NJN,1997,Eric Montross,25,31,31,844,73,162,.451,0,0,,73,162,.451,.451,11,28,.393,115,167,282,29,11,39,26,118,157
9545,NJN,1997,Sam Cassell,27,23,22,777,167,377,.443,47,120,.392,120,257,.467,.505,64,77,.831,21,61,82,149,37,7,67,86,445
9546,NJN,1997,Ed O'Bannon,24,45,5,634,76,207,.367,17,60,.283,59,147,.401,.408,20,23,.870,41,71,112,28,24,10,14,78,189
9547,NJN,1997,Kevin Edwards,31,32,0,477,69,183,.377,15,43,.349,54,140,.386,.418,37,43,.860,9,34,43,57,17,4,49,34,190
9548,NJN,1997,Joe Kleine,35,28,0,453,35,82,.427,1,2,.500,34,80,.425,.433,13,18,.722,39,75,114,23,8,12,21,57,84
9549,NJN,1997,Yinka Dare,24,41,2,313,19,54,.352,0,0,,19,54,.352,.352,19,37,.514,35,47,82,3,4,28,21,51,57
9550,NJN,1997,Lloyd Daniels,29,17,0,282,34,103,.330,19,59,.322,15,44,.341,.422,5,6,.833,18,21,39,25,9,3,11,29,92
9551,NJN,1997,Adrian Caldwell,30,18,0,204,10,35,.286,0,2,.000,10,33,.303,.286,9,17,.529,20,36,56,5,8,1,12,27,29
9552,NJN,1997,Reggie Williams,32,11,0,167,27,67,.403,9,33,.273,18,34,.529,.470,8,10,.800,4,20,24,8,8,4,10,28,71
9553,NJN,1997,Chris Gatling,29,3,0,92,18,43,.419,0,0,,18,43,.419,.419,15,16,.938,8,14,22,3,4,0,6,13,51
9554,NJN,1997,Jack Haley,33,20,0,74,13,37,.351,0,0,,13,37,.351,.351,14,19,.737,13,19,32,5,1,1,2,14,40
9555,NJN,1997,Evric Gray,27,5,0,42,4,15,.267,1,4,.250,3,11,.273,.300,4,4,1.000,1,2,3,2,1,0,3,5,13
9556,NJN,1997,Robert Werdann,26,6,0,31,3,7,.429,0,0,,3,7,.429,.429,3,3,1.000,3,3,6,0,2,1,2,10,9
9557,NJN,1997,Vincent Askew,30,1,0,7,0,0,,0,0,,0,0,,,0,0,,0,0,0,0,0,0,0,1,0
9558,NJN,1996,P.J. Brown,26,81,81,2942,354,798,.444,3,15,.200,351,783,.448,.445,204,265,.770,215,345,560,165,79,100,133,249,915
9559,NJN,1996,Armen Gilliam,31,78,76,2856,576,1216,.474,0,1,.000,576,1215,.474,.474,277,350,.791,241,472,713,140,73,53,177,180,1429
9560,NJN,1996,Chris Childs,28,78,54,2408,324,778,.416,95,259,.367,229,519,.441,.478,259,304,.852,51,194,245,548,111,8,230,246,1002
9561,NJN,1996,Shawn Bradley,23,67,57,1995,344,776,.443,1,4,.250,343,772,.444,.444,150,221,.679,187,345,532,55,41,250,148,244,839
9562,NJN,1996,Jayson Williams,27,80,6,1858,279,660,.423,2,7,.286,277,653,.424,.424,161,272,.592,342,461,803,47,35,57,106,238,721
9563,NJN,1996,Vern Fleming,33,77,3,1747,227,524,.433,3,28,.107,224,496,.452,.436,133,177,.751,49,121,170,255,41,5,122,115,590
9564,NJN,1996,Ed O'Bannon,23,64,29,1253,156,400,.390,10,56,.179,146,344,.424,.403,77,108,.713,65,103,168,63,44,11,62,95,399
9565,NJN,1996,Kenny Anderson,25,31,28,1042,143,380,.376,36,99,.364,107,281,.381,.424,151,188,.803,37,64,101,247,52,8,58,73,473
9566,NJN,1996,Kevin Edwards,30,34,33,1007,142,390,.364,42,104,.404,100,286,.350,.418,68,84,.810,14,61,75,71,54,7,68,67,394
9567,NJN,1996,Yinka Dare,23,58,23,626,63,144,.438,0,0,,63,144,.438,.438,38,62,.613,56,125,181,0,8,40,72,117,164
9568,NJN,1996,Greg Graham,25,45,2,485,61,161,.379,25,68,.368,36,93,.387,.457,37,51,.725,12,30,42,41,20,1,29,48,184
9569,NJN,1996,Rick Mahorn,37,50,0,450,43,122,.352,0,1,.000,43,121,.355,.352,34,47,.723,31,79,110,16,14,13,30,72,120
9570,NJN,1996,Kendall Gill,27,11,10,418,67,152,.441,9,25,.360,58,127,.457,.470,49,59,.831,16,27,43,35,22,2,21,30,192
9571,NJN,1996,Khalid Reeves,23,31,7,415,41,109,.376,17,55,.309,24,54,.444,.454,18,31,.581,7,32,39,46,21,2,33,69,117
9572,NJN,1996,Tim Perry,30,22,1,167,23,47,.489,3,7,.429,20,40,.500,.521,3,6,.500,15,20,35,6,2,10,7,11,52
9573,NJN,1996,Robert Werdann,25,13,0,93,16,32,.500,0,0,,16,32,.500,.500,7,13,.538,5,18,23,2,5,3,6,17,39
9574,NJN,1996,Rex Walters,25,11,0,87,12,33,.364,3,12,.250,9,21,.429,.409,6,6,1.000,2,5,7,11,3,0,7,4,33
9575,NJN,1996,Gerald Glass,28,10,0,56,10,28,.357,1,5,.200,9,23,.391,.375,0,0,,5,1,6,4,2,1,0,5,21
9576,NJN,1995,Kenny Anderson,24,72,70,2689,411,1031,.399,97,294,.330,314,737,.426,.446,348,414,.841,73,177,250,680,103,14,225,184,1267
9577,NJN,1995,Armen Gilliam,30,82,30,2472,455,905,.503,0,2,.000,455,903,.504,.503,302,392,.770,192,421,613,99,67,89,152,171,1212
9578,NJN,1995,P.J. Brown,25,80,63,2466,254,570,.446,4,24,.167,250,546,.458,.449,139,207,.671,178,309,487,135,69,135,80,262,651
9579,NJN,1995,Chris Morris,29,71,49,2131,351,856,.410,106,317,.334,245,539,.455,.472,142,195,.728,181,221,402,147,86,51,117,155,950
9580,NJN,1995,Derrick Coleman,27,56,54,2103,371,875,.424,28,120,.233,343,755,.454,.440,376,490,.767,167,424,591,187,35,94,172,162,1146
9581,NJN,1995,Benoit Benjamin,30,61,57,1598,271,531,.510,0,0,,271,531,.510,.510,133,175,.760,94,346,440,38,23,64,125,151,675
9582,NJN,1995,Rex Walters,24,80,30,1435,206,469,.439,71,196,.362,135,273,.495,.515,40,52,.769,18,75,93,121,37,16,71,135,523
9583,NJN,1995,Chris Childs,27,53,11,1021,106,279,.380,41,125,.328,65,154,.422,.453,55,73,.753,14,55,69,219,42,3,76,116,308
9584,NJN,1995,Jayson Williams,26,75,6,982,149,323,.461,0,5,.000,149,318,.469,.461,65,122,.533,179,246,425,35,26,33,59,160,363
9585,NJN,1995,Sleepy Floyd,34,48,1,831,71,212,.335,25,88,.284,46,124,.371,.394,30,43,.698,8,46,54,126,13,6,51,73,197
9586,NJN,1995,Sean Higgins,26,57,7,735,105,273,.385,23,78,.295,82,195,.421,.427,35,40,.875,25,52,77,29,10,9,35,93,268
9587,NJN,1995,Rick Mahorn,36,58,7,630,79,151,.523,1,3,.333,78,148,.527,.526,39,49,.796,45,117,162,26,11,12,34,93,198
9588,NJN,1995,Kevin Edwards,29,14,14,466,69,154,.448,18,45,.400,51,109,.468,.506,40,42,.952,10,27,37,27,19,5,35,42,196
9589,NJN,1995,Dwayne Schintzius,26,43,11,318,41,108,.380,0,0,,41,108,.380,.380,6,11,.545,29,52,81,15,3,17,17,45,88
9590,NJN,1995,Yinka Dare,22,1,0,3,0,1,.000,0,0,,0,1,.000,.000,0,0,,0,1,1,0,0,0,1,2,0
9591,NJN,1994,Kenny Anderson,23,82,82,3135,576,1381,.417,40,132,.303,536,1249,.429,.432,346,423,.818,89,233,322,784,158,15,266,201,1538
9592,NJN,1994,Derrick Coleman,26,77,77,2778,541,1209,.447,38,121,.314,503,1088,.462,.463,439,567,.774,262,608,870,262,68,142,208,209,1559
9593,NJN,1994,Kevin Edwards,28,82,82,2727,471,1028,.458,35,99,.354,436,929,.469,.475,167,217,.770,94,187,281,232,120,34,135,150,1144
9594,NJN,1994,Armen Gilliam,29,82,5,1969,348,682,.510,0,1,.000,348,681,.511,.510,274,361,.759,197,303,500,69,38,61,106,129,970
9595,NJN,1994,P.J. Brown,24,79,54,1950,167,402,.415,1,6,.167,166,396,.419,.417,115,152,.757,188,305,493,93,71,93,72,177,450
9596,NJN,1994,Benoit Benjamin,29,77,74,1817,283,589,.480,0,0,,283,589,.480,.480,152,214,.710,135,364,499,44,35,90,97,198,718
9597,NJN,1994,Chris Morris,28,50,27,1349,203,454,.447,53,147,.361,150,307,.489,.506,85,118,.720,91,137,228,83,55,49,52,120,544
9598,NJN,1994,Johnny Newman,30,63,0,1268,222,490,.453,20,74,.270,202,416,.486,.473,134,166,.807,65,57,122,43,51,22,62,152,598
9599,NJN,1994,Jayson Williams,25,70,0,877,125,293,.427,0,0,,125,293,.427,.427,72,119,.605,109,154,263,26,17,36,35,140,322
9600,NJN,1994,David Wesley,23,60,0,542,64,174,.368,11,47,.234,53,127,.417,.399,44,53,.830,10,34,44,123,38,4,52,47,183
9601,NJN,1994,Rex Walters,23,48,0,386,60,115,.522,14,28,.500,46,87,.529,.583,28,34,.824,6,32,38,71,15,3,30,41,162
9602,NJN,1994,Dwayne Schintzius,25,30,7,319,29,84,.345,0,0,,29,84,.345,.345,10,17,.588,26,63,89,13,7,17,13,49,68
9603,NJN,1994,Rumeal Robinson,27,17,0,301,42,119,.353,7,15,.467,35,104,.337,.382,10,20,.500,4,20,24,45,15,3,25,33,101
9604,NJN,1994,Rick Mahorn,35,28,0,226,23,47,.489,0,1,.000,23,46,.500,.489,13,20,.650,16,38,54,5,3,5,7,38,59
9605,NJN,1994,Ron Anderson,35,11,2,176,15,43,.349,4,12,.333,11,31,.355,.395,10,12,.833,8,18,26,6,5,2,1,9,44
9606,NJN,1994,Dave Jamerson,26,4,0,10,0,5,.000,0,0,,0,5,.000,.000,1,2,.500,0,3,3,1,0,0,1,0,1
9607,NJN,1993,Derrick Coleman,25,76,73,2759,564,1226,.460,23,99,.232,541,1127,.480,.469,421,521,.808,247,605,852,276,92,126,243,210,1572
9608,NJN,1993,Dražen Petrović,28,70,67,2660,587,1134,.518,75,167,.449,512,967,.529,.551,315,362,.870,42,148,190,247,94,13,204,237,1564
9609,NJN,1993,Chris Morris,27,77,57,2302,436,907,.481,17,76,.224,419,831,.504,.490,197,248,.794,227,227,454,106,144,52,119,171,1086
9610,NJN,1993,Sam Bowie,31,79,65,2092,287,638,.450,2,6,.333,285,632,.451,.451,141,181,.779,158,398,556,127,32,128,120,226,717
9611,NJN,1993,Kenny Anderson,22,55,55,2010,370,850,.435,7,25,.280,363,825,.440,.439,180,232,.776,51,175,226,449,96,11,153,140,927
9612,NJN,1993,Rumeal Robinson,26,80,28,1585,270,638,.423,20,56,.357,250,582,.430,.439,112,195,.574,49,110,159,323,96,12,140,169,672
9613,NJN,1993,Chris Dudley,27,71,16,1398,94,266,.353,0,0,,94,266,.353,.353,57,110,.518,215,298,513,16,17,103,54,195,245
9614,NJN,1993,Chucky Brown,24,77,20,1186,160,331,.483,0,5,.000,160,326,.491,.483,71,98,.724,88,144,232,51,20,24,56,112,391
9615,NJN,1993,Rafael Addison,28,68,15,1164,182,411,.443,7,34,.206,175,377,.464,.451,57,70,.814,45,87,132,53,23,11,64,125,428
9616,NJN,1993,Rick Mahorn,34,74,9,1077,101,214,.472,1,3,.333,100,211,.474,.474,88,110,.800,93,186,279,33,19,31,58,156,291
9617,NJN,1993,Maurice Cheeks,36,35,0,510,51,93,.548,0,2,.000,51,91,.560,.548,24,27,.889,5,37,42,107,33,2,33,35,126
9618,NJN,1993,Bernard King,36,32,2,430,91,177,.514,2,7,.286,89,170,.524,.520,39,57,.684,35,41,76,18,11,3,21,53,223
9619,NJN,1993,Tate George,24,48,1,380,51,135,.378,0,5,.000,51,130,.392,.378,20,24,.833,9,18,27,59,10,3,31,25,122
9620,NJN,1993,Jayson Williams,24,12,2,139,21,46,.457,0,0,,21,46,.457,.457,7,18,.389,22,19,41,0,4,4,8,24,49
9621,NJN,1993,Dwayne Schintzius,24,5,0,35,2,7,.286,0,0,,2,7,.286,.286,3,3,1.000,2,6,8,2,2,2,0,4,7
9622,NJN,1993,Doug Lee,28,5,0,33,2,7,.286,1,3,.333,1,4,.250,.357,0,0,,0,2,2,5,0,1,3,7,5
9623,NJN,1993,Dan O'Sullivan,24,3,0,10,2,3,.667,0,0,,2,3,.667,.667,0,0,,2,2,4,0,0,0,0,1,4
9624,NJN,1993,Dave Hoppen,28,2,0,10,1,1,1.000,0,0,,1,1,1.000,1.000,0,2,.000,1,3,4,0,0,0,0,2,2
9625,NJN,1992,Dražen Petrović,27,82,82,3027,668,1315,.508,123,277,.444,545,1038,.525,.555,232,287,.808,97,161,258,252,105,11,215,248,1691
9626,NJN,1992,Mookie Blaylock,24,72,67,2548,429,993,.432,12,54,.222,417,939,.444,.438,126,177,.712,101,168,269,492,170,40,152,182,996
9627,NJN,1992,Chris Morris,26,77,74,2394,346,726,.477,22,110,.200,324,616,.526,.492,165,231,.714,199,295,494,197,129,81,171,211,879
9628,NJN,1992,Derrick Coleman,24,65,58,2207,483,958,.504,23,76,.303,460,882,.522,.516,300,393,.763,203,415,618,205,54,98,248,168,1289
9629,NJN,1992,Sam Bowie,30,71,61,2179,421,947,.445,8,25,.320,413,922,.448,.449,212,280,.757,203,375,578,186,41,120,150,212,1062
9630,NJN,1992,Chris Dudley,26,82,21,1902,190,472,.403,0,0,,190,472,.403,.403,80,171,.468,343,396,739,58,38,179,79,275,460
9631,NJN,1992,Terry Mills,24,82,24,1714,310,670,.463,8,23,.348,302,647,.467,.469,114,152,.750,187,266,453,84,48,41,82,200,742
9632,NJN,1992,Rafael Addison,27,76,8,1175,187,432,.433,14,49,.286,173,383,.452,.449,56,76,.737,65,100,165,68,28,28,46,109,444
9633,NJN,1992,Kenny Anderson,21,64,13,1086,187,480,.390,3,13,.231,184,467,.394,.393,73,98,.745,38,89,127,203,67,9,97,68,450
9634,NJN,1992,Tate George,23,70,2,1037,165,386,.427,1,6,.167,164,380,.432,.429,87,106,.821,36,69,105,162,41,3,82,98,418
9635,NJN,1992,Doug Lee,27,46,0,307,50,116,.431,10,37,.270,40,79,.506,.474,10,19,.526,17,18,35,22,11,1,12,39,120
9636,NJN,1992,Dave Feitl,29,34,0,175,33,77,.429,0,0,,33,77,.429,.429,16,19,.842,21,40,61,6,2,3,19,22,82
9637,NJN,1992,Jud Buechler,23,2,0,29,4,8,.500,0,0,,4,8,.500,.500,0,0,,2,0,2,2,2,1,1,2,8
9638,NJN,1991,Reggie Theus,33,81,81,2955,583,1247,.468,52,144,.361,531,1103,.481,.488,292,343,.851,69,160,229,378,85,35,252,231,1510
9639,NJN,1991,Derrick Coleman,23,74,68,2602,514,1100,.467,13,38,.342,501,1062,.472,.473,323,442,.731,269,490,759,163,71,99,217,217,1364
9640,NJN,1991,Mookie Blaylock,23,72,70,2585,432,1039,.416,14,91,.154,418,948,.441,.423,139,176,.790,67,182,249,441,169,40,207,180,1017
9641,NJN,1991,Chris Morris,25,79,68,2553,409,962,.425,45,179,.251,364,783,.465,.449,179,244,.734,210,311,521,220,138,96,167,248,1042
9642,NJN,1991,Sam Bowie,29,62,51,1916,314,723,.434,4,22,.182,310,701,.442,.437,169,231,.732,176,304,480,147,43,90,141,175,801
9643,NJN,1991,Chris Dudley,25,61,25,1560,170,417,.408,0,0,,170,417,.408,.408,94,176,.534,229,282,511,37,39,153,80,217,434
9644,NJN,1991,Jack Haley,27,78,18,1178,161,343,.469,0,0,,161,343,.469,.469,112,181,.619,140,216,356,31,20,21,63,199,434
9645,NJN,1991,Dražen Petrović,26,43,0,882,211,422,.500,22,59,.373,189,363,.521,.526,99,115,.861,41,51,92,66,37,1,69,111,543
9646,NJN,1991,Jud Buechler,22,74,10,859,94,226,.416,1,4,.250,93,222,.419,.418,43,66,.652,61,80,141,51,33,15,26,79,232
9647,NJN,1991,Derrick Gervin,27,56,4,743,164,394,.416,7,28,.250,157,366,.429,.425,90,114,.789,40,70,110,30,19,19,45,88,425
9648,NJN,1991,Tate George,22,56,11,594,80,193,.415,0,2,.000,80,191,.419,.415,32,40,.800,19,28,47,104,25,5,42,58,192
9649,NJN,1991,Terry Mills,23,38,2,540,78,168,.464,0,2,.000,78,166,.470,.464,31,44,.705,51,90,141,17,19,20,25,56,187
9650,NJN,1991,Lester Conner,31,35,2,489,58,111,.523,0,2,.000,58,109,.532,.523,29,42,.690,11,46,57,58,37,1,27,38,145
9651,NJN,1991,Kurk Lee,23,48,0,265,19,71,.268,3,15,.200,16,56,.286,.289,25,28,.893,7,23,30,34,11,2,20,39,66
9652,NJN,1991,Roy Hinson,29,9,0,91,20,39,.513,0,0,,20,39,.513,.513,1,3,.333,6,13,19,4,0,3,6,14,41
9653,NJN,1991,Greg Anderson,26,1,0,18,4,4,1.000,0,0,,4,4,1.000,1.000,0,0,,4,2,6,1,2,0,1,4,8
9654,NJN,1990,Dennis Hopson,24,79,64,2551,474,1093,.434,32,101,.317,442,992,.446,.448,271,342,.792,113,166,279,151,100,51,168,183,1251
9655,NJN,1990,Chris Morris,24,80,76,2449,449,1065,.422,61,193,.316,388,872,.445,.450,228,316,.722,194,228,422,143,130,79,185,219,1187
9656,NJN,1990,Lester Conner,30,82,61,2355,237,573,.414,2,13,.154,235,560,.420,.415,172,214,.804,90,175,265,385,172,8,138,182,648
9657,NJN,1990,Purvis Short,32,82,24,2213,432,950,.455,10,35,.286,422,915,.461,.460,198,237,.835,101,147,248,145,66,20,119,202,1072
9658,NJN,1990,Sam Bowie,28,68,54,2207,347,834,.416,10,31,.323,337,803,.420,.422,294,379,.776,206,484,690,91,38,121,125,211,998
9659,NJN,1990,Charles Shackleford,23,70,37,1557,247,535,.462,0,1,.000,247,534,.463,.462,79,115,.687,180,299,479,56,40,35,116,183,573
9660,NJN,1990,Mookie Blaylock,22,50,17,1267,212,571,.371,18,80,.225,194,491,.395,.387,63,81,.778,42,98,140,210,82,14,111,110,505
9661,NJN,1990,Jack Haley,26,56,26,1026,129,327,.394,0,1,.000,129,326,.396,.394,78,118,.661,108,174,282,22,18,11,65,163,336
9662,NJN,1990,Joe Barry Carroll,31,46,20,1002,159,405,.393,0,2,.000,159,403,.395,.393,85,107,.794,82,168,250,43,19,56,64,122,403
9663,NJN,1990,Roy Hinson,28,25,19,793,145,286,.507,0,0,,145,286,.507,.507,86,99,.869,61,111,172,22,14,27,52,87,376
9664,NJN,1990,Chris Dudley,24,27,8,672,67,152,.441,0,0,,67,152,.441,.441,32,105,.305,86,134,220,19,22,31,36,81,166
9665,NJN,1990,Pete Myers,26,28,2,543,74,180,.411,0,6,.000,74,174,.425,.411,50,69,.725,23,45,68,100,20,9,58,70,198
9666,NJN,1990,Derrick Gervin,26,21,0,339,93,197,.472,0,3,.000,93,194,.479,.472,65,89,.730,29,36,65,8,20,7,12,47,251
9667,NJN,1990,Leon Wood,27,28,2,200,16,49,.327,4,21,.190,12,28,.429,.367,14,16,.875,1,11,12,47,6,0,8,16,50
9668,NJN,1990,Jaren Jackson,22,28,0,160,25,69,.362,0,3,.000,25,66,.379,.362,17,21,.810,16,8,24,13,13,1,18,16,67
9669,NJN,1990,Stanley Brundy,22,16,0,128,15,30,.500,0,0,,15,30,.500,.500,7,18,.389,15,11,26,3,6,5,6,24,37
9670,NJN,1990,Jay Taylor,22,17,0,114,21,52,.404,3,13,.231,18,39,.462,.433,6,9,.667,5,6,11,5,5,3,10,9,51
9671,NJN,1990,Anthony Mason,23,21,0,108,14,40,.350,0,0,,14,40,.350,.350,9,15,.600,11,23,34,7,2,2,11,20,37
9672,NJN,1990,Rick Carlisle,30,5,0,21,1,7,.143,0,3,.000,1,4,.250,.143,0,0,,0,0,0,5,1,1,4,7,2
9673,NJN,1989,Roy Hinson,27,82,39,2542,495,1027,.482,0,2,.000,495,1025,.483,.482,318,420,.757,152,370,522,71,34,121,165,298,1308
9674,NJN,1989,Lester Conner,29,82,63,2532,309,676,.457,13,37,.351,296,639,.463,.467,212,269,.788,100,255,355,604,181,5,181,132,843
9675,NJN,1989,Buck Williams,28,74,72,2446,373,702,.531,0,3,.000,373,699,.534,.531,213,320,.666,249,447,696,78,61,36,142,223,959
9676,NJN,1989,Chris Morris,23,76,48,2096,414,905,.457,64,175,.366,350,730,.479,.493,182,254,.717,188,209,397,119,102,60,190,250,1074
9677,NJN,1989,Mike McGee,29,80,49,2027,434,917,.473,93,255,.365,341,662,.515,.524,77,144,.535,73,116,189,116,80,12,124,184,1038
9678,NJN,1989,Joe Barry Carroll,30,64,62,1996,363,810,.448,0,0,,363,810,.448,.448,176,220,.800,118,355,473,105,71,81,143,193,902
9679,NJN,1989,John Bagley,28,68,20,1642,200,481,.416,11,54,.204,189,427,.443,.427,89,123,.724,36,108,144,391,72,5,159,117,500
9680,NJN,1989,Dennis Hopson,23,62,36,1551,299,714,.419,4,27,.148,295,687,.429,.422,186,219,.849,91,111,202,103,70,30,102,150,788
9681,NJN,1989,Keith Lee,26,57,4,840,109,258,.422,0,2,.000,109,256,.426,.422,53,71,.746,73,186,259,42,20,33,53,138,271
9682,NJN,1989,Walter Berry,24,29,17,556,108,231,.468,0,0,,108,231,.468,.468,43,63,.683,32,83,115,20,10,13,40,69,259
9683,NJN,1989,Charles Shackleford,22,60,0,484,83,168,.494,0,1,.000,83,167,.497,.494,21,42,.500,50,103,153,21,15,18,27,71,187
9684,NJN,1989,Kevin Williams,27,41,0,433,67,168,.399,1,6,.167,66,162,.407,.402,40,51,.784,19,31,50,36,25,8,42,74,175
9685,NJN,1989,Corey Gaines,23,32,0,337,27,64,.422,1,5,.200,26,59,.441,.430,12,16,.750,3,16,19,67,15,1,20,27,67
9686,NJN,1989,Bill Jones,22,37,0,307,50,102,.490,0,1,.000,50,101,.495,.490,29,43,.674,20,27,47,20,17,6,18,38,129
9687,NJN,1989,Ron Cavenall,29,5,0,16,2,3,.667,0,0,,2,3,.667,.667,2,5,.400,0,2,2,0,0,2,2,2,6
9688,NJN,1988,John Bagley,27,82,74,2774,393,896,.439,47,161,.292,346,735,.471,.465,148,180,.822,61,196,257,479,110,10,201,162,981
9689,NJN,1988,Buck Williams,27,70,70,2637,466,832,.560,1,1,1.000,465,831,.560,.561,346,518,.668,298,536,834,109,68,44,189,266,1279
9690,NJN,1988,Otis Birdsong,32,67,59,1882,337,736,.458,9,25,.360,328,711,.461,.464,47,92,.511,73,94,167,222,54,11,129,143,730
9691,NJN,1988,Roy Hinson,26,48,47,1747,330,658,.502,0,1,.000,330,657,.502,.502,183,227,.806,106,242,348,72,45,72,106,185,843
9692,NJN,1988,Tim McCormick,25,47,38,1513,277,510,.543,0,2,.000,277,508,.545,.543,108,162,.667,97,226,323,92,18,15,76,159,662
9693,NJN,1988,Dudley Bradley,30,63,15,1432,156,364,.429,37,101,.366,119,263,.452,.479,74,97,.763,25,101,126,150,114,43,88,170,423
9694,NJN,1988,Pearl Washington,24,68,10,1379,245,547,.448,11,49,.224,234,498,.470,.458,132,189,.698,54,64,118,206,91,4,141,163,633
9695,NJN,1988,Dennis Hopson,22,61,19,1365,222,549,.404,12,45,.267,210,504,.417,.415,131,177,.740,63,80,143,118,57,25,119,145,587
9696,NJN,1988,Mike Gminski,28,34,34,1194,215,474,.454,0,2,.000,215,472,.456,.454,143,166,.861,82,238,320,55,28,33,83,78,573
9697,NJN,1988,Dallas Comegys,23,75,17,1122,156,363,.430,0,1,.000,156,362,.431,.430,106,150,.707,54,164,218,65,36,70,116,175,418
9698,NJN,1988,Ben Coleman,26,27,10,657,116,240,.483,0,2,.000,116,238,.487,.483,65,84,.774,58,115,173,39,28,16,72,110,297
9699,NJN,1988,Orlando Woolridge,28,19,12,622,110,247,.445,0,2,.000,110,245,.449,.445,92,130,.708,31,60,91,71,13,20,48,73,312
9700,NJN,1988,Chris Engler,28,54,0,399,36,88,.409,0,0,,36,88,.409,.409,31,35,.886,32,66,98,15,9,6,29,73,103
9701,NJN,1988,Kevin McKenna,29,31,2,393,43,109,.394,16,50,.320,27,59,.458,.468,24,25,.960,4,27,31,40,15,2,19,55,126
9702,NJN,1988,Adrian Branch,24,20,3,308,56,134,.418,1,5,.200,55,129,.426,.422,20,23,.870,20,28,48,16,16,11,29,41,133
9703,NJN,1988,Duane Washington,23,15,0,156,18,42,.429,2,4,.500,16,38,.421,.452,16,20,.800,5,17,22,34,12,0,9,23,54
9704,NJN,1988,Jamie Waller,23,9,0,91,16,40,.400,0,2,.000,16,38,.421,.400,10,18,.556,9,4,13,3,4,1,11,13,42
9705,NJN,1988,Mike O'Koren,29,4,0,52,9,16,.563,0,1,.000,9,15,.600,.563,0,4,.000,1,3,4,2,3,2,0,2,18
9706,NJN,1988,Ricky Wilson,23,6,0,47,7,11,.636,1,1,1.000,6,10,.600,.682,6,11,.545,1,0,1,6,6,0,4,6,21
9707,NJN,1988,Johnny Moore,29,1,0,10,0,1,.000,0,0,,0,1,.000,.000,0,0,,1,1,2,1,0,0,3,0,0
9708,NJN,1987,Buck Williams,26,82,82,2976,521,936,.557,0,1,.000,521,935,.557,.557,430,588,.731,322,701,1023,129,78,91,280,315,1472
9709,NJN,1987,Orlando Woolridge,27,75,53,2638,556,1067,.521,1,8,.125,555,1059,.524,.522,438,564,.777,118,249,367,261,54,86,213,243,1551
9710,NJN,1987,Tony Brown,26,77,67,2339,358,810,.442,5,20,.250,353,790,.447,.445,152,206,.738,84,135,219,259,89,14,153,273,873
9711,NJN,1987,Mike Gminski,27,72,66,2272,433,947,.457,0,0,,433,947,.457,.457,313,370,.846,192,438,630,99,52,69,129,159,1179
9712,NJN,1987,Leon Wood,24,76,7,1733,187,501,.373,60,200,.300,127,301,.422,.433,123,154,.799,23,97,120,370,48,3,108,126,557
9713,NJN,1987,Pearl Washington,23,72,61,1600,257,538,.478,4,24,.167,253,514,.492,.481,98,125,.784,37,92,129,301,92,7,175,184,616
9714,NJN,1987,Albert King,27,61,15,1291,244,573,.426,13,32,.406,231,541,.427,.437,81,100,.810,82,132,214,103,34,28,103,177,582
9715,NJN,1987,Ben Coleman,25,68,7,1029,182,313,.581,0,1,.000,182,312,.583,.581,88,121,.727,99,189,288,37,32,31,94,200,452
9716,NJN,1987,Jeff Turner,24,76,22,1003,151,325,.465,0,1,.000,151,324,.466,.465,76,104,.731,80,117,197,60,33,13,81,200,378
9717,NJN,1987,Kevin McKenna,28,56,3,942,153,337,.454,52,124,.419,101,213,.474,.531,43,57,.754,21,56,77,93,54,7,53,141,401
9718,NJN,1987,Ray Williams,32,32,14,800,131,290,.452,7,28,.250,124,262,.473,.464,49,60,.817,26,49,75,185,38,9,94,111,318
9719,NJN,1987,James Bailey,29,34,2,542,112,239,.469,0,0,,112,239,.469,.469,58,80,.725,48,89,137,20,12,23,54,119,282
9720,NJN,1987,Pace Mannion,26,23,3,284,31,94,.330,3,9,.333,28,85,.329,.346,18,31,.581,10,29,39,45,18,4,23,32,83
9721,NJN,1987,Chris Engler,27,18,0,130,16,31,.516,0,0,,16,31,.516,.516,8,12,.667,14,19,33,4,3,9,10,23,40
9722,NJN,1987,Otis Birdsong,31,7,6,127,19,42,.452,0,1,.000,19,41,.463,.452,6,9,.667,3,4,7,17,3,0,9,16,44
9723,NJN,1987,Darryl Dawkins,30,6,2,106,20,32,.625,0,0,,20,32,.625,.625,17,24,.708,9,10,19,2,2,3,15,25,57
9724,NJN,1987,Michael Wilson,27,5,0,43,3,8,.375,0,0,,3,8,.375,.375,2,2,1.000,1,3,4,6,1,0,4,9,8
9725,NJN,1986,Buck Williams,25,82,82,3070,500,956,.523,0,2,.000,500,954,.524,.523,301,445,.676,329,657,986,131,73,96,244,294,1301
9726,NJN,1986,Mike Gminski,26,81,78,2525,491,949,.517,0,1,.000,491,948,.518,.517,351,393,.893,206,462,668,133,56,71,140,163,1333
9727,NJN,1986,Otis Birdsong,30,77,74,2395,542,1056,.513,8,22,.364,534,1034,.516,.517,122,210,.581,88,114,202,261,85,17,179,228,1214
9728,NJN,1986,Albert King,26,73,69,1998,438,961,.456,4,23,.174,434,938,.463,.458,167,203,.823,116,250,366,181,58,24,181,205,1047
9729,NJN,1986,Darwin Cook,27,79,33,1965,267,627,.426,11,53,.208,256,574,.446,.435,84,111,.757,51,126,177,390,156,22,132,172,629
9730,NJN,1986,Micheal Ray Richardson,30,47,39,1604,296,661,.448,4,27,.148,292,634,.461,.451,141,179,.788,77,173,250,340,125,11,150,163,737
9731,NJN,1986,Mickey Johnson,33,79,4,1574,214,507,.422,5,24,.208,209,483,.433,.427,183,233,.785,98,234,332,217,67,25,165,248,616
9732,NJN,1986,Kelvin Ransey,27,79,15,1504,231,505,.457,3,24,.125,228,481,.474,.460,121,148,.818,34,82,116,252,51,4,114,128,586
9733,NJN,1986,Darryl Dawkins,29,51,3,1207,284,441,.644,0,1,.000,284,440,.645,.644,210,297,.707,85,166,251,77,16,59,124,227,778
9734,NJN,1986,Mike O'Koren,27,67,11,1031,160,336,.476,7,27,.259,153,309,.495,.487,23,39,.590,33,102,135,118,29,9,54,134,350
9735,NJN,1986,Jeff Turner,23,53,1,650,84,171,.491,0,1,.000,84,170,.494,.491,58,78,.744,45,92,137,14,21,3,49,125,226
9736,NJN,1986,Bobby Cattage,27,29,1,185,28,83,.337,1,5,.200,27,78,.346,.343,35,44,.795,15,19,34,4,6,0,13,23,92
9737,NJN,1986,Ray Williams,31,5,0,63,10,32,.313,0,2,.000,10,30,.333,.313,12,14,.857,3,1,4,9,5,0,9,12,32
9738,NJN,1986,Rod Higgins,26,2,0,29,3,16,.188,0,2,.000,3,14,.214,.188,0,0,,3,5,8,1,1,4,2,6,6
9739,NJN,1986,Yvon Joseph,28,1,0,5,0,0,,0,0,,0,0,,,2,2,1.000,0,0,0,0,0,0,0,1,2
9740,NJN,1985,Buck Williams,24,82,82,3182,577,1089,.530,1,4,.250,576,1085,.531,.530,336,538,.625,323,682,1005,167,63,110,238,293,1491
9741,NJN,1985,Micheal Ray Richardson,29,82,82,3127,690,1470,.469,29,115,.252,661,1355,.488,.479,240,313,.767,156,301,457,669,243,22,249,277,1649
9742,NJN,1985,Mike Gminski,25,81,54,2418,380,818,.465,0,1,.000,380,817,.465,.465,276,328,.841,229,404,633,158,38,92,136,135,1036
9743,NJN,1985,Otis Birdsong,29,56,45,1842,495,968,.511,4,21,.190,491,947,.518,.513,161,259,.622,60,88,148,232,84,7,117,145,1155
9744,NJN,1985,Kelvin Ransey,26,81,29,1689,300,654,.459,2,11,.182,298,643,.463,.460,122,142,.859,40,90,130,355,87,7,113,134,724
9745,NJN,1985,Jeff Turner,22,72,36,1429,171,377,.454,0,3,.000,171,374,.457,.454,79,92,.859,88,130,218,108,29,7,90,243,421
9746,NJN,1985,Mike O'Koren,26,43,29,1119,194,393,.494,8,21,.381,186,372,.500,.504,42,67,.627,46,120,166,102,32,16,51,115,438
9747,NJN,1985,Darwin Cook,26,58,9,1063,212,453,.468,2,23,.087,210,430,.488,.470,47,54,.870,21,71,92,160,74,10,75,96,473
9748,NJN,1985,Darryl Dawkins,28,39,30,972,192,339,.566,0,1,.000,192,338,.568,.566,143,201,.711,55,126,181,45,14,35,93,171,527
9749,NJN,1985,Albert King,25,42,7,860,226,460,.491,0,8,.000,226,452,.500,.491,85,104,.817,70,89,159,58,41,9,65,110,537
9750,NJN,1985,George Johnson,36,65,0,800,42,79,.532,1,1,1.000,41,78,.526,.538,22,27,.815,74,111,185,22,19,78,39,151,107
9751,NJN,1985,Kevin McKenna,26,29,7,535,61,134,.455,5,13,.385,56,121,.463,.474,38,43,.884,20,29,49,58,30,7,32,63,165
9752,NJN,1985,Wayne Sappleton,24,33,0,298,41,87,.471,0,0,,41,87,.471,.471,14,34,.412,28,47,75,7,7,4,21,50,96
9753,NJN,1985,Ron Brewer,29,11,0,245,49,84,.583,0,2,.000,49,82,.598,.583,16,18,.889,8,10,18,11,5,5,5,15,114
9754,NJN,1985,Michael Wilson,25,8,0,92,9,23,.391,0,0,,9,23,.391,.391,4,6,.667,4,9,13,11,4,2,5,7,22
9755,NJN,1985,Chris Engler,25,7,0,76,7,16,.438,0,0,,7,16,.438,.438,5,9,.556,10,17,27,0,2,4,1,4,19
9756,NJN,1985,Tom LaGarde,29,1,0,8,0,1,.000,0,0,,0,1,.000,.000,1,2,.500,1,1,2,0,0,0,1,2,1
9757,NJN,1984,Buck Williams,23,81,81,3003,495,926,.535,0,4,.000,495,922,.537,.535,284,498,.570,355,645,1000,130,81,125,237,298,1274
9758,NJN,1984,Darryl Dawkins,27,81,80,2417,507,855,.593,2,5,.400,505,850,.594,.594,341,464,.735,159,382,541,123,60,136,231,386,1357
9759,NJN,1984,Otis Birdsong,28,69,57,2168,583,1147,.508,5,20,.250,578,1127,.513,.510,194,319,.608,74,96,170,266,86,17,170,180,1365
9760,NJN,1984,Albert King,24,79,53,2103,465,946,.492,3,22,.136,462,924,.500,.493,232,295,.786,125,263,388,203,91,33,208,258,1165
9761,NJN,1984,Kelvin Ransey,25,80,50,1937,304,700,.434,7,32,.219,297,668,.445,.439,145,183,.792,28,99,127,483,91,6,141,182,760
9762,NJN,1984,Darwin Cook,25,82,31,1870,304,687,.443,11,46,.239,293,641,.457,.451,95,126,.754,51,105,156,356,164,36,142,184,714
9763,NJN,1984,Mike Gminski,24,82,2,1655,237,462,.513,0,3,.000,237,459,.516,.513,147,184,.799,161,272,433,92,37,70,120,162,621
9764,NJN,1984,Micheal Ray Richardson,28,48,25,1285,243,528,.460,14,58,.241,229,470,.487,.473,76,108,.704,56,116,172,214,103,20,118,156,576
9765,NJN,1984,Mike O'Koren,25,73,25,1191,186,385,.483,5,28,.179,181,357,.507,.490,53,87,.609,71,104,175,95,34,11,75,148,430
9766,NJN,1984,Bill Willoughby,26,67,2,936,124,258,.481,0,7,.000,124,251,.494,.481,55,63,.873,75,118,193,56,23,24,53,106,303
9767,NJN,1984,Reggie Johnson,26,72,4,818,127,256,.496,0,1,.000,127,255,.498,.496,92,126,.730,53,85,138,40,24,18,59,141,346
9768,NJN,1984,Foots Walker,32,34,0,378,32,90,.356,2,5,.400,30,85,.353,.367,24,27,.889,8,23,31,81,20,3,31,37,90
9769,NJN,1984,Bruce Kuczenski,22,7,0,28,4,12,.333,0,0,,4,12,.333,.333,3,6,.500,3,5,8,4,0,0,2,3,11
9770,NJN,1984,Mark Jones,22,6,0,16,3,6,.500,0,1,.000,3,5,.600,.500,1,2,.500,2,0,2,5,0,0,2,2,7
9771,NJN,1983,Buck Williams,22,82,82,2961,536,912,.588,0,4,.000,536,908,.590,.588,324,523,.620,365,662,1027,125,91,110,246,270,1396
9772,NJN,1983,Darwin Cook,24,82,47,2625,443,986,.449,8,38,.211,435,948,.459,.453,186,242,.769,73,167,240,448,194,48,238,213,1080
9773,NJN,1983,Albert King,23,79,75,2447,582,1226,.475,6,23,.261,576,1203,.479,.477,176,227,.775,157,299,456,291,95,41,245,278,1346
9774,NJN,1983,Darryl Dawkins,26,81,81,2093,401,669,.599,0,0,,401,669,.599,.599,166,257,.646,127,293,420,114,67,152,281,379,968
9775,NJN,1983,Otis Birdsong,27,62,54,1885,426,834,.511,2,6,.333,424,828,.512,.512,82,145,.566,53,97,150,239,85,16,114,155,936
9776,NJN,1983,Foots Walker,31,79,10,1388,114,250,.456,2,12,.167,112,238,.471,.460,116,149,.779,30,106,136,264,78,3,104,134,346
9777,NJN,1983,Mike Gminski,23,80,1,1255,213,426,.500,0,1,.000,213,425,.501,.500,175,225,.778,154,228,382,61,35,116,126,118,601
9778,NJN,1983,Micheal Ray Richardson,27,31,26,1002,170,388,.438,4,20,.200,166,368,.451,.443,51,76,.671,68,82,150,187,81,15,107,116,395
9779,NJN,1983,Mickey Johnson,30,42,7,1001,199,496,.401,2,17,.118,197,479,.411,.403,164,201,.816,66,158,224,144,56,21,121,135,564
9780,NJN,1983,Len Elmore,30,74,0,975,97,244,.398,0,1,.000,97,243,.399,.398,54,84,.643,81,157,238,39,44,38,83,125,248
9781,NJN,1983,Mike O'Koren,24,46,14,803,136,259,.525,2,9,.222,134,250,.536,.529,34,48,.708,42,72,114,82,42,11,62,67,308
9782,NJN,1983,Sleepy Floyd,22,43,6,494,92,216,.426,4,14,.286,88,202,.436,.435,38,45,.844,16,26,42,67,19,9,40,56,226
9783,NJN,1983,Eddie Phillips,21,48,0,416,56,138,.406,0,2,.000,56,136,.412,.406,40,59,.678,27,50,77,29,14,8,50,58,152
9784,NJN,1983,Phil Ford,26,7,7,163,20,35,.571,0,1,.000,20,34,.588,.571,7,10,.700,0,7,7,38,6,0,21,22,47
9785,NJN,1983,Bill Willoughby,25,10,0,84,11,29,.379,0,1,.000,11,28,.393,.379,2,2,1.000,2,9,11,8,1,1,5,16,24
9786,NJN,1983,Jan van Breda Kolff,31,13,0,63,5,14,.357,0,0,,5,14,.357,.357,5,6,.833,2,11,13,5,2,2,3,9,15
9787,NJN,1983,James Bailey,25,6,0,50,9,18,.500,0,0,,9,18,.500,.500,2,2,1.000,3,3,6,2,1,1,6,15,20
9788,NJN,1982,Buck Williams,21,82,82,2825,513,881,.582,0,1,.000,513,880,.583,.582,242,388,.624,347,658,1005,107,84,84,235,285,1268
9789,NJN,1982,Ray Williams,27,82,69,2732,639,1383,.462,9,54,.167,630,1329,.474,.465,387,465,.832,117,208,325,488,199,43,290,302,1674
9790,NJN,1982,Len Elmore,29,81,70,2100,300,652,.460,0,0,,300,652,.460,.460,135,170,.794,167,274,441,100,92,92,136,280,735
9791,NJN,1982,Darwin Cook,23,82,17,2090,387,803,.482,7,31,.226,380,772,.492,.486,118,162,.728,52,103,155,319,146,24,175,196,899
9792,NJN,1982,Mike O'Koren,23,80,32,2018,383,778,.492,8,23,.348,375,755,.497,.497,135,189,.714,111,194,305,192,83,13,147,175,909
9793,NJN,1982,Foots Walker,30,77,54,1861,156,378,.413,3,9,.333,153,369,.415,.417,141,194,.727,31,119,150,398,120,6,107,179,456
9794,NJN,1982,Albert King,22,76,52,1694,391,812,.482,3,13,.231,388,799,.486,.483,133,171,.778,105,207,312,142,64,36,180,261,918
9795,NJN,1982,James Bailey,24,67,0,1288,230,440,.523,0,0,,230,440,.523,.523,133,213,.624,110,233,343,52,39,76,120,228,593
9796,NJN,1982,Otis Birdsong,26,37,22,1025,225,480,.469,0,10,.000,225,470,.479,.469,74,127,.583,30,67,97,124,30,5,64,74,524
9797,NJN,1982,Mike Gminski,22,64,6,740,119,270,.441,0,0,,119,270,.441,.441,97,118,.822,70,116,186,41,17,48,56,69,335
9798,NJN,1982,Sam Lacey,33,54,6,650,64,149,.430,0,1,.000,64,148,.432,.430,27,35,.771,20,83,103,73,20,37,54,137,155
9799,NJN,1982,Jan van Breda Kolff,30,41,0,452,41,82,.500,0,2,.000,41,80,.513,.500,62,76,.816,17,31,48,32,12,13,29,63,144
9800,NJN,1982,Mike Woodson,23,7,0,145,30,68,.441,0,1,.000,30,67,.448,.441,23,32,.719,5,8,13,16,7,2,9,21,83
9801,NJN,1982,Ray Tolbert,23,12,0,115,20,44,.455,0,1,.000,20,43,.465,.455,4,8,.500,11,16,27,8,4,2,12,19,44
9802,NJN,1982,David Burns,23,3,0,34,2,5,.400,0,0,,2,5,.400,.400,3,6,.500,0,2,2,4,1,0,5,4,7
9803,NJN,1982,Joe Cooper,24,1,0,11,1,2,.500,0,0,,1,2,.500,.500,0,0,,1,1,2,0,0,0,1,2,2
9804,NJN,1981,Mike Newlin,32,79,,2911,632,1272,.497,10,30,.333,622,1242,.501,.501,414,466,.888,78,141,219,299,87,9,248,237,1688
9805,NJN,1981,Mike O'Koren,22,79,,2473,365,751,.486,5,18,.278,360,733,.491,.489,135,212,.637,179,299,478,252,86,27,146,243,870
9806,NJN,1981,Maurice Lucas,28,68,,2162,404,835,.484,0,2,.000,404,833,.485,.484,191,254,.752,153,422,575,173,57,59,176,260,999
9807,NJN,1981,Darwin Cook,22,81,,1980,383,819,.468,6,25,.240,377,794,.475,.471,132,180,.733,96,140,236,297,141,36,176,197,904
9808,NJN,1981,Cliff Robinson,20,63,,1822,525,1070,.491,1,1,1.000,524,1069,.490,.491,178,248,.718,120,361,481,105,58,52,182,216,1229
9809,NJN,1981,Mike Gminski,21,56,,1579,291,688,.423,0,1,.000,291,687,.424,.423,155,202,.767,137,282,419,72,54,100,128,127,737
9810,NJN,1981,Jan van Breda Kolff,29,78,,1426,100,245,.408,2,8,.250,98,237,.414,.412,98,117,.838,48,154,202,129,38,50,108,214,300
9811,NJN,1981,Lowes Moore,23,71,,1406,212,478,.444,4,27,.148,208,451,.461,.448,69,92,.750,43,125,168,228,61,17,108,179,497
9812,NJN,1981,Bob Elliott,25,73,,1320,214,419,.511,1,2,.500,213,417,.511,.512,121,202,.599,104,157,261,129,34,16,119,175,550
9813,NJN,1981,Foots Walker,29,41,,1172,72,169,.426,2,9,.222,70,160,.438,.432,88,111,.793,22,80,102,253,52,1,85,105,234
9814,NJN,1981,Edgar Jones,24,60,,950,189,357,.529,0,4,.000,189,353,.535,.529,146,218,.670,92,171,263,43,36,81,101,185,524
9815,NJN,1981,Eddie Jordan,26,14,,239,30,73,.411,3,10,.300,27,63,.429,.432,24,32,.750,5,13,18,46,24,1,23,29,87
9816,NJN,1981,Rory Sparrow,22,15,,212,22,63,.349,0,0,,22,63,.349,.349,12,16,.750,7,11,18,32,13,3,18,15,56
9817,NJN,1981,Bob McAdoo,29,10,,153,38,75,.507,0,1,.000,38,74,.514,.507,17,21,.810,8,18,26,10,9,6,14,22,93
9818,NJN,1980,Eddie Jordan,25,82,82,2657,437,1017,.430,12,48,.250,425,969,.439,.436,201,258,.779,62,208,270,557,223,27,258,238,1087
9819,NJN,1980,Mike Newlin,31,78,,2510,611,1329,.460,45,152,.296,566,1177,.481,.477,367,415,.884,101,163,264,314,115,4,231,195,1634
9820,NJN,1980,Jan van Breda Kolff,28,82,,2399,212,458,.463,7,20,.350,205,438,.468,.471,130,155,.839,103,326,429,247,100,76,158,307,561
9821,NJN,1980,George Johnson,31,81,,2119,248,543,.457,0,1,.000,248,542,.458,.457,89,126,.706,192,410,602,173,53,258,199,312,585
9822,NJN,1980,Calvin Natt,23,53,,2046,421,879,.479,1,5,.200,420,874,.481,.480,199,280,.711,173,340,513,112,78,22,133,148,1042
9823,NJN,1980,Cliff Robinson,19,70,,1661,391,833,.469,1,4,.250,390,829,.470,.470,168,242,.694,174,332,506,98,61,34,137,178,951
9824,NJN,1980,Rich Kelley,26,57,,1466,186,399,.466,0,3,.000,186,396,.470,.466,197,250,.788,156,241,397,128,50,79,152,215,569
9825,NJN,1980,Winford Boynes,22,64,,1102,221,467,.473,0,4,.000,221,463,.477,.473,104,136,.765,51,82,133,95,59,19,96,132,546
9826,NJN,1980,John Williamson,28,28,,771,206,461,.447,8,19,.421,198,442,.448,.456,76,88,.864,24,30,54,87,26,9,43,71,496
9827,NJN,1980,Robert Smith,24,59,,736,113,254,.445,8,26,.308,105,228,.461,.461,75,87,.862,17,59,76,85,22,4,52,102,309
9828,NJN,1980,Bob Elliott,24,54,,722,101,228,.443,1,4,.250,100,224,.446,.445,104,152,.684,67,118,185,53,29,14,88,97,307
9829,NJN,1980,Maurice Lucas,27,22,,708,128,261,.490,0,4,.000,128,257,.498,.490,79,102,.775,58,154,212,83,19,27,70,82,335
9830,NJN,1980,Roger Phegley,23,28,,541,126,260,.485,2,4,.500,124,256,.484,.488,73,83,.880,26,44,70,32,15,4,49,52,327
9831,NJN,1980,Phil Jackson,34,16,,194,29,46,.630,0,2,.000,29,44,.659,.630,7,10,.700,12,12,24,12,5,4,9,35,65
9832,NJN,1980,Tim Bassett,28,7,,92,8,22,.364,0,0,,8,22,.364,.364,8,12,.667,7,11,18,4,5,0,4,14,24
9833,NJN,1980,Ralph Simpson,30,8,,81,18,47,.383,0,2,.000,18,45,.400,.383,5,10,.500,6,5,11,14,9,0,12,3,41
9834,CHI,2024,DeMar DeRozan,34,79,79,2989,650,1355,.480,75,225,.333,575,1130,.509,.507,522,612,.853,43,297,340,421,90,45,135,161,1897
9835,CHI,2024,Coby White,23,79,78,2881,541,1209,.447,209,556,.376,332,653,.508,.534,218,260,.838,44,314,358,405,53,18,166,186,1509
9836,CHI,2024,Nikola Vučević,33,76,74,2610,586,1211,.484,92,313,.294,494,898,.550,.522,106,129,.822,210,591,801,254,50,60,120,190,1370
9837,CHI,2024,Ayo Dosunmu,24,76,37,2212,360,719,.501,119,295,.403,241,424,.568,.583,85,105,.810,54,162,216,242,68,36,103,166,924
9838,CHI,2024,Alex Caruso,29,71,57,2040,253,541,.468,136,333,.408,117,208,.563,.593,73,96,.760,62,211,273,247,120,70,102,181,715
9839,CHI,2024,Andre Drummond,30,79,10,1351,267,480,.556,0,3,.000,267,477,.560,.556,129,218,.592,265,443,708,37,73,48,81,140,663
9840,CHI,2024,Patrick Williams,22,43,30,1174,159,359,.443,59,148,.399,100,211,.474,.525,52,66,.788,46,120,166,66,40,33,57,87,429
9841,CHI,2024,Torrey Craig,33,53,14,1049,108,251,.430,60,153,.392,48,98,.490,.550,27,36,.750,69,148,217,58,30,21,32,110,303
9842,CHI,2024,Jevon Carter,28,72,0,1004,138,365,.378,77,234,.329,61,131,.466,.484,4,7,.571,11,49,60,94,37,16,36,71,357
9843,CHI,2024,Zach LaVine,28,25,23,872,170,376,.452,59,169,.349,111,207,.536,.531,88,103,.854,8,121,129,98,21,8,52,57,487
9844,CHI,2024,Dalen Terry,21,59,2,681,69,157,.439,17,74,.230,52,83,.627,.494,25,43,.581,29,84,113,81,27,18,32,81,180
9845,CHI,2024,Julian Phillips,20,40,0,323,32,77,.416,12,38,.316,20,39,.513,.494,13,19,.684,12,24,36,13,7,7,10,40,89
9846,CHI,2024,Onuralp Bitim,24,23,1,268,32,84,.381,12,44,.273,20,40,.500,.452,4,5,.800,6,26,32,13,3,2,10,24,80
9847,CHI,2024,Javonte Green,30,9,5,230,45,75,.600,10,27,.370,35,48,.729,.667,10,13,.769,20,47,67,5,10,8,7,19,110
9848,CHI,2024,Terry Taylor,24,31,0,188,20,39,.513,2,9,.222,18,30,.600,.538,4,5,.800,17,20,37,10,5,2,7,17,46
9849,CHI,2024,Adama Sanogo,21,9,0,66,14,27,.519,0,0,,14,27,.519,.519,8,12,.667,19,17,36,0,1,0,5,5,36
9850,CHI,2024,Henri Drell,23,4,0,30,4,10,.400,2,6,.333,2,4,.500,.500,1,2,.500,1,3,4,4,2,1,2,6,11
9851,CHI,2024,Andrew Funk,24,5,0,13,0,4,.000,0,3,.000,0,1,.000,.000,0,0,,0,0,0,0,1,1,0,0,0
9852,CHI,2023,Zach LaVine,27,77,77,2768,673,1388,.485,204,544,.375,469,844,.556,.558,363,428,.848,42,303,345,327,69,18,194,159,1913
9853,CHI,2023,Nikola Vučević,32,82,82,2746,597,1148,.520,121,347,.349,476,801,.594,.573,132,158,.835,159,744,903,265,60,57,139,179,1447
9854,CHI,2023,DeMar DeRozan,33,74,74,2682,657,1303,.504,46,142,.324,611,1161,.526,.522,456,523,.872,34,309,343,377,83,36,153,186,1816
9855,CHI,2023,Patrick Williams,21,82,65,2323,314,677,.464,115,277,.415,199,400,.498,.549,90,105,.857,78,249,327,100,72,70,101,147,833
9856,CHI,2023,Ayo Dosunmu,23,80,51,2098,281,570,.493,59,189,.312,222,381,.583,.545,66,82,.805,45,175,220,206,62,26,99,182,687
9857,CHI,2023,Coby White,22,74,2,1730,263,594,.443,128,344,.372,135,250,.540,.551,61,70,.871,16,196,212,204,54,6,74,122,715
9858,CHI,2023,Alex Caruso,28,67,36,1575,130,286,.455,55,151,.364,75,135,.556,.551,59,73,.808,42,154,196,193,98,46,77,159,374
9859,CHI,2023,Derrick Jones Jr.,25,64,0,893,115,230,.500,27,80,.338,88,150,.587,.559,62,84,.738,60,93,153,34,29,37,25,86,319
9860,CHI,2023,Andre Drummond,29,67,0,849,166,274,.606,0,3,.000,166,271,.613,.606,67,125,.536,138,306,444,33,45,27,75,117,399
9861,CHI,2023,Goran Dragić,36,51,0,787,127,299,.425,45,128,.352,82,171,.480,.500,27,41,.659,13,56,69,139,11,4,56,63,326
9862,CHI,2023,Patrick Beverley,34,22,22,605,47,119,.395,25,81,.309,22,38,.579,.500,8,15,.533,20,87,107,76,23,16,18,63,127
9863,CHI,2023,Javonte Green,29,32,1,480,61,108,.565,13,35,.371,48,73,.658,.625,30,45,.667,27,61,88,23,24,21,20,52,165
9864,CHI,2023,Dalen Terry,20,38,0,214,32,72,.444,7,27,.259,25,45,.556,.493,14,21,.667,12,25,37,22,11,5,8,24,85
9865,CHI,2023,Carlik Jones,25,7,0,56,6,15,.400,3,6,.500,3,9,.333,.500,5,8,.625,1,4,5,6,2,0,2,2,20
9866,CHI,2023,Terry Taylor,23,5,0,36,9,10,.900,1,1,1.000,8,9,.889,.950,1,4,.250,5,3,8,0,0,1,0,2,20
9867,CHI,2023,Tony Bradley,25,12,0,33,6,12,.500,3,5,.600,3,7,.429,.625,4,4,1.000,1,10,11,1,1,1,1,2,19
9868,CHI,2023,Marko Simonovic,23,7,0,20,2,7,.286,1,4,.250,1,3,.333,.357,1,2,.500,1,1,2,0,0,0,0,5,6
9869,CHI,2023,Malcolm Hill,27,5,0,9,2,4,.500,1,3,.333,1,1,1.000,.625,0,0,,0,3,3,0,0,0,0,1,5
9870,CHI,2022,DeMar DeRozan,32,76,76,2743,774,1535,.504,50,142,.352,724,1393,.520,.521,520,593,.877,56,336,392,374,68,24,181,178,2118
9871,CHI,2022,Nikola Vučević,31,73,73,2418,546,1154,.473,104,331,.314,442,823,.537,.518,92,121,.760,142,662,804,236,70,71,136,181,1288
9872,CHI,2022,Zach LaVine,26,67,67,2328,565,1186,.476,185,475,.389,380,711,.534,.554,320,375,.853,22,286,308,303,41,23,171,120,1635
9873,CHI,2022,Ayo Dosunmu,22,77,40,2110,278,535,.520,70,186,.376,208,349,.596,.585,53,78,.679,27,187,214,256,60,29,108,182,679
9874,CHI,2022,Coby White,21,61,17,1675,279,644,.433,136,353,.385,143,291,.491,.539,78,91,.857,17,165,182,176,29,11,70,137,772
9875,CHI,2022,Javonte Green,28,65,45,1519,176,325,.542,36,101,.356,140,224,.625,.597,80,96,.833,91,185,276,60,67,32,30,132,468
9876,CHI,2022,Lonzo Ball,24,35,35,1212,162,383,.423,110,260,.423,52,123,.423,.567,21,28,.750,35,155,190,178,64,31,82,85,455
9877,CHI,2022,Alex Caruso,27,41,18,1147,102,256,.398,42,126,.333,60,130,.462,.480,58,73,.795,33,115,148,165,71,15,57,106,304
9878,CHI,2022,Troy Brown Jr.,22,66,7,1055,108,258,.419,47,133,.353,61,125,.488,.510,20,26,.769,39,164,203,66,36,5,26,62,283
9879,CHI,2022,Derrick Jones Jr.,24,51,8,899,105,195,.538,20,61,.328,85,134,.634,.590,56,70,.800,60,109,169,30,25,33,30,105,286
9880,CHI,2022,Tony Bradley,24,55,7,549,72,123,.585,0,0,,72,123,.585,.585,19,29,.655,67,119,186,27,10,33,34,62,163
9881,CHI,2022,Matt Thomas,27,40,0,459,55,134,.410,35,91,.385,20,43,.465,.541,16,20,.800,3,47,50,20,8,3,8,18,161
9882,CHI,2022,Patrick Williams,20,17,9,422,54,102,.529,15,29,.517,39,73,.534,.603,30,41,.732,17,52,69,15,9,9,16,28,153
9883,CHI,2022,Tristan Thompson,30,23,3,376,52,92,.565,0,2,.000,52,90,.578,.565,26,48,.542,41,68,109,14,12,7,12,39,130
9884,CHI,2022,Alfonzo McKinnie,29,17,3,206,24,61,.393,9,27,.333,15,34,.441,.467,2,8,.250,13,20,33,5,2,3,7,26,59
9885,CHI,2022,Tyler Cook,24,20,2,200,23,38,.605,0,0,,23,38,.605,.605,21,32,.656,16,37,53,3,4,4,7,28,67
9886,CHI,2022,Malcolm Hill,26,16,0,166,19,44,.432,10,31,.323,9,13,.692,.545,7,10,.700,9,20,29,7,3,2,3,17,55
9887,CHI,2022,Alize Johnson,25,16,0,121,12,23,.522,0,2,.000,12,21,.571,.522,4,7,.571,16,20,36,8,3,0,8,15,28
9888,CHI,2022,Devon Dotson,22,11,0,85,11,23,.478,2,9,.222,9,14,.643,.522,5,9,.556,1,8,9,15,1,0,5,11,29
9889,CHI,2022,Marko Simonovic,22,9,0,35,4,15,.267,1,5,.200,3,10,.300,.300,8,11,.727,5,5,10,0,1,1,2,6,17
9890,CHI,2022,Mac McClung,23,1,0,3,1,1,1.000,0,0,,1,1,1.000,1.000,0,0,,0,0,0,0,0,0,1,0,2
9891,CHI,2022,Jordan Bell,27,1,0,2,0,0,,0,0,,0,0,,,0,0,,1,0,1,0,1,0,0,2,0
9892,CHI,2021,Coby White,20,69,54,2156,375,902,.416,163,454,.359,212,448,.473,.506,128,142,.901,28,256,284,328,38,15,156,179,1041
9893,CHI,2021,Zach LaVine,25,58,58,2034,569,1123,.507,200,477,.419,369,646,.571,.596,253,298,.849,36,253,289,282,46,27,203,138,1591
9894,CHI,2021,Patrick Williams,19,71,71,1983,255,528,.483,54,138,.391,201,390,.515,.534,91,125,.728,66,261,327,99,64,46,98,126,655
9895,CHI,2021,Thaddeus Young,32,68,23,1652,370,662,.559,12,45,.267,358,617,.580,.568,71,113,.628,168,255,423,291,74,40,137,152,823
9896,CHI,2021,Garrett Temple,34,56,25,1528,158,381,.415,67,200,.335,91,181,.503,.503,40,50,.800,29,131,160,124,43,30,58,126,423
9897,CHI,2021,Lauri Markkanen,23,51,26,1317,250,521,.480,119,296,.402,131,225,.582,.594,76,92,.826,35,233,268,45,26,15,52,75,695
9898,CHI,2021,Tomáš Satoranský,29,58,18,1307,169,329,.514,42,118,.356,127,211,.602,.578,67,79,.848,30,112,142,271,40,14,96,89,447
9899,CHI,2021,Denzel Valentine,27,62,3,1036,155,416,.373,80,242,.331,75,174,.431,.469,16,17,.941,24,173,197,105,30,7,42,70,406
9900,CHI,2021,Nikola Vučević,30,26,26,848,230,488,.471,59,152,.388,171,336,.509,.532,40,46,.870,59,241,300,102,23,20,43,58,559
9901,CHI,2021,Wendell Carter Jr.,21,32,25,792,129,252,.512,8,22,.364,121,230,.526,.528,82,111,.739,70,180,250,69,18,24,49,96,348
9902,CHI,2021,Daniel Theis,28,23,14,574,93,178,.522,16,57,.281,77,121,.636,.567,28,43,.651,39,97,136,41,16,14,25,47,230
9903,CHI,2021,Otto Porter Jr.,27,25,6,540,89,202,.441,38,95,.400,51,107,.477,.535,31,37,.838,28,110,138,50,12,4,25,37,247
9904,CHI,2021,Ryan Arcidiacono,26,44,0,450,49,117,.419,25,67,.373,24,50,.480,.526,13,20,.650,5,62,67,56,9,0,10,47,136
9905,CHI,2021,Daniel Gafford,22,31,11,383,60,87,.690,0,0,,60,87,.690,.690,27,41,.659,44,59,103,17,11,34,22,54,147
9906,CHI,2021,Troy Brown Jr.,21,13,0,237,29,55,.527,8,24,.333,21,31,.677,.600,5,6,.833,9,35,44,10,7,2,5,20,71
9907,CHI,2021,Javonte Green,27,16,0,128,14,31,.452,3,8,.375,11,23,.478,.500,10,10,1.000,6,13,19,6,10,4,6,13,41
9908,CHI,2021,Luke Kornet,25,13,0,94,9,27,.333,6,23,.261,3,4,.750,.444,2,4,.500,1,14,15,4,2,7,1,1,26
9909,CHI,2021,Cristiano Felício,28,18,0,84,7,13,.538,0,2,.000,7,11,.636,.538,9,16,.563,10,16,26,9,4,0,4,10,23
9910,CHI,2021,Al-Farouq Aminu,30,6,0,67,2,10,.200,1,6,.167,1,4,.250,.250,4,5,.800,2,17,19,2,2,0,3,7,9
9911,CHI,2021,Chandler Hutchison,24,7,0,64,5,18,.278,1,3,.333,4,15,.267,.306,2,2,1.000,1,19,20,4,1,0,5,9,13
9912,CHI,2021,Adam Mokoka,22,14,0,56,7,19,.368,1,10,.100,6,9,.667,.395,0,1,.000,1,4,5,5,2,1,5,5,15
9913,CHI,2021,Devon Dotson,21,11,0,50,11,21,.524,1,7,.143,10,14,.714,.548,0,0,,2,3,5,7,4,0,0,3,23
9914,CHI,2020,Zach LaVine,24,60,60,2085,539,1199,.450,184,484,.380,355,715,.497,.526,268,334,.802,41,248,289,254,88,28,206,131,1530
9915,CHI,2020,Tomáš Satoranský,28,65,64,1878,237,551,.430,64,199,.322,173,352,.491,.488,106,121,.876,76,178,254,354,80,7,130,135,644
9916,CHI,2020,Coby White,19,65,1,1674,312,792,.394,133,376,.354,179,416,.430,.478,102,129,.791,28,202,230,175,49,6,109,117,859
9917,CHI,2020,Thaddeus Young,31,64,16,1591,269,601,.448,79,222,.356,190,379,.501,.513,42,72,.583,94,221,315,117,92,23,102,134,659
9918,CHI,2020,Lauri Markkanen,22,50,50,1492,251,591,.425,109,317,.344,142,274,.518,.517,126,153,.824,60,253,313,74,42,23,81,96,737
9919,CHI,2020,Kris Dunn,25,51,32,1269,152,342,.444,29,112,.259,123,230,.535,.487,40,54,.741,23,163,186,173,101,17,68,158,373
9920,CHI,2020,Wendell Carter Jr.,20,43,43,1256,183,343,.534,6,29,.207,177,314,.564,.542,112,152,.737,139,266,405,51,33,36,72,162,484
9921,CHI,2020,Ryan Arcidiacono,25,58,4,930,90,220,.409,54,138,.391,36,82,.439,.532,27,38,.711,20,90,110,96,27,3,37,96,261
9922,CHI,2020,Daniel Gafford,21,43,7,609,94,134,.701,0,0,,94,134,.701,.701,32,60,.533,52,54,106,21,13,56,29,98,220
9923,CHI,2020,Luke Kornet,24,36,14,559,82,187,.439,31,108,.287,51,79,.646,.521,20,28,.714,22,62,84,32,11,26,14,54,215
9924,CHI,2020,Chandler Hutchison,23,28,10,527,80,175,.457,12,38,.316,68,137,.496,.491,46,78,.590,18,90,108,26,27,7,27,47,218
9925,CHI,2020,Denzel Valentine,26,36,5,488,97,237,.409,46,137,.336,51,100,.510,.506,6,8,.750,9,65,74,43,26,6,26,51,246
9926,CHI,2020,Shaquille Harrison,26,43,10,484,77,165,.467,16,42,.381,61,123,.496,.515,39,50,.780,22,64,86,49,34,19,19,55,209
9927,CHI,2020,Cristiano Felício,27,22,0,386,34,54,.630,0,2,.000,34,52,.654,.630,18,23,.783,55,47,102,16,10,2,18,34,86
9928,CHI,2020,Otto Porter Jr.,26,14,9,331,62,140,.443,24,62,.387,38,78,.487,.529,19,27,.704,13,35,48,25,15,6,11,31,167
9929,CHI,2020,Adam Mokoka,21,11,0,112,12,28,.429,6,15,.400,6,13,.462,.536,2,4,.500,7,3,10,4,4,0,2,17,32
9930,CHI,2020,Max Strus,23,2,0,6,2,3,.667,0,1,.000,2,2,1.000,.667,1,1,1.000,1,0,1,0,0,0,0,1,5
9931,CHI,2019,Zach LaVine,23,63,62,2171,530,1135,.467,120,321,.374,410,814,.504,.520,312,375,.832,40,254,294,283,60,26,215,140,1492
9932,CHI,2019,Ryan Arcidiacono,24,81,32,1961,187,418,.447,81,217,.373,106,201,.527,.544,89,102,.873,27,192,219,269,65,4,63,171,544
9933,CHI,2019,Lauri Markkanen,21,52,51,1682,342,795,.430,120,332,.361,222,463,.479,.506,170,195,.872,74,396,470,75,37,33,85,122,974
9934,CHI,2019,Robin Lopez,30,74,36,1606,304,535,.568,7,31,.226,297,504,.589,.575,89,123,.724,140,146,286,89,11,78,96,124,704
9935,CHI,2019,Shaquille Harrison,25,73,11,1430,184,426,.432,24,89,.270,160,337,.475,.460,82,123,.667,33,189,222,139,89,30,60,124,474
9936,CHI,2019,Kris Dunn,24,46,44,1389,215,506,.425,34,96,.354,181,410,.441,.458,55,69,.797,19,168,187,277,68,21,104,166,519
9937,CHI,2019,Justin Holiday,29,38,38,1325,151,394,.383,97,270,.359,54,124,.435,.506,41,46,.891,19,150,169,85,67,21,47,79,440
9938,CHI,2019,Wendell Carter Jr.,19,44,44,1110,180,371,.485,6,32,.188,174,339,.513,.493,89,112,.795,87,220,307,78,26,58,65,152,455
9939,CHI,2019,Jabari Parker,23,39,17,1042,220,464,.474,37,114,.325,183,350,.523,.514,79,108,.731,41,200,241,84,23,14,84,87,556
9940,CHI,2019,Wayne Selden,24,43,13,984,131,322,.407,35,111,.315,96,211,.455,.461,45,63,.714,21,115,136,73,23,7,56,83,342
9941,CHI,2019,Chandler Hutchison,22,44,14,895,96,209,.459,14,50,.280,82,159,.516,.493,23,38,.605,31,154,185,34,23,6,25,59,229
9942,CHI,2019,Antonio Blakeney,22,57,3,829,166,396,.419,36,91,.396,130,305,.426,.465,50,76,.658,7,99,106,42,12,9,35,41,418
9943,CHI,2019,Cristiano Felício,26,60,0,746,95,179,.531,0,4,.000,95,175,.543,.531,50,73,.685,79,139,218,37,11,7,33,69,240
9944,CHI,2019,Timothé Luwawu-Cabarrot,23,29,6,546,69,175,.394,31,94,.330,38,81,.469,.483,27,35,.771,7,72,79,22,15,7,16,59,196
9945,CHI,2019,Cameron Payne,24,31,12,536,69,168,.411,16,59,.271,53,109,.486,.458,22,25,.880,10,43,53,83,20,6,34,49,176
9946,CHI,2019,Bobby Portis,23,22,6,531,122,271,.450,27,72,.375,95,199,.477,.500,39,50,.780,46,115,161,29,11,8,29,61,310
9947,CHI,2019,Otto Porter Jr.,25,15,15,492,97,201,.483,39,80,.488,58,121,.479,.580,29,32,.906,14,69,83,40,18,9,25,29,262
9948,CHI,2019,Brandon Sampson,21,14,2,214,28,60,.467,11,29,.379,17,31,.548,.558,4,6,.667,3,13,16,10,8,3,12,19,71
9949,CHI,2019,Walt Lemon Jr.,26,6,3,167,38,87,.437,2,5,.400,36,82,.439,.448,8,11,.727,4,23,27,30,11,1,10,14,86
9950,CHI,2019,JaKarr Sampson,25,4,0,127,29,54,.537,5,14,.357,24,40,.600,.583,17,21,.810,5,27,32,4,4,3,4,8,80
9951,CHI,2019,Rawle Alkins,21,10,1,120,13,39,.333,3,12,.250,10,27,.370,.372,8,12,.667,11,15,26,13,1,0,8,7,37
9952,CHI,2019,Tyler Ulis,23,1,0,1,0,0,,0,0,,0,0,,,0,0,,0,0,0,0,0,0,0,0,0
9953,CHI,2018,Justin Holiday,28,72,72,2265,290,782,.371,161,449,.359,129,333,.387,.474,135,164,.823,31,260,291,153,80,31,93,134,876
9954,CHI,2018,Denzel Valentine,24,77,37,2095,301,721,.417,143,370,.386,158,351,.450,.517,38,51,.745,48,345,393,244,65,11,99,185,783
9955,CHI,2018,Lauri Markkanen,20,68,68,2020,374,862,.434,145,401,.362,229,461,.497,.518,140,166,.843,79,429,508,79,39,40,83,103,1033
9956,CHI,2018,Robin Lopez,29,64,64,1690,342,645,.530,4,14,.286,338,631,.536,.533,68,90,.756,134,156,290,124,14,53,107,109,756
9957,CHI,2018,Jerian Grant,25,74,26,1686,209,503,.416,61,187,.326,148,316,.468,.476,140,188,.745,31,141,172,342,63,8,89,132,619
9958,CHI,2018,David Nwaba,25,70,21,1646,202,423,.478,18,52,.346,184,371,.496,.499,133,203,.655,89,237,326,104,59,29,77,158,555
9959,CHI,2018,Bobby Portis,22,73,4,1643,382,811,.471,80,223,.359,302,588,.514,.520,120,156,.769,159,339,498,123,50,23,103,130,964
9960,CHI,2018,Kris Dunn,23,52,43,1525,286,666,.429,43,134,.321,243,532,.457,.462,84,114,.737,24,197,221,310,104,27,150,174,699
9961,CHI,2018,Cristiano Felício,25,55,16,977,127,215,.591,0,2,.000,127,213,.596,.591,54,81,.667,83,150,233,55,16,11,54,104,308
9962,CHI,2018,Paul Zipser,23,54,12,824,81,234,.346,37,110,.336,44,124,.355,.425,19,25,.760,13,118,131,46,20,15,43,86,218
9963,CHI,2018,Zach LaVine,22,24,24,656,136,355,.383,42,123,.341,94,232,.405,.442,87,107,.813,9,85,94,72,24,4,43,55,401
9964,CHI,2018,Nikola Mirotić,26,25,3,622,143,302,.474,69,161,.429,74,141,.525,.588,65,79,.823,18,141,159,39,15,13,31,45,420
9965,CHI,2018,Cameron Payne,23,25,14,582,87,215,.405,35,91,.385,52,124,.419,.486,12,16,.750,18,51,69,113,26,9,36,44,221
9966,CHI,2018,Noah Vonleh,22,21,4,399,57,138,.413,18,60,.300,39,78,.500,.478,13,27,.481,35,109,144,21,13,6,16,26,145
9967,CHI,2018,Antonio Blakeney,21,19,0,314,53,143,.371,15,52,.288,38,91,.418,.423,30,39,.769,4,29,33,20,7,1,11,19,151
9968,CHI,2018,Ryan Arcidiacono,23,24,0,304,17,41,.415,9,31,.290,8,10,.800,.524,5,6,.833,1,24,25,35,13,0,13,18,48
9969,CHI,2018,Sean Kilpatrick,28,9,1,214,47,107,.439,19,48,.396,28,59,.475,.528,26,32,.813,3,22,25,13,6,3,12,8,139
9970,CHI,2018,Quincy Pondexter,29,23,1,196,14,49,.286,3,22,.136,11,27,.407,.316,14,17,.824,8,19,27,9,8,2,11,24,45
9971,CHI,2018,Kay Felder,22,14,0,134,20,66,.303,4,18,.222,16,48,.333,.333,11,12,.917,1,13,14,20,3,1,15,11,55
9972,CHI,2018,Ömer Aşık,31,4,0,61,2,6,.333,0,0,,2,6,.333,.333,0,1,.000,2,8,10,1,1,2,4,6,4
9973,CHI,2018,Jarell Eddie,26,1,0,3,0,1,.000,0,1,.000,0,0,,.000,0,0,,0,0,0,0,0,0,0,0,0
9974,CHI,2017,Jimmy Butler,27,76,75,2809,570,1252,.455,91,248,.367,479,1004,.477,.492,585,676,.865,129,341,470,417,143,32,159,112,1816
9975,CHI,2017,Robin Lopez,28,81,81,2271,382,775,.493,0,2,.000,382,773,.494,.493,75,104,.721,244,276,520,80,18,117,91,151,839
9976,CHI,2017,Rajon Rondo,30,69,42,1843,229,561,.408,50,133,.376,179,428,.418,.453,30,50,.600,73,282,355,461,99,11,169,144,538
9977,CHI,2017,Dwyane Wade,35,60,59,1792,414,955,.434,45,145,.310,369,810,.456,.457,223,281,.794,63,207,270,228,86,41,138,112,1096
9978,CHI,2017,Nikola Mirotić,25,70,15,1679,258,625,.413,129,377,.342,129,248,.520,.516,99,128,.773,61,323,384,75,53,55,80,128,744
9979,CHI,2017,Taj Gibson,31,55,55,1502,276,530,.521,2,12,.167,274,518,.529,.523,85,119,.714,120,262,382,60,27,50,77,123,639
9980,CHI,2017,Doug McDermott,25,44,4,1078,166,373,.445,56,150,.373,110,223,.493,.520,59,67,.881,14,116,130,45,11,4,32,57,447
9981,CHI,2017,Cristiano Felício,24,66,0,1040,128,221,.579,0,0,,128,221,.579,.579,60,93,.645,124,187,311,40,25,17,33,110,316
9982,CHI,2017,Jerian Grant,24,63,28,1028,128,301,.425,49,134,.366,79,167,.473,.507,65,73,.890,17,94,111,121,47,8,44,93,370
9983,CHI,2017,Bobby Portis,21,64,13,1000,183,375,.488,32,96,.333,151,279,.541,.531,39,59,.661,75,221,296,35,16,11,37,94,437
9984,CHI,2017,Denzel Valentine,23,57,0,976,102,288,.354,73,208,.351,29,80,.363,.481,14,18,.778,11,140,151,63,30,7,49,86,291
9985,CHI,2017,Michael Carter-Williams,25,45,19,846,112,306,.366,15,64,.234,97,242,.401,.391,58,77,.753,24,129,153,113,38,23,66,102,297
9986,CHI,2017,Paul Zipser,22,44,18,843,88,221,.398,33,99,.333,55,122,.451,.473,31,40,.775,15,110,125,36,15,16,40,78,240
9987,CHI,2017,Isaiah Canaan,25,39,0,592,63,173,.364,25,94,.266,38,79,.481,.436,30,33,.909,6,44,50,37,22,1,21,35,181
9988,CHI,2017,Joffrey Lauvergne,25,20,1,241,37,92,.402,6,20,.300,31,72,.431,.435,9,15,.600,21,47,68,19,7,0,16,12,89
9989,CHI,2017,Cameron Payne,22,11,0,142,21,63,.333,11,34,.324,10,29,.345,.421,1,4,.250,1,16,17,15,4,0,13,14,54
9990,CHI,2017,Anthony Morrow,31,9,0,87,12,29,.414,6,14,.429,6,15,.400,.517,11,11,1.000,1,1,2,6,2,0,0,4,41
9991,CHI,2017,R.J. Hunter,23,3,0,9,0,1,.000,0,1,.000,0,0,,.000,0,0,,0,1,1,0,0,0,0,0,0
9992,CHI,2016,Jimmy Butler,26,67,67,2474,470,1035,.454,64,205,.312,406,830,.489,.485,395,475,.832,79,279,358,321,110,43,132,124,1399
9993,CHI,2016,Pau Gasol,35,72,72,2291,467,995,.469,24,69,.348,443,926,.478,.481,229,289,.792,155,638,793,294,42,146,164,148,1187
9994,CHI,2016,Derrick Rose,27,66,66,2097,447,1048,.427,44,150,.293,403,898,.449,.448,142,179,.793,46,179,225,311,44,14,175,84,1080
9995,CHI,2016,Taj Gibson,30,73,55,1936,263,500,.526,0,3,.000,263,497,.529,.526,101,146,.692,206,298,504,106,47,77,78,180,627
9996,CHI,2016,Doug McDermott,24,81,4,1861,291,644,.452,110,259,.425,181,385,.470,.537,72,84,.857,37,158,195,59,14,6,53,127,764
9997,CHI,2016,Nikola Mirotić,24,66,38,1646,248,609,.407,135,346,.390,113,263,.430,.518,146,181,.807,58,304,362,100,58,46,102,151,777
9998,CHI,2016,Tony Snell,24,64,33,1301,126,339,.372,56,155,.361,70,184,.380,.454,30,33,.909,19,180,199,63,16,17,52,100,338
9999,CHI,2016,E'Twaun Moore,26,59,22,1263,187,389,.481,47,104,.452,140,285,.491,.541,22,35,.629,19,114,133,99,37,18,53,103,443
10000,CHI,2016,Aaron Brooks,31,69,0,1108,188,469,.401,66,185,.357,122,284,.430,.471,49,64,.766,21,80,101,180,30,10,82,132,491
10001,CHI,2016,Bobby Portis,20,62,4,1102,186,436,.427,16,52,.308,170,384,.443,.445,48,66,.727,123,214,337,52,25,22,54,100,436
10002,CHI,2016,Mike Dunleavy,35,31,30,703,77,188,.410,39,99,.394,38,89,.427,.513,29,37,.784,8,75,83,39,14,10,26,66,222
10003,CHI,2016,Joakim Noah,30,29,2,635,51,133,.383,0,1,.000,51,132,.386,.383,22,45,.489,87,168,255,110,18,29,52,77,124
10004,CHI,2016,Kirk Hinrich,35,35,7,555,47,118,.398,23,56,.411,24,62,.387,.496,15,16,.938,7,51,58,59,13,1,27,63,132
10005,CHI,2016,Justin Holiday,26,27,4,510,64,155,.413,26,60,.433,38,95,.400,.497,22,27,.815,8,55,63,45,19,15,26,40,176
10006,CHI,2016,Cristiano Felício,23,31,4,321,40,72,.556,0,4,.000,40,68,.588,.556,25,35,.714,30,72,102,26,6,13,13,31,105
10007,CHI,2016,Cameron Bairstow,25,18,2,103,13,40,.325,1,5,.200,12,35,.343,.338,7,8,.875,4,24,28,6,2,3,4,19,34
10008,CHI,2015,Pau Gasol,34,78,78,2681,570,1153,.494,12,26,.462,558,1127,.495,.500,294,366,.803,220,699,919,210,25,147,158,147,1446
10009,CHI,2015,Jimmy Butler,25,65,65,2513,421,912,.462,73,193,.378,348,719,.484,.502,386,463,.834,114,265,379,212,114,36,93,108,1301
10010,CHI,2015,Joakim Noah,29,67,67,2049,190,427,.445,0,2,.000,190,425,.447,.445,105,174,.603,219,427,646,312,48,74,123,203,485
10011,CHI,2015,Aaron Brooks,30,82,21,1885,344,817,.421,121,313,.387,223,504,.442,.495,145,174,.833,32,134,166,261,54,15,157,189,954
10012,CHI,2015,Mike Dunleavy,34,63,63,1838,209,481,.435,107,263,.407,102,218,.468,.546,70,87,.805,28,220,248,114,39,21,60,123,595
10013,CHI,2015,Taj Gibson,29,62,17,1692,254,506,.502,0,0,,254,506,.502,.502,132,184,.717,162,234,396,71,36,75,77,162,640
10014,CHI,2015,Nikola Mirotić,23,82,3,1654,253,624,.405,99,313,.316,154,311,.495,.485,228,284,.803,63,341,404,97,54,54,89,172,833
10015,CHI,2015,Kirk Hinrich,34,66,22,1610,142,381,.373,58,168,.345,84,213,.394,.449,35,50,.700,20,101,121,148,46,14,73,144,377
10016,CHI,2015,Derrick Rose,26,51,51,1530,338,835,.405,76,271,.280,262,564,.465,.450,152,187,.813,35,126,161,251,36,16,161,63,904
10017,CHI,2015,Tony Snell,23,72,22,1412,159,371,.429,73,197,.371,86,174,.494,.527,44,55,.800,31,145,176,62,32,11,48,86,435
10018,CHI,2015,E'Twaun Moore,25,56,0,504,62,139,.446,13,38,.342,49,101,.485,.493,12,20,.600,12,34,46,33,20,6,14,45,149
10019,CHI,2015,Doug McDermott,23,36,0,321,43,107,.402,13,41,.317,30,66,.455,.463,10,15,.667,6,37,43,6,4,1,17,29,109
10020,CHI,2015,Nazr Mohammed,37,23,0,128,13,30,.433,0,0,,13,30,.433,.433,1,3,.333,11,27,38,3,4,5,7,16,27
10021,CHI,2015,Cameron Bairstow,24,18,1,64,3,14,.214,0,0,,3,14,.214,.214,4,5,.800,6,2,8,1,2,1,3,8,10
10022,CHI,2014,Joakim Noah,28,80,80,2820,380,800,.475,0,2,.000,380,798,.476,.475,247,335,.737,282,618,900,431,99,121,194,245,1007
10023,CHI,2014,Jimmy Butler,24,67,67,2591,275,693,.397,68,240,.283,207,453,.457,.446,260,338,.769,87,243,330,175,127,36,102,106,878
10024,CHI,2014,Mike Dunleavy,33,82,61,2584,333,774,.430,123,324,.380,210,450,.467,.510,140,164,.854,46,299,345,186,64,46,108,163,929
10025,CHI,2014,Taj Gibson,28,82,8,2351,429,896,.479,0,7,.000,429,889,.483,.479,211,281,.751,200,358,558,91,41,112,150,207,1069
10026,CHI,2014,Carlos Boozer,32,76,76,2141,447,980,.456,0,2,.000,447,978,.457,.456,148,193,.767,137,495,632,118,53,22,154,216,1042
10027,CHI,2014,Kirk Hinrich,33,73,61,2116,243,619,.393,85,242,.351,158,377,.419,.461,95,125,.760,31,161,192,286,80,26,120,203,666
10028,CHI,2014,D.J. Augustin,26,61,9,1857,291,694,.419,132,321,.411,159,373,.426,.514,195,221,.882,15,111,126,303,52,3,116,140,909
10029,CHI,2014,Tony Snell,22,77,12,1231,129,336,.384,57,178,.320,72,158,.456,.469,31,41,.756,19,105,124,68,29,15,44,84,346
10030,CHI,2014,Luol Deng,28,23,23,860,160,354,.452,17,62,.274,143,292,.490,.476,101,124,.815,40,118,158,85,24,4,59,53,438
10031,CHI,2014,Nazr Mohammed,36,80,1,562,54,126,.429,0,0,,54,126,.429,.429,16,30,.533,66,109,175,20,14,30,37,77,124
10032,CHI,2014,Derrick Rose,25,10,10,311,58,164,.354,16,47,.340,42,117,.359,.402,27,32,.844,9,23,32,43,5,1,34,15,159
10033,CHI,2014,Marquis Teague,20,19,2,242,16,66,.242,2,10,.200,14,56,.250,.258,11,16,.688,1,18,19,28,2,4,17,25,45
10034,CHI,2014,Mike James,38,11,0,77,5,21,.238,1,5,.200,4,16,.250,.262,0,2,.000,0,7,7,17,2,0,5,11,11
10035,CHI,2014,Erik Murphy,23,24,0,62,3,13,.231,0,3,.000,3,10,.300,.231,0,0,,2,6,8,2,0,4,2,7,6
10036,CHI,2014,Jimmer Fredette,24,8,0,56,13,29,.448,4,11,.364,9,18,.500,.517,2,2,1.000,1,6,7,3,0,0,4,7,32
10037,CHI,2014,Cartier Martin,29,6,0,48,5,8,.625,3,5,.600,2,3,.667,.813,2,4,.500,1,4,5,2,1,0,1,3,15
10038,CHI,2014,Tornike Shengelia,22,9,0,17,2,4,.500,0,0,,2,4,.500,.500,0,0,,0,2,2,2,1,0,1,2,4
10039,CHI,2014,Ronnie Brewer,28,1,0,2,0,0,,0,0,,0,0,,,0,0,,0,0,0,0,0,0,0,0,0
10040,CHI,2014,Jarvis Varnado,25,1,0,2,0,0,,0,0,,0,0,,,0,0,,0,0,0,0,0,0,0,1,0
10041,CHI,2014,Lou Amundson,31,1,0,1,0,0,,0,0,,0,0,,,0,0,,0,0,0,0,0,0,0,0,0
10042,CHI,2013,Luol Deng,27,75,75,2903,466,1093,.426,75,233,.322,391,860,.455,.461,230,282,.816,162,314,476,222,81,32,144,105,1237
10043,CHI,2013,Carlos Boozer,31,79,79,2546,544,1140,.477,0,2,.000,544,1138,.478,.477,193,264,.731,175,596,771,179,66,28,176,239,1281
10044,CHI,2013,Joakim Noah,27,66,64,2426,303,630,.481,0,5,.000,303,625,.485,.481,178,237,.751,260,473,733,262,78,141,176,185,784
10045,CHI,2013,Jimmy Butler,23,82,20,2134,239,512,.467,40,105,.381,199,407,.489,.506,187,233,.803,136,192,328,115,78,31,62,97,705
10046,CHI,2013,Nate Robinson,28,82,23,2086,399,921,.433,141,348,.405,258,573,.450,.510,135,169,.799,29,155,184,358,85,10,144,207,1074
10047,CHI,2013,Marco Belinelli,26,73,27,1882,241,610,.395,79,221,.357,162,389,.416,.460,141,168,.839,13,127,140,148,44,6,82,140,702
10048,CHI,2013,Kirk Hinrich,32,60,60,1764,159,422,.377,71,182,.390,88,240,.367,.461,70,98,.714,16,142,158,314,63,25,99,192,459
10049,CHI,2013,Taj Gibson,27,65,5,1459,214,441,.485,0,4,.000,214,437,.490,.485,89,131,.679,125,220,345,61,27,90,76,166,517
10050,CHI,2013,Richard Hamilton,34,50,45,1088,204,475,.429,16,52,.308,188,423,.444,.446,66,77,.857,16,67,83,119,24,5,84,93,490
10051,CHI,2013,Nazr Mohammed,35,63,12,693,66,180,.367,0,2,.000,66,178,.371,.367,34,47,.723,73,122,195,26,21,32,24,97,166
10052,CHI,2013,Marquis Teague,19,48,0,392,43,113,.381,4,23,.174,39,90,.433,.398,9,16,.563,3,41,44,63,9,7,35,47,99
10053,CHI,2013,Daequan Cook,25,33,0,276,30,108,.278,15,61,.246,15,47,.319,.347,7,9,.778,2,41,43,9,2,5,9,13,82
10054,CHI,2013,Vladimir Radmanović,32,25,0,144,13,43,.302,5,27,.185,8,16,.500,.360,2,3,.667,10,18,28,8,8,4,7,29,33
10055,CHI,2013,Malcolm Thomas,24,7,0,36,5,9,.556,0,0,,5,9,.556,.556,2,4,.500,5,6,11,2,2,1,2,7,12
10056,CHI,2013,Lou Amundson,30,1,0,2,0,1,.000,0,0,,0,1,.000,.000,0,0,,1,0,1,0,0,0,0,0,0
10057,CHI,2012,Luol Deng,26,54,54,2129,311,755,.412,79,215,.367,232,540,.430,.464,127,165,.770,77,273,350,157,56,36,96,81,828
10058,CHI,2012,Carlos Boozer,30,66,66,1948,448,842,.532,0,1,.000,448,841,.533,.532,95,137,.693,114,450,564,125,63,24,115,168,991
10059,CHI,2012,Joakim Noah,26,64,64,1945,249,490,.508,0,1,.000,249,489,.509,.508,154,206,.748,242,387,629,160,41,92,92,162,652
10060,CHI,2012,Ronnie Brewer,26,66,43,1635,190,445,.427,19,69,.275,171,376,.455,.448,56,100,.560,72,159,231,137,72,21,59,64,455
10061,CHI,2012,Kyle Korver,30,65,7,1469,178,412,.432,118,271,.435,60,141,.426,.575,55,66,.833,26,133,159,112,36,15,53,110,529
10062,CHI,2012,Derrick Rose,23,39,39,1375,302,695,.435,54,173,.312,248,522,.475,.473,194,239,.812,26,105,131,307,35,28,119,52,852
10063,CHI,2012,Taj Gibson,26,63,0,1284,200,404,.495,0,0,,200,404,.495,.495,84,135,.622,135,197,332,47,27,81,60,131,484
10064,CHI,2012,C.J. Watson,27,49,25,1159,161,437,.368,68,173,.393,93,264,.352,.446,84,104,.808,21,84,105,200,45,8,97,103,474
10065,CHI,2012,Ömer Aşık,25,66,2,971,79,156,.506,0,0,,79,156,.506,.506,47,103,.456,127,223,350,32,30,68,68,121,205
10066,CHI,2012,John Lucas III,29,49,2,726,143,358,.399,55,140,.393,88,218,.404,.476,28,32,.875,22,54,76,108,19,1,42,42,369
10067,CHI,2012,Richard Hamilton,33,28,28,697,140,310,.452,17,46,.370,123,264,.466,.479,29,37,.784,20,46,66,84,12,1,49,56,326
10068,CHI,2012,Jimmy Butler,22,42,0,359,32,79,.405,2,11,.182,30,68,.441,.418,43,56,.768,23,33,56,14,11,5,14,20,109
10069,CHI,2012,Brian Scalabrine,33,28,0,122,14,30,.467,1,7,.143,13,23,.565,.483,3,6,.500,8,13,21,15,5,6,9,9,32
10070,CHI,2012,Mike James,36,11,0,120,20,49,.408,6,10,.600,14,39,.359,.469,7,8,.875,2,8,10,29,4,2,14,20,53
10071,CHI,2011,Luol Deng,25,82,82,3208,531,1155,.460,115,333,.345,416,822,.506,.510,253,336,.753,116,360,476,230,78,48,156,162,1430
10072,CHI,2011,Derrick Rose,22,81,81,3026,711,1597,.445,128,385,.332,583,1212,.481,.485,476,555,.858,81,249,330,623,85,51,278,136,2026
10073,CHI,2011,Carlos Boozer,29,59,59,1882,431,845,.510,0,0,,431,845,.510,.510,171,244,.701,130,435,565,145,45,18,149,186,1033
10074,CHI,2011,Ronnie Brewer,25,81,1,1781,205,427,.480,6,27,.222,199,400,.498,.487,87,133,.654,55,207,262,140,106,22,55,82,503
10075,CHI,2011,Taj Gibson,25,80,19,1742,234,502,.466,1,8,.125,233,494,.472,.467,100,148,.676,162,296,458,58,39,106,71,203,569
10076,CHI,2011,Kyle Korver,29,82,0,1649,242,557,.434,120,289,.415,122,268,.455,.542,77,87,.885,12,138,150,124,35,20,60,156,681
10077,CHI,2011,Joakim Noah,25,48,48,1576,211,402,.525,0,1,.000,211,401,.526,.525,139,188,.739,182,316,498,107,48,72,90,156,561
10078,CHI,2011,Keith Bogans,30,82,82,1461,124,307,.404,90,237,.380,34,70,.486,.550,21,32,.656,19,129,148,101,38,9,41,113,359
10079,CHI,2011,Kurt Thomas,38,52,37,1178,95,186,.511,1,1,1.000,94,185,.508,.513,20,32,.625,75,226,301,60,32,42,42,164,211
10080,CHI,2011,C.J. Watson,26,82,1,1091,146,394,.371,44,112,.393,102,282,.362,.426,69,93,.742,16,78,94,186,55,11,73,82,405
10081,CHI,2011,Ömer Aşık,24,82,0,989,78,141,.553,0,0,,78,141,.553,.553,73,145,.503,112,194,306,32,20,56,64,153,229
10082,CHI,2011,James Johnson,23,13,0,123,17,41,.415,2,9,.222,15,32,.469,.439,6,13,.462,6,18,24,14,8,9,18,25,42
10083,CHI,2011,Brian Scalabrine,32,18,0,88,10,19,.526,0,5,.000,10,14,.714,.526,0,0,,1,7,8,6,3,4,5,18,20
10084,CHI,2011,Rasual Butler,31,6,0,26,6,11,.545,4,7,.571,2,4,.500,.727,0,0,,0,1,1,0,0,0,2,3,16
10085,CHI,2011,John Lucas III,28,2,0,10,1,3,.333,0,1,.000,1,2,.500,.333,0,2,.000,0,0,0,1,0,0,0,0,2
10086,CHI,2010,Derrick Rose,21,78,78,2871,672,1373,.489,16,60,.267,656,1313,.500,.495,259,338,.766,65,228,293,469,57,27,217,96,1619
10087,CHI,2010,Luol Deng,24,70,69,2651,473,1014,.466,32,83,.386,441,931,.474,.482,252,330,.764,131,381,512,143,66,61,134,129,1230
10088,CHI,2010,Kirk Hinrich,29,74,53,2481,308,753,.409,104,280,.371,204,473,.431,.478,85,113,.752,24,236,260,330,85,24,113,204,805
10089,CHI,2010,Taj Gibson,24,82,70,2204,311,629,.494,0,0,,311,629,.494,.494,113,175,.646,226,385,611,70,50,104,114,282,735
10090,CHI,2010,Brad Miller,33,82,37,1950,250,581,.430,37,132,.280,213,449,.474,.462,182,220,.827,83,316,399,154,44,29,107,189,719
10091,CHI,2010,Joakim Noah,24,64,54,1925,262,520,.504,0,0,,262,520,.504,.504,163,219,.744,220,484,704,132,32,100,117,198,687
10092,CHI,2010,John Salmons,30,51,28,1695,230,548,.420,73,192,.380,157,356,.441,.486,116,147,.789,18,156,174,125,65,22,70,101,649
10093,CHI,2010,Jannero Pargo,30,63,5,829,132,381,.346,38,138,.275,94,243,.387,.396,42,45,.933,9,69,78,89,29,2,50,68,344
10094,CHI,2010,James Johnson,22,65,11,757,95,210,.452,15,46,.326,80,164,.488,.488,51,70,.729,34,94,128,48,21,43,62,126,256
10095,CHI,2010,Ronald Murray,30,29,1,680,108,272,.397,28,90,.311,80,182,.440,.449,48,63,.762,13,72,85,51,18,4,26,49,292
10096,CHI,2010,Tyrus Thomas,23,29,3,678,99,205,.483,0,1,.000,99,204,.485,.483,58,90,.644,42,141,183,33,40,48,52,64,256
10097,CHI,2010,Hakim Warrick,27,28,0,533,83,172,.483,0,1,.000,83,171,.485,.483,77,102,.755,40,62,102,17,7,8,23,43,243
10098,CHI,2010,Chris Richard,25,18,0,224,15,29,.517,0,0,,15,29,.517,.517,7,11,.636,19,40,59,7,8,4,14,50,37
10099,CHI,2010,Acie Law,25,12,1,135,21,45,.467,4,12,.333,17,33,.515,.511,20,27,.741,3,11,14,16,4,0,12,8,66
10100,CHI,2010,Lindsey Hunter,39,13,0,122,5,30,.167,1,13,.077,4,17,.235,.183,2,2,1.000,1,13,14,9,1,0,4,12,13
10101,CHI,2010,Devin Brown,31,11,0,93,8,36,.222,4,17,.235,4,19,.211,.278,0,0,,2,13,15,7,3,1,5,10,20
10102,CHI,2010,Aaron Gray,25,8,0,50,8,21,.381,0,0,,8,21,.381,.381,2,7,.286,5,11,16,2,0,0,1,10,18
10103,CHI,2010,Joe Alexander,23,8,0,29,1,6,.167,0,1,.000,1,5,.200,.167,2,3,.667,2,3,5,2,1,1,0,9,4
10104,CHI,2009,Derrick Rose,20,81,80,3000,574,1208,.475,16,72,.222,558,1136,.491,.482,197,250,.788,96,221,317,512,66,18,202,125,1361
10105,CHI,2009,Ben Gordon,25,82,76,2999,598,1315,.455,173,422,.410,425,893,.476,.521,330,382,.864,52,231,283,279,71,22,200,184,1699
10106,CHI,2009,Tyrus Thomas,22,79,61,2175,308,683,.451,3,9,.333,305,674,.453,.453,238,304,.783,148,360,508,77,91,151,129,220,857
10107,CHI,2009,Joakim Noah,23,80,55,1938,207,372,.556,0,1,.000,207,371,.558,.556,123,182,.676,244,362,606,106,49,110,82,238,537
10108,CHI,2009,Luol Deng,23,49,46,1665,265,591,.448,8,20,.400,257,571,.450,.455,152,191,.796,80,215,295,94,60,25,72,85,690
10109,CHI,2009,Kirk Hinrich,28,51,4,1339,183,419,.437,69,169,.408,114,250,.456,.519,68,86,.791,16,107,123,197,66,19,87,126,503
10110,CHI,2009,Andrés Nocioni,29,53,2,1278,186,449,.414,79,209,.378,107,240,.446,.502,100,124,.806,34,188,222,60,26,16,73,176,551
10111,CHI,2009,John Salmons,29,26,21,979,165,349,.473,49,118,.415,116,231,.502,.543,97,115,.843,16,96,112,53,25,15,43,60,476
10112,CHI,2009,Drew Gooden,27,31,27,918,161,352,.457,0,3,.000,161,349,.461,.457,84,97,.866,82,184,266,43,26,14,57,103,406
10113,CHI,2009,Larry Hughes,30,30,6,792,127,308,.412,40,102,.392,87,206,.422,.477,67,82,.817,6,88,94,59,36,9,36,51,361
10114,CHI,2009,Brad Miller,32,27,0,746,108,226,.478,3,13,.231,105,213,.493,.485,99,116,.853,67,134,201,86,22,12,47,88,318
10115,CHI,2009,Thabo Sefolosha,24,43,14,735,79,182,.434,15,50,.300,64,132,.485,.475,21,25,.840,26,97,123,65,35,19,37,50,194
10116,CHI,2009,Aaron Gray,24,56,18,715,81,167,.485,0,1,.000,81,166,.488,.485,34,59,.576,84,136,220,46,14,18,40,135,196
10117,CHI,2009,Lindsey Hunter,38,28,0,266,27,82,.329,16,48,.333,11,34,.324,.427,3,5,.600,2,10,12,37,20,1,19,28,73
10118,CHI,2009,Tim Thomas,31,18,0,254,36,90,.400,19,43,.442,17,47,.362,.506,14,20,.700,8,34,42,12,6,0,10,27,105
10119,CHI,2009,Cedric Simmons,23,11,0,61,11,21,.524,0,0,,11,21,.524,.524,6,14,.429,4,8,12,2,1,4,0,6,28
10120,CHI,2009,Linton Johnson,28,8,0,42,4,11,.364,1,2,.500,3,9,.333,.409,0,0,,3,5,8,2,1,0,2,6,9
10121,CHI,2009,Anthony Roberson,25,6,0,23,5,17,.294,2,10,.200,3,7,.429,.353,0,0,,2,5,7,1,0,0,1,0,12
10122,CHI,2009,Demetris Nichols,24,2,0,5,1,4,.250,0,1,.000,1,3,.333,.250,0,0,,0,0,0,1,0,0,0,1,2
10123,CHI,2008,Kirk Hinrich,27,75,72,2380,330,797,.414,84,240,.350,246,557,.442,.467,118,142,.831,28,216,244,452,87,19,157,224,862
10124,CHI,2008,Ben Gordon,24,72,27,2291,464,1069,.434,142,346,.410,322,723,.445,.500,266,293,.908,40,181,221,213,55,8,150,171,1336
10125,CHI,2008,Luol Deng,22,63,59,2128,429,896,.479,8,22,.364,421,874,.482,.483,204,265,.770,136,258,394,155,57,29,120,117,1070
10126,CHI,2008,Andrés Nocioni,28,82,27,2021,379,877,.432,126,346,.364,253,531,.476,.504,196,243,.807,48,294,342,95,25,43,133,245,1080
10127,CHI,2008,Ben Wallace,33,50,50,1627,101,271,.373,0,4,.000,101,267,.378,.373,53,125,.424,175,266,441,92,69,80,49,86,255
10128,CHI,2008,Joakim Noah,22,74,31,1534,177,367,.482,0,1,.000,177,366,.484,.482,134,194,.691,174,242,416,84,68,64,89,173,488
10129,CHI,2008,Chris Duhon,25,66,18,1490,133,344,.387,54,155,.348,79,189,.418,.465,65,80,.813,19,97,116,263,48,2,71,92,385
10130,CHI,2008,Thabo Sefolosha,23,69,22,1436,180,421,.428,29,88,.330,151,333,.453,.462,75,104,.721,50,205,255,129,61,30,93,128,464
10131,CHI,2008,Tyrus Thomas,21,74,27,1330,186,440,.423,1,6,.167,185,434,.426,.424,129,174,.741,102,240,342,90,48,72,77,170,502
10132,CHI,2008,Joe Smith,32,50,35,1146,225,483,.466,0,1,.000,225,482,.467,.466,109,135,.807,108,157,265,47,25,31,49,113,559
10133,CHI,2008,Larry Hughes,29,28,25,810,125,323,.387,24,68,.353,101,255,.396,.424,62,80,.775,12,75,87,87,39,6,44,48,336
10134,CHI,2008,Aaron Gray,23,61,1,613,103,204,.505,0,1,.000,103,203,.507,.505,56,99,.566,70,98,168,41,21,16,57,117,262
10135,CHI,2008,Drew Gooden,26,18,14,558,100,217,.461,0,3,.000,100,214,.467,.461,52,64,.813,58,109,167,31,13,23,31,59,252
10136,CHI,2008,Adrian Griffin,33,22,2,222,24,60,.400,0,0,,24,60,.400,.400,3,7,.429,19,18,37,22,12,1,16,19,51
10137,CHI,2008,Viktor Khryapa,25,9,0,105,12,31,.387,0,1,.000,12,30,.400,.387,8,14,.571,6,14,20,8,6,0,6,11,32
10138,CHI,2008,Thomas Gardner,22,4,0,45,9,23,.391,3,12,.250,6,11,.545,.457,0,2,.000,3,1,4,1,0,0,4,4,21
10139,CHI,2008,Demetris Nichols,23,11,0,30,5,15,.333,3,10,.300,2,5,.400,.433,0,0,,0,4,4,1,0,3,2,4,13
10140,CHI,2008,Shannon Brown,22,6,0,22,3,15,.200,0,1,.000,3,14,.214,.200,3,6,.500,1,1,2,0,1,2,5,2,9
10141,CHI,2008,Cedric Simmons,22,7,0,19,2,8,.250,0,0,,2,8,.250,.250,0,2,.000,1,2,3,0,0,0,2,1,4
10142,CHI,2007,Luol Deng,21,82,82,3071,630,1218,.517,1,7,.143,629,1211,.519,.518,279,359,.777,148,431,579,204,97,48,153,167,1540
10143,CHI,2007,Kirk Hinrich,26,80,80,2839,475,1061,.448,140,337,.415,335,724,.463,.514,237,284,.835,32,242,274,500,100,23,191,274,1327
10144,CHI,2007,Ben Gordon,23,82,51,2704,609,1338,.455,155,375,.413,454,963,.471,.513,380,440,.864,35,223,258,296,64,17,249,252,1753
10145,CHI,2007,Ben Wallace,32,77,77,2697,192,424,.453,1,5,.200,191,419,.456,.454,109,267,.408,303,518,821,186,111,156,101,153,494
10146,CHI,2007,Chris Duhon,24,78,30,1906,197,483,.408,88,245,.359,109,238,.458,.499,76,101,.752,23,146,169,310,69,6,105,150,558
10147,CHI,2007,P.J. Brown,37,72,49,1456,170,418,.407,0,2,.000,170,416,.409,.407,96,122,.787,129,218,347,48,24,52,85,187,436
10148,CHI,2007,Andrés Nocioni,27,53,31,1406,273,584,.467,80,209,.383,193,375,.515,.536,123,145,.848,42,259,301,57,27,24,104,164,749
10149,CHI,2007,Tyrus Thomas,20,72,4,966,134,282,.475,0,2,.000,134,280,.479,.475,106,175,.606,89,180,269,40,46,76,94,162,374
10150,CHI,2007,Thabo Sefolosha,22,71,4,868,109,256,.426,15,42,.357,94,214,.439,.455,23,45,.511,35,118,153,60,33,11,60,100,256
10151,CHI,2007,Malik Allen,28,60,1,638,107,258,.415,0,1,.000,107,257,.416,.415,28,34,.824,42,77,119,16,17,16,21,85,242
10152,CHI,2007,Adrian Griffin,32,54,1,585,61,129,.473,0,6,.000,61,123,.496,.473,15,19,.789,40,69,109,59,32,4,38,78,137
10153,CHI,2007,Mike Sweetney,24,48,0,385,58,134,.433,0,0,,58,134,.433,.433,37,66,.561,45,75,120,28,9,11,42,79,153
10154,CHI,2007,Viktor Khryapa,24,33,0,231,27,70,.386,0,6,.000,27,64,.422,.386,19,26,.731,20,37,57,21,10,1,16,53,73
10155,CHI,2007,Andre Barrett,24,6,0,29,4,8,.500,0,0,,4,8,.500,.500,0,0,,1,4,5,7,0,0,4,4,8
10156,CHI,2006,Kirk Hinrich,25,81,81,2955,451,1078,.418,126,341,.370,325,737,.441,.477,256,314,.815,29,259,288,514,94,21,188,251,1284
10157,CHI,2006,Luol Deng,20,78,56,2604,442,954,.463,21,78,.269,421,876,.481,.474,207,276,.750,127,389,516,147,72,50,105,128,1112
10158,CHI,2006,Ben Gordon,22,80,47,2482,486,1152,.422,166,382,.435,320,770,.416,.494,211,268,.787,43,176,219,240,75,5,180,238,1349
10159,CHI,2006,Andrés Nocioni,26,82,43,2239,383,831,.461,93,238,.391,290,593,.489,.517,204,242,.843,89,411,500,117,40,52,120,252,1063
10160,CHI,2006,Chris Duhon,23,74,38,2155,215,538,.400,100,278,.360,115,260,.442,.493,117,143,.818,28,192,220,373,70,3,117,152,647
10161,CHI,2006,Tyson Chandler,23,79,50,2121,160,283,.565,0,1,.000,160,282,.567,.565,97,193,.503,265,449,714,81,41,104,123,298,417
10162,CHI,2006,Darius Songaila,27,62,7,1329,236,491,.481,2,5,.400,234,486,.481,.483,94,115,.817,76,170,246,88,35,16,85,157,568
10163,CHI,2006,Mike Sweetney,23,66,44,1222,200,444,.450,0,0,,200,444,.450,.450,133,204,.652,118,232,350,59,19,56,95,209,533
10164,CHI,2006,Othella Harrington,32,72,23,824,135,273,.495,0,0,,135,273,.495,.495,77,123,.626,54,100,154,39,7,13,61,131,347
10165,CHI,2006,Malik Allen,27,54,20,701,121,247,.490,1,1,1.000,120,246,.488,.492,23,38,.605,44,96,140,20,14,16,34,92,266
10166,CHI,2006,Jannero Pargo,26,57,0,646,109,292,.373,39,103,.379,70,189,.370,.440,17,21,.810,8,53,61,94,24,2,61,57,274
10167,CHI,2006,Eric Piatkowski,35,29,1,228,24,61,.393,9,33,.273,15,28,.536,.467,2,5,.400,4,19,23,13,6,1,11,20,59
10168,CHI,2006,Luke Schenscher,23,20,0,149,16,26,.615,0,0,,16,26,.615,.615,4,13,.308,8,21,29,7,1,3,5,21,36
10169,CHI,2006,Eddie Basden,22,19,0,141,15,37,.405,1,7,.143,14,30,.467,.419,8,10,.800,7,21,28,8,9,2,9,17,39
10170,CHI,2006,Tim Thomas,28,3,0,32,6,16,.375,1,6,.167,5,10,.500,.406,0,0,,0,4,4,2,0,1,1,1,13
10171,CHI,2006,James Thomas,25,7,0,26,3,6,.500,0,0,,3,6,.500,.500,0,0,,4,4,8,0,0,0,0,3,6
10172,CHI,2006,Randy Livingston,30,5,0,22,0,2,.000,0,0,,0,2,.000,.000,0,0,,1,3,4,1,1,0,1,6,0
10173,CHI,2006,Stephen Graham,23,3,0,20,1,5,.200,1,4,.250,0,1,.000,.300,2,2,1.000,0,3,3,1,0,0,1,3,5
10174,CHI,2006,Randy Holcomb,26,4,0,11,1,1,1.000,0,0,,1,1,1.000,1.000,0,0,,1,0,1,0,0,0,0,2,2
10175,CHI,2005,Kirk Hinrich,24,77,77,2800,445,1122,.397,145,408,.355,300,714,.420,.461,171,216,.792,32,272,304,494,122,21,176,244,1206
10176,CHI,2005,Tyson Chandler,22,80,10,2189,207,419,.494,0,2,.000,207,417,.496,.494,226,336,.673,261,514,775,65,69,141,118,268,640
10177,CHI,2005,Chris Duhon,22,82,73,2177,172,488,.352,94,265,.355,78,223,.350,.449,49,67,.731,23,190,213,398,82,3,119,205,487
10178,CHI,2005,Ben Gordon,21,82,3,2002,434,1056,.411,134,331,.405,300,725,.414,.474,233,270,.863,55,160,215,164,53,10,186,224,1235
10179,CHI,2005,Andrés Nocioni,25,81,38,1892,241,601,.401,25,97,.258,216,504,.429,.422,170,222,.766,69,317,386,122,37,34,135,208,677
10180,CHI,2005,Antonio Davis,36,72,62,1843,193,419,.461,0,0,,193,419,.461,.461,115,152,.757,152,276,428,80,27,41,96,147,501
10181,CHI,2005,Eddy Curry,22,63,60,1808,393,730,.538,0,0,,393,730,.538,.538,226,314,.720,116,222,338,37,21,58,163,202,1012
10182,CHI,2005,Luol Deng,19,61,45,1663,280,645,.434,31,117,.265,249,528,.472,.458,120,162,.741,92,230,322,135,48,27,118,98,711
10183,CHI,2005,Othella Harrington,31,70,28,1271,217,424,.512,0,0,,217,424,.512,.512,127,177,.718,106,186,292,56,24,18,84,188,561
10184,CHI,2005,Eric Piatkowski,34,68,11,841,111,258,.430,57,134,.425,54,124,.435,.541,45,56,.804,15,64,79,51,29,1,37,67,324
10185,CHI,2005,Adrian Griffin,30,69,1,667,58,161,.360,2,9,.222,56,152,.368,.366,33,44,.750,52,94,146,53,43,4,30,78,151
10186,CHI,2005,Jannero Pargo,25,32,0,453,82,213,.385,23,66,.348,59,147,.401,.439,17,23,.739,12,35,47,76,16,1,45,53,204
10187,CHI,2005,Jared Reiner,22,19,2,132,10,30,.333,0,0,,10,30,.333,.333,1,4,.250,13,25,38,1,3,7,9,35,21
10188,CHI,2005,Frank Williams,24,9,0,71,3,20,.150,0,4,.000,3,16,.188,.150,0,0,,2,4,6,11,2,3,3,9,6
10189,CHI,2005,Lawrence Funderburke,34,2,0,21,3,6,.500,0,0,,3,6,.500,.500,3,5,.600,1,2,3,0,0,0,0,2,9
10190,CHI,2004,Jamal Crawford,23,80,73,2811,509,1318,.386,165,521,.317,344,797,.432,.449,200,240,.833,46,237,283,405,111,29,193,161,1383
10191,CHI,2004,Kirk Hinrich,23,76,66,2706,318,823,.386,144,369,.390,174,454,.383,.474,135,168,.804,42,217,259,517,101,21,204,276,915
10192,CHI,2004,Eddy Curry,21,73,63,2154,417,840,.496,1,1,1.000,416,839,.496,.497,235,350,.671,143,308,451,68,24,83,177,258,1070
10193,CHI,2004,Antonio Davis,35,65,64,2032,220,540,.407,0,0,,220,540,.407,.407,139,181,.768,158,370,528,123,29,57,93,161,579
10194,CHI,2004,Kendall Gill,35,56,35,1411,215,548,.392,9,38,.237,206,510,.404,.401,100,136,.735,61,129,190,89,65,16,83,107,539
10195,CHI,2004,Jerome Williams,30,53,32,1230,130,279,.466,0,7,.000,130,272,.478,.466,85,126,.675,142,205,347,61,71,5,51,104,345
10196,CHI,2004,Eddie Robinson,27,51,4,1024,157,326,.482,1,5,.200,156,321,.486,.483,28,43,.651,27,77,104,58,33,10,45,57,343
10197,CHI,2004,Ronald Dupree,23,47,8,893,111,282,.394,4,9,.444,107,273,.392,.401,66,105,.629,55,112,167,55,32,18,51,134,292
10198,CHI,2004,Tyson Chandler,21,35,8,782,67,158,.424,0,1,.000,67,157,.427,.424,79,118,.669,82,188,270,23,17,43,38,87,213
10199,CHI,2004,Corie Blount,35,46,3,756,97,206,.471,0,3,.000,97,203,.478,.471,13,24,.542,76,130,206,45,38,19,35,86,207
10200,CHI,2004,Marcus Fizer,25,46,2,738,134,350,.383,2,17,.118,132,333,.396,.386,90,120,.750,61,141,202,43,16,8,51,97,360
10201,CHI,2004,Linton Johnson,23,41,20,734,72,203,.355,7,33,.212,65,170,.382,.372,22,37,.595,59,124,183,27,37,32,37,90,173
10202,CHI,2004,Jalen Rose,31,16,14,529,75,200,.375,23,54,.426,52,146,.356,.433,39,51,.765,7,57,64,56,12,4,37,45,212
10203,CHI,2004,Scottie Pippen,38,23,6,412,53,140,.379,13,48,.271,40,92,.435,.425,17,27,.630,20,48,68,50,21,9,29,38,136
10204,CHI,2004,Donyell Marshall,30,16,8,408,57,136,.419,11,27,.407,46,109,.422,.460,14,20,.700,28,71,99,28,13,20,22,47,139
10205,CHI,2004,Rick Brunson,31,37,0,402,38,101,.376,11,23,.478,27,78,.346,.431,27,31,.871,9,28,37,80,25,3,33,44,114
10206,CHI,2004,Jannero Pargo,24,13,1,345,66,154,.429,20,53,.377,46,101,.455,.494,23,27,.852,8,19,27,47,7,5,30,38,175
10207,CHI,2004,Chris Jefferies,23,19,2,187,24,66,.364,16,39,.410,8,27,.296,.485,12,19,.632,5,23,28,6,4,7,18,36,76
10208,CHI,2004,Lonny Baxter,25,14,1,147,27,49,.551,1,1,1.000,26,48,.542,.561,5,8,.625,11,24,35,5,1,6,11,31,60
10209,CHI,2004,Paul Shirley,26,7,0,86,10,23,.435,0,1,.000,10,22,.455,.435,1,3,.333,8,8,16,4,1,1,9,9,21
10210,CHI,2004,Roger Mason,23,3,0,43,1,11,.091,1,6,.167,0,5,.000,.136,0,0,,0,3,3,3,1,0,2,5,3
10211,CHI,2003,Jalen Rose,30,82,82,3351,642,1583,.406,133,359,.370,509,1224,.416,.448,399,467,.854,68,283,351,395,72,23,285,271,1816
10212,CHI,2003,Donyell Marshall,29,78,53,2378,421,918,.459,33,87,.379,388,831,.467,.477,167,221,.756,234,465,699,137,95,85,135,234,1042
10213,CHI,2003,Trenton Hassell,23,82,53,1999,144,392,.367,13,40,.325,131,352,.372,.384,41,55,.745,37,218,255,151,45,61,83,197,342
10214,CHI,2003,Jamal Crawford,22,80,31,1992,334,808,.413,86,242,.355,248,566,.438,.467,104,129,.806,21,164,185,334,77,25,134,126,858
10215,CHI,2003,Jay Williams,21,75,54,1961,273,685,.399,65,202,.322,208,483,.431,.446,103,161,.640,27,168,195,350,86,17,171,179,714
10216,CHI,2003,Tyson Chandler,20,75,68,1827,257,484,.531,0,0,,257,484,.531,.531,177,291,.608,169,345,514,76,37,106,135,220,691
10217,CHI,2003,Eddy Curry,20,81,48,1571,335,573,.585,0,0,,335,573,.585,.585,179,287,.624,116,237,353,37,18,62,137,226,849
10218,CHI,2003,Eddie Robinson,26,64,18,1355,155,315,.492,3,14,.214,152,301,.505,.497,51,63,.810,76,124,200,66,62,13,52,120,364
10219,CHI,2003,Corie Blount,34,50,3,836,65,134,.485,0,0,,65,134,.485,.485,20,35,.571,68,137,205,50,33,19,43,121,150
10220,CHI,2003,Marcus Fizer,24,38,0,809,178,383,.465,1,6,.167,177,377,.469,.466,88,134,.657,80,136,216,48,14,17,57,89,445
10221,CHI,2003,Fred Hoiberg,30,63,0,784,49,126,.389,5,21,.238,44,105,.419,.409,41,50,.820,11,126,137,70,40,5,25,59,144
10222,CHI,2003,Lonny Baxter,24,55,0,682,96,206,.466,0,2,.000,96,204,.471,.466,70,103,.680,65,100,165,16,9,22,46,135,262
10223,CHI,2003,Rick Brunson,30,17,0,196,23,50,.460,4,6,.667,19,44,.432,.500,10,12,.833,4,15,19,36,10,3,17,20,60
10224,CHI,2003,Roger Mason,22,17,0,113,11,31,.355,6,18,.333,5,13,.385,.452,2,2,1.000,2,10,12,12,4,0,5,20,30
10225,CHI,2003,Dalibor Bagarić,22,10,0,76,8,26,.308,0,0,,8,26,.308,.308,3,4,.750,7,13,20,4,3,3,5,11,19
10226,CHI,2002,Trenton Hassell,22,78,47,2237,267,628,.425,60,165,.364,207,463,.447,.473,87,114,.763,65,190,255,172,55,44,101,184,681
10227,CHI,2002,Marcus Fizer,23,76,20,1963,371,848,.438,7,41,.171,364,807,.451,.442,189,283,.668,128,299,427,120,49,24,131,186,938
10228,CHI,2002,Ron Mercer,25,40,40,1503,286,717,.399,17,57,.298,269,660,.408,.411,84,108,.778,44,111,155,118,30,10,79,86,673
10229,CHI,2002,Fred Hoiberg,29,79,8,1408,121,291,.416,24,92,.261,97,199,.487,.457,79,94,.840,18,192,210,136,61,5,32,87,345
10230,CHI,2002,Brad Miller,25,48,47,1391,208,452,.460,2,4,.500,206,448,.460,.462,190,253,.751,176,225,401,101,52,29,74,156,608
10231,CHI,2002,Tyson Chandler,19,71,31,1389,151,304,.497,0,0,,151,304,.497,.497,134,222,.604,114,229,343,54,28,93,99,179,436
10232,CHI,2002,Charles Oakley,38,57,36,1383,97,263,.369,1,6,.167,96,257,.374,.371,21,28,.750,72,271,343,114,49,11,87,175,216
10233,CHI,2002,Jalen Rose,29,30,30,1216,276,587,.470,37,100,.370,239,487,.491,.502,125,149,.839,14,110,124,158,33,16,96,103,714
10234,CHI,2002,Eddy Curry,19,72,31,1150,189,377,.501,0,0,,189,377,.501,.501,105,160,.656,111,161,272,25,16,53,69,173,483
10235,CHI,2002,Kevin Ollie,29,52,17,1146,97,253,.383,1,2,.500,96,251,.382,.385,109,130,.838,18,110,128,193,36,1,80,64,304
10236,CHI,2002,Greg Anthony,34,36,35,961,113,287,.394,29,90,.322,84,197,.426,.444,47,70,.671,16,72,88,203,49,4,58,72,302
10237,CHI,2002,Metta World Peace,22,27,26,823,152,351,.433,36,91,.396,116,260,.446,.484,81,129,.628,40,91,131,77,75,23,69,108,421
10238,CHI,2002,Travis Best,29,30,18,793,112,254,.441,8,25,.320,104,229,.454,.457,47,51,.922,10,71,81,149,32,1,40,72,279
10239,CHI,2002,Eddie Robinson,25,29,12,653,112,247,.453,2,5,.400,110,242,.455,.457,36,48,.750,24,54,78,37,23,11,36,35,262
10240,CHI,2002,Dalibor Bagarić,21,50,0,638,72,178,.404,0,1,.000,72,177,.407,.404,41,70,.586,55,107,162,23,17,24,46,108,185
10241,CHI,2002,A.J. Guyton,23,45,6,607,88,244,.361,46,123,.374,42,121,.347,.455,22,27,.815,12,32,44,81,10,7,37,23,244
10242,CHI,2002,Jamal Crawford,21,23,6,481,89,187,.476,26,58,.448,63,129,.488,.545,10,13,.769,5,29,34,55,18,5,32,18,214
10243,CHI,2002,Norm Richardson,22,8,0,63,10,23,.435,4,8,.500,6,15,.400,.522,6,9,.667,2,5,7,1,0,0,3,5,30
10244,CHI,2001,Elton Brand,21,74,74,2906,578,1215,.476,0,2,.000,578,1213,.477,.476,334,472,.708,285,461,746,240,71,118,219,243,1490
10245,CHI,2001,Ron Mercer,24,61,61,2535,500,1121,.446,14,46,.304,486,1075,.452,.452,188,228,.825,72,164,236,201,78,27,129,148,1202
10246,CHI,2001,Metta World Peace,21,76,74,2363,327,815,.401,43,148,.291,284,667,.426,.428,210,280,.750,59,235,294,228,152,45,159,254,907
10247,CHI,2001,Fred Hoiberg,28,74,37,2247,217,495,.438,103,250,.412,114,245,.465,.542,136,157,.866,21,287,308,263,98,12,74,155,673
10248,CHI,2001,Marcus Fizer,22,72,13,1580,278,646,.430,10,39,.256,268,607,.442,.438,117,161,.727,76,237,313,76,30,19,124,175,683
10249,CHI,2001,Brad Miller,24,57,45,1434,168,386,.435,1,5,.200,167,381,.438,.437,168,226,.743,144,275,419,107,33,38,73,176,505
10250,CHI,2001,Bryce Drew,26,48,41,1305,124,327,.379,40,105,.381,84,222,.378,.440,14,19,.737,12,57,69,185,32,3,68,99,302
10251,CHI,2001,Jamal Crawford,20,61,8,1050,107,304,.352,41,117,.350,66,187,.353,.419,27,34,.794,9,80,89,141,43,14,85,68,282
10252,CHI,2001,Khalid El-Amin,21,50,14,936,115,311,.370,28,84,.333,87,227,.383,.415,56,72,.778,21,60,81,145,48,2,54,99,314
10253,CHI,2001,Michael Ruffin,24,45,16,879,40,90,.444,0,0,,40,90,.444,.444,39,77,.506,101,161,262,39,30,38,46,131,119
10254,CHI,2001,Corey Benjamin,22,65,5,857,115,302,.381,21,81,.259,94,221,.425,.416,56,83,.675,38,62,100,69,28,16,63,128,307
10255,CHI,2001,A.J. Guyton,22,33,8,630,78,192,.406,27,69,.391,51,123,.415,.477,15,18,.833,10,26,36,64,9,5,24,35,198
10256,CHI,2001,Dragan Tarlać,27,43,12,598,39,99,.394,0,0,,39,99,.394,.394,25,33,.758,37,85,122,31,7,19,38,95,103
10257,CHI,2001,Dalibor Bagarić,20,35,0,259,17,65,.262,0,1,.000,17,64,.266,.262,13,28,.464,22,34,56,10,9,16,21,44,47
10258,CHI,2001,Jake Voskuhl,23,16,2,143,11,25,.440,0,0,,11,25,.440,.440,8,14,.571,12,22,34,5,5,6,12,38,30
10259,CHI,2001,Steve Goodrich,24,12,0,133,7,18,.389,1,3,.333,6,15,.400,.417,4,7,.571,7,14,21,6,2,1,8,14,19
10260,CHI,2000,Elton Brand,20,81,80,2999,630,1306,.482,0,2,.000,630,1304,.483,.482,367,536,.685,348,462,810,155,66,132,228,259,1627
10261,CHI,2000,Metta World Peace,20,72,63,2238,309,759,.407,60,191,.314,249,568,.438,.447,188,279,.674,62,246,308,202,119,39,166,159,866
10262,CHI,2000,Dickey Simpkins,27,69,48,1651,111,274,.405,0,1,.000,111,273,.407,.405,65,120,.542,124,248,372,100,22,22,128,217,287
10263,CHI,2000,Randy Brown,31,59,55,1625,157,435,.361,3,6,.500,154,429,.359,.364,62,84,.738,23,121,144,202,61,15,105,120,379
10264,CHI,2000,Hersey Hawkins,33,61,49,1622,159,375,.424,55,141,.390,104,234,.444,.497,107,119,.899,31,144,175,134,74,15,100,146,480
10265,CHI,2000,Matt Maloney,28,51,12,1175,114,318,.358,62,174,.356,52,144,.361,.456,37,45,.822,10,54,64,138,32,3,63,42,327
10266,CHI,2000,Chris Carr,25,50,2,1092,185,463,.400,31,93,.333,154,370,.416,.433,91,106,.858,36,124,160,81,30,14,112,101,492
10267,CHI,2000,Will Perdue,34,67,15,1012,59,168,.351,0,0,,59,168,.351,.351,50,105,.476,88,174,262,65,14,42,78,126,168
10268,CHI,2000,Chris Anstey,25,73,11,1007,161,364,.442,1,6,.167,160,358,.447,.444,116,147,.789,90,190,280,65,29,25,80,180,439
10269,CHI,2000,Michael Ruffin,23,71,6,975,58,138,.420,0,0,,58,138,.420,.420,43,88,.489,117,133,250,44,26,26,59,170,159
10270,CHI,2000,Toni Kukoč,31,24,23,868,148,388,.381,18,78,.231,130,310,.419,.405,118,155,.761,37,93,130,124,44,19,75,51,432
10271,CHI,2000,Corey Benjamin,21,48,10,862,145,350,.414,31,89,.348,114,261,.437,.459,49,82,.598,21,67,88,54,31,22,74,122,370
10272,CHI,2000,Fred Hoiberg,27,31,11,845,89,230,.387,32,94,.340,57,136,.419,.457,69,76,.908,7,103,110,85,40,2,43,66,279
10273,CHI,2000,B.J. Armstrong,32,27,18,583,83,186,.446,13,29,.448,70,157,.446,.481,22,25,.880,2,45,47,78,7,1,40,34,201
10274,CHI,2000,Dedric Willoughby,25,25,1,508,61,179,.341,29,98,.296,32,81,.395,.422,39,51,.765,11,40,51,66,23,2,37,32,190
10275,CHI,2000,Kornél Dávid,28,26,5,443,63,148,.426,0,3,.000,63,145,.434,.426,42,52,.808,22,51,73,16,13,2,31,49,168
10276,CHI,2000,Rusty LaRue,26,4,1,129,15,43,.349,2,14,.143,13,29,.448,.372,5,7,.714,1,9,10,11,7,0,7,9,37
10277,CHI,2000,John Starks,34,4,0,82,11,34,.324,3,10,.300,8,24,.333,.368,5,5,1.000,0,10,10,11,5,1,3,9,30
10278,CHI,2000,Khalid Reeves,27,3,0,48,3,12,.250,0,3,.000,3,9,.333,.250,5,5,1.000,2,2,4,13,2,0,6,8,11
10279,CHI,2000,Lari Ketner,22,6,0,41,4,10,.400,0,0,,4,10,.400,.400,2,2,1.000,0,7,7,1,1,1,3,8,10
10280,CHI,1999,Toni Kukoč,30,44,44,1654,315,750,.420,39,137,.285,276,613,.450,.446,159,215,.740,65,245,310,235,49,11,121,82,828
10281,CHI,1999,Dickey Simpkins,26,50,35,1448,150,324,.463,0,1,.000,150,323,.464,.463,156,242,.645,110,229,339,65,36,13,72,128,456
10282,CHI,1999,Mark Bryant,33,45,29,1204,168,348,.483,0,1,.000,168,347,.484,.483,71,110,.645,92,140,232,48,34,16,68,149,407
10283,CHI,1999,Brent Barry,27,37,30,1181,141,356,.396,52,172,.302,89,184,.484,.469,78,101,.772,39,105,144,116,42,11,72,98,412
10284,CHI,1999,Randy Brown,30,39,32,1139,132,319,.414,0,10,.000,132,309,.427,.414,78,103,.757,27,105,132,149,68,8,80,93,342
10285,CHI,1999,Ron Harper,35,35,35,1107,147,390,.377,27,85,.318,120,305,.393,.412,71,101,.703,49,131,180,115,60,35,65,80,392
10286,CHI,1999,Kornél Dávid,27,50,6,902,109,243,.449,0,1,.000,109,242,.450,.449,90,111,.811,70,103,173,40,23,17,48,88,308
10287,CHI,1999,Rusty LaRue,25,43,6,732,78,217,.359,30,89,.337,48,128,.375,.429,17,17,1.000,9,47,56,63,33,3,34,66,203
10288,CHI,1999,Cory Carr,23,42,7,624,71,216,.329,5,30,.167,66,186,.355,.340,24,32,.750,8,41,49,66,21,7,46,66,171
10289,CHI,1999,Charles Jones,23,29,5,476,39,123,.317,19,61,.311,20,62,.323,.394,11,22,.500,9,33,42,41,18,5,29,30,108
10290,CHI,1999,Bill Wennington,35,38,3,451,62,178,.348,1,1,1.000,61,177,.345,.351,18,22,.818,20,59,79,18,13,12,17,79,143
10291,CHI,1999,Keith Booth,24,39,4,432,49,151,.325,1,10,.100,48,141,.340,.328,21,42,.500,25,68,93,38,22,11,39,60,120
10292,CHI,1999,Andrew Lang,32,21,13,386,32,99,.323,0,0,,32,99,.323,.323,16,23,.696,33,60,93,13,5,12,17,43,80
10293,CHI,1999,Corey Benjamin,20,31,1,320,44,117,.376,3,14,.214,41,103,.398,.389,27,40,.675,15,25,40,10,11,8,21,46,118
10294,CHI,1999,Mario Bennett,25,3,0,19,2,6,.333,0,0,,2,6,.333,.333,3,4,.750,2,3,5,0,1,0,1,4,7
10295,CHI,1998,Michael Jordan,34,82,82,3181,881,1893,.465,30,126,.238,851,1767,.482,.473,565,721,.784,130,345,475,283,141,45,185,151,2357
10296,CHI,1998,Dennis Rodman,36,80,66,2856,155,360,.431,4,23,.174,151,337,.448,.436,61,111,.550,421,780,1201,230,47,18,147,238,375
10297,CHI,1998,Ron Harper,34,82,82,2284,293,665,.441,16,84,.190,277,581,.477,.453,162,216,.750,107,183,290,241,108,48,91,181,764
10298,CHI,1998,Toni Kukoč,29,74,52,2235,383,841,.455,63,174,.362,320,667,.480,.493,155,219,.708,121,206,327,314,76,37,154,149,984
10299,CHI,1998,Luc Longley,29,58,58,1703,277,609,.455,0,0,,277,609,.455,.455,109,148,.736,113,228,341,161,34,62,130,206,663
10300,CHI,1998,Scottie Pippen,32,44,44,1652,315,704,.447,61,192,.318,254,512,.496,.491,150,193,.777,53,174,227,254,79,43,109,116,841
10301,CHI,1998,Randy Brown,29,71,6,1147,116,302,.384,0,5,.000,116,297,.391,.384,56,78,.718,34,60,94,151,71,12,63,118,288
10302,CHI,1998,Steve Kerr,32,50,0,1119,137,302,.454,57,130,.438,80,172,.465,.548,45,49,.918,14,63,77,96,26,5,27,71,376
10303,CHI,1998,Scott Burrell,27,80,3,1096,159,375,.424,51,144,.354,108,231,.468,.492,47,64,.734,80,118,198,65,64,37,50,131,416
10304,CHI,1998,Jason Caffey,24,51,8,710,100,199,.503,0,1,.000,100,198,.505,.503,68,103,.660,76,97,173,36,13,17,48,92,268
10305,CHI,1998,Jud Buechler,29,74,0,608,85,176,.483,25,65,.385,60,111,.541,.554,3,6,.500,24,53,77,49,22,15,21,47,198
10306,CHI,1998,Bill Wennington,34,48,8,467,75,172,.436,0,0,,75,172,.436,.436,17,21,.810,32,48,80,19,4,5,16,77,167
10307,CHI,1998,Joe Kleine,36,46,1,397,39,106,.368,0,0,,39,106,.368,.368,15,18,.833,27,50,77,30,4,5,28,63,93
10308,CHI,1998,Dickey Simpkins,25,21,0,237,26,41,.634,0,1,.000,26,40,.650,.634,26,44,.591,8,23,31,17,4,3,13,35,78
10309,CHI,1998,Rusty LaRue,24,14,0,140,20,49,.408,4,16,.250,16,33,.485,.449,5,8,.625,1,7,8,5,3,1,6,12,49
10310,CHI,1998,Keith Booth,23,6,0,17,2,6,.333,0,1,.000,2,5,.400,.333,6,6,1.000,2,2,4,1,0,0,3,3,10
10311,CHI,1998,David Vaughn,24,3,0,6,1,1,1.000,0,0,,1,1,1.000,1.000,2,4,.500,0,1,1,0,0,0,0,1,4
10312,CHI,1997,Michael Jordan,33,82,82,3106,920,1892,.486,111,297,.374,809,1595,.507,.516,480,576,.833,113,369,482,352,140,44,166,156,2431
10313,CHI,1997,Scottie Pippen,31,82,82,3095,648,1366,.474,156,424,.368,492,942,.522,.531,204,291,.701,160,371,531,467,154,45,214,213,1656
10314,CHI,1997,Dennis Rodman,35,55,54,1947,128,286,.448,5,19,.263,123,267,.461,.456,50,88,.568,320,563,883,170,32,19,111,172,311
10315,CHI,1997,Steve Kerr,31,82,0,1861,249,467,.533,110,237,.464,139,230,.604,.651,54,67,.806,29,101,130,175,67,3,43,98,662
10316,CHI,1997,Ron Harper,33,76,74,1740,177,406,.436,68,188,.362,109,218,.500,.520,58,82,.707,46,147,193,191,86,38,50,138,480
10317,CHI,1997,Toni Kukoč,28,57,15,1610,285,605,.471,50,151,.331,235,454,.518,.512,134,174,.770,94,167,261,256,60,29,91,97,754
10318,CHI,1997,Luc Longley,28,59,59,1472,221,485,.456,0,2,.000,221,483,.458,.456,95,120,.792,121,211,332,141,23,66,111,191,537
10319,CHI,1997,Jason Caffey,23,75,19,1405,205,385,.532,0,1,.000,205,384,.534,.532,139,211,.659,135,166,301,89,25,9,97,149,549
10320,CHI,1997,Randy Brown,28,72,3,1057,140,333,.420,4,22,.182,136,311,.437,.426,57,84,.679,34,77,111,133,81,17,58,116,341
10321,CHI,1997,Bill Wennington,33,61,19,783,118,237,.498,0,2,.000,118,235,.502,.498,44,53,.830,46,83,129,41,10,11,31,132,280
10322,CHI,1997,Jud Buechler,28,76,0,703,58,158,.367,18,54,.333,40,104,.385,.424,5,14,.357,45,81,126,60,23,21,27,50,139
10323,CHI,1997,Robert Parish,43,43,3,406,70,143,.490,0,0,,70,143,.490,.490,21,31,.677,42,47,89,22,6,19,28,40,161
10324,CHI,1997,Dickey Simpkins,24,48,0,395,31,93,.333,1,4,.250,30,89,.337,.339,28,40,.700,36,56,92,31,5,5,35,44,91
10325,CHI,1997,Bison Dele,27,9,0,138,26,63,.413,0,0,,26,63,.413,.413,11,15,.733,14,19,33,12,3,5,11,20,63
10326,CHI,1997,Matt Steigenga,26,2,0,12,1,4,.250,0,2,.000,1,2,.500,.250,1,2,.500,0,3,3,2,1,1,2,1,3
10327,CHI,1996,Michael Jordan,32,82,82,3090,916,1850,.495,111,260,.427,805,1590,.506,.525,548,657,.834,148,395,543,352,180,42,197,195,2491
10328,CHI,1996,Scottie Pippen,30,77,77,2825,563,1216,.463,150,401,.374,413,815,.507,.525,220,324,.679,152,344,496,452,133,57,207,198,1496
10329,CHI,1996,Toni Kukoč,27,81,20,2103,386,787,.490,87,216,.403,299,571,.524,.546,206,267,.772,115,208,323,287,64,28,114,150,1065
10330,CHI,1996,Dennis Rodman,34,64,57,2088,146,304,.480,3,27,.111,143,277,.516,.485,56,106,.528,356,596,952,160,36,27,138,196,351
10331,CHI,1996,Steve Kerr,30,82,0,1919,244,482,.506,122,237,.515,122,245,.498,.633,78,84,.929,25,85,110,192,63,2,42,109,688
10332,CHI,1996,Ron Harper,32,80,80,1886,234,501,.467,28,104,.269,206,397,.519,.495,98,139,.705,74,139,213,208,105,32,73,137,594
10333,CHI,1996,Luc Longley,27,62,62,1641,242,502,.482,0,0,,242,502,.482,.482,80,103,.777,104,214,318,119,22,84,114,223,564
10334,CHI,1996,Bill Wennington,32,71,20,1065,169,343,.493,1,1,1.000,168,342,.491,.494,37,43,.860,58,116,174,46,21,16,37,171,376
10335,CHI,1996,Jud Buechler,27,74,0,740,112,242,.463,40,90,.444,72,152,.474,.545,14,22,.636,45,66,111,56,34,7,39,70,278
10336,CHI,1996,Dickey Simpkins,23,60,12,685,77,160,.481,1,1,1.000,76,159,.478,.484,61,97,.629,66,90,156,38,9,8,56,78,216
10337,CHI,1996,Randy Brown,27,68,0,671,78,192,.406,1,11,.091,77,181,.425,.409,28,46,.609,17,49,66,73,57,12,31,88,185
10338,CHI,1996,Jason Caffey,22,57,0,545,71,162,.438,0,1,.000,71,161,.441,.438,40,68,.588,51,60,111,24,12,7,48,91,182
10339,CHI,1996,James Edwards,40,28,0,274,41,110,.373,0,0,,41,110,.373,.373,16,26,.615,15,25,40,11,1,8,21,61,98
10340,CHI,1996,John Salley,31,17,0,191,12,35,.343,0,0,,12,35,.343,.343,12,20,.600,20,23,43,15,8,15,16,38,36
10341,CHI,1996,Jack Haley,32,1,0,7,2,6,.333,0,0,,2,6,.333,.333,1,2,.500,1,1,2,0,0,0,1,2,5
10342,CHI,1995,Scottie Pippen,29,79,79,3014,634,1320,.480,109,316,.345,525,1004,.523,.522,315,440,.716,175,464,639,409,232,89,271,238,1692
10343,CHI,1995,Toni Kukoč,26,81,55,2584,487,967,.504,62,198,.313,425,769,.553,.536,235,314,.748,155,285,440,372,102,16,165,163,1271
10344,CHI,1995,B.J. Armstrong,27,82,82,2577,418,894,.468,108,253,.427,310,641,.484,.528,206,233,.884,25,161,186,244,84,8,103,159,1150
10345,CHI,1995,Steve Kerr,29,82,0,1839,261,495,.527,89,170,.524,172,325,.529,.617,63,81,.778,20,99,119,151,44,3,48,114,674
10346,CHI,1995,Will Perdue,29,78,78,1592,254,459,.553,0,1,.000,254,458,.555,.553,113,194,.582,211,311,522,90,26,56,116,220,621
10347,CHI,1995,Ron Harper,31,77,53,1536,209,491,.426,31,110,.282,178,381,.467,.457,81,131,.618,51,129,180,157,97,27,100,132,530
10348,CHI,1995,Pete Myers,31,71,14,1270,119,287,.415,10,39,.256,109,248,.440,.432,70,114,.614,57,82,139,148,58,15,88,125,318
10349,CHI,1995,Luc Longley,26,55,0,1001,135,302,.447,0,2,.000,135,300,.450,.447,88,107,.822,82,181,263,73,24,45,86,177,358
10350,CHI,1995,Bill Wennington,31,73,1,956,156,317,.492,0,4,.000,156,313,.498,.492,51,63,.810,64,126,190,40,22,17,39,198,363
10351,CHI,1995,Corie Blount,26,68,9,889,100,210,.476,0,2,.000,100,208,.481,.476,38,67,.567,107,133,240,60,26,33,59,146,238
10352,CHI,1995,Michael Jordan,31,17,17,668,166,404,.411,16,32,.500,150,372,.403,.431,109,136,.801,25,92,117,90,30,13,35,47,457
10353,CHI,1995,Jud Buechler,26,57,0,605,90,183,.492,15,48,.313,75,135,.556,.533,22,39,.564,36,62,98,50,24,12,30,64,217
10354,CHI,1995,Dickey Simpkins,22,59,5,586,78,184,.424,0,0,,78,184,.424,.424,50,72,.694,60,91,151,37,10,7,45,72,206
10355,CHI,1995,Greg Foster,26,17,3,299,41,86,.477,0,0,,41,86,.477,.477,22,31,.710,18,36,54,16,2,8,17,54,104
10356,CHI,1995,Larry Krystkowiak,30,19,14,287,28,72,.389,0,0,,28,72,.389,.389,27,30,.900,19,40,59,26,9,2,25,34,83
10357,CHI,1995,Jo Jo English,24,8,0,127,15,39,.385,3,12,.250,12,27,.444,.423,10,13,.769,1,2,3,7,7,1,6,19,43
10358,CHI,1994,B.J. Armstrong,26,82,82,2770,479,1007,.476,60,135,.444,419,872,.481,.505,194,227,.855,28,142,170,323,80,9,131,147,1212
10359,CHI,1994,Scottie Pippen,28,72,72,2759,627,1278,.491,63,197,.320,564,1081,.522,.515,270,409,.660,173,456,629,403,211,58,232,227,1587
10360,CHI,1994,Horace Grant,28,70,69,2570,460,878,.524,0,6,.000,460,872,.528,.524,137,230,.596,306,463,769,236,74,84,109,164,1057
10361,CHI,1994,Steve Kerr,28,82,0,2036,287,577,.497,52,124,.419,235,453,.519,.542,83,97,.856,26,105,131,210,75,3,57,97,709
10362,CHI,1994,Pete Myers,30,82,81,2030,253,556,.455,8,29,.276,245,527,.465,.462,136,194,.701,54,127,181,245,78,20,136,195,650
10363,CHI,1994,Toni Kukoč,25,75,8,1808,313,726,.431,32,118,.271,281,608,.462,.453,156,210,.743,98,199,297,252,81,33,167,122,814
10364,CHI,1994,Bill Wennington,30,76,0,1371,235,482,.488,0,2,.000,235,480,.490,.488,72,88,.818,117,236,353,70,43,29,75,214,542
10365,CHI,1994,Bill Cartwright,36,42,41,780,98,191,.513,0,0,,98,191,.513,.513,39,57,.684,43,109,152,57,8,8,50,83,235
10366,CHI,1994,Corie Blount,25,67,8,690,76,174,.437,0,0,,76,174,.437,.437,46,75,.613,76,118,194,56,19,33,52,93,198
10367,CHI,1994,Scott Williams,25,38,11,638,114,236,.483,1,5,.200,113,231,.489,.485,60,98,.612,69,112,181,39,16,21,44,112,289
10368,CHI,1994,Stacey King,27,31,15,537,68,171,.398,0,2,.000,68,169,.402,.398,36,53,.679,50,82,132,39,18,12,43,64,172
10369,CHI,1994,Luc Longley,25,27,17,513,85,176,.483,0,0,,85,176,.483,.483,34,45,.756,42,96,138,63,10,21,40,85,204
10370,CHI,1994,Jo Jo English,23,36,0,419,56,129,.434,8,17,.471,48,112,.429,.465,10,21,.476,9,36,45,38,8,10,36,61,130
10371,CHI,1994,Will Perdue,28,43,6,397,47,112,.420,0,1,.000,47,111,.423,.420,23,32,.719,40,86,126,34,8,11,42,61,117
10372,CHI,1994,John Paxson,33,27,0,343,30,68,.441,9,22,.409,21,46,.457,.507,1,2,.500,3,17,20,33,7,2,6,18,70
10373,CHI,1994,Dave Johnson,23,17,0,119,17,54,.315,0,1,.000,17,53,.321,.315,13,21,.619,9,7,16,4,4,0,9,7,47
10374,CHI,1993,Scottie Pippen,27,81,81,3123,628,1327,.473,22,93,.237,606,1234,.491,.482,232,350,.663,203,418,621,507,173,73,246,219,1510
10375,CHI,1993,Michael Jordan,29,78,78,3067,992,2003,.495,81,230,.352,911,1773,.514,.515,476,569,.837,135,387,522,428,221,61,207,188,2541
10376,CHI,1993,Horace Grant,27,77,77,2745,421,829,.508,1,5,.200,420,824,.510,.508,174,281,.619,341,388,729,201,89,96,110,218,1017
10377,CHI,1993,B.J. Armstrong,25,82,74,2492,408,818,.499,63,139,.453,345,679,.508,.537,130,151,.861,27,122,149,330,66,6,83,169,1009
10378,CHI,1993,Scott Williams,24,71,5,1369,166,356,.466,0,7,.000,166,349,.476,.466,90,126,.714,168,283,451,68,55,66,73,230,422
10379,CHI,1993,Bill Cartwright,35,63,63,1253,141,343,.411,0,0,,141,343,.411,.411,72,98,.735,83,150,233,83,20,10,62,154,354
10380,CHI,1993,Stacey King,26,76,3,1059,160,340,.471,2,6,.333,158,334,.473,.474,86,122,.705,105,102,207,71,26,20,70,128,408
10381,CHI,1993,John Paxson,32,59,8,1030,105,233,.451,19,41,.463,86,192,.448,.491,17,20,.850,9,39,48,136,38,2,31,99,246
10382,CHI,1993,Rodney McCray,31,64,5,1019,92,204,.451,2,5,.400,90,199,.452,.456,36,52,.692,53,105,158,81,12,15,53,99,222
10383,CHI,1993,Will Perdue,27,72,16,998,137,246,.557,0,1,.000,137,245,.559,.557,67,111,.604,103,184,287,74,22,47,74,139,341
10384,CHI,1993,Trent Tucker,33,69,0,909,143,295,.485,52,131,.397,91,164,.555,.573,18,22,.818,16,55,71,82,24,6,18,65,356
10385,CHI,1993,Darrell Walker,31,28,0,367,31,77,.403,0,0,,31,77,.403,.403,10,20,.500,18,21,39,44,23,2,12,51,72
10386,CHI,1993,Corey Williams,22,35,0,242,31,85,.365,1,3,.333,30,82,.366,.371,18,22,.818,19,12,31,23,4,2,11,24,81
10387,CHI,1993,Ed Nealy,32,11,0,79,10,23,.435,1,5,.200,9,18,.500,.457,2,2,1.000,4,12,16,2,3,1,2,6,23
10388,CHI,1993,Joe Courtney,23,5,0,34,4,9,.444,0,0,,4,9,.444,.444,3,4,.750,2,0,2,1,2,1,3,9,11
10389,CHI,1993,Jo Jo English,22,6,0,31,3,10,.300,0,3,.000,3,7,.429,.300,0,2,.000,2,4,6,1,3,2,4,5,6
10390,CHI,1993,Ricky Blanton,26,2,0,13,3,7,.429,0,0,,3,7,.429,.429,0,0,,2,1,3,1,2,0,1,1,6
10391,CHI,1992,Scottie Pippen,26,82,82,3164,687,1359,.506,16,80,.200,671,1279,.525,.511,330,434,.760,185,445,630,572,155,93,253,242,1720
10392,CHI,1992,Michael Jordan,28,80,80,3102,943,1818,.519,27,100,.270,916,1718,.533,.526,491,590,.832,91,420,511,489,182,75,200,201,2404
10393,CHI,1992,Horace Grant,26,81,81,2859,457,790,.578,0,2,.000,457,788,.580,.578,235,317,.741,344,463,807,217,100,131,98,196,1149
10394,CHI,1992,John Paxson,31,79,79,1946,257,487,.528,12,44,.273,245,443,.553,.540,29,37,.784,21,75,96,241,49,9,44,142,555
10395,CHI,1992,B.J. Armstrong,24,82,3,1875,335,697,.481,35,87,.402,300,610,.492,.506,104,129,.806,19,126,145,266,46,5,94,88,809
10396,CHI,1992,Bill Cartwright,34,64,64,1471,208,445,.467,0,0,,208,445,.467,.467,96,159,.604,93,231,324,87,22,14,75,131,512
10397,CHI,1992,Stacey King,25,79,12,1268,215,425,.506,2,5,.400,213,420,.507,.508,119,158,.753,87,118,205,77,21,25,76,129,551
10398,CHI,1992,Cliff Levingston,31,79,0,1020,125,251,.498,1,6,.167,124,245,.506,.500,60,96,.625,109,118,227,66,27,45,42,134,311
10399,CHI,1992,Will Perdue,26,77,7,1007,152,278,.547,1,2,.500,151,276,.547,.549,45,91,.495,108,204,312,80,16,43,72,133,350
10400,CHI,1992,Bob Hansen,31,66,0,769,75,169,.444,7,25,.280,68,144,.472,.464,8,22,.364,15,58,73,68,26,3,28,128,165
10401,CHI,1992,Scott Williams,23,63,0,690,83,172,.483,0,3,.000,83,169,.491,.483,48,74,.649,90,157,247,50,13,36,35,122,214
10402,CHI,1992,Craig Hodges,31,56,2,555,93,242,.384,36,96,.375,57,146,.390,.459,16,17,.941,7,17,24,54,14,1,22,33,238
10403,CHI,1992,Mark Randall,24,15,0,67,10,22,.455,0,2,.000,10,20,.500,.455,6,8,.750,4,5,9,7,0,0,6,8,26
10404,CHI,1992,Rory Sparrow,33,4,0,18,1,8,.125,1,2,.500,0,6,.000,.188,0,0,,0,1,1,4,0,0,2,2,3
10405,CHI,1992,Dennis Hopson,26,2,0,10,1,2,.500,0,0,,1,2,.500,.500,0,0,,0,0,0,0,1,0,0,2,2
10406,CHI,1992,Chuck Nevitt,32,4,0,9,1,3,.333,0,0,,1,3,.333,.333,0,0,,0,1,1,1,0,0,3,2,2
10407,CHI,1991,Michael Jordan,27,82,82,3034,990,1837,.539,29,93,.312,961,1744,.551,.547,571,671,.851,118,374,492,453,223,83,202,229,2580
10408,CHI,1991,Scottie Pippen,25,82,82,3014,600,1153,.520,21,68,.309,579,1085,.534,.529,240,340,.706,163,432,595,511,193,93,232,270,1461
10409,CHI,1991,Horace Grant,25,78,76,2641,401,733,.547,1,6,.167,400,727,.550,.548,197,277,.711,266,393,659,178,95,69,92,203,1000
10410,CHI,1991,Bill Cartwright,33,79,79,2273,318,649,.490,0,0,,318,649,.490,.490,124,178,.697,167,319,486,126,32,15,113,167,760
10411,CHI,1991,John Paxson,30,82,82,1971,317,578,.548,42,96,.438,275,482,.571,.585,34,41,.829,15,76,91,297,62,3,69,136,710
10412,CHI,1991,B.J. Armstrong,23,82,0,1731,304,632,.481,15,30,.500,289,602,.480,.493,97,111,.874,25,124,149,301,70,4,107,118,720
10413,CHI,1991,Stacey King,24,76,6,1198,156,334,.467,0,2,.000,156,332,.470,.467,107,152,.704,72,136,208,65,24,42,91,134,419
10414,CHI,1991,Cliff Levingston,30,78,0,1013,127,282,.450,1,4,.250,126,278,.453,.452,59,91,.648,99,126,225,56,29,43,50,143,314
10415,CHI,1991,Will Perdue,25,74,3,972,116,235,.494,0,3,.000,116,232,.500,.494,75,112,.670,122,214,336,47,23,57,75,147,307
10416,CHI,1991,Craig Hodges,30,73,0,843,146,344,.424,44,115,.383,102,229,.445,.488,26,27,.963,10,32,42,97,34,2,35,74,362
10417,CHI,1991,Dennis Hopson,25,61,0,728,104,244,.426,1,5,.200,103,239,.431,.428,55,83,.663,49,60,109,65,25,14,59,79,264
10418,CHI,1991,Scott Williams,22,51,0,337,53,104,.510,1,2,.500,52,102,.510,.514,20,28,.714,42,56,98,16,12,13,23,51,127
10419,CHI,1990,Michael Jordan,26,82,82,3197,1034,1964,.526,92,245,.376,942,1719,.548,.550,593,699,.848,143,422,565,519,227,54,247,241,2753
10420,CHI,1990,Scottie Pippen,24,82,82,3148,562,1150,.489,28,112,.250,534,1038,.514,.501,199,295,.675,150,397,547,444,211,101,278,298,1351
10421,CHI,1990,Horace Grant,24,80,80,2753,446,853,.523,0,0,,446,853,.523,.523,179,256,.699,236,393,629,227,92,84,110,230,1071
10422,CHI,1990,John Paxson,29,82,82,2365,365,708,.516,33,92,.359,332,616,.539,.539,56,68,.824,27,92,119,335,83,6,85,176,819
10423,CHI,1990,Bill Cartwright,32,71,71,2160,292,598,.488,0,0,,292,598,.488,.488,227,280,.811,137,328,465,145,38,34,123,243,811
10424,CHI,1990,Stacey King,23,82,2,1777,267,530,.504,0,1,.000,267,529,.505,.504,194,267,.727,169,215,384,87,38,58,119,215,728
10425,CHI,1990,B.J. Armstrong,22,81,0,1291,190,392,.485,3,6,.500,187,386,.484,.489,69,78,.885,19,83,102,199,46,6,83,105,452
10426,CHI,1990,Craig Hodges,29,63,0,1055,145,331,.438,87,181,.481,58,150,.387,.569,30,33,.909,11,42,53,110,30,2,30,87,407
10427,CHI,1990,Will Perdue,24,77,11,884,111,268,.414,0,5,.000,111,263,.422,.414,72,104,.692,88,126,214,46,19,26,65,150,294
10428,CHI,1990,Ed Nealy,29,46,0,503,37,70,.529,0,2,.000,37,68,.544,.529,30,41,.732,46,92,138,28,16,4,17,67,104
10429,CHI,1990,Charles Davis,31,53,0,429,58,158,.367,7,25,.280,51,133,.383,.389,7,8,.875,25,56,81,18,10,8,20,52,130
10430,CHI,1990,Jeff Sanders,24,31,0,182,13,40,.325,0,0,,13,40,.325,.325,2,4,.500,17,22,39,9,4,4,15,27,28
10431,CHI,1990,Jack Haley,26,11,0,58,9,20,.450,0,0,,9,20,.450,.450,7,7,1.000,7,11,18,4,0,1,7,7,25
10432,CHI,1990,Clifford Lett,24,4,0,28,2,8,.250,0,0,,2,8,.250,.250,0,0,,0,0,0,1,0,0,2,8,4
10433,CHI,1989,Michael Jordan,25,81,81,3255,966,1795,.538,27,98,.276,939,1697,.553,.546,674,793,.850,149,503,652,650,234,65,290,247,2633
10434,CHI,1989,Horace Grant,23,79,79,2809,405,781,.519,0,5,.000,405,776,.522,.519,140,199,.704,240,441,681,168,86,62,128,251,950
10435,CHI,1989,Scottie Pippen,23,73,56,2413,413,867,.476,21,77,.273,392,790,.496,.488,201,301,.668,138,307,445,256,139,61,199,261,1048
10436,CHI,1989,Bill Cartwright,31,78,76,2333,365,768,.475,0,0,,365,768,.475,.475,236,308,.766,152,369,521,90,21,41,190,234,966
10437,CHI,1989,John Paxson,28,78,20,1738,246,513,.480,44,133,.331,202,380,.532,.522,31,36,.861,13,81,94,308,53,6,71,162,567
10438,CHI,1989,Brad Sellers,26,80,25,1732,231,476,.485,3,6,.500,228,470,.485,.488,86,101,.851,85,142,227,99,35,69,72,176,551
10439,CHI,1989,Sam Vincent,25,70,56,1703,274,566,.484,2,17,.118,272,549,.495,.486,106,129,.822,34,156,190,335,53,10,142,124,656
10440,CHI,1989,Dave Corzine,32,81,7,1483,203,440,.461,2,8,.250,201,432,.465,.464,71,96,.740,92,223,315,103,29,45,93,134,479
10441,CHI,1989,Craig Hodges,28,49,6,1112,187,394,.475,71,168,.423,116,226,.513,.565,45,53,.849,21,63,84,138,41,4,52,82,490
10442,CHI,1989,Charles Davis,30,49,3,545,81,190,.426,4,15,.267,77,175,.440,.437,19,26,.731,47,67,114,31,11,5,22,58,185
10443,CHI,1989,Jack Haley,25,51,1,289,37,78,.474,0,0,,37,78,.474,.474,36,46,.783,21,50,71,10,11,0,26,56,110
10444,CHI,1989,Will Perdue,23,30,0,190,29,72,.403,0,0,,29,72,.403,.403,8,14,.571,18,27,45,11,4,6,15,38,66
10445,CHI,1989,Ed Nealy,28,13,0,94,5,7,.714,0,0,,5,7,.714,.714,1,2,.500,4,19,23,6,3,1,1,23,11
10446,CHI,1989,Anthony Jones,26,8,0,65,5,15,.333,0,1,.000,5,14,.357,.333,2,2,1.000,4,4,8,4,2,1,1,7,12
10447,CHI,1989,Dominic Pressley,24,3,0,17,1,6,.167,0,2,.000,1,4,.250,.167,0,0,,0,1,1,4,0,0,0,2,2
10448,CHI,1989,David Wood,24,2,0,2,0,0,,0,0,,0,0,,,0,0,,0,0,0,0,0,0,0,0,0
10449,CHI,1988,Michael Jordan,24,82,82,3311,1069,1998,.535,7,53,.132,1062,1945,.546,.537,723,860,.841,139,310,449,485,259,131,252,270,2868
10450,CHI,1988,Charles Oakley,24,82,82,2816,375,776,.483,3,12,.250,372,764,.487,.485,261,359,.727,326,740,1066,248,68,28,241,272,1014
10451,CHI,1988,Dave Corzine,31,80,32,2328,344,715,.481,1,9,.111,343,706,.486,.482,115,153,.752,170,357,527,154,36,95,109,149,804
10452,CHI,1988,Brad Sellers,25,82,76,2212,326,714,.457,1,7,.143,325,707,.460,.457,124,157,.790,107,143,250,141,34,66,91,174,777
10453,CHI,1988,John Paxson,27,81,30,1888,287,582,.493,33,95,.347,254,487,.522,.521,33,45,.733,16,88,104,303,49,1,64,154,640
10454,CHI,1988,Horace Grant,22,81,6,1827,254,507,.501,0,2,.000,254,505,.503,.501,114,182,.626,155,292,447,89,51,53,86,221,622
10455,CHI,1988,Scottie Pippen,22,79,0,1650,261,564,.463,4,23,.174,257,541,.475,.466,99,172,.576,115,183,298,169,91,52,131,214,625
10456,CHI,1988,Rory Sparrow,29,55,25,992,112,274,.409,2,12,.167,110,262,.420,.412,24,33,.727,14,56,70,162,37,3,52,72,250
10457,CHI,1988,Sam Vincent,24,29,27,953,138,309,.447,3,8,.375,135,301,.449,.451,99,107,.925,18,85,103,244,34,12,84,82,378
10458,CHI,1988,Sedale Threatt,26,45,0,701,132,263,.502,2,20,.100,130,243,.535,.506,32,41,.780,12,43,55,107,27,3,44,71,298
10459,CHI,1988,Mike Brown,24,46,27,591,78,174,.448,0,1,.000,78,173,.451,.448,41,71,.577,66,93,159,28,11,4,38,85,197
10460,CHI,1988,Artis Gilmore,38,24,23,372,41,80,.513,0,0,,41,80,.513,.513,19,37,.514,15,48,63,9,5,12,28,54,101
10461,CHI,1988,Granville Waiters,27,22,0,114,9,29,.310,0,1,.000,9,28,.321,.310,0,2,.000,9,19,28,1,2,15,6,26,18
10462,CHI,1988,Elston Turner,28,17,0,98,8,30,.267,0,0,,8,30,.267,.267,1,2,.500,8,2,10,9,8,0,10,5,17
10463,CHI,1988,Tony White,22,2,0,2,0,0,,0,0,,0,0,,,0,0,,0,0,0,0,0,0,0,0,0
10464,CHI,1987,Michael Jordan,23,82,82,3281,1098,2279,.482,12,66,.182,1086,2213,.491,.484,833,972,.857,166,264,430,377,236,125,272,237,3041
10465,CHI,1987,Charles Oakley,23,82,81,2980,468,1052,.445,11,30,.367,457,1022,.447,.450,245,357,.686,299,775,1074,296,85,36,299,315,1192
10466,CHI,1987,John Paxson,26,82,64,2689,386,793,.487,52,140,.371,334,653,.511,.520,106,131,.809,22,117,139,467,66,8,105,207,930
10467,CHI,1987,Dave Corzine,30,82,39,2287,294,619,.475,0,5,.000,294,614,.479,.475,95,129,.736,199,341,540,209,38,87,114,202,683
10468,CHI,1987,Gene Banks,27,63,39,1822,249,462,.539,0,5,.000,249,457,.545,.539,112,146,.767,115,193,308,170,52,17,113,173,610
10469,CHI,1987,Brad Sellers,24,80,17,1751,276,606,.455,2,10,.200,274,596,.460,.457,126,173,.728,155,218,373,102,44,68,84,194,680
10470,CHI,1987,Earl Cureton,29,43,36,1105,129,276,.467,0,1,.000,129,275,.469,.467,39,73,.534,113,114,227,70,15,26,45,102,297
10471,CHI,1987,Elston Turner,27,70,4,936,112,252,.444,1,8,.125,111,244,.455,.446,23,31,.742,34,81,115,102,30,4,31,97,248
10472,CHI,1987,Mike Brown,23,62,3,818,106,201,.527,0,0,,106,201,.527,.527,46,72,.639,71,143,214,24,20,7,59,129,258
10473,CHI,1987,Sedale Threatt,25,40,0,778,131,273,.480,0,16,.000,131,257,.510,.480,53,66,.803,8,43,51,177,42,9,42,88,315
10474,CHI,1987,Granville Waiters,26,44,26,534,40,93,.430,0,1,.000,40,92,.435,.430,5,9,.556,38,49,87,22,10,31,16,83,85
10475,CHI,1987,Steve Colter,24,27,18,473,49,142,.345,0,9,.000,49,133,.368,.345,33,39,.846,9,33,42,94,19,6,32,38,131
10476,CHI,1987,Ben Poquette,31,21,1,167,21,40,.525,0,1,.000,21,39,.538,.525,9,11,.818,10,14,24,7,3,12,4,26,51
10477,CHI,1987,Pete Myers,23,29,0,155,19,52,.365,0,6,.000,19,46,.413,.365,28,43,.651,8,9,17,21,14,2,10,25,66
10478,CHI,1987,Fred Cofield,25,5,0,27,2,11,.182,0,1,.000,2,10,.200,.182,0,0,,1,4,5,4,2,0,1,1,4
10479,CHI,1987,Perry Young,23,5,0,20,2,4,.500,0,0,,2,4,.500,.500,1,2,.500,0,1,1,0,1,0,1,3,5
10480,CHI,1987,Darren Daye,26,1,0,7,0,0,,0,0,,0,0,,,0,0,,0,1,1,1,0,0,1,2,0
10481,CHI,1986,Kyle Macy,28,82,79,2426,286,592,.483,58,141,.411,228,451,.506,.532,73,90,.811,41,137,178,446,81,11,117,201,703
10482,CHI,1986,Sidney Green,25,80,68,2307,407,875,.465,0,8,.000,407,867,.469,.465,262,335,.782,208,450,658,139,70,37,220,292,1076
10483,CHI,1986,Orlando Woolridge,26,70,59,2248,540,1090,.495,4,23,.174,536,1067,.502,.497,364,462,.788,150,200,350,213,49,47,174,186,1448
10484,CHI,1986,Gene Banks,26,82,33,2139,356,688,.517,0,19,.000,356,669,.532,.517,183,255,.718,178,182,360,251,81,10,139,212,895
10485,CHI,1986,George Gervin,33,82,75,2065,519,1100,.472,4,19,.211,515,1081,.476,.474,283,322,.879,78,137,215,144,49,23,161,210,1325
10486,CHI,1986,Charles Oakley,22,77,30,1772,281,541,.519,0,3,.000,281,538,.522,.519,178,269,.662,255,409,664,133,68,30,175,250,740
10487,CHI,1986,Dave Corzine,29,67,4,1709,255,519,.491,3,12,.250,252,507,.497,.494,127,171,.743,132,301,433,150,28,53,104,133,640
10488,CHI,1986,John Paxson,25,75,3,1570,153,328,.466,15,50,.300,138,278,.496,.489,74,92,.804,18,76,94,274,55,2,63,172,395
10489,CHI,1986,Jawann Oldham,28,52,47,1276,167,323,.517,0,1,.000,167,322,.519,.517,53,91,.582,112,194,306,37,28,134,86,206,387
10490,CHI,1986,Quintin Dailey,25,35,0,723,203,470,.432,0,8,.000,203,462,.439,.432,163,198,.823,20,48,68,67,22,5,67,86,569
10491,CHI,1986,Michael Jordan,22,18,7,451,150,328,.457,3,18,.167,147,310,.474,.462,105,125,.840,23,41,64,53,37,21,45,46,408
10492,CHI,1986,Michael Holton,24,24,0,447,73,155,.471,1,10,.100,72,145,.497,.474,24,38,.632,10,20,30,48,23,0,23,40,171
10493,CHI,1986,Mike Smrek,23,38,5,408,46,122,.377,0,2,.000,46,120,.383,.377,16,29,.552,46,64,110,19,6,23,29,95,108
10494,CHI,1986,Tony Brown,25,10,0,132,18,41,.439,0,2,.000,18,39,.462,.439,9,13,.692,5,11,16,14,5,1,4,16,45
10495,CHI,1986,Billy McKinney,30,9,0,83,10,23,.435,0,0,,10,23,.435,.435,2,2,1.000,1,4,5,13,3,0,2,9,22
10496,CHI,1986,Rod Higgins,26,5,0,81,9,23,.391,0,1,.000,9,22,.409,.391,5,6,.833,3,4,7,5,4,3,2,11,23
10497,CHI,1986,Ron Brewer,30,4,0,18,3,9,.333,0,0,,3,9,.333,.333,1,1,1.000,0,0,0,0,0,0,2,1,7
10498,CHI,1985,Michael Jordan,21,82,82,3144,837,1625,.515,9,52,.173,828,1573,.526,.518,630,746,.845,167,367,534,481,196,69,291,285,2313
10499,CHI,1985,Orlando Woolridge,25,77,76,2816,679,1225,.554,0,5,.000,679,1220,.557,.554,409,521,.785,158,277,435,135,58,38,178,185,1767
10500,CHI,1985,Quintin Dailey,24,79,0,2101,525,1111,.473,7,30,.233,518,1081,.479,.476,205,251,.817,57,151,208,191,71,5,154,192,1262
10501,CHI,1985,Dave Corzine,28,82,50,2062,276,568,.486,0,1,.000,276,567,.487,.486,149,200,.745,130,292,422,140,32,64,124,189,701
10502,CHI,1985,Steve Johnson,27,74,54,1659,281,516,.545,0,3,.000,281,513,.548,.545,181,252,.718,146,291,437,64,37,62,151,265,743
10503,CHI,1985,Dave Greenwood,27,61,28,1523,152,332,.458,0,1,.000,152,331,.459,.458,67,94,.713,108,280,388,78,34,18,63,190,371
10504,CHI,1985,Wes Matthews,25,78,38,1523,191,386,.495,2,16,.125,189,370,.511,.497,59,85,.694,16,51,67,354,73,12,124,133,443
10505,CHI,1985,Ennis Whatley,22,70,44,1385,140,313,.447,1,9,.111,139,304,.457,.449,68,86,.791,34,67,101,381,66,10,144,141,349
10506,CHI,1985,Jawann Oldham,27,63,0,993,89,192,.464,0,1,.000,89,191,.466,.464,34,50,.680,79,157,236,31,11,127,58,166,212
10507,CHI,1985,Rod Higgins,25,68,5,942,119,270,.441,10,37,.270,109,233,.468,.459,60,90,.667,55,92,147,73,21,13,49,91,308
10508,CHI,1985,Caldwell Jones,34,42,32,885,53,115,.461,0,2,.000,53,113,.469,.461,36,47,.766,49,162,211,34,12,31,40,125,142
10509,CHI,1985,Sidney Green,24,48,1,740,108,250,.432,0,4,.000,108,246,.439,.432,79,98,.806,72,174,246,29,11,14,68,102,295
10510,CHI,1985,Charles Jones,27,3,0,29,2,4,.500,0,0,,2,4,.500,.500,4,6,.667,2,4,6,1,0,5,4,6,8
10511,CHI,1985,Chris Engler,25,3,0,3,1,2,.500,0,0,,1,2,.500,.500,0,0,,1,1,2,0,0,0,1,1,2
10512,CHI,1984,Dave Greenwood,26,78,76,2718,369,753,.490,0,1,.000,369,752,.491,.490,213,289,.737,214,572,786,139,67,72,149,265,951
10513,CHI,1984,Dave Corzine,27,82,82,2674,385,824,.467,3,9,.333,382,815,.469,.469,231,275,.840,169,406,575,202,58,120,175,227,1004
10514,CHI,1984,Orlando Woolridge,24,75,74,2544,570,1086,.525,1,2,.500,569,1084,.525,.525,303,424,.715,130,239,369,136,71,60,188,253,1444
10515,CHI,1984,Quintin Dailey,23,82,42,2449,583,1229,.474,4,32,.125,579,1197,.484,.476,321,396,.811,61,174,235,254,109,11,220,218,1491
10516,CHI,1984,Ennis Whatley,21,80,73,2159,261,556,.469,0,2,.000,261,554,.471,.469,146,200,.730,63,134,197,662,119,17,268,223,668
10517,CHI,1984,Mitchell Wiggins,24,82,40,2123,399,890,.448,7,29,.241,392,861,.455,.452,213,287,.742,138,190,328,187,106,11,139,278,1018
10518,CHI,1984,Rod Higgins,24,78,6,1577,193,432,.447,1,22,.045,192,410,.468,.448,113,156,.724,87,119,206,116,49,29,76,161,500
10519,CHI,1984,Jawann Oldham,26,64,0,870,110,218,.505,0,0,,110,218,.505,.505,39,66,.591,75,158,233,33,15,76,83,139,259
10520,CHI,1984,Ronnie Lester,25,43,3,687,78,188,.415,1,5,.200,77,183,.421,.418,75,87,.862,20,26,46,168,30,6,72,59,232
10521,CHI,1984,Sidney Green,23,49,0,667,100,228,.439,0,0,,100,228,.439,.439,55,77,.714,58,116,174,25,18,17,60,128,255
10522,CHI,1984,Reggie Theus,26,31,5,601,92,237,.388,3,15,.200,89,222,.401,.395,84,108,.778,21,25,46,142,21,3,59,78,271
10523,CHI,1984,Steve Johnson,26,31,9,594,113,198,.571,0,0,,113,198,.571,.571,64,110,.582,68,98,166,18,15,21,59,119,290
10524,CHI,1984,Wallace Bryant,24,29,0,317,52,133,.391,0,0,,52,133,.391,.391,14,33,.424,37,43,80,13,9,11,16,48,118
10525,CHI,1983,Reggie Theus,25,82,81,2856,749,1567,.478,21,91,.231,728,1476,.493,.485,434,542,.801,91,209,300,484,143,17,321,281,1953
10526,CHI,1983,Dave Corzine,26,82,71,2496,457,920,.497,0,2,.000,457,918,.498,.497,232,322,.720,243,474,717,154,47,109,228,242,1146
10527,CHI,1983,Dave Greenwood,25,79,61,2355,312,686,.455,0,4,.000,312,682,.457,.455,165,233,.708,217,548,765,151,54,90,154,261,789
10528,CHI,1983,Rod Higgins,23,82,42,2196,313,698,.448,13,41,.317,300,657,.457,.458,209,264,.792,159,207,366,175,66,65,127,248,848
10529,CHI,1983,Quintin Dailey,22,76,32,2081,470,1008,.466,5,25,.200,465,983,.473,.469,206,282,.730,87,173,260,280,72,10,205,248,1151
10530,CHI,1983,Mark Olberding,26,80,31,1817,251,522,.481,2,12,.167,249,510,.488,.483,194,248,.782,108,250,358,131,50,9,152,246,698
10531,CHI,1983,Orlando Woolridge,23,57,38,1627,361,622,.580,0,3,.000,361,619,.583,.580,217,340,.638,122,176,298,97,38,44,157,177,939
10532,CHI,1983,Ronnie Lester,24,65,38,1437,202,446,.453,0,5,.000,202,441,.458,.453,124,171,.725,46,126,172,332,51,6,134,121,528
10533,CHI,1983,Tracy Jackson,23,78,3,1309,199,426,.467,2,13,.154,197,413,.477,.469,92,126,.730,87,92,179,105,64,11,83,132,492
10534,CHI,1983,Dudley Bradley,25,58,11,683,82,159,.516,1,5,.200,81,154,.526,.519,36,45,.800,27,78,105,106,49,10,59,91,201
10535,CHI,1983,Dwight Jones,30,49,2,673,86,193,.446,0,0,,86,193,.446,.446,47,75,.627,56,139,195,40,18,14,66,90,219
10536,CHI,1983,Jawann Oldham,25,16,0,171,31,58,.534,0,0,,31,58,.534,.534,12,22,.545,18,29,47,5,5,13,13,30,74
10537,CHI,1983,Mike Bratz,27,15,0,140,14,42,.333,1,8,.125,13,34,.382,.345,10,13,.769,3,16,19,23,7,0,14,20,39
10538,CHI,1983,Larry Spriggs,23,9,0,39,8,20,.400,0,0,,8,20,.400,.400,5,7,.714,2,7,9,3,1,2,2,3,21
10539,CHI,1983,Larry Kenon,30,5,0,25,2,6,.333,0,0,,2,6,.333,.333,0,0,,1,3,4,0,1,0,2,2,4
10540,CHI,1982,Dave Greenwood,24,82,82,2914,480,1014,.473,0,3,.000,480,1011,.475,.473,240,291,.825,192,594,786,262,70,93,180,292,1200
10541,CHI,1982,Reggie Theus,24,82,82,2838,560,1194,.469,25,100,.250,535,1094,.489,.479,363,449,.808,115,197,312,476,87,16,277,243,1508
10542,CHI,1982,Artis Gilmore,32,82,82,2796,546,837,.652,1,1,1.000,545,836,.652,.653,424,552,.768,224,611,835,136,49,220,227,287,1517
10543,CHI,1982,Ronnie Lester,23,75,74,2252,329,657,.501,4,8,.500,325,649,.501,.504,208,256,.813,75,138,213,362,80,14,185,158,870
10544,CHI,1982,Dwight Jones,29,78,18,2040,303,572,.530,1,1,1.000,302,571,.529,.531,172,238,.723,156,351,507,114,49,36,155,217,779
10545,CHI,1982,Ricky Sobers,29,80,6,1938,363,801,.453,19,76,.250,344,725,.474,.465,195,254,.768,37,105,142,301,73,18,217,238,940
10546,CHI,1982,Orlando Woolridge,22,75,12,1188,202,394,.513,0,3,.000,202,391,.517,.513,144,206,.699,82,145,227,81,23,24,107,152,548
10547,CHI,1982,Larry Kenon,29,60,30,1036,192,412,.466,0,0,,192,412,.466,.466,50,88,.568,72,108,180,65,30,7,82,71,434
10548,CHI,1982,Coby Dietrick,33,74,0,999,92,200,.460,0,1,.000,92,199,.462,.460,38,54,.704,63,125,188,87,49,30,44,131,222
10549,CHI,1982,James Wilkes,23,57,22,862,128,266,.481,0,1,.000,128,265,.483,.481,58,80,.725,62,97,159,64,30,18,62,112,314
10550,CHI,1982,Ray Blume,23,49,2,546,102,222,.459,4,18,.222,98,204,.480,.468,18,28,.643,14,27,41,68,23,2,54,57,226
10551,CHI,1982,Tracy Jackson,22,38,0,412,69,146,.473,0,0,,69,146,.473,.473,32,39,.821,28,23,51,22,11,3,18,43,170
10552,CHI,1982,Roger Burkman,23,6,0,30,0,4,.000,0,1,.000,0,3,.000,.000,5,6,.833,2,4,6,5,6,2,3,6,5
10553,CHI,1982,Jackie Robinson,26,3,0,29,3,9,.333,0,0,,3,9,.333,.333,4,4,1.000,3,0,3,0,0,0,1,1,10
10554,CHI,1981,Artis Gilmore,31,82,82,2832,547,816,.670,0,0,,547,816,.670,.670,375,532,.705,220,608,828,172,47,198,236,295,1469
10555,CHI,1981,Reggie Theus,23,82,82,2820,543,1097,.495,18,90,.200,525,1007,.521,.503,445,550,.809,124,163,287,426,122,20,259,258,1549
10556,CHI,1981,Dave Greenwood,23,82,82,2710,481,989,.486,0,2,.000,481,987,.487,.486,217,290,.748,243,481,724,218,77,124,192,282,1179
10557,CHI,1981,Bob Wilkerson,26,80,49,2238,330,715,.462,1,10,.100,329,705,.467,.462,137,163,.840,86,196,282,272,102,23,175,170,798
10558,CHI,1981,Larry Kenon,28,77,70,2161,454,946,.480,0,0,,454,946,.480,.480,180,245,.735,179,219,398,120,75,18,161,160,1088
10559,CHI,1981,Ricky Sobers,28,71,0,1803,355,769,.462,17,66,.258,338,703,.481,.473,231,247,.935,46,98,144,284,98,17,206,225,958
10560,CHI,1981,Dwight Jones,28,81,9,1574,245,507,.483,0,0,,245,507,.483,.483,125,161,.776,127,274,401,99,40,36,126,200,615
10561,CHI,1981,Coby Dietrick,32,82,0,1243,146,320,.456,2,6,.333,144,314,.459,.459,77,111,.694,79,186,265,118,48,53,88,176,371
10562,CHI,1981,Sam Worthen,23,64,33,945,95,192,.495,0,4,.000,95,188,.505,.495,45,60,.750,22,93,115,115,57,6,91,115,235
10563,CHI,1981,Scott May,26,63,2,815,165,338,.488,0,0,,165,338,.488,.488,113,149,.758,62,93,155,63,35,7,71,83,443
10564,CHI,1981,James Wilkes,22,48,1,540,85,184,.462,0,1,.000,85,183,.464,.462,29,42,.690,36,60,96,30,25,12,34,86,199
10565,CHI,1981,Ronnie Lester,22,8,0,83,10,24,.417,0,0,,10,24,.417,.417,10,11,.909,3,3,6,7,2,0,9,5,30
10566,CHI,1981,Ollie Mack,23,3,0,16,1,6,.167,0,0,,1,6,.167,.167,1,2,.500,0,1,1,1,1,0,0,3,3
10567,CHI,1980,Reggie Theus,22,82,82,3029,566,1172,.483,28,105,.267,538,1067,.504,.495,500,597,.838,143,186,329,515,114,20,348,262,1660
10568,CHI,1980,Dave Greenwood,22,82,82,2791,498,1051,.474,1,7,.143,497,1044,.476,.474,337,416,.810,223,550,773,182,60,129,210,313,1334
10569,CHI,1980,Ricky Sobers,27,82,82,2673,470,1002,.469,21,68,.309,449,934,.481,.480,200,239,.837,75,167,242,426,136,17,282,294,1161
10570,CHI,1980,Coby Dietrick,31,79,40,1830,227,500,.454,1,9,.111,226,491,.460,.455,90,118,.763,101,262,363,216,89,51,112,230,545
10571,CHI,1980,Artis Gilmore,30,48,48,1568,305,513,.595,0,0,,305,513,.595,.595,245,344,.712,108,324,432,133,29,59,133,167,855
10572,CHI,1980,Ollie Johnson,30,79,1,1535,262,527,.497,1,11,.091,261,516,.506,.498,82,93,.882,50,113,163,161,59,24,96,165,607
10573,CHI,1980,Scott May,25,54,53,1298,264,587,.450,0,4,.000,264,583,.453,.450,144,172,.837,78,140,218,104,45,5,77,126,672
10574,CHI,1980,Dwight Jones,27,53,0,1170,207,387,.535,0,0,,207,387,.535,.535,119,165,.721,83,213,296,90,24,37,102,159,533
10575,CHI,1980,Mark Landsberger,24,54,16,1136,183,346,.529,0,0,,183,346,.529,.529,87,166,.524,157,293,450,32,23,17,75,113,453
10576,CHI,1980,Del Beshore,23,68,0,869,88,250,.352,10,26,.385,78,224,.348,.372,58,87,.667,16,47,63,139,58,5,104,105,244
10577,CHI,1980,Dennis Awtrey,31,26,6,560,27,60,.450,0,0,,27,60,.450,.450,32,50,.640,29,86,115,40,12,15,27,66,86
10578,CHI,1980,Ollie Mack,22,23,,526,77,149,.517,0,4,.000,77,145,.531,.517,29,33,.879,25,24,49,33,20,3,26,34,183
10579,CHI,1980,Sam Smith,25,30,0,496,97,230,.422,8,35,.229,89,195,.456,.439,57,63,.905,22,32,54,42,25,7,33,54,259
10580,CHI,1980,John Mengelt,30,36,0,387,90,166,.542,0,6,.000,90,160,.563,.542,39,49,.796,3,20,23,38,10,0,36,54,219
10581,CHI,1980,Roger Brown,29,4,0,37,1,3,.333,0,0,,1,3,.333,.333,0,0,,2,8,10,1,0,3,0,4,2
10582,CHO,2024,Miles Bridges,25,69,67,2581,559,1210,.462,157,450,.349,402,760,.529,.527,174,211,.825,71,434,505,231,65,33,138,118,1449
10583,CHO,2024,Brandon Miller,21,74,68,2383,476,1083,.440,184,493,.373,292,590,.495,.524,143,173,.827,60,255,315,175,66,42,132,184,1279
10584,CHO,2024,Nick Richards,26,67,51,1759,260,376,.691,0,1,.000,260,375,.693,.691,132,179,.737,172,367,539,54,26,74,73,176,652
10585,CHO,2024,P.J. Washington,25,44,17,1286,227,509,.446,79,244,.324,148,265,.558,.524,67,94,.713,53,179,232,97,38,32,66,112,600
10586,CHO,2024,Terry Rozier,29,30,30,1065,252,549,.459,83,232,.358,169,317,.533,.535,109,129,.845,17,100,117,198,32,12,65,52,696
10587,CHO,2024,Grant Williams,25,29,10,888,145,288,.503,47,126,.373,98,162,.605,.585,65,85,.765,40,109,149,93,20,12,56,89,402
10588,CHO,2024,Bryce McGowens,21,59,14,882,101,230,.439,34,102,.333,67,128,.523,.513,66,85,.776,17,85,102,51,21,10,30,74,302
10589,CHO,2024,Tre Mann,22,28,28,868,125,276,.453,39,107,.364,86,169,.509,.524,44,58,.759,16,109,125,145,48,3,56,45,333
10590,CHO,2024,Vasilije Micić,30,30,21,815,122,279,.437,32,109,.294,90,170,.529,.495,47,56,.839,13,51,64,186,22,4,70,46,323
10591,CHO,2024,Gordon Hayward,33,25,25,798,139,297,.468,22,61,.361,117,236,.496,.505,62,81,.765,25,92,117,116,28,12,51,46,362
10592,CHO,2024,JT Thor,21,63,3,781,80,183,.437,28,81,.346,52,102,.510,.514,11,20,.550,43,103,146,29,11,27,15,60,199
10593,CHO,2024,Cody Martin,28,28,22,753,82,215,.381,27,86,.314,55,129,.426,.444,20,33,.606,19,90,109,104,32,18,44,48,211
10594,CHO,2024,Ish Smith,35,43,5,741,66,158,.418,4,8,.500,62,150,.413,.430,3,4,.750,11,65,76,145,17,4,47,49,139
10595,CHO,2024,Nick Smith Jr.,19,51,0,729,113,289,.391,63,146,.432,50,143,.350,.500,13,15,.867,18,54,72,59,10,7,39,55,302
10596,CHO,2024,LaMelo Ball,22,22,22,711,183,423,.433,70,197,.355,113,226,.500,.515,90,104,.865,29,84,113,176,40,4,83,79,526
10597,CHO,2024,Dāvis Bertāns,31,28,1,583,82,208,.394,66,176,.375,16,32,.500,.553,16,18,.889,7,44,51,26,23,9,17,46,246
10598,CHO,2024,Mark Williams,22,19,19,508,98,151,.649,0,0,,98,151,.649,.649,46,64,.719,76,108,184,22,16,20,17,50,242
10599,CHO,2024,Aleksej Pokusevski,22,18,0,345,45,105,.429,16,44,.364,29,61,.475,.505,28,37,.757,15,64,79,30,14,12,16,17,134
10600,CHO,2024,Nathan Mensah,25,25,0,307,12,28,.429,0,0,,12,28,.429,.429,9,12,.750,29,36,65,9,6,14,14,64,33
10601,CHO,2024,Leaky Black,24,26,3,284,25,52,.481,9,20,.450,16,32,.500,.567,10,15,.667,9,39,48,24,8,11,6,19,69
10602,CHO,2024,Théo Maledon,22,13,1,200,19,66,.288,5,30,.167,14,36,.389,.326,11,12,.917,4,19,23,28,7,0,15,18,54
10603,CHO,2024,Seth Curry,33,8,1,159,26,59,.441,9,28,.321,17,31,.548,.517,11,12,.917,3,13,16,14,5,3,5,7,72
10604,CHO,2024,Marques Bolden,25,9,2,118,17,25,.680,0,1,.000,17,24,.708,.680,3,4,.750,10,22,32,4,3,7,3,9,37
10605,CHO,2024,James Bouknight,23,14,0,81,18,41,.439,13,30,.433,5,11,.455,.598,1,2,.500,1,8,9,6,1,1,2,3,50
10606,CHO,2024,Amari Bailey,19,10,0,65,8,24,.333,1,8,.125,7,16,.438,.354,6,7,.857,6,3,9,7,3,0,4,2,23
10607,CHO,2024,Frank Ntilikina,25,5,0,43,1,9,.111,1,8,.125,0,1,.000,.167,2,2,1.000,1,5,6,4,0,0,1,4,5
10608,CHO,2023,P.J. Washington,24,73,73,2380,434,978,.444,149,428,.348,285,550,.518,.520,127,174,.730,73,285,358,175,66,79,110,193,1144
10609,CHO,2023,Terry Rozier,28,63,63,2221,493,1188,.415,165,505,.327,328,683,.480,.484,178,220,.809,51,208,259,319,74,16,134,119,1329
10610,CHO,2023,Mason Plumlee,32,56,56,1597,265,396,.669,0,0,,265,396,.669,.669,155,256,.605,187,354,541,205,35,35,87,161,685
10611,CHO,2023,Gordon Hayward,32,50,50,1577,276,581,.475,52,160,.325,224,421,.532,.520,129,159,.811,33,182,215,206,42,12,99,70,733
10612,CHO,2023,Kelly Oubre Jr.,27,48,40,1548,353,819,.431,108,339,.319,245,480,.510,.497,158,208,.760,65,184,249,54,68,18,64,141,972
10613,CHO,2023,Jalen McDaniels,25,56,21,1494,221,494,.447,65,202,.322,156,292,.534,.513,88,104,.846,44,226,270,111,66,29,80,158,595
10614,CHO,2023,Dennis Smith Jr.,25,54,15,1390,186,452,.412,24,111,.216,162,341,.475,.438,78,106,.736,27,140,167,261,75,25,82,122,474
10615,CHO,2023,LaMelo Ball,21,36,36,1268,296,721,.411,144,383,.376,152,338,.450,.510,102,122,.836,42,189,231,304,46,11,129,118,838
10616,CHO,2023,Nick Richards,25,65,9,1217,197,313,.629,1,1,1.000,196,312,.628,.631,137,183,.749,147,269,416,38,11,71,59,154,532
10617,CHO,2023,JT Thor,20,69,8,969,95,238,.399,39,123,.317,56,115,.487,.481,33,47,.702,36,116,152,36,22,23,44,66,262
10618,CHO,2023,Théo Maledon,21,44,7,854,102,254,.402,28,95,.295,74,159,.465,.457,63,74,.851,14,109,123,152,37,12,59,61,295
10619,CHO,2023,Mark Williams,21,43,17,828,160,251,.637,0,0,,160,251,.637,.637,67,97,.691,93,211,304,18,28,45,40,94,387
10620,CHO,2023,Bryce McGowens,20,46,7,787,80,202,.396,26,80,.325,54,122,.443,.460,60,80,.750,20,73,93,54,15,6,43,48,246
10621,CHO,2023,Kai Jones,22,46,0,550,67,120,.558,4,19,.211,63,101,.624,.575,19,26,.731,37,86,123,15,17,30,31,65,157
10622,CHO,2023,James Bouknight,22,34,0,515,69,193,.358,33,109,.303,36,84,.429,.443,20,30,.667,8,64,72,41,14,5,32,49,191
10623,CHO,2023,Svi Mykhailiuk,25,19,8,428,71,161,.441,36,89,.404,35,72,.486,.553,23,34,.676,15,31,46,52,14,4,22,22,201
10624,CHO,2023,Cody Martin,27,7,0,134,14,36,.389,3,14,.214,11,22,.500,.431,4,7,.571,8,16,24,11,4,1,2,13,35
10625,CHO,2023,Xavier Sneed,25,4,0,48,5,10,.500,3,6,.500,2,4,.500,.650,4,4,1.000,0,5,5,5,0,1,3,7,17
10626,CHO,2023,Kobi Simmons,25,5,0,28,1,6,.167,1,5,.200,0,1,.000,.250,2,2,1.000,1,3,4,5,0,2,1,0,5
10627,CHO,2022,Miles Bridges,23,80,80,2837,596,1214,.491,154,465,.331,442,749,.590,.554,267,333,.802,90,469,559,300,74,67,150,193,1613
10628,CHO,2022,Terry Rozier,27,73,73,2458,518,1167,.444,222,593,.374,296,574,.516,.539,150,176,.852,56,259,315,326,93,25,96,119,1408
10629,CHO,2022,LaMelo Ball,20,75,75,2422,538,1254,.429,220,565,.389,318,689,.462,.517,212,243,.872,108,393,501,571,119,30,245,237,1508
10630,CHO,2022,Kelly Oubre Jr.,26,76,13,1999,410,932,.440,191,553,.345,219,379,.578,.542,126,189,.667,79,223,302,84,77,31,67,189,1137
10631,CHO,2022,Cody Martin,26,71,11,1866,204,423,.482,61,159,.384,143,264,.542,.554,75,107,.701,82,203,285,179,88,32,61,116,544
10632,CHO,2022,Mason Plumlee,31,73,73,1793,205,320,.641,0,2,.000,205,318,.645,.641,67,171,.392,176,389,565,226,61,52,100,224,477
10633,CHO,2022,P.J. Washington,23,65,28,1768,250,532,.470,110,301,.365,140,231,.606,.573,58,81,.716,82,255,337,147,57,61,82,152,668
10634,CHO,2022,Gordon Hayward,31,49,48,1564,283,617,.459,86,220,.391,197,397,.496,.528,126,149,.846,38,186,224,177,47,22,81,85,778
10635,CHO,2022,Jalen McDaniels,24,55,2,895,123,254,.484,41,108,.380,82,146,.562,.565,53,72,.736,37,133,170,58,26,22,36,93,340
10636,CHO,2022,Montrezl Harrell,28,25,0,524,111,172,.645,0,2,.000,111,170,.653,.645,63,91,.692,53,69,122,49,11,12,22,49,285
10637,CHO,2022,Ish Smith,33,37,1,511,73,185,.395,10,25,.400,63,160,.394,.422,12,19,.632,11,46,57,98,20,10,36,34,168
10638,CHO,2022,Nick Richards,24,50,5,367,60,90,.667,0,0,,60,90,.667,.667,30,43,.698,34,52,86,13,9,21,24,51,150
10639,CHO,2022,James Bouknight,21,31,0,304,49,141,.348,17,49,.347,32,92,.348,.408,27,31,.871,22,30,52,26,7,1,15,29,142
10640,CHO,2022,JT Thor,19,33,0,262,24,55,.436,7,27,.259,17,28,.607,.500,12,20,.600,11,32,43,19,8,11,10,26,67
10641,CHO,2022,Isaiah Thomas,32,17,0,219,52,120,.433,23,58,.397,29,62,.468,.529,14,15,.933,3,18,21,24,7,3,10,22,141
10642,CHO,2022,Kai Jones,21,21,0,63,9,14,.643,1,2,.500,8,12,.667,.679,3,8,.375,3,8,11,4,1,2,6,8,22
10643,CHO,2022,Vernon Carey Jr.,20,4,1,17,3,6,.500,0,0,,3,6,.500,.500,2,3,.667,3,2,5,0,1,0,1,1,8
10644,CHO,2022,Scottie Lewis,21,2,0,7,0,0,,0,0,,0,0,,,1,2,.500,0,0,0,1,1,0,0,0,1
10645,CHO,2022,Arnoldas Kulboka,24,2,0,5,0,1,.000,0,1,.000,0,0,,.000,0,0,,0,0,0,0,0,0,0,1,0
10646,CHO,2021,Terry Rozier,26,69,69,2383,510,1134,.450,222,571,.389,288,563,.512,.548,165,202,.817,47,255,302,293,87,26,128,119,1407
10647,CHO,2021,P.J. Washington,22,64,61,1954,302,686,.440,112,290,.386,190,396,.480,.522,108,145,.745,93,325,418,161,69,79,128,171,824
10648,CHO,2021,Miles Bridges,22,66,19,1932,313,622,.503,116,290,.400,197,332,.593,.596,98,113,.867,81,316,397,147,44,52,106,143,840
10649,CHO,2021,Devonte' Graham,25,55,44,1659,252,669,.377,179,477,.375,73,192,.380,.510,133,158,.842,22,126,148,295,48,6,84,77,816
10650,CHO,2021,Gordon Hayward,30,44,44,1496,311,658,.473,85,205,.415,226,453,.499,.537,156,185,.843,37,221,258,181,52,14,91,74,863
10651,CHO,2021,LaMelo Ball,19,51,31,1469,293,672,.436,92,261,.352,201,411,.489,.504,125,165,.758,63,239,302,313,81,18,145,136,803
10652,CHO,2021,Bismack Biyombo,28,66,36,1349,142,242,.587,0,1,.000,142,241,.589,.587,47,105,.448,137,210,347,81,17,74,71,141,331
10653,CHO,2021,Cody Zeller,28,48,21,1005,181,324,.559,4,28,.143,177,296,.598,.565,85,119,.714,119,209,328,86,27,17,51,121,451
10654,CHO,2021,Jalen McDaniels,23,47,18,904,133,284,.468,35,105,.333,98,179,.547,.530,45,64,.703,45,124,169,53,28,19,45,95,346
10655,CHO,2021,Malik Monk,22,42,0,878,173,399,.434,85,212,.401,88,187,.471,.540,59,72,.819,14,87,101,87,19,4,55,47,490
10656,CHO,2021,Cody Martin,25,52,10,849,83,188,.441,16,58,.276,67,130,.515,.484,25,43,.581,52,109,161,86,37,12,40,52,207
10657,CHO,2021,Caleb Martin,25,53,3,818,96,256,.375,31,125,.248,65,131,.496,.436,41,64,.641,31,110,141,67,37,12,33,62,264
10658,CHO,2021,Brad Wanamaker,31,22,0,428,54,126,.429,3,24,.125,51,102,.500,.440,40,45,.889,10,29,39,75,17,5,34,39,151
10659,CHO,2021,Vernon Carey Jr.,19,19,4,115,18,36,.500,1,7,.143,17,29,.586,.514,9,11,.818,6,21,27,2,1,5,5,13,46
10660,CHO,2021,Nick Richards,23,18,0,63,4,9,.444,0,1,.000,4,8,.500,.444,7,11,.636,4,7,11,2,0,0,3,7,15
10661,CHO,2021,Grant Riller,23,7,0,27,8,12,.667,2,4,.500,6,8,.750,.750,0,0,,0,1,1,3,1,0,1,0,18
10662,CHO,2021,Nate Darling,22,7,0,26,2,7,.286,2,7,.286,0,0,,.429,3,3,1.000,1,0,1,1,0,1,1,1,9
10663,CHO,2020,Devonte' Graham,24,63,53,2211,368,963,.382,218,585,.373,150,378,.397,.495,191,233,.820,42,170,212,471,62,15,181,115,1145
10664,CHO,2020,Terry Rozier,25,63,63,2164,398,941,.423,172,423,.407,226,518,.436,.514,166,190,.874,50,226,276,259,61,10,141,126,1134
10665,CHO,2020,Miles Bridges,21,65,64,1995,319,753,.424,99,300,.330,220,453,.486,.489,106,131,.809,88,274,362,114,40,48,95,132,843
10666,CHO,2020,P.J. Washington,21,58,57,1759,268,589,.455,86,230,.374,182,359,.507,.528,88,136,.647,58,258,316,123,51,44,93,158,710
10667,CHO,2020,Cody Zeller,27,58,39,1341,251,479,.524,18,75,.240,233,404,.577,.543,122,179,.682,160,251,411,88,40,25,75,140,642
10668,CHO,2020,Malik Monk,21,55,1,1169,212,488,.434,58,204,.284,154,284,.542,.494,82,100,.820,27,130,157,114,25,16,77,74,564
10669,CHO,2020,Bismack Biyombo,27,53,29,1029,151,278,.543,0,0,,151,278,.543,.543,91,151,.603,120,188,308,50,10,49,48,116,393
10670,CHO,2020,Cody Martin,24,48,3,903,89,207,.430,18,77,.234,71,130,.546,.473,42,65,.646,38,120,158,95,39,9,44,78,238
10671,CHO,2020,Marvin Williams,33,41,1,808,94,210,.448,44,117,.376,50,93,.538,.552,43,50,.860,15,94,109,41,26,22,25,71,275
10672,CHO,2020,Dwayne Bacon,24,39,11,687,85,244,.348,19,67,.284,66,177,.373,.387,35,53,.660,15,85,100,52,23,2,37,52,224
10673,CHO,2020,Nicolas Batum,31,22,3,505,28,81,.346,14,49,.286,14,32,.438,.432,9,10,.900,25,75,100,66,17,8,22,41,79
10674,CHO,2020,Willy Hernangómez,25,31,0,375,74,139,.532,5,22,.227,69,117,.590,.550,37,59,.627,43,91,134,29,10,7,30,32,190
10675,CHO,2020,Caleb Martin,24,18,1,317,37,84,.440,20,37,.541,17,47,.362,.560,17,21,.810,10,28,38,23,12,7,15,32,111
10676,CHO,2020,Jalen McDaniels,22,16,0,293,33,70,.471,9,24,.375,24,46,.522,.536,14,17,.824,15,50,65,13,8,3,11,36,89
10677,CHO,2020,Michael Kidd-Gilchrist,26,12,0,160,18,53,.340,5,17,.294,13,36,.361,.387,7,9,.778,9,26,35,10,0,3,7,18,48
10678,CHO,2020,Joe Chealey,24,4,0,33,0,7,.000,0,4,.000,0,3,.000,.000,2,2,1.000,0,0,0,1,4,0,2,2,2
10679,CHO,2019,Kemba Walker,28,82,82,2863,731,1684,.434,260,731,.356,471,953,.494,.511,380,450,.844,52,309,361,484,102,34,211,131,2102
10680,CHO,2019,Nicolas Batum,30,75,72,2354,253,562,.450,116,298,.389,137,264,.519,.553,77,89,.865,71,319,390,247,71,43,117,140,699
10681,CHO,2019,Jeremy Lamb,26,79,55,2250,431,979,.440,115,330,.348,316,649,.487,.499,231,260,.888,65,369,434,172,88,32,80,140,1208
10682,CHO,2019,Marvin Williams,32,75,75,2133,275,652,.422,140,382,.366,135,270,.500,.529,66,86,.767,76,331,407,92,71,61,47,156,756
10683,CHO,2019,Miles Bridges,20,80,25,1696,237,511,.464,65,200,.325,172,311,.553,.527,58,77,.753,67,256,323,95,55,49,50,111,597
10684,CHO,2019,Malik Monk,20,73,0,1258,227,586,.387,109,330,.330,118,256,.461,.480,90,102,.882,16,121,137,117,37,19,86,106,653
10685,CHO,2019,Cody Zeller,26,49,47,1243,190,345,.551,6,22,.273,184,323,.570,.559,111,141,.787,110,223,333,102,38,41,62,164,497
10686,CHO,2019,Michael Kidd-Gilchrist,25,64,3,1179,158,332,.476,16,47,.340,142,285,.498,.500,95,123,.772,88,158,246,61,32,39,43,156,427
10687,CHO,2019,Tony Parker,36,56,0,1003,213,463,.460,13,51,.255,200,412,.485,.474,91,124,.734,14,69,83,207,21,7,75,53,530
10688,CHO,2019,Willy Hernangómez,24,58,3,812,153,295,.519,15,39,.385,138,256,.539,.544,100,144,.694,117,194,311,60,16,20,58,98,421
10689,CHO,2019,Bismack Biyombo,26,54,32,783,89,156,.571,0,0,,89,156,.571,.571,58,91,.637,81,166,247,33,11,41,34,103,236
10690,CHO,2019,Dwayne Bacon,23,43,13,759,122,257,.475,38,87,.437,84,170,.494,.549,34,46,.739,8,81,89,47,12,5,18,72,316
10691,CHO,2019,Frank Kaminsky,25,47,0,755,138,298,.463,50,139,.360,88,159,.553,.547,79,107,.738,39,124,163,63,12,12,41,68,405
10692,CHO,2019,Devonte' Graham,23,46,3,676,74,216,.343,34,121,.281,40,95,.421,.421,35,46,.761,10,53,63,121,23,2,30,48,217
10693,CHO,2019,Shelvin Mack,28,4,0,42,2,14,.143,0,2,.000,2,12,.167,.143,5,9,.556,0,2,2,1,2,0,4,3,9
10694,CHO,2019,J.P. Macura,23,2,0,17,3,9,.333,0,4,.000,3,5,.600,.333,0,0,,0,3,3,2,0,0,0,0,6
10695,CHO,2019,Joe Chealey,23,1,0,8,1,3,.333,0,0,,1,3,.333,.333,0,0,,0,0,0,1,0,0,0,1,2
10696,CHO,2018,Kemba Walker,27,80,80,2736,588,1363,.431,231,601,.384,357,762,.469,.516,363,420,.864,32,216,248,444,91,24,179,98,1770
10697,CHO,2018,Dwight Howard,32,81,81,2463,506,911,.555,1,7,.143,505,904,.559,.556,334,582,.574,255,757,1012,105,48,131,208,249,1347
10698,CHO,2018,Marvin Williams,31,78,78,2006,258,563,.458,126,305,.413,132,258,.512,.570,102,123,.829,74,296,370,96,56,38,66,116,744
10699,CHO,2018,Nicolas Batum,29,64,64,1981,270,650,.415,92,274,.336,178,376,.473,.486,108,130,.831,57,249,306,349,65,23,131,72,740
10700,CHO,2018,Jeremy Lamb,25,80,18,1967,380,832,.457,94,254,.370,286,578,.495,.513,179,208,.861,49,275,324,186,61,32,93,138,1033
10701,CHO,2018,Michael Kidd-Gilchrist,24,74,74,1850,282,560,.504,0,2,.000,282,558,.505,.504,117,171,.684,84,218,302,71,51,32,53,143,681
10702,CHO,2018,Frank Kaminsky,24,79,4,1835,307,716,.429,104,274,.380,203,442,.459,.501,155,194,.799,46,242,288,129,36,19,66,95,873
10703,CHO,2018,Treveon Graham,24,63,2,1050,96,221,.434,40,97,.412,56,124,.452,.525,41,59,.695,42,79,121,59,33,2,27,109,273
10704,CHO,2018,Malik Monk,19,63,0,854,153,425,.360,83,243,.342,70,182,.385,.458,32,38,.842,8,58,66,91,20,9,49,60,421
10705,CHO,2018,Michael Carter-Williams,26,52,2,835,76,229,.332,14,59,.237,62,170,.365,.362,73,89,.820,37,101,138,116,44,23,52,99,239
10706,CHO,2018,Dwayne Bacon,22,53,6,713,72,192,.375,11,43,.256,61,149,.409,.404,20,25,.800,4,120,124,38,16,2,23,46,175
10707,CHO,2018,Cody Zeller,25,33,0,627,85,156,.545,2,3,.667,83,153,.542,.551,61,85,.718,67,110,177,31,14,21,33,81,233
10708,CHO,2018,Johnny O'Bryant,24,36,0,379,68,171,.398,14,43,.326,54,128,.422,.439,21,25,.840,29,64,93,14,9,6,15,45,171
10709,CHO,2018,Willy Hernangómez,23,22,1,262,42,83,.506,4,7,.571,38,76,.500,.530,47,62,.758,39,77,116,12,10,9,9,32,135
10710,CHO,2018,Julyan Stone,29,23,0,175,6,13,.462,6,13,.462,0,0,,.692,1,2,.500,1,28,29,26,4,2,7,21,19
10711,CHO,2018,Marcus Paige,24,5,0,28,4,14,.286,2,8,.250,2,6,.333,.357,2,2,1.000,0,4,4,3,0,0,0,0,12
10712,CHO,2018,Mangok Mathiang,25,4,0,20,4,7,.571,0,0,,4,7,.571,.571,0,1,.000,3,7,10,0,1,0,0,5,8
10713,CHO,2017,Kemba Walker,26,79,79,2739,643,1449,.444,240,602,.399,403,847,.476,.527,304,359,.847,45,263,308,434,85,22,168,119,1830
10714,CHO,2017,Nicolas Batum,28,77,77,2617,393,975,.403,135,405,.333,258,570,.453,.472,243,284,.856,46,435,481,456,86,29,194,109,1164
10715,CHO,2017,Michael Kidd-Gilchrist,23,81,81,2349,295,618,.477,1,9,.111,294,609,.483,.478,152,194,.784,156,409,565,114,81,77,56,187,743
10716,CHO,2017,Marvin Williams,30,76,76,2295,297,704,.422,124,354,.350,173,350,.494,.510,131,150,.873,89,411,500,106,58,53,60,134,849
10717,CHO,2017,Frank Kaminsky,23,75,16,1954,320,802,.399,116,354,.328,204,448,.455,.471,118,156,.756,57,279,336,162,46,34,76,139,874
10718,CHO,2017,Marco Belinelli,30,74,0,1778,264,615,.429,102,283,.360,162,332,.488,.512,150,168,.893,14,164,178,147,44,9,70,90,780
10719,CHO,2017,Cody Zeller,24,62,58,1725,253,443,.571,0,1,.000,253,442,.572,.571,133,196,.679,135,270,405,99,62,58,65,189,639
10720,CHO,2017,Jeremy Lamb,24,62,5,1143,226,491,.460,41,146,.281,185,345,.536,.502,110,129,.853,30,234,264,75,27,23,40,98,603
10721,CHO,2017,Ramon Sessions,30,50,1,811,100,263,.380,21,62,.339,79,201,.393,.420,91,118,.771,11,62,73,129,27,3,46,43,312
10722,CHO,2017,Roy Hibbert,30,42,13,671,78,144,.542,0,0,,78,144,.542,.542,61,75,.813,53,97,150,20,8,44,31,97,217
10723,CHO,2017,Spencer Hawes,28,35,1,626,104,218,.477,16,55,.291,88,163,.540,.514,30,34,.882,32,114,146,62,13,26,40,61,254
10724,CHO,2017,Brian Roberts,31,41,2,416,46,122,.377,17,44,.386,29,78,.372,.447,33,39,.846,5,34,39,52,9,1,26,18,142
10725,CHO,2017,Treveon Graham,23,27,1,189,19,40,.475,9,15,.600,10,25,.400,.588,10,15,.667,5,17,22,6,6,1,3,18,57
10726,CHO,2017,Miles Plumlee,28,13,0,174,14,24,.583,0,0,,14,24,.583,.583,3,4,.750,15,27,42,3,7,4,8,25,31
10727,CHO,2017,Briante Weber,24,13,0,159,20,46,.435,1,7,.143,19,39,.487,.446,9,13,.692,8,14,22,16,9,0,5,12,50
10728,CHO,2017,Christian Wood,21,13,0,107,12,23,.522,0,5,.000,12,18,.667,.522,11,15,.733,14,15,29,2,3,6,7,11,35
10729,CHO,2017,Johnny O'Bryant,23,4,0,34,8,15,.533,1,3,.333,7,12,.583,.567,1,2,.500,4,4,8,4,0,0,3,6,18
10730,CHO,2017,Mike Tobey,22,2,0,25,1,4,.250,0,0,,1,4,.250,.250,0,0,,2,1,3,1,0,0,1,2,2
10731,CHO,2017,Aaron Harrison,22,5,0,17,0,4,.000,0,2,.000,0,2,.000,.000,1,2,.500,0,3,3,3,0,0,0,2,1
10732,CHO,2016,Kemba Walker,25,81,81,2885,568,1331,.427,182,490,.371,386,841,.459,.495,371,438,.847,56,301,357,421,126,39,171,111,1689
10733,CHO,2016,Nicolas Batum,27,70,70,2448,372,873,.426,139,399,.348,233,474,.492,.506,163,192,.849,55,373,428,403,65,43,205,114,1046
10734,CHO,2016,Marvin Williams,29,81,81,2338,338,747,.452,152,378,.402,186,369,.504,.554,120,144,.833,127,394,521,110,58,77,62,133,948
10735,CHO,2016,Jeremy Lin,27,78,13,2048,300,728,.412,76,226,.336,224,502,.446,.464,238,292,.815,42,211,253,235,58,42,150,165,914
10736,CHO,2016,Cody Zeller,23,73,60,1774,231,437,.529,1,10,.100,230,427,.539,.530,175,232,.754,138,317,455,71,57,63,68,204,638
10737,CHO,2016,Frank Kaminsky,22,81,3,1708,215,525,.410,68,202,.337,147,323,.455,.474,108,148,.730,69,266,335,98,38,43,58,126,606
10738,CHO,2016,Jeremy Lamb,23,66,0,1227,230,510,.451,56,181,.309,174,329,.529,.506,64,88,.727,44,208,252,77,42,30,50,105,580
10739,CHO,2016,Al Jefferson,31,47,18,1096,245,505,.485,0,0,,245,505,.485,.485,72,111,.649,57,244,301,70,30,41,34,117,562
10740,CHO,2016,Spencer Hawes,27,57,6,1035,124,306,.405,38,102,.373,86,204,.422,.467,54,65,.831,51,193,244,109,22,27,58,111,340
10741,CHO,2016,P.J. Hairston,23,48,43,938,99,276,.359,54,172,.314,45,104,.433,.457,34,42,.810,18,110,128,29,24,7,24,106,286
10742,CHO,2016,Courtney Lee,30,28,28,845,98,220,.445,31,79,.392,67,141,.475,.516,23,26,.885,10,77,87,60,33,12,23,55,250
10743,CHO,2016,Troy Daniels,24,43,0,476,89,187,.476,59,122,.484,30,65,.462,.634,5,9,.556,7,50,57,21,11,3,24,40,242
10744,CHO,2016,Tyler Hansbrough,30,44,0,343,32,71,.451,2,3,.667,30,68,.441,.465,38,65,.585,40,49,89,8,12,7,12,55,104
10745,CHO,2016,Brian Roberts,30,30,0,333,51,115,.443,9,27,.333,42,88,.477,.483,34,37,.919,4,25,29,38,7,1,16,23,145
10746,CHO,2016,Michael Kidd-Gilchrist,22,7,7,205,33,61,.541,3,7,.429,30,54,.556,.566,20,29,.690,12,33,45,9,3,3,8,9,89
10747,CHO,2016,Aaron Harrison,21,21,0,93,5,19,.263,3,10,.300,2,9,.222,.342,5,12,.417,4,11,15,2,6,0,4,10,18
10748,CHO,2016,Jorge Gutiérrez,27,12,0,63,6,11,.545,0,2,.000,6,9,.667,.545,10,11,.909,0,7,7,17,3,0,6,3,22
10749,CHO,2015,Gerald Henderson,27,80,72,2315,370,847,.437,45,136,.331,325,711,.457,.463,184,217,.848,36,237,273,206,51,22,110,135,969
10750,CHO,2015,Kemba Walker,24,62,58,2119,378,981,.385,85,280,.304,293,701,.418,.429,234,283,.827,35,185,220,318,89,31,100,92,1075
10751,CHO,2015,Marvin Williams,28,78,37,2035,210,495,.424,95,265,.358,115,230,.500,.520,62,87,.713,58,328,386,100,69,36,60,146,577
10752,CHO,2015,Al Jefferson,30,65,61,1992,486,1010,.481,2,5,.400,484,1005,.482,.482,108,165,.655,99,449,548,113,47,84,68,139,1082
10753,CHO,2015,Michael Kidd-Gilchrist,21,55,52,1587,224,482,.465,0,0,,224,482,.465,.465,150,214,.701,109,307,416,77,30,38,63,115,598
10754,CHO,2015,Lance Stephenson,24,61,25,1573,207,550,.376,18,105,.171,189,445,.425,.393,69,110,.627,39,238,277,240,38,8,128,134,501
10755,CHO,2015,Cody Zeller,22,62,45,1487,172,373,.461,1,1,1.000,171,372,.460,.462,127,164,.774,97,265,362,100,34,49,62,156,472
10756,CHO,2015,Brian Roberts,29,72,10,1330,176,452,.389,62,193,.321,114,259,.440,.458,66,74,.892,13,96,109,162,33,6,57,75,480
10757,CHO,2015,Bismack Biyombo,22,64,21,1243,101,186,.543,0,0,,101,186,.543,.543,102,175,.583,159,248,407,16,18,99,52,140,304
10758,CHO,2015,Gary Neal,30,43,0,931,143,398,.359,39,133,.293,104,265,.392,.408,88,102,.863,14,80,94,80,16,1,55,70,413
10759,CHO,2015,Jason Maxiell,31,61,0,878,81,192,.422,0,0,,81,192,.422,.422,41,71,.577,86,117,203,19,18,44,29,96,203
10760,CHO,2015,Mo Williams,32,27,14,831,161,413,.390,60,178,.337,101,235,.430,.462,83,93,.892,9,67,76,163,16,6,70,59,465
10761,CHO,2015,P.J. Hairston,22,45,2,687,87,269,.323,49,163,.301,38,106,.358,.414,31,36,.861,22,70,92,21,21,13,22,61,254
10762,CHO,2015,Jeff Taylor,25,29,13,430,45,114,.395,11,36,.306,34,78,.436,.443,26,41,.634,14,39,53,22,12,1,19,36,127
10763,CHO,2015,Noah Vonleh,19,25,0,259,30,76,.395,5,13,.385,25,63,.397,.428,18,26,.692,28,58,86,4,4,9,11,20,83
10764,CHO,2015,Troy Daniels,23,11,0,135,27,59,.458,17,36,.472,10,23,.435,.602,6,7,.857,2,6,8,5,3,1,7,12,77
10765,CHO,2015,Jannero Pargo,35,9,0,73,15,35,.429,9,22,.409,6,13,.462,.557,2,2,1.000,0,3,3,8,0,0,3,8,41
10766,CHA,2014,Kemba Walker,23,73,73,2614,449,1143,.393,109,327,.333,340,816,.417,.441,282,337,.837,39,267,306,447,86,32,169,128,1289
10767,CHA,2014,Al Jefferson,29,73,73,2553,700,1376,.509,3,15,.200,697,1361,.512,.510,191,277,.690,156,636,792,155,67,79,124,176,1594
10768,CHA,2014,Gerald Henderson,26,77,77,2461,403,930,.433,40,115,.348,363,815,.445,.455,235,309,.761,31,279,310,199,51,32,113,159,1081
10769,CHA,2014,Josh McRoberts,26,78,78,2360,247,566,.436,105,291,.361,142,275,.516,.529,62,85,.729,85,288,373,333,58,46,83,189,661
10770,CHA,2014,Michael Kidd-Gilchrist,20,62,62,1502,167,353,.473,1,9,.111,166,344,.483,.475,113,184,.614,109,215,324,52,43,39,60,145,448
10771,CHA,2014,Cody Zeller,21,82,3,1416,172,404,.426,0,1,.000,172,403,.427,.426,146,200,.730,118,235,353,92,40,41,87,170,490
10772,CHA,2014,Ramon Sessions,27,55,7,1305,190,465,.409,15,68,.221,175,397,.441,.425,183,234,.782,22,95,117,206,33,6,93,50,578
10773,CHA,2014,Anthony Tolliver,28,64,9,1298,129,307,.420,102,247,.413,27,60,.450,.586,33,41,.805,33,135,168,42,19,15,23,82,393
10774,CHA,2014,Bismack Biyombo,21,77,9,1072,88,144,.611,0,0,,88,144,.611,.611,46,89,.517,105,261,366,8,7,86,40,124,222
10775,CHA,2014,Chris Douglas-Roberts,27,49,8,1016,111,252,.440,51,132,.386,60,120,.500,.542,66,82,.805,16,103,119,51,29,16,36,61,339
10776,CHA,2014,Jeff Taylor,24,26,8,629,82,218,.376,18,67,.269,64,151,.424,.417,26,47,.553,15,45,60,22,13,5,25,62,208
10777,CHA,2014,Gary Neal,29,22,1,507,85,194,.438,28,69,.406,57,125,.456,.510,49,51,.961,2,38,40,37,11,0,25,39,247
10778,CHA,2014,Luke Ridnour,32,25,2,378,42,108,.389,12,40,.300,30,68,.441,.444,4,7,.571,8,27,35,54,9,6,20,37,100
10779,CHA,2014,Ben Gordon,30,19,0,279,37,108,.343,8,29,.276,29,79,.367,.380,17,21,.810,3,24,27,21,10,2,21,18,99
10780,CHA,2014,Jeff Adrien,27,25,0,256,22,40,.550,0,0,,22,40,.550,.550,13,25,.520,33,55,88,7,7,15,8,35,57
10781,CHA,2014,Jannero Pargo,34,29,0,242,52,118,.441,24,60,.400,28,58,.483,.542,8,11,.727,1,19,20,52,14,1,26,17,136
10782,CHA,2014,D.J. White,27,2,0,10,0,1,.000,0,0,,0,1,.000,.000,0,0,,0,2,2,0,1,0,0,1,0
10783,CHA,2014,Justin Hamilton,23,1,0,4,0,0,,0,0,,0,0,,,0,0,,0,0,0,0,1,0,1,0,0
10784,CHA,2014,James Southerland,23,1,0,3,0,3,.000,0,1,.000,0,2,.000,.000,0,0,,0,0,0,0,0,0,0,0,0
10785,CHA,2013,Kemba Walker,22,82,82,2859,526,1244,.423,107,332,.322,419,912,.459,.466,296,371,.798,60,223,283,471,160,31,200,153,1455
10786,CHA,2013,Bismack Biyombo,20,80,65,2186,156,346,.451,0,0,,156,346,.451,.451,74,142,.521,194,388,582,35,28,143,82,195,386
10787,CHA,2013,Gerald Henderson,25,68,58,2133,382,855,.447,33,100,.330,349,755,.462,.466,258,313,.824,55,195,250,177,68,34,108,149,1055
10788,CHA,2013,Michael Kidd-Gilchrist,19,78,77,2025,281,613,.458,2,9,.222,279,604,.462,.460,140,187,.749,131,324,455,117,54,70,101,164,704
10789,CHA,2013,Ramon Sessions,26,61,0,1652,276,676,.408,33,107,.308,243,569,.427,.433,291,347,.839,27,142,169,230,48,7,104,91,876
10790,CHA,2013,Ben Gordon,29,75,0,1560,310,760,.408,113,292,.387,197,468,.421,.482,107,127,.843,18,112,130,141,35,16,136,134,840
10791,CHA,2013,Jeff Taylor,23,77,29,1507,172,399,.431,53,154,.344,119,245,.486,.497,75,103,.728,51,99,150,63,47,15,48,136,472
10792,CHA,2013,Byron Mullens,23,53,41,1428,217,563,.385,66,208,.317,151,355,.425,.444,64,99,.646,71,266,337,81,34,32,74,110,564
10793,CHA,2013,Brendan Haywood,33,61,17,1162,93,216,.431,0,1,.000,93,215,.433,.431,30,66,.455,125,165,290,29,16,49,50,125,216
10794,CHA,2013,Josh McRoberts,25,26,19,802,96,190,.505,7,29,.241,89,161,.553,.524,43,55,.782,52,136,188,71,22,15,38,66,242
10795,CHA,2013,Jeff Adrien,26,52,5,713,72,168,.429,0,2,.000,72,166,.434,.429,65,100,.650,68,128,196,36,18,27,32,80,209
10796,CHA,2013,Hakim Warrick,30,27,14,482,66,163,.405,0,3,.000,66,160,.413,.405,58,86,.674,21,68,89,25,12,6,29,37,190
10797,CHA,2013,Reggie Williams,26,40,0,380,57,132,.432,22,72,.306,35,60,.583,.515,10,21,.476,8,43,51,39,12,1,19,19,146
10798,CHA,2013,Tyrus Thomas,26,26,2,360,48,136,.353,3,8,.375,45,128,.352,.364,26,31,.839,16,44,60,19,14,15,17,51,125
10799,CHA,2013,Jannero Pargo,33,18,0,292,57,142,.401,29,76,.382,28,66,.424,.504,8,9,.889,9,13,22,34,15,2,28,26,151
10800,CHA,2013,DeSagana Diop,31,22,1,226,8,27,.296,0,1,.000,8,26,.308,.296,0,1,.000,10,41,51,13,5,16,8,19,16
10801,CHA,2013,Cory Higgins,23,6,0,32,6,19,.316,1,5,.200,5,14,.357,.342,1,2,.500,1,2,3,5,3,0,0,5,14
10802,CHA,2013,Matt Carroll,32,1,0,6,0,0,,0,0,,0,0,,,0,0,,0,0,0,1,0,0,0,1,0
10803,CHA,2012,Gerald Henderson,24,55,55,1831,332,723,.459,11,47,.234,321,676,.475,.467,155,204,.760,64,161,225,126,49,20,100,128,830
10804,CHA,2012,Kemba Walker,21,66,25,1792,281,767,.366,69,226,.305,212,541,.392,.411,168,213,.789,30,204,234,289,60,20,119,79,799
10805,CHA,2012,Byron Mullens,22,65,25,1465,251,591,.425,12,51,.235,239,540,.443,.435,92,112,.821,96,231,327,57,21,52,74,137,606
10806,CHA,2012,Bismack Biyombo,19,63,41,1455,129,278,.464,0,0,,129,278,.464,.464,69,143,.483,113,255,368,27,20,115,71,145,327
10807,CHA,2012,Derrick Brown,24,65,17,1443,212,409,.518,6,24,.250,206,385,.535,.526,94,141,.667,95,141,236,67,48,12,55,96,524
10808,CHA,2012,D.J. Augustin,24,48,46,1408,183,487,.376,61,179,.341,122,308,.396,.438,105,120,.875,24,85,109,307,36,1,110,65,532
10809,CHA,2012,D.J. White,25,58,11,1098,174,353,.493,1,1,1.000,173,352,.491,.494,43,61,.705,50,159,209,47,17,23,43,94,392
10810,CHA,2012,Boris Diaw,29,37,28,1018,116,283,.410,23,86,.267,93,197,.472,.451,17,27,.630,47,148,195,158,20,19,84,71,272
10811,CHA,2012,Tyrus Thomas,25,54,30,1013,120,327,.367,1,3,.333,119,324,.367,.369,63,83,.759,49,151,200,35,36,60,53,144,304
10812,CHA,2012,Corey Maggette,32,32,28,881,139,373,.373,24,66,.364,115,307,.375,.405,178,208,.856,21,104,125,39,23,1,59,83,480
10813,CHA,2012,Reggie Williams,25,33,13,747,106,255,.416,33,107,.308,73,148,.493,.480,29,40,.725,27,66,93,60,20,3,33,34,274
10814,CHA,2012,Matt Carroll,31,53,2,596,52,157,.331,8,43,.186,44,114,.386,.357,30,38,.789,8,50,58,38,16,7,24,52,142
10815,CHA,2012,Cory Higgins,22,38,0,423,52,160,.325,4,20,.200,48,140,.343,.338,42,60,.700,7,28,35,36,5,6,39,40,150
10816,CHA,2012,DeSagana Diop,30,27,9,325,15,42,.357,0,0,,15,42,.357,.357,1,6,.167,33,52,85,23,6,13,19,36,31
10817,CHA,2012,Eduardo Nájera,35,22,0,270,24,64,.375,8,29,.276,16,35,.457,.438,2,4,.500,11,39,50,12,19,4,7,40,58
10818,CHA,2012,Jamario Moon,31,8,0,123,7,24,.292,2,10,.200,5,14,.357,.333,2,2,1.000,2,20,22,5,1,5,8,5,18
10819,CHA,2011,Boris Diaw,28,82,82,2778,381,774,.492,78,226,.345,303,548,.553,.543,84,123,.683,105,309,414,337,74,46,166,190,924
10820,CHA,2011,D.J. Augustin,23,82,82,2757,399,958,.416,111,333,.333,288,625,.461,.474,269,297,.906,38,187,225,498,54,3,155,152,1178
10821,CHA,2011,Stephen Jackson,32,67,67,2405,435,1059,.411,121,359,.337,314,700,.449,.468,249,305,.816,53,251,304,241,80,28,209,161,1240
10822,CHA,2011,Gerald Wallace,28,48,48,1872,252,582,.433,35,106,.330,217,476,.456,.463,210,284,.739,72,322,394,116,59,48,100,120,749
10823,CHA,2011,Kwame Brown,28,66,50,1714,194,375,.517,0,0,,194,375,.517,.517,136,231,.589,147,303,450,43,26,39,69,174,524
10824,CHA,2011,Gerald Henderson,23,68,30,1661,259,570,.454,7,36,.194,252,534,.472,.461,128,163,.785,49,158,207,101,50,32,64,118,653
10825,CHA,2011,Shaun Livingston,25,73,0,1261,185,397,.466,1,4,.250,184,393,.468,.467,108,125,.864,29,120,149,164,47,29,88,109,479
10826,CHA,2011,Tyrus Thomas,24,41,2,861,156,331,.471,0,3,.000,156,328,.476,.471,107,136,.787,65,159,224,29,30,66,65,113,419
10827,CHA,2011,Nazr Mohammed,33,51,30,851,159,317,.502,0,1,.000,159,316,.503,.502,52,88,.591,94,158,252,17,14,46,51,121,370
10828,CHA,2011,Dominic McGuire,25,52,8,760,72,182,.396,0,2,.000,72,180,.400,.396,30,39,.769,63,136,199,43,10,33,25,94,174
10829,CHA,2011,Matt Carroll,30,54,1,582,89,199,.447,17,46,.370,72,153,.471,.490,40,52,.769,12,56,68,23,17,6,23,43,235
10830,CHA,2011,Dante Cunningham,23,22,9,529,92,181,.508,1,9,.111,91,172,.529,.511,13,17,.765,23,65,88,13,15,11,18,38,198
10831,CHA,2011,Derrick Brown,23,41,1,488,62,113,.549,2,6,.333,60,107,.561,.558,25,47,.532,32,52,84,29,16,8,28,48,151
10832,CHA,2011,D.J. White,24,24,0,466,81,154,.526,0,2,.000,81,152,.533,.526,41,54,.759,31,75,106,15,6,12,7,46,203
10833,CHA,2011,Eduardo Nájera,34,31,0,372,26,72,.361,11,34,.324,15,38,.395,.438,6,11,.545,14,30,44,20,11,6,13,52,69
10834,CHA,2011,DeSagana Diop,29,16,0,181,8,24,.333,0,0,,8,24,.333,.333,4,11,.364,12,28,40,7,4,15,11,26,20
10835,CHA,2011,Garrett Temple,24,12,0,126,12,42,.286,7,26,.269,5,16,.313,.369,7,11,.636,0,15,15,24,9,4,20,14,38
10836,CHA,2011,Joel Przybilla,31,5,0,74,4,10,.400,0,0,,4,10,.400,.400,1,4,.250,9,15,24,0,0,1,7,16,9
10837,CHA,2011,Sherron Collins,23,20,0,66,7,25,.280,2,10,.200,5,15,.333,.320,1,1,1.000,0,5,5,8,2,0,4,2,17
10838,CHA,2010,Gerald Wallace,27,76,76,3119,456,943,.484,52,140,.371,404,803,.503,.511,422,544,.776,150,612,762,161,117,83,178,194,1386
10839,CHA,2010,Boris Diaw,27,82,82,2906,373,773,.483,66,206,.320,307,567,.541,.525,113,147,.769,131,293,424,325,60,57,178,219,925
10840,CHA,2010,Stephen Jackson,31,72,72,2829,544,1285,.423,118,353,.334,426,932,.457,.469,312,397,.786,72,294,366,258,118,37,233,181,1518
10841,CHA,2010,Raymond Felton,25,80,80,2643,388,846,.459,60,156,.385,328,690,.475,.494,132,173,.763,53,235,288,446,123,22,168,172,968
10842,CHA,2010,D.J. Augustin,22,80,2,1472,168,435,.386,70,178,.393,98,257,.381,.467,102,131,.779,11,86,97,193,45,5,74,127,508
10843,CHA,2010,Tyson Chandler,27,51,27,1163,109,190,.574,0,0,,109,190,.574,.574,115,157,.732,114,206,320,16,17,55,91,138,333
10844,CHA,2010,Ronald Murray,30,46,1,993,160,411,.389,41,131,.313,119,280,.425,.439,93,131,.710,15,83,98,84,28,12,65,77,454
10845,CHA,2010,Nazr Mohammed,32,58,29,984,189,342,.553,0,0,,189,342,.553,.553,81,125,.648,114,190,304,28,15,43,53,105,459
10846,CHA,2010,Stephen Graham,27,70,8,804,119,240,.496,16,50,.320,103,190,.542,.529,42,65,.646,24,111,135,23,20,10,36,94,296
10847,CHA,2010,Theo Ratliff,36,28,26,624,54,116,.466,0,0,,54,116,.466,.466,36,46,.783,44,73,117,16,9,43,25,60,144
10848,CHA,2010,Tyrus Thomas,23,25,0,542,95,215,.442,0,2,.000,95,213,.446,.442,62,85,.729,39,113,152,23,23,37,40,65,252
10849,CHA,2010,Derrick Brown,22,57,0,535,68,147,.463,2,7,.286,66,140,.471,.469,48,72,.667,31,47,78,19,21,10,19,53,186
10850,CHA,2010,Gerald Henderson,22,43,0,355,37,104,.356,4,19,.211,33,85,.388,.375,35,47,.745,15,40,55,13,10,9,14,25,113
10851,CHA,2010,Larry Hughes,31,14,2,295,35,107,.327,15,42,.357,20,65,.308,.397,29,34,.853,7,25,32,28,12,4,19,17,114
10852,CHA,2010,DeSagana Diop,28,27,0,262,15,29,.517,0,0,,15,29,.517,.517,2,9,.222,24,41,65,5,5,14,12,31,32
10853,CHA,2010,Raja Bell,33,5,5,157,24,55,.436,9,24,.375,15,31,.484,.518,3,3,1.000,5,16,21,10,4,2,5,13,60
10854,CHA,2010,Vladimir Radmanović,29,8,0,133,14,42,.333,7,22,.318,7,20,.350,.417,4,6,.667,8,21,29,7,3,1,5,18,39
10855,CHA,2010,Acie Law,25,9,0,33,5,16,.313,0,1,.000,5,15,.333,.313,6,7,.857,0,1,1,3,1,1,3,3,16
10856,CHA,2010,Alexis Ajinça,21,6,0,30,5,10,.500,0,0,,5,10,.500,.500,0,1,.000,1,3,4,0,1,1,2,5,10
10857,CHA,2009,Raymond Felton,24,82,81,3086,442,1083,.408,59,207,.285,383,876,.437,.435,219,272,.805,54,256,310,553,126,30,228,191,1162
10858,CHA,2009,Emeka Okafor,26,82,81,2691,433,772,.561,0,0,,433,772,.561,.561,219,369,.593,275,552,827,53,48,136,144,247,1085
10859,CHA,2009,Gerald Wallace,26,71,71,2669,389,811,.480,39,131,.298,350,680,.515,.504,365,454,.804,112,441,553,189,121,67,148,210,1182
10860,CHA,2009,Boris Diaw,26,59,59,2216,368,743,.495,70,167,.419,298,576,.517,.542,83,121,.686,94,254,348,287,50,44,178,163,889
10861,CHA,2009,D.J. Augustin,21,72,12,1908,267,621,.430,108,246,.439,159,375,.424,.517,208,233,.893,17,116,133,250,42,2,119,140,850
10862,CHA,2009,Raja Bell,32,45,44,1603,223,507,.440,70,177,.395,153,330,.464,.509,71,81,.877,33,146,179,113,37,6,68,109,587
10863,CHA,2009,Vladimir Radmanović,28,32,3,674,101,252,.401,45,126,.357,56,126,.444,.490,20,31,.645,27,78,105,43,18,8,51,60,267
10864,CHA,2009,Adam Morrison,24,44,5,667,76,211,.360,31,92,.337,45,119,.378,.434,16,21,.762,16,56,72,38,9,4,29,73,199
10865,CHA,2009,DeSagana Diop,27,41,1,584,52,113,.460,0,0,,52,113,.460,.460,10,37,.270,69,86,155,19,17,31,28,73,114
10866,CHA,2009,Jason Richardson,28,14,14,491,97,220,.441,27,59,.458,70,161,.435,.502,41,55,.745,13,45,58,36,14,3,24,43,262
10867,CHA,2009,Matt Carroll,28,34,10,475,56,138,.406,12,45,.267,44,93,.473,.449,15,19,.789,5,50,55,24,18,5,26,53,139
10868,CHA,2009,Juwan Howard,35,39,2,450,74,145,.510,0,0,,74,145,.510,.510,23,34,.676,29,43,72,24,6,5,26,67,171
10869,CHA,2009,Jared Dudley,23,20,7,427,45,96,.469,3,8,.375,42,88,.477,.484,15,24,.625,25,34,59,19,18,2,10,40,108
10870,CHA,2009,Shannon Brown,23,30,0,341,56,123,.455,8,28,.286,48,95,.505,.488,24,30,.800,8,16,24,28,18,5,29,33,144
10871,CHA,2009,Nazr Mohammed,31,39,1,341,41,101,.406,0,0,,41,101,.406,.406,22,40,.550,35,44,79,8,5,16,23,63,104
10872,CHA,2009,Sean May,24,24,12,301,39,98,.398,1,1,1.000,38,97,.392,.403,14,20,.700,20,49,69,10,5,4,26,32,93
10873,CHA,2009,Cartier Martin,24,33,1,266,28,77,.364,10,33,.303,18,44,.409,.429,20,25,.800,7,26,33,13,8,4,9,33,86
10874,CHA,2009,Ryan Hollins,24,18,1,184,19,35,.543,0,0,,19,35,.543,.543,26,39,.667,19,17,36,4,3,17,10,34,64
10875,CHA,2009,Alexis Ajinça,20,31,4,182,25,69,.362,0,2,.000,25,67,.373,.362,20,28,.714,9,21,30,3,7,6,12,34,70
10876,CHA,2009,Sean Singletary,23,24,1,181,19,48,.396,6,15,.400,13,33,.394,.458,12,15,.800,5,14,19,17,5,0,18,31,56
10877,CHA,2009,Dontell Jefferson,25,6,0,84,11,22,.500,1,2,.500,10,20,.500,.523,6,9,.667,1,11,12,9,4,1,6,9,29
10878,CHA,2009,Dwayne Jones,25,6,0,52,4,7,.571,0,0,,4,7,.571,.571,4,6,.667,6,6,12,0,0,1,4,6,12
10879,CHA,2009,Andre Brown,27,4,0,41,1,7,.143,0,0,,1,7,.143,.143,2,2,1.000,7,5,12,1,1,0,5,9,4
10880,CHA,2009,Linton Johnson,28,2,0,13,0,0,,0,0,,0,0,,,0,0,,0,0,0,0,0,0,0,1,0
10881,CHA,2008,Jason Richardson,27,82,82,3149,648,1468,.441,243,599,.406,405,869,.466,.524,249,331,.752,80,361,441,258,116,57,166,241,1788
10882,CHA,2008,Raymond Felton,23,79,79,2972,412,997,.413,56,200,.280,356,797,.447,.441,260,325,.800,37,199,236,583,96,12,213,184,1140
10883,CHA,2008,Emeka Okafor,25,82,82,2718,460,860,.535,0,0,,460,860,.535,.535,213,374,.570,255,621,876,70,62,138,164,241,1133
10884,CHA,2008,Gerald Wallace,25,62,59,2376,408,908,.449,71,221,.321,337,687,.491,.488,313,428,.731,58,315,373,216,131,58,180,189,1200
10885,CHA,2008,Matt Carroll,27,80,18,2016,252,589,.428,105,241,.436,147,348,.422,.517,111,138,.804,33,193,226,73,46,19,58,187,720
10886,CHA,2008,Nazr Mohammed,30,61,29,1422,244,469,.520,0,0,,244,469,.520,.520,82,133,.617,165,256,421,66,38,52,90,194,570
10887,CHA,2008,Jeff McInnis,33,54,26,1410,108,249,.434,3,19,.158,105,230,.457,.440,23,30,.767,16,80,96,220,23,3,76,120,242
10888,CHA,2008,Jared Dudley,22,73,14,1384,163,348,.468,9,41,.220,154,307,.502,.481,87,118,.737,121,165,286,81,55,10,50,128,422
10889,CHA,2008,Earl Boykins,31,36,0,577,61,172,.355,14,44,.318,47,128,.367,.395,49,59,.831,9,25,34,96,13,0,41,21,185
10890,CHA,2008,Ryan Hollins,23,60,1,532,46,94,.489,0,0,,46,94,.489,.489,55,82,.671,53,54,107,14,10,30,25,96,147
10891,CHA,2008,Derek Anderson,33,28,0,396,47,125,.376,19,52,.365,28,73,.384,.452,28,38,.737,9,43,52,44,12,1,25,49,141
10892,CHA,2008,Jermareo Davidson,23,38,2,322,51,125,.408,0,0,,51,125,.408,.408,18,28,.643,21,41,62,13,7,15,17,46,120
10893,CHA,2008,Primož Brezec,28,20,18,267,17,43,.395,0,0,,17,43,.395,.395,3,5,.600,14,30,44,6,0,3,15,35,37
10894,CHA,2008,Walter Herrmann,28,17,0,174,25,65,.385,9,26,.346,16,39,.410,.454,9,10,.900,10,26,36,4,4,0,4,12,68
10895,CHA,2008,Othella Harrington,34,22,0,166,18,42,.429,0,0,,18,42,.429,.429,10,16,.625,11,31,42,4,1,4,11,34,46
10896,CHA,2007,Raymond Felton,22,78,75,2832,393,1024,.384,103,312,.330,290,712,.407,.434,204,256,.797,51,216,267,545,118,10,230,180,1093
10897,CHA,2007,Gerald Wallace,24,72,71,2640,478,952,.502,39,120,.325,439,832,.528,.523,309,447,.691,142,376,518,185,144,69,160,209,1304
10898,CHA,2007,Emeka Okafor,24,67,65,2329,394,740,.532,0,0,,394,740,.532,.532,175,295,.593,258,499,757,80,57,172,111,210,963
10899,CHA,2007,Adam Morrison,22,78,23,2326,355,944,.376,87,258,.337,268,686,.391,.422,120,169,.710,54,176,230,163,28,6,130,179,917
10900,CHA,2007,Matt Carroll,26,72,47,1878,285,658,.433,111,267,.416,174,391,.445,.517,188,208,.904,35,172,207,91,53,9,73,176,869
10901,CHA,2007,Brevin Knight,31,45,25,1273,152,363,.419,1,18,.056,151,345,.438,.420,103,128,.805,14,101,115,296,67,3,95,113,408
10902,CHA,2007,Derek Anderson,32,50,32,1190,126,294,.429,54,152,.355,72,142,.507,.520,93,106,.877,29,84,113,133,52,7,56,115,399
10903,CHA,2007,Jake Voskuhl,29,73,9,1043,121,255,.475,0,0,,121,255,.475,.475,77,113,.681,84,172,256,44,30,24,56,199,319
10904,CHA,2007,Walter Herrmann,27,48,12,936,174,330,.527,53,115,.461,121,215,.563,.608,41,53,.774,28,111,139,26,17,7,32,76,442
10905,CHA,2007,Sean May,22,35,8,838,164,328,.500,2,3,.667,162,325,.498,.503,86,112,.768,73,160,233,66,19,24,56,100,416
10906,CHA,2007,Primož Brezec,27,58,40,838,122,274,.445,1,3,.333,121,271,.446,.447,43,68,.632,80,104,184,23,11,23,38,161,288
10907,CHA,2007,Jeff McInnis,32,38,3,702,71,181,.392,1,8,.125,70,173,.405,.395,22,32,.688,14,48,62,124,14,0,42,72,165
10908,CHA,2007,Alan Anderson,24,17,0,256,37,81,.457,5,20,.250,32,61,.525,.488,19,23,.826,11,21,32,21,7,0,22,33,98
10909,CHA,2007,Melvin Ely,28,24,0,244,23,60,.383,0,0,,23,60,.383,.383,24,35,.686,12,27,39,14,2,6,23,39,70
10910,CHA,2007,Bernard Robinson,26,21,0,241,16,54,.296,0,2,.000,16,52,.308,.296,19,22,.864,9,33,42,17,13,1,16,28,51
10911,CHA,2007,Othella Harrington,33,26,0,220,25,56,.446,0,0,,25,56,.446,.446,17,22,.773,13,25,38,6,1,1,15,49,67
10912,CHA,2007,Ryan Hollins,22,27,0,185,20,36,.556,0,0,,20,36,.556,.556,24,40,.600,11,20,31,1,4,7,16,40,64
10913,CHA,2007,Eric Williams,34,5,0,33,4,13,.308,0,2,.000,4,11,.364,.308,4,7,.571,2,1,3,1,1,0,2,6,12
10914,CHA,2006,Raymond Felton,21,80,54,2406,345,883,.391,97,271,.358,248,612,.405,.446,161,222,.725,77,188,265,446,102,8,182,181,948
10915,CHA,2006,Brevin Knight,30,69,67,2351,308,772,.399,3,13,.231,305,759,.402,.401,252,314,.803,35,188,223,610,157,4,164,202,871
10916,CHA,2006,Primož Brezec,26,79,79,2165,409,791,.517,0,2,.000,409,789,.518,.517,164,224,.732,181,259,440,45,19,32,85,227,982
10917,CHA,2006,Jumaine Jones,26,76,42,2089,298,736,.405,115,335,.343,183,401,.456,.483,88,121,.727,105,271,376,63,68,22,74,200,799
10918,CHA,2006,Gerald Wallace,23,55,52,1895,317,589,.538,14,50,.280,303,539,.562,.550,188,306,.614,123,289,412,96,138,115,99,150,836
10919,CHA,2006,Melvin Ely,27,57,22,1348,216,425,.508,0,2,.000,216,423,.511,.508,128,192,.667,94,183,277,76,29,44,100,160,560
10920,CHA,2006,Bernard Robinson,25,66,18,1303,157,365,.430,2,21,.095,155,344,.451,.433,106,134,.791,62,157,219,77,81,10,74,141,422
10921,CHA,2006,Matt Carroll,25,78,6,1275,192,476,.403,72,185,.389,120,291,.412,.479,138,168,.821,34,123,157,35,47,11,48,120,594
10922,CHA,2006,Kareem Rush,25,47,25,1111,181,469,.386,57,164,.348,124,305,.407,.447,55,77,.714,18,85,103,50,38,13,65,79,474
10923,CHA,2006,Emeka Okafor,23,26,25,874,131,316,.415,0,0,,131,316,.415,.415,82,125,.656,94,167,261,31,22,50,53,88,344
10924,CHA,2006,Keith Bogans,25,39,9,848,114,288,.396,33,98,.337,81,190,.426,.453,80,105,.762,29,77,106,45,39,3,41,78,341
10925,CHA,2006,Jake Voskuhl,28,51,2,818,114,261,.437,1,3,.333,113,258,.438,.439,41,60,.683,62,121,183,39,26,23,33,157,270
10926,CHA,2006,Alan Anderson,23,36,7,564,75,181,.414,24,58,.414,51,123,.415,.481,33,41,.805,23,47,70,32,11,4,32,48,207
10927,CHA,2006,Sean May,21,23,1,398,70,171,.409,0,5,.000,70,166,.422,.409,49,64,.766,42,67,109,22,17,12,33,58,189
10928,CHA,2006,Kevin Burleson,26,39,1,340,22,88,.250,10,54,.185,12,34,.353,.307,16,17,.941,4,22,26,48,26,2,25,63,70
10929,CHA,2006,Lonny Baxter,27,18,0,119,12,32,.375,0,0,,12,32,.375,.375,12,16,.750,7,26,33,2,2,1,7,8,36
10930,CHA,2005,Emeka Okafor,22,73,73,2600,448,1003,.447,0,1,.000,448,1002,.447,.447,209,343,.609,275,520,795,64,62,125,125,214,1105
10931,CHA,2005,Primož Brezec,25,72,72,2276,387,756,.512,0,0,,387,756,.512,.512,164,220,.745,226,305,531,86,33,55,106,183,938
10932,CHA,2005,Gerald Wallace,22,70,68,2147,286,637,.449,17,62,.274,269,575,.468,.462,191,289,.661,118,268,386,137,117,91,159,182,780
10933,CHA,2005,Brevin Knight,29,66,61,1944,248,587,.422,3,20,.150,245,567,.432,.425,167,196,.852,21,149,170,591,131,5,147,192,666
10934,CHA,2005,Jason Hart,26,74,27,1887,257,573,.449,35,95,.368,222,478,.464,.479,157,200,.785,18,185,203,367,99,14,102,167,706
10935,CHA,2005,Keith Bogans,24,74,42,1791,262,688,.381,57,173,.329,205,515,.398,.422,133,183,.727,76,150,226,135,68,8,122,167,714
10936,CHA,2005,Melvin Ely,26,79,17,1649,227,526,.432,0,0,,227,526,.432,.432,122,212,.575,142,184,326,76,32,69,115,199,576
10937,CHA,2005,Jason Kapono,23,81,14,1491,269,671,.401,80,194,.412,189,477,.396,.461,70,85,.824,32,132,164,61,40,6,46,132,688
10938,CHA,2005,Kareem Rush,24,34,22,877,153,386,.396,49,127,.386,104,259,.402,.460,35,46,.761,17,62,79,65,18,6,44,67,390
10939,CHA,2005,Steve Smith,35,37,1,636,93,218,.427,38,90,.422,55,128,.430,.514,67,77,.870,13,36,49,57,12,7,24,74,291
10940,CHA,2005,Theron Smith,24,33,5,510,44,136,.324,3,12,.250,41,124,.331,.335,14,16,.875,39,77,116,28,6,4,27,58,105
10941,CHA,2005,Matt Carroll,24,25,0,430,70,180,.389,13,39,.333,57,141,.404,.425,71,83,.855,13,47,60,17,17,2,25,37,224
10942,CHA,2005,Jamal Sampson,21,23,0,329,28,62,.452,0,0,,28,62,.452,.452,23,39,.590,36,86,122,8,4,17,17,53,79
10943,CHA,2005,Bernard Robinson,24,31,1,328,36,81,.444,3,8,.375,33,73,.452,.463,18,26,.692,14,34,48,30,11,4,20,42,93
10944,CHA,2005,Eddie House,26,13,5,300,61,135,.452,12,29,.414,49,106,.462,.496,10,13,.769,2,17,19,24,24,3,13,23,144
10945,CHA,2005,Malik Allen,26,22,1,271,49,101,.485,0,0,,49,101,.485,.485,13,14,.929,16,31,47,7,5,11,7,24,111
10946,CHA,2005,Cory Alexander,31,16,1,201,16,49,.327,8,19,.421,8,30,.267,.408,9,12,.750,8,21,29,37,9,1,19,29,49
10947,CHA,2005,Jahidi White,28,17,0,135,14,31,.452,0,0,,14,31,.452,.452,14,40,.350,11,23,34,1,2,12,11,31,42
10948,CHA,2005,Tamar Slay,24,8,0,78,13,39,.333,2,12,.167,11,27,.407,.359,0,2,.000,6,8,14,3,5,0,8,20,28
10949,CHH,2002,Baron Davis,22,82,82,3318,559,1341,.417,170,478,.356,389,863,.451,.480,196,338,.580,93,256,349,698,172,47,246,241,1484
10950,CHH,2002,P.J. Brown,32,80,80,2563,250,527,.474,0,0,,250,527,.474,.474,169,197,.858,273,513,786,107,59,78,85,222,669
10951,CHH,2002,David Wesley,31,67,63,2487,364,910,.400,85,256,.332,279,654,.427,.447,138,188,.734,44,99,143,236,74,15,119,147,951
10952,CHH,2002,Elden Campbell,33,77,74,2156,384,794,.484,0,2,.000,384,792,.485,.484,306,384,.797,133,397,530,102,60,137,138,264,1074
10953,CHH,2002,Lee Nailon,26,79,41,1912,369,764,.483,1,2,.500,368,762,.483,.484,112,150,.747,103,188,291,94,59,17,96,175,851
10954,CHH,2002,Jamal Mashburn,29,40,40,1601,303,744,.407,41,112,.366,262,632,.415,.435,211,241,.876,31,211,242,171,45,6,110,80,858
10955,CHH,2002,Jamaal Magloire,23,82,8,1549,228,414,.551,0,1,.000,228,413,.552,.551,243,333,.730,153,308,461,31,27,86,118,201,699
10956,CHH,2002,Stacey Augmon,33,77,3,1319,140,328,.427,0,3,.000,140,325,.431,.427,77,101,.762,59,166,225,103,56,12,54,115,357
10957,CHH,2002,George Lynch,31,45,18,893,73,198,.369,1,6,.167,72,192,.375,.371,25,40,.625,70,116,186,54,40,14,41,75,172
10958,CHH,2002,Bryce Drew,27,61,0,774,78,182,.429,31,73,.425,47,109,.431,.514,23,29,.793,14,58,72,101,32,2,33,49,210
10959,CHH,2002,Robert Traylor,24,61,1,678,87,204,.426,1,1,1.000,86,203,.424,.429,53,84,.631,67,120,187,37,24,37,45,127,228
10960,CHH,2002,Matt Bullard,34,31,0,350,39,115,.339,16,57,.281,23,58,.397,.409,11,12,.917,10,37,47,16,2,2,12,29,105
10961,CHH,2002,Kirk Haston,22,15,0,77,11,39,.282,0,3,.000,11,36,.306,.282,4,8,.500,5,15,20,5,0,1,3,9,26
10962,CHH,2002,Jérôme Moïso,23,15,0,76,8,20,.400,0,0,,8,20,.400,.400,0,0,,4,21,25,4,3,2,8,12,16
10963,CHH,2002,Eldridge Recasner,34,1,0,2,0,0,,0,0,,0,0,,,0,0,,0,0,0,0,0,0,0,1,0
10964,CHH,2001,Baron Davis,21,82,82,3192,409,957,.427,85,274,.310,324,683,.474,.472,228,337,.677,129,279,408,598,170,36,226,267,1131
10965,CHH,2001,David Wesley,30,82,82,3106,523,1239,.422,97,258,.376,426,981,.434,.461,271,339,.799,64,160,224,361,128,16,171,220,1414
10966,CHH,2001,Jamal Mashburn,28,76,76,2989,573,1388,.413,103,289,.356,470,1099,.428,.450,279,364,.766,92,484,576,411,85,13,211,185,1528
10967,CHH,2001,P.J. Brown,31,80,79,2811,249,561,.444,0,4,.000,249,557,.447,.444,178,209,.852,257,485,742,127,78,92,108,260,676
10968,CHH,2001,Elden Campbell,32,78,78,2337,367,834,.440,0,6,.000,367,828,.443,.440,288,406,.709,157,451,608,104,60,140,144,280,1022
10969,CHH,2001,Eddie Robinson,24,67,6,1201,216,407,.531,2,4,.500,214,403,.531,.533,64,88,.727,60,138,198,59,50,32,43,66,498
10970,CHH,2001,Jamaal Magloire,22,74,0,1095,122,271,.450,0,2,.000,122,269,.454,.450,95,145,.655,103,192,295,27,18,78,61,139,339
10971,CHH,2001,Derrick Coleman,33,34,3,683,97,255,.380,20,51,.392,77,204,.377,.420,63,92,.685,46,138,184,39,10,21,42,53,277
10972,CHH,2001,Hersey Hawkins,34,59,0,681,56,137,.409,17,46,.370,39,91,.429,.471,54,63,.857,17,63,80,72,33,9,19,45,183
10973,CHH,2001,Otis Thorpe,38,49,4,647,59,131,.450,0,0,,59,131,.450,.450,20,24,.833,50,95,145,29,12,7,32,108,138
10974,CHH,2001,Lee Nailon,25,42,0,469,66,136,.485,0,1,.000,66,135,.489,.485,32,43,.744,29,63,92,24,9,5,27,60,164
10975,CHH,2001,Eldridge Recasner,33,43,0,403,38,114,.333,13,39,.333,25,75,.333,.390,14,18,.778,13,37,50,39,6,1,27,30,103
10976,CHH,2001,Tim James,24,30,0,197,16,52,.308,1,3,.333,15,49,.306,.317,12,14,.857,15,20,35,8,2,5,8,27,45
10977,CHH,2001,Scott Burrell,30,4,0,41,7,15,.467,2,6,.333,5,9,.556,.533,1,4,.250,1,2,3,1,3,0,0,8,17
10978,CHH,2001,Doug Overton,31,2,0,15,2,2,1.000,0,0,,2,2,1.000,1.000,0,0,,0,0,0,0,1,0,3,2,4
10979,CHH,2001,Terrance Roberson,24,3,0,13,0,2,.000,0,1,.000,0,1,.000,.000,0,0,,0,1,1,1,0,0,2,3,0
10980,CHH,2000,Anthony Mason,33,82,81,3133,317,661,.480,0,1,.000,317,660,.480,.480,314,421,.746,145,554,699,367,74,29,160,220,948
10981,CHH,2000,Eddie Jones,28,72,72,2807,478,1119,.427,128,341,.375,350,778,.450,.484,362,419,.864,81,262,343,305,192,49,160,176,1446
10982,CHH,2000,David Wesley,29,82,82,2760,407,955,.426,88,248,.355,319,707,.451,.472,214,275,.778,39,186,225,463,109,11,159,186,1116
10983,CHH,2000,Elden Campbell,31,78,77,2538,370,829,.446,0,6,.000,370,823,.450,.446,247,358,.690,168,422,590,129,56,150,127,269,987
10984,CHH,2000,Derrick Coleman,32,74,64,2347,446,979,.456,51,141,.362,395,838,.471,.482,296,377,.785,124,508,632,175,34,130,173,195,1239
10985,CHH,2000,Baron Davis,20,82,0,1523,182,433,.420,25,111,.225,157,322,.488,.449,97,153,.634,48,117,165,309,97,19,140,201,486
10986,CHH,2000,Eddie Robinson,23,67,8,1112,212,386,.549,0,4,.000,212,382,.555,.549,47,64,.734,54,130,184,32,48,25,39,67,471
10987,CHH,2000,Brad Miller,23,55,4,961,135,293,.461,0,2,.000,135,291,.464,.461,153,195,.785,113,180,293,45,23,35,48,111,423
10988,CHH,2000,Bobby Phills,30,28,9,825,152,335,.454,30,91,.330,122,244,.500,.499,47,65,.723,17,54,71,79,41,8,48,72,381
10989,CHH,2000,Ricky Davis,20,48,4,570,94,187,.503,0,4,.000,94,183,.514,.503,39,51,.765,29,54,83,62,30,8,46,39,227
10990,CHH,2000,Chucky Brown,31,33,2,494,66,152,.434,1,7,.143,65,145,.448,.438,11,21,.524,24,66,90,25,12,8,17,61,144
10991,CHH,2000,Todd Fuller,25,41,2,399,51,122,.418,0,0,,51,122,.418,.418,32,53,.604,36,74,110,5,9,8,27,46,134
10992,CHH,2000,Dale Ellis,39,24,5,240,19,58,.328,14,35,.400,5,23,.217,.448,3,4,.750,6,16,22,8,7,0,13,22,55
10993,CHH,2000,Michael Hawkins,27,12,0,36,3,13,.231,1,5,.200,2,8,.250,.269,1,2,.500,0,7,7,13,0,0,3,2,8
10994,CHH,2000,Eldridge Recasner,32,7,0,28,3,7,.429,1,4,.250,2,3,.667,.500,0,0,,0,4,4,5,0,0,0,1,7
10995,CHH,2000,Derek Hood,23,2,0,4,0,3,.000,0,0,,0,3,.000,.000,0,0,,0,1,1,0,0,0,0,0,0
10996,CHH,2000,Jason Miskiri,24,1,0,3,0,1,.000,0,1,.000,0,0,,.000,0,0,,0,0,0,1,0,0,0,2,0
10997,CHH,1999,David Wesley,28,50,50,1848,243,545,.446,61,170,.359,182,375,.485,.502,159,191,.832,23,138,161,322,100,10,142,130,706
10998,CHH,1999,Bobby Phills,29,43,43,1574,215,497,.433,68,172,.395,147,325,.452,.501,115,168,.685,39,135,174,149,60,25,92,124,613
10999,CHH,1999,Chucky Brown,30,48,21,1192,176,373,.472,15,40,.375,161,333,.483,.492,40,59,.678,36,138,174,57,16,19,38,106,407
11000,CHH,1999,Derrick Coleman,31,37,29,1178,168,406,.414,7,33,.212,161,373,.432,.422,143,190,.753,76,252,328,78,24,42,90,96,486
11001,CHH,1999,Eddie Jones,27,30,30,1157,164,368,.446,28,78,.359,136,290,.469,.484,153,191,.801,30,88,118,125,90,34,72,86,509
11002,CHH,1999,Elden Campbell,30,32,32,1134,178,364,.489,0,1,.000,178,363,.490,.489,134,207,.647,88,213,301,61,38,57,58,108,490
11003,CHH,1999,Chuck Person,34,50,21,990,112,289,.388,55,157,.350,57,132,.432,.483,24,32,.750,17,115,132,60,20,8,41,90,303
11004,CHH,1999,Eldridge Recasner,31,44,2,708,82,184,.446,24,60,.400,58,124,.468,.511,34,39,.872,20,57,77,91,17,1,58,66,222
11005,CHH,1999,Ricky Davis,19,46,1,557,81,200,.405,2,12,.167,79,188,.420,.410,45,59,.763,40,44,84,58,30,7,54,46,209
11006,CHH,1999,J.R. Reid,30,16,16,556,88,169,.521,0,0,,88,169,.521,.521,67,84,.798,21,92,113,25,22,10,28,63,243
11007,CHH,1999,Brad Miller,22,38,0,469,78,138,.565,1,2,.500,77,136,.566,.569,81,102,.794,35,82,117,22,9,18,32,65,238
11008,CHH,1999,Charles Shackleford,32,32,4,367,44,90,.489,0,0,,44,90,.489,.489,19,29,.655,41,88,129,13,5,13,27,66,107
11009,CHH,1999,B.J. Armstrong,31,10,1,178,21,43,.488,6,8,.750,15,35,.429,.558,9,10,.900,1,15,16,27,3,0,10,16,57
11010,CHH,1999,Corey Beck,27,16,0,150,14,31,.452,1,1,1.000,13,30,.433,.468,6,13,.462,3,20,23,20,7,2,11,21,35
11011,CHH,1999,Travis Williams,29,8,0,62,6,13,.462,0,0,,6,13,.462,.462,3,4,.750,6,13,19,2,2,1,6,10,15
11012,CHH,1999,Willie Burton,30,3,0,18,1,7,.143,0,1,.000,1,6,.167,.143,2,4,.500,4,2,6,0,0,0,1,2,4
11013,CHH,1999,Joe Wolf,34,3,0,12,0,1,.000,0,0,,0,1,.000,.000,0,2,.000,0,1,1,0,0,0,0,6,0
11014,CHH,1998,Glen Rice,30,82,82,3295,634,1386,.457,130,300,.433,504,1086,.464,.504,428,504,.849,89,264,353,182,77,22,182,200,1826
11015,CHH,1998,Anthony Mason,31,81,80,3148,389,764,.509,0,4,.000,389,760,.512,.509,261,402,.649,177,649,826,342,68,18,146,182,1039
11016,CHH,1998,David Wesley,27,81,81,2845,383,864,.443,59,170,.347,324,694,.467,.477,229,288,.795,49,164,213,529,140,30,226,229,1054
11017,CHH,1998,Bobby Phills,28,62,61,1887,246,552,.446,44,114,.386,202,438,.461,.486,106,140,.757,59,157,216,187,81,18,108,181,642
11018,CHH,1998,Matt Geiger,28,78,42,1839,358,709,.505,1,11,.091,357,698,.511,.506,168,236,.712,196,325,521,78,68,87,111,191,885
11019,CHH,1998,Vlade Divac,29,64,41,1805,267,536,.498,3,14,.214,264,522,.506,.501,130,188,.691,183,335,518,172,83,94,114,179,667
11020,CHH,1998,J.R. Reid,29,79,1,1109,146,318,.459,3,8,.375,143,310,.461,.464,89,122,.730,72,138,210,51,35,19,65,172,384
11021,CHH,1998,Dell Curry,33,52,1,971,194,434,.447,61,145,.421,133,289,.460,.517,41,52,.788,26,75,101,69,31,4,54,85,490
11022,CHH,1998,B.J. Armstrong,30,62,0,772,99,194,.510,9,34,.265,90,160,.563,.534,37,43,.860,12,57,69,144,25,0,35,68,244
11023,CHH,1998,Corey Beck,26,59,14,738,73,159,.459,2,4,.500,71,155,.458,.465,43,59,.729,27,63,90,98,33,7,70,100,191
11024,CHH,1998,Vernon Maxwell,32,31,0,467,77,180,.428,31,86,.360,46,94,.489,.514,25,34,.735,9,35,44,40,14,3,28,51,210
11025,CHH,1998,Travis Williams,28,39,0,365,56,119,.471,0,1,.000,56,118,.475,.471,24,46,.522,53,39,92,20,18,5,30,55,136
11026,CHH,1998,Donald Royal,31,29,5,305,24,63,.381,0,0,,24,63,.381,.381,26,29,.897,16,21,37,16,6,1,7,30,74
11027,CHH,1998,Tony Farmer,28,27,2,169,17,53,.321,2,9,.222,15,44,.341,.340,31,39,.795,16,16,32,5,10,4,9,23,67
11028,CHH,1998,Tony Delk,24,3,0,34,3,4,.750,1,1,1.000,2,3,.667,.875,1,2,.500,0,2,2,3,0,0,4,8,8
11029,CHH,1998,Muggsy Bogues,33,2,0,16,2,5,.400,0,0,,2,5,.400,.400,2,2,1.000,0,1,1,4,2,0,1,2,6
11030,CHH,1998,Jeff Grayer,32,1,0,11,0,4,.000,0,3,.000,0,1,.000,.000,0,0,,0,0,0,1,0,0,2,0,0
11031,CHH,1998,Michael McDonald,28,1,0,4,0,0,,0,0,,0,0,,,0,0,,1,0,1,0,0,0,2,1,0
11032,CHH,1997,Glen Rice,29,79,78,3362,722,1513,.477,207,440,.470,515,1073,.480,.546,464,535,.867,67,251,318,160,72,26,177,190,2115
11033,CHH,1997,Anthony Mason,30,73,73,3143,433,825,.525,1,3,.333,432,822,.526,.525,319,428,.745,186,643,829,414,76,33,165,202,1186
11034,CHH,1997,Vlade Divac,28,81,80,2840,418,847,.494,11,47,.234,407,800,.509,.500,177,259,.683,241,484,725,301,103,180,193,277,1024
11035,CHH,1997,Dell Curry,32,68,20,2078,384,836,.459,126,296,.426,258,540,.478,.535,114,142,.803,40,171,211,118,60,14,93,147,1008
11036,CHH,1997,Muggsy Bogues,32,65,65,1880,204,443,.460,60,144,.417,144,299,.482,.528,54,64,.844,25,116,141,469,82,2,108,114,522
11037,CHH,1997,Tony Smith,28,69,39,1291,138,337,.409,32,99,.323,106,238,.445,.457,38,59,.644,38,56,94,150,48,19,73,110,346
11038,CHH,1997,Matt Geiger,27,49,13,1044,171,350,.489,6,20,.300,165,330,.500,.497,89,127,.701,100,158,258,38,20,27,67,153,437
11039,CHH,1997,Tony Delk,23,61,1,867,119,256,.465,52,112,.464,67,144,.465,.566,42,51,.824,31,68,99,99,36,6,68,71,332
11040,CHH,1997,Ricky Pierce,37,27,17,650,119,237,.502,30,56,.536,89,181,.492,.565,56,63,.889,19,49,68,49,14,4,30,48,324
11041,CHH,1997,Anthony Goldwire,25,33,9,576,62,154,.403,36,82,.439,26,72,.361,.519,30,40,.750,3,35,38,94,19,1,41,58,190
11042,CHH,1997,Malik Rose,22,54,1,525,61,128,.477,0,2,.000,61,126,.484,.477,38,62,.613,70,94,164,32,28,17,41,114,160
11043,CHH,1997,Scott Burrell,26,28,2,482,45,131,.344,19,55,.345,26,76,.342,.416,42,53,.792,24,55,79,39,14,11,25,60,151
11044,CHH,1997,Rafael Addison,32,41,3,355,49,122,.402,8,20,.400,41,102,.402,.434,22,28,.786,19,26,45,34,8,3,17,52,128
11045,CHH,1997,Donald Royal,30,25,2,320,21,40,.525,0,0,,21,40,.525,.525,28,35,.800,18,40,58,10,12,2,22,42,70
11046,CHH,1997,George Zídek,23,36,2,288,33,85,.388,0,2,.000,33,83,.398,.388,25,32,.781,25,38,63,9,4,3,23,44,91
11047,CHH,1997,Tom Chambers,37,12,5,83,7,31,.226,2,3,.667,5,28,.179,.258,3,4,.750,3,11,14,4,1,0,9,14,19
11048,CHH,1997,Eric Leckner,30,1,0,11,0,3,.000,0,0,,0,3,.000,.000,0,0,,0,1,1,1,0,0,0,3,0
11049,CHH,1997,Jamie Feick,22,3,0,10,2,4,.500,1,1,1.000,1,3,.333,.625,0,2,.000,1,2,3,0,0,1,0,3,5
11050,CHH,1996,Larry Johnson,26,81,81,3274,583,1225,.476,67,183,.366,516,1042,.495,.503,427,564,.757,249,434,683,355,55,43,182,173,1660
11051,CHH,1996,Glen Rice,28,79,79,3142,610,1296,.471,171,403,.424,439,893,.492,.537,319,381,.837,86,292,378,232,91,19,163,217,1710
11052,CHH,1996,Dell Curry,31,82,29,2371,441,974,.453,164,406,.404,277,568,.488,.537,146,171,.854,68,196,264,176,108,25,130,173,1192
11053,CHH,1996,Matt Geiger,26,77,50,2349,357,666,.536,3,8,.375,354,658,.538,.538,149,205,.727,201,448,649,60,46,63,137,290,866
11054,CHH,1996,Kenny Anderson,25,38,36,1302,206,454,.454,56,157,.357,150,297,.505,.515,109,150,.727,26,76,102,328,59,6,88,105,577
11055,CHH,1996,Kendall Gill,27,36,36,1265,179,372,.481,17,54,.315,162,318,.509,.504,89,117,.761,56,133,189,225,42,22,110,101,464
11056,CHH,1996,Robert Parish,42,74,34,1086,120,241,.498,0,0,,120,241,.498,.498,50,71,.704,89,214,303,29,21,54,50,80,290
11057,CHH,1996,George Zídek,22,71,21,888,105,248,.423,0,0,,105,248,.423,.423,71,93,.763,69,114,183,16,9,7,38,170,281
11058,CHH,1996,Darrin Hancock,24,63,7,838,112,214,.523,1,3,.333,111,211,.526,.526,47,73,.644,40,58,98,47,28,5,56,94,272
11059,CHH,1996,Scott Burrell,25,20,20,693,92,206,.447,37,98,.378,55,108,.509,.536,42,56,.750,26,72,98,47,27,13,43,76,263
11060,CHH,1996,Anthony Goldwire,24,42,8,621,76,189,.402,33,83,.398,43,106,.406,.489,46,60,.767,8,35,43,112,16,0,63,79,231
11061,CHH,1996,Rafael Addison,31,53,0,516,77,165,.467,0,9,.000,77,156,.494,.467,17,22,.773,25,65,90,30,9,9,27,74,171
11062,CHH,1996,Pete Myers,32,32,1,453,29,87,.333,3,16,.188,26,71,.366,.351,31,46,.674,14,53,67,48,20,6,25,57,92
11063,CHH,1996,Khalid Reeves,23,20,5,418,54,118,.458,11,36,.306,43,82,.524,.504,43,51,.843,11,29,40,72,16,1,30,46,162
11064,CHH,1996,Michael Adams,33,21,3,329,37,83,.446,14,41,.341,23,42,.548,.530,26,35,.743,5,17,22,67,21,4,25,25,114
11065,CHH,1996,Greg Sutton,28,18,0,190,20,50,.400,7,21,.333,13,29,.448,.470,15,19,.789,4,11,15,39,8,0,17,36,62
11066,CHH,1996,Muggsy Bogues,31,6,0,77,6,16,.375,0,1,.000,6,15,.400,.375,2,2,1.000,6,1,7,19,2,0,6,4,14
11067,CHH,1996,Corey Beck,24,5,0,33,2,8,.250,0,0,,2,8,.250,.250,1,2,.500,3,4,7,5,1,0,4,8,5
11068,CHH,1996,Joe Wolf,31,1,0,18,0,1,.000,0,0,,0,1,.000,.000,0,0,,0,2,2,0,2,0,2,2,0
11069,CHH,1996,Gerald Glass,28,5,0,15,2,5,.400,0,1,.000,2,4,.500,.400,1,1,1.000,1,1,2,0,1,0,0,5,5
11070,CHH,1996,Donald Hodge,26,2,0,2,0,0,,0,0,,0,0,,,0,0,,0,1,1,0,0,0,0,0,0
11071,CHH,1995,Larry Johnson,25,81,81,3234,585,1219,.480,81,210,.386,504,1009,.500,.513,274,354,.774,190,395,585,369,78,28,207,174,1525
11072,CHH,1995,Alonzo Mourning,24,77,77,2941,571,1101,.519,11,34,.324,560,1067,.525,.524,490,644,.761,200,561,761,111,49,225,241,275,1643
11073,CHH,1995,Hersey Hawkins,28,82,82,2731,390,809,.482,131,298,.440,259,511,.507,.563,261,301,.867,60,254,314,262,122,18,150,178,1172
11074,CHH,1995,Muggsy Bogues,30,78,78,2629,348,730,.477,6,30,.200,342,700,.489,.481,160,180,.889,51,206,257,675,103,0,132,151,862
11075,CHH,1995,Scott Burrell,24,65,62,2014,277,593,.467,96,235,.409,181,358,.506,.548,100,144,.694,96,272,368,161,75,40,85,187,750
11076,CHH,1995,Dell Curry,30,69,0,1718,343,778,.441,154,361,.427,189,417,.453,.540,95,111,.856,41,127,168,113,55,18,98,144,935
11077,CHH,1995,Robert Parish,41,81,4,1352,159,372,.427,0,0,,159,372,.427,.427,71,101,.703,93,257,350,44,27,36,66,132,389
11078,CHH,1995,Greg Sutton,27,53,4,690,94,230,.409,43,115,.374,51,115,.443,.502,32,45,.711,8,48,56,91,33,2,51,114,263
11079,CHH,1995,Joe Wolf,30,63,6,583,38,81,.469,2,6,.333,36,75,.480,.481,12,16,.750,34,95,129,37,9,6,22,101,90
11080,CHH,1995,David Wingate,31,52,9,515,50,122,.410,4,22,.182,46,100,.460,.426,18,24,.750,11,49,60,56,19,6,27,60,122
11081,CHH,1995,Michael Adams,32,29,0,443,67,148,.453,29,81,.358,38,67,.567,.551,25,30,.833,6,23,29,95,23,1,26,41,188
11082,CHH,1995,Darrin Hancock,23,46,7,424,68,121,.562,1,3,.333,67,118,.568,.566,16,39,.410,14,39,53,30,19,4,30,48,153
11083,CHH,1995,Kenny Gattison,30,21,0,409,47,100,.470,0,1,.000,47,99,.475,.470,31,51,.608,21,54,75,17,7,15,22,64,125
11084,CHH,1995,Tom Tolbert,29,10,0,57,6,18,.333,0,4,.000,6,14,.429,.333,2,2,1.000,7,10,17,2,0,0,3,9,14
11085,CHH,1995,Tony Bennett,25,3,0,46,6,13,.462,2,9,.222,4,4,1.000,.538,0,0,,0,2,2,4,0,0,3,6,14
11086,CHH,1995,James Blackwell,26,4,0,19,2,3,.667,0,0,,2,3,.667,.667,0,0,,0,3,3,5,1,0,2,1,4
11087,CHH,1994,Muggsy Bogues,29,77,77,2746,354,751,.471,2,12,.167,352,739,.476,.473,125,155,.806,78,235,313,780,133,2,171,147,835
11088,CHH,1994,Hersey Hawkins,27,82,82,2648,395,859,.460,78,235,.332,317,624,.508,.505,312,362,.862,89,288,377,216,135,22,158,167,1180
11089,CHH,1994,Dell Curry,29,82,0,2173,533,1171,.455,152,378,.402,381,793,.480,.520,117,134,.873,71,191,262,221,98,27,120,161,1335
11090,CHH,1994,Alonzo Mourning,23,60,59,2018,427,845,.505,0,2,.000,427,843,.507,.505,433,568,.762,177,433,610,86,27,188,199,207,1287
11091,CHH,1994,Larry Johnson,24,51,51,1757,346,672,.515,5,21,.238,341,651,.524,.519,137,197,.695,143,305,448,184,29,14,116,131,834
11092,CHH,1994,Kenny Gattison,29,77,18,1644,233,445,.524,0,0,,233,445,.524,.524,126,195,.646,105,253,358,95,59,46,79,229,592
11093,CHH,1994,Eddie Johnson,34,73,27,1460,339,738,.459,59,150,.393,280,588,.476,.499,99,127,.780,80,144,224,125,36,8,84,143,836
11094,CHH,1994,David Wingate,30,50,36,1005,136,283,.481,4,12,.333,132,271,.487,.488,34,51,.667,30,104,134,104,42,6,53,85,310
11095,CHH,1994,Tony Bennett,24,74,5,983,105,263,.399,27,75,.360,78,188,.415,.451,11,15,.733,16,74,90,163,39,1,40,84,248
11096,CHH,1994,Scott Burrell,23,51,16,767,98,234,.419,2,6,.333,96,228,.421,.423,46,70,.657,46,86,132,62,37,16,45,88,244
11097,CHH,1994,LeRon Ellis,24,50,1,680,88,182,.484,0,0,,88,182,.484,.484,45,68,.662,70,118,188,24,17,25,21,83,221
11098,CHH,1994,Frank Brickowski,34,28,6,653,117,233,.502,1,2,.500,116,231,.502,.504,47,63,.746,32,93,125,57,28,11,56,77,282
11099,CHH,1994,Johnny Newman,30,18,18,429,91,174,.523,4,16,.250,87,158,.551,.534,48,59,.814,21,37,58,29,18,5,28,44,234
11100,CHH,1994,Marty Conlon,26,16,8,378,66,109,.606,0,1,.000,66,108,.611,.606,31,38,.816,34,55,89,28,5,7,23,36,163
11101,CHH,1994,Mike Gminski,34,21,6,255,31,79,.392,0,0,,31,79,.392,.392,11,14,.786,19,40,59,11,13,13,11,20,73
11102,CHH,1994,Tim Kempton,30,9,0,103,9,26,.346,0,0,,9,26,.346,.346,7,10,.700,6,8,14,6,4,1,4,25,25
11103,CHH,1994,Rumeal Robinson,27,14,0,95,13,33,.394,1,5,.200,12,28,.429,.409,3,9,.333,2,6,8,18,3,0,18,15,30
11104,CHH,1994,Lorenzo Williams,24,1,0,19,0,1,.000,0,0,,0,1,.000,.000,0,0,,0,4,4,0,1,2,1,2,0
11105,CHH,1994,Steve Henson,25,3,0,17,1,2,.500,1,1,1.000,0,1,.000,.750,0,0,,0,1,1,5,0,0,1,3,3
11106,CHH,1993,Larry Johnson,23,82,82,3323,728,1385,.526,18,71,.254,710,1314,.540,.532,336,438,.767,281,583,864,353,53,27,227,187,1810
11107,CHH,1993,Muggsy Bogues,28,81,80,2833,331,730,.453,6,26,.231,325,704,.462,.458,140,168,.833,51,247,298,711,161,5,154,179,808
11108,CHH,1993,Alonzo Mourning,22,78,78,2644,572,1119,.511,0,3,.000,572,1116,.513,.511,495,634,.781,263,542,805,76,27,271,236,286,1639
11109,CHH,1993,Kendall Gill,24,69,67,2430,463,1032,.449,17,62,.274,446,970,.460,.457,224,290,.772,120,220,340,268,98,36,174,191,1167
11110,CHH,1993,Dell Curry,28,80,0,2094,498,1102,.452,95,237,.401,403,865,.466,.495,136,157,.866,51,235,286,180,87,23,129,150,1227
11111,CHH,1993,Kenny Gattison,28,75,5,1475,203,384,.529,0,3,.000,203,381,.533,.529,102,169,.604,108,245,353,68,48,55,64,237,508
11112,CHH,1993,Johnny Newman,29,64,27,1471,279,534,.522,12,45,.267,267,489,.546,.534,194,240,.808,72,71,143,117,45,19,90,154,764
11113,CHH,1993,David Wingate,29,72,55,1471,180,336,.536,1,6,.167,179,330,.542,.537,79,107,.738,49,125,174,183,66,9,89,135,440
11114,CHH,1993,Tony Bennett,23,75,2,857,110,260,.423,26,80,.325,84,180,.467,.473,30,41,.732,12,51,63,136,30,0,50,110,276
11115,CHH,1993,Kevin Lynch,24,40,8,324,30,59,.508,0,1,.000,30,58,.517,.508,26,38,.684,12,23,35,25,11,6,24,44,86
11116,CHH,1993,J.R. Reid,24,17,1,295,42,98,.429,0,1,.000,42,97,.433,.429,43,58,.741,20,50,70,24,11,5,24,49,127
11117,CHH,1993,Mike Gminski,33,34,0,251,42,83,.506,0,0,,42,83,.506,.506,9,10,.900,34,51,85,7,1,9,11,28,93
11118,CHH,1993,Tom Hammonds,25,19,5,142,19,45,.422,0,0,,19,45,.422,.422,5,8,.625,5,26,31,8,0,4,3,20,43
11119,CHH,1993,Sidney Green,32,24,0,127,14,40,.350,0,2,.000,14,38,.368,.350,12,16,.750,14,33,47,5,1,2,8,16,40
11120,CHH,1993,Lorenzo Williams,23,2,0,18,1,3,.333,0,0,,1,3,.333,.333,0,0,,3,6,9,0,0,2,2,4,2
11121,CHH,1992,Larry Johnson,22,82,77,3047,616,1258,.490,5,22,.227,611,1236,.494,.492,339,409,.829,323,576,899,292,81,51,160,225,1576
11122,CHH,1992,Kendall Gill,23,79,79,2906,666,1427,.467,6,25,.240,660,1402,.471,.469,284,381,.745,165,237,402,329,154,46,180,237,1622
11123,CHH,1992,Muggsy Bogues,27,82,69,2790,317,671,.472,2,27,.074,315,644,.489,.474,94,120,.783,58,177,235,743,170,6,156,156,730
11124,CHH,1992,Kenny Gattison,27,82,71,2223,423,799,.529,0,2,.000,423,797,.531,.529,196,285,.688,177,403,580,131,59,69,140,273,1042
11125,CHH,1992,Dell Curry,27,77,0,2020,504,1038,.486,74,183,.404,430,855,.503,.521,127,152,.836,57,202,259,177,93,20,134,156,1209
11126,CHH,1992,Johnny Newman,28,55,55,1651,295,618,.477,13,46,.283,282,572,.493,.488,236,308,.766,71,108,179,146,70,14,129,181,839
11127,CHH,1992,J.R. Reid,23,51,7,1257,213,435,.490,0,3,.000,213,432,.493,.490,134,190,.705,96,221,317,81,49,23,84,159,560
11128,CHH,1992,Anthony Frederick,27,66,26,852,161,370,.435,4,17,.235,157,353,.445,.441,63,92,.685,75,69,144,71,40,26,58,91,389
11129,CHH,1992,Kevin Lynch,23,55,3,819,93,223,.417,3,8,.375,90,215,.419,.424,35,46,.761,30,55,85,83,37,9,44,107,224
11130,CHH,1992,Eric Leckner,25,59,2,716,79,154,.513,0,1,.000,79,153,.516,.513,38,51,.745,49,157,206,31,9,18,39,114,196
11131,CHH,1992,Rex Chapman,24,21,11,545,108,240,.450,8,27,.296,100,213,.469,.467,36,53,.679,9,45,54,86,14,8,42,47,260
11132,CHH,1992,Mike Gminski,32,35,10,499,90,199,.452,1,3,.333,89,196,.454,.455,21,28,.750,37,81,118,31,11,16,20,37,202
11133,CHH,1992,Elliot Perry,22,40,0,371,43,114,.377,1,5,.200,42,109,.385,.382,26,39,.667,12,20,32,64,25,2,37,26,113
11134,CHH,1992,Greg Grant,25,13,0,57,0,8,.000,0,0,,0,8,.000,.000,1,2,.500,1,3,4,18,8,0,5,3,1
11135,CHH,1992,Ron Grandison,27,3,0,25,2,4,.500,0,0,,2,4,.500,.500,6,10,.600,3,8,11,1,1,1,3,4,10
11136,CHH,1992,Tony Massenburg,24,3,0,13,0,3,.000,0,0,,0,3,.000,.000,1,2,.500,1,3,4,0,1,0,4,2,1
11137,CHH,1992,Michael Ansley,24,2,0,13,3,7,.429,0,0,,3,7,.429,.429,0,0,,0,2,2,0,0,0,0,1,6
11138,CHH,1992,Cedric Hunter,27,1,0,1,0,0,,0,0,,0,0,,,0,0,,0,0,0,0,0,0,0,0,0
11139,CHH,1991,Johnny Newman,27,81,81,2477,478,1017,.470,30,84,.357,448,933,.480,.485,385,476,.809,94,160,254,188,100,17,189,278,1371
11140,CHH,1991,J.R. Reid,22,80,80,2467,360,773,.466,0,2,.000,360,771,.467,.466,182,259,.703,154,348,502,89,87,47,153,286,902
11141,CHH,1991,Muggsy Bogues,26,81,46,2299,241,524,.460,0,12,.000,241,512,.471,.460,86,108,.796,58,158,216,669,137,3,120,160,568
11142,CHH,1991,Rex Chapman,23,70,68,2100,410,922,.445,48,148,.324,362,774,.468,.471,234,282,.830,45,146,191,250,73,16,131,167,1102
11143,CHH,1991,Kendall Gill,22,82,36,1944,376,836,.450,2,14,.143,374,822,.455,.451,152,182,.835,105,158,263,303,104,39,163,186,906
11144,CHH,1991,Kenny Gattison,26,72,6,1552,243,457,.532,0,2,.000,243,455,.534,.532,164,248,.661,136,243,379,44,48,67,102,211,650
11145,CHH,1991,Dell Curry,26,76,14,1515,337,715,.471,32,86,.372,305,629,.485,.494,96,114,.842,47,152,199,166,75,25,80,125,802
11146,CHH,1991,Mike Gminski,31,50,50,1405,248,524,.473,1,6,.167,247,518,.477,.474,75,95,.789,115,266,381,60,24,22,54,58,572
11147,CHH,1991,Kelly Tripucka,31,77,1,1289,187,412,.454,15,45,.333,172,367,.469,.472,152,167,.910,46,130,176,159,33,13,92,130,541
11148,CHH,1991,Armen Gilliam,26,25,25,949,195,380,.513,0,0,,195,380,.513,.513,104,128,.813,86,148,234,27,34,21,64,65,494
11149,CHH,1991,Eric Leckner,24,40,2,744,92,198,.465,0,0,,92,198,.465,.465,46,84,.548,55,153,208,21,10,11,44,123,230
11150,CHH,1991,Randolph Keys,24,44,0,473,59,145,.407,3,14,.214,56,131,.427,.417,19,33,.576,40,60,100,18,22,15,35,93,140
11151,CHH,1991,Steve Scheffler,23,39,0,227,20,39,.513,0,0,,20,39,.513,.513,19,21,.905,21,24,45,9,6,2,4,20,59
11152,CHH,1991,Earl Cureton,33,9,1,159,8,24,.333,0,1,.000,8,23,.348,.333,1,3,.333,6,30,36,3,0,3,6,16,17
11153,CHH,1991,Dave Hoppen,26,19,0,112,18,32,.563,0,1,.000,18,31,.581,.563,8,10,.800,14,16,30,3,2,1,12,18,44
11154,CHH,1991,Scott Haffner,24,7,0,50,8,21,.381,0,2,.000,8,19,.421,.381,1,2,.500,2,2,4,9,3,1,4,4,17
11155,CHH,1991,Jeff Sanders,25,3,0,43,6,14,.429,0,0,,6,14,.429,.429,1,2,.500,3,6,9,1,1,1,1,6,13
11156,CHH,1990,J.R. Reid,21,82,82,2757,358,814,.440,0,5,.000,358,809,.443,.440,192,289,.664,199,492,691,101,92,54,172,292,908
11157,CHH,1990,Muggsy Bogues,25,81,65,2743,326,664,.491,5,26,.192,321,638,.503,.495,106,134,.791,48,159,207,867,166,3,146,168,763
11158,CHH,1990,Kelly Tripucka,30,79,73,2404,442,1029,.430,38,104,.365,404,925,.437,.448,310,351,.883,82,240,322,224,75,16,176,220,1232
11159,CHH,1990,Armen Gilliam,25,60,59,2159,432,819,.527,0,2,.000,432,817,.529,.527,264,363,.727,185,344,529,91,63,46,166,184,1128
11160,CHH,1990,Dell Curry,25,67,13,1860,461,990,.466,52,147,.354,409,843,.485,.492,96,104,.923,31,137,168,159,98,26,100,148,1070
11161,CHH,1990,Rex Chapman,22,54,52,1762,377,924,.408,47,142,.331,330,782,.422,.433,144,192,.750,52,127,179,132,46,6,100,113,945
11162,CHH,1990,Robert Reid,34,60,27,1117,162,414,.391,9,29,.310,153,385,.397,.402,50,78,.641,33,110,143,82,36,14,44,136,383
11163,CHH,1990,Kenny Gattison,25,63,2,941,148,269,.550,1,1,1.000,147,268,.549,.552,75,110,.682,75,122,197,39,35,31,67,150,372
11164,CHH,1990,Randolph Keys,23,32,5,723,142,319,.445,12,33,.364,130,286,.455,.464,40,58,.690,48,68,116,49,30,6,37,107,336
11165,CHH,1990,Richard Anderson,29,54,2,604,88,211,.417,37,100,.370,51,111,.459,.505,18,23,.783,33,94,127,55,20,9,26,64,231
11166,CHH,1990,Brian Rowsom,24,44,2,559,78,179,.436,1,2,.500,77,177,.435,.439,68,83,.819,44,87,131,22,18,11,25,58,225
11167,CHH,1990,Jerry Sichting,33,34,8,469,50,119,.420,3,12,.250,47,107,.439,.433,15,18,.833,3,16,19,92,16,2,22,39,118
11168,CHH,1990,Stuart Gray,26,39,1,466,38,82,.463,0,2,.000,38,80,.475,.463,25,39,.641,38,93,131,17,12,24,19,64,101
11169,CHH,1990,Kurt Rambis,31,16,16,448,58,116,.500,0,1,.000,58,115,.504,.500,30,55,.545,48,72,120,28,32,10,29,45,146
11170,CHH,1990,Micheal Williams,23,22,1,303,58,109,.532,0,3,.000,58,106,.547,.532,35,44,.795,11,20,31,77,22,1,28,39,151
11171,CHH,1990,Dave Hoppen,25,10,2,135,16,41,.390,0,0,,16,41,.390,.390,8,10,.800,19,17,36,6,2,1,8,26,40
11172,CHH,1990,Michael Holton,28,16,0,109,14,26,.538,0,0,,14,26,.538,.538,1,2,.500,1,1,2,16,1,0,13,19,29
11173,CHH,1990,Terry Dozier,23,9,0,92,9,27,.333,0,1,.000,9,26,.346,.333,4,8,.500,7,8,15,3,6,2,7,10,22
11174,CHH,1990,Andre Turner,25,8,0,84,9,25,.360,0,1,.000,9,24,.375,.360,4,4,1.000,1,2,3,20,7,0,8,5,22
11175,CHH,1990,Ralph Lewis,26,3,0,20,4,6,.667,0,0,,4,6,.667,.667,2,2,1.000,4,2,6,0,1,0,1,2,10
11176,CHH,1989,Kelly Tripucka,29,71,65,2302,568,1215,.467,30,84,.357,538,1131,.476,.480,440,508,.866,79,188,267,224,88,16,236,196,1606
11177,CHH,1989,Kurt Rambis,30,75,75,2233,325,627,.518,0,3,.000,325,624,.521,.518,182,248,.734,269,434,703,159,100,57,148,208,832
11178,CHH,1989,Rex Chapman,21,75,44,2219,526,1271,.414,60,191,.314,466,1080,.431,.437,155,195,.795,74,113,187,176,70,25,113,167,1267
11179,CHH,1989,Robert Reid,33,82,54,2152,519,1214,.428,17,52,.327,502,1162,.432,.435,152,196,.776,82,220,302,153,53,20,106,235,1207
11180,CHH,1989,Earl Cureton,31,82,41,2047,233,465,.501,0,1,.000,233,464,.502,.501,66,123,.537,188,300,488,130,50,61,114,230,532
11181,CHH,1989,Muggsy Bogues,24,79,21,1755,178,418,.426,1,13,.077,177,405,.437,.427,66,88,.750,53,112,165,620,111,7,124,141,423
11182,CHH,1989,Michael Holton,27,67,60,1696,215,504,.427,3,14,.214,212,490,.433,.430,120,143,.839,30,75,105,424,66,12,119,165,553
11183,CHH,1989,Dave Hoppen,24,77,36,1419,199,353,.564,1,2,.500,198,351,.564,.565,101,139,.727,123,261,384,57,25,21,77,239,500
11184,CHH,1989,Tim Kempton,25,79,0,1341,171,335,.510,0,1,.000,171,334,.512,.510,142,207,.686,91,213,304,102,41,14,121,215,484
11185,CHH,1989,Dell Curry,24,48,0,813,256,521,.491,19,55,.345,237,466,.509,.510,40,46,.870,26,78,104,50,42,4,44,68,571
11186,CHH,1989,Brian Rowsom,23,34,0,517,80,162,.494,1,1,1.000,79,161,.491,.497,65,81,.802,56,81,137,24,10,12,18,69,226
11187,CHH,1989,Rickey Green,34,33,2,370,57,132,.432,1,5,.200,56,127,.441,.436,13,14,.929,4,19,23,82,18,0,28,16,128
11188,CHH,1989,Ralph Lewis,25,42,0,336,58,121,.479,1,3,.333,57,118,.483,.483,19,39,.487,35,26,61,15,11,3,24,28,136
11189,CHH,1989,Sidney Lowe,29,14,0,250,8,25,.320,0,2,.000,8,23,.348,.320,7,11,.636,6,28,34,93,14,0,9,28,23
11190,CHH,1989,Greg Kite,27,12,12,213,16,30,.533,0,0,,16,30,.533,.533,6,10,.600,15,38,53,7,4,8,12,43,38
11191,CHH,1989,Tom Tolbert,23,14,0,117,17,37,.459,0,3,.000,17,34,.500,.459,6,12,.500,7,14,21,7,2,4,2,20,40
11192,DET,2024,Jaden Ivey,21,77,61,2217,417,973,.429,124,369,.336,293,604,.485,.492,227,303,.749,86,178,264,296,57,41,190,204,1185
11193,DET,2024,Cade Cunningham,22,62,62,2074,524,1167,.449,119,335,.355,405,832,.487,.500,238,274,.869,33,235,268,464,56,22,212,153,1405
11194,DET,2024,Jalen Duren,20,61,60,1777,349,564,.619,0,4,.000,349,560,.623,.619,143,181,.790,192,517,709,147,33,47,129,192,841
11195,DET,2024,Ausar Thompson,21,63,38,1583,232,480,.483,21,113,.186,211,367,.575,.505,71,119,.597,129,273,402,120,68,59,84,175,556
11196,DET,2024,Isaiah Stewart,22,46,45,1423,186,382,.487,67,175,.383,119,207,.575,.575,64,85,.753,74,231,305,73,17,38,66,99,503
11197,DET,2024,Marcus Sasser,23,71,11,1351,219,512,.428,90,240,.375,129,272,.474,.516,58,66,.879,11,114,125,236,44,12,90,103,586
11198,DET,2024,James Wiseman,22,63,6,1091,187,305,.613,0,2,.000,187,303,.617,.613,72,102,.706,110,226,336,54,12,39,66,141,446
11199,DET,2024,Killian Hayes,22,42,31,1008,117,283,.413,22,74,.297,95,209,.455,.452,33,50,.660,11,108,119,205,36,20,51,75,289
11200,DET,2024,Bojan Bogdanović,34,28,27,921,199,425,.468,86,207,.415,113,218,.518,.569,81,104,.779,13,81,94,71,23,4,63,57,565
11201,DET,2024,Alec Burks,32,43,0,901,160,406,.394,99,247,.401,61,159,.384,.516,121,134,.903,16,94,110,68,21,11,32,64,540
11202,DET,2024,Kevin Knox,24,31,11,560,86,186,.462,31,94,.330,55,92,.598,.546,20,22,.909,18,57,75,23,13,7,22,50,223
11203,DET,2024,Evan Fournier,31,29,0,541,75,201,.373,31,115,.270,44,86,.512,.450,27,34,.794,5,49,54,45,25,7,20,44,208
11204,DET,2024,Simone Fontecchio,28,16,9,484,91,190,.479,43,101,.426,48,89,.539,.592,22,26,.846,12,58,70,28,14,5,17,29,247
11205,DET,2024,Marvin Bagley III,24,26,10,478,107,181,.591,1,6,.167,106,175,.606,.594,50,61,.820,46,72,118,27,5,14,29,40,265
11206,DET,2024,Isaiah Livers,25,23,6,469,40,116,.345,22,77,.286,18,39,.462,.440,12,18,.667,15,33,48,25,13,5,16,43,114
11207,DET,2024,Troy Brown Jr.,24,22,12,417,32,108,.296,16,57,.281,16,51,.314,.370,13,15,.867,11,61,72,25,16,1,12,16,93
11208,DET,2024,Chimezie Metu,26,14,7,411,57,114,.500,13,43,.302,44,71,.620,.557,20,21,.952,17,67,84,27,24,7,25,32,147
11209,DET,2024,Malachi Flynn,25,24,0,342,71,165,.430,24,76,.316,47,89,.528,.503,26,38,.684,8,35,43,51,19,2,27,21,192
11210,DET,2024,Stanley Umude,24,24,2,307,37,84,.440,24,53,.453,13,31,.419,.583,29,32,.906,8,43,51,11,8,7,14,40,127
11211,DET,2024,Tosan Evbuomwan,22,13,8,293,32,56,.571,10,24,.417,22,32,.688,.661,17,25,.680,10,36,46,10,6,4,8,18,91
11212,DET,2024,Jared Rhoden,24,17,0,245,33,66,.500,12,31,.387,21,35,.600,.591,5,8,.625,3,30,33,14,3,13,7,28,83
11213,DET,2024,Mike Muscala,32,13,4,171,15,44,.341,13,34,.382,2,10,.200,.489,2,4,.500,10,19,29,10,3,5,2,13,45
11214,DET,2024,Joe Harris,32,16,0,170,14,39,.359,10,30,.333,4,9,.444,.487,1,2,.500,3,10,13,10,3,2,4,19,39
11215,DET,2024,Quentin Grimes,23,6,0,115,9,42,.214,4,28,.143,5,14,.357,.262,10,11,.909,1,11,12,14,5,4,7,9,32
11216,DET,2024,Danilo Gallinari,35,6,0,90,12,22,.545,7,12,.583,5,10,.500,.705,21,24,.875,2,12,14,12,2,2,1,9,52
11217,DET,2024,Buddy Boeheim,24,10,0,84,9,29,.310,8,25,.320,1,4,.250,.448,8,10,.800,3,7,10,3,0,1,0,5,34
11218,DET,2024,Monte Morris,28,6,0,68,12,33,.364,2,11,.182,10,22,.455,.394,1,2,.500,2,10,12,8,1,1,2,1,27
11219,DET,2024,Shake Milton,27,4,0,63,11,26,.423,3,9,.333,8,17,.471,.481,2,3,.667,7,11,18,6,2,1,3,3,27
11220,DET,2024,Jaylen Nowell,24,4,0,58,12,23,.522,2,6,.333,10,17,.588,.565,4,6,.667,3,7,10,3,1,2,2,2,30
11221,DET,2024,Taj Gibson,38,4,0,39,8,14,.571,2,4,.500,6,10,.600,.643,0,0,,2,7,9,2,1,1,0,3,18
11222,DET,2024,Malcolm Cazalon,22,1,0,3,0,0,,0,0,,0,0,,,0,0,,0,0,0,0,0,0,0,0,0
11223,DET,2023,Jaden Ivey,20,74,73,2304,409,983,.416,120,350,.343,289,633,.457,.477,266,356,.747,73,215,288,387,61,17,237,242,1204
11224,DET,2023,Killian Hayes,21,76,56,2154,307,815,.377,80,286,.280,227,529,.429,.426,92,112,.821,28,193,221,470,104,28,173,219,786
11225,DET,2023,Bojan Bogdanović,33,59,59,1893,430,882,.488,145,353,.411,285,529,.539,.570,268,303,.884,36,187,223,152,34,8,135,113,1273
11226,DET,2023,Jalen Duren,19,67,31,1670,258,398,.648,0,2,.000,258,396,.652,.648,96,157,.611,229,366,595,75,44,59,92,182,612
11227,DET,2023,Saddiq Bey,23,52,30,1500,245,606,.404,101,293,.345,144,313,.460,.488,180,209,.861,59,183,242,84,50,12,54,86,771
11228,DET,2023,Isaiah Stewart,21,50,47,1414,195,441,.442,67,205,.327,128,236,.542,.518,110,149,.738,115,288,403,70,20,34,68,133,567
11229,DET,2023,Cory Joseph,31,62,2,1227,150,351,.427,70,180,.389,80,171,.468,.527,57,72,.792,21,85,106,217,34,9,56,88,427
11230,DET,2023,Isaiah Livers,24,52,22,1199,120,288,.417,74,203,.365,46,85,.541,.545,32,39,.821,28,115,143,41,28,28,30,103,346
11231,DET,2023,Alec Burks,31,51,8,1122,200,459,.436,99,239,.414,101,220,.459,.544,153,188,.814,19,139,158,114,38,8,58,98,652
11232,DET,2023,Hamidou Diallo,24,56,0,996,215,375,.573,5,21,.238,210,354,.593,.580,87,148,.588,57,137,194,55,53,16,71,124,522
11233,DET,2023,Marvin Bagley III,23,42,25,990,202,382,.529,19,66,.288,183,316,.579,.554,81,108,.750,94,175,269,36,19,30,46,81,504
11234,DET,2023,James Wiseman,21,24,22,605,130,245,.531,3,18,.167,127,227,.559,.537,42,59,.712,55,139,194,16,4,20,37,69,305
11235,DET,2023,Kevin Knox,23,42,1,593,84,179,.469,43,116,.371,41,63,.651,.589,26,33,.788,20,88,108,15,14,12,32,74,237
11236,DET,2023,Rodney McGruder,31,32,12,524,62,152,.408,41,97,.423,21,55,.382,.543,18,22,.818,20,54,74,28,16,1,11,39,183
11237,DET,2023,Cade Cunningham,21,12,12,400,93,224,.415,17,61,.279,76,163,.466,.453,36,43,.837,12,62,74,72,10,7,39,34,239
11238,DET,2023,R.J. Hampton,21,21,3,389,52,123,.423,23,63,.365,29,60,.483,.516,26,39,.667,9,39,48,20,11,5,21,29,153
11239,DET,2023,Eugene Omoruyi,25,17,4,373,57,134,.425,17,58,.293,40,76,.526,.489,34,47,.723,21,38,59,17,14,3,18,45,165
11240,DET,2023,Jared Rhoden,23,14,0,198,17,44,.386,5,20,.250,12,24,.500,.443,6,6,1.000,11,26,37,4,4,1,3,23,45
11241,DET,2023,Nerlens Noel,28,14,3,152,12,30,.400,1,2,.500,11,28,.393,.417,7,10,.700,7,30,37,7,13,9,8,25,32
11242,DET,2023,Buddy Boeheim,23,10,0,90,5,27,.185,4,25,.160,1,2,.500,.259,2,2,1.000,2,4,6,4,2,0,0,6,16
11243,DET,2023,Braxton Key,25,3,0,9,1,1,1.000,0,0,,1,1,1.000,1.000,2,2,1.000,0,1,1,0,0,0,0,0,4
11244,DET,2023,Stanley Umude,23,1,0,2,0,1,.000,0,1,.000,0,0,,.000,2,2,1.000,0,0,0,0,1,1,0,0,2
11245,DET,2022,Saddiq Bey,22,82,82,2704,450,1136,.396,211,610,.346,239,526,.454,.489,210,254,.827,107,334,441,233,73,16,96,128,1321
11246,DET,2022,Cade Cunningham,20,64,64,2088,429,1031,.416,114,363,.314,315,668,.472,.471,142,168,.845,58,296,354,356,78,43,234,200,1114
11247,DET,2022,Isaiah Stewart,20,71,71,1816,250,490,.510,15,46,.326,235,444,.529,.526,74,103,.718,226,391,617,82,22,78,85,211,589
11248,DET,2022,Killian Hayes,20,66,40,1647,176,459,.383,44,167,.263,132,292,.452,.431,57,74,.770,36,174,210,277,78,35,111,183,453
11249,DET,2022,Cory Joseph,30,65,39,1600,178,400,.445,65,157,.414,113,243,.465,.526,100,113,.885,29,145,174,237,42,17,85,147,521
11250,DET,2022,Jerami Grant,27,47,47,1500,298,699,.426,91,254,.358,207,445,.465,.491,217,259,.838,28,163,191,111,44,49,85,107,904
11251,DET,2022,Hamidou Diallo,23,58,29,1269,261,526,.496,23,93,.247,238,433,.550,.518,91,140,.650,69,208,277,73,71,17,58,143,636
11252,DET,2022,Frank Jackson,23,53,7,1164,194,483,.402,86,279,.308,108,204,.529,.491,86,104,.827,19,68,87,55,27,9,38,89,560
11253,DET,2022,Trey Lyles,26,51,3,990,175,384,.456,44,146,.301,131,238,.550,.513,138,176,.784,60,184,244,58,22,26,54,91,532
11254,DET,2022,Kelly Olynyk,30,40,1,764,128,286,.448,40,119,.336,88,167,.527,.517,69,89,.775,54,123,177,111,31,19,58,100,365
11255,DET,2022,Rodney McGruder,30,51,2,754,98,225,.436,58,146,.397,40,79,.506,.564,19,26,.731,31,80,111,48,21,7,24,58,273
11256,DET,2022,Josh Jackson,24,39,3,707,103,251,.410,30,113,.265,73,138,.529,.470,40,56,.714,17,106,123,49,21,18,38,71,276
11257,DET,2022,Saben Lee,22,37,0,604,69,177,.390,14,60,.233,55,117,.470,.429,56,71,.789,18,69,87,107,36,12,36,44,208
11258,DET,2022,Marvin Bagley III,22,18,8,490,111,200,.555,8,35,.229,103,165,.624,.575,32,54,.593,38,85,123,19,13,7,18,43,262
11259,DET,2022,Luka Garza,23,32,5,389,66,147,.449,16,49,.327,50,98,.510,.503,38,61,.623,58,42,100,20,9,6,18,55,186
11260,DET,2022,Isaiah Livers,23,19,5,383,41,90,.456,27,64,.422,14,26,.538,.606,12,14,.857,15,42,57,21,13,7,15,37,121
11261,DET,2022,Braxton Key,24,9,0,191,32,70,.457,6,20,.300,26,50,.520,.500,7,13,.538,12,36,48,10,9,11,9,25,77
11262,DET,2022,Jamorko Pickett,24,13,0,176,18,50,.360,13,39,.333,5,11,.455,.490,1,2,.500,6,26,32,7,0,7,5,12,50
11263,DET,2022,Cassius Stanley,22,9,1,155,19,46,.413,4,17,.235,15,29,.517,.457,10,10,1.000,5,14,19,4,5,2,6,17,52
11264,DET,2022,Derrick Walton,26,3,3,108,6,26,.231,3,13,.231,3,13,.231,.288,4,4,1.000,2,8,10,21,7,4,11,8,19
11265,DET,2022,Justin Robinson,24,5,0,91,9,28,.321,8,21,.381,1,7,.143,.464,2,6,.333,2,5,7,9,1,1,5,8,28
11266,DET,2022,Carsen Edwards,23,4,0,79,9,30,.300,4,16,.250,5,14,.357,.367,1,1,1.000,2,4,6,14,2,0,5,4,23
11267,DET,2022,Micah Potter,23,3,0,31,5,11,.455,0,2,.000,5,9,.556,.455,2,2,1.000,4,5,9,0,1,1,1,4,12
11268,DET,2022,Cheick Diallo,25,3,0,31,3,8,.375,0,0,,3,8,.375,.375,5,6,.833,4,8,12,0,1,0,1,6,11
11269,DET,2022,Deividas Sirvydis,21,3,0,27,1,10,.100,1,7,.143,0,3,.000,.150,0,0,,0,6,6,1,3,1,0,4,3
11270,DET,2022,Trayvon Palmer,27,1,0,17,0,1,.000,0,0,,0,1,.000,.000,0,0,,0,2,2,0,0,0,1,2,0
11271,DET,2022,Jaysean Paige,27,1,0,7,0,3,.000,0,2,.000,0,1,.000,.000,0,0,,0,1,1,1,0,0,1,2,0
11272,DET,2021,Saddiq Bey,21,70,53,1909,279,691,.404,175,460,.380,104,231,.450,.530,124,147,.844,43,275,318,95,52,14,60,110,857
11273,DET,2021,Jerami Grant,26,54,54,1829,400,932,.429,115,329,.350,285,603,.473,.491,290,343,.845,35,215,250,152,35,58,109,125,1205
11274,DET,2021,Josh Jackson,23,62,25,1560,296,707,.419,77,257,.300,219,450,.487,.473,159,218,.729,57,197,254,143,53,47,142,178,828
11275,DET,2021,Mason Plumlee,30,56,56,1499,234,381,.614,0,7,.000,234,374,.626,.614,113,169,.669,145,374,519,202,43,50,105,186,581
11276,DET,2021,Isaiah Stewart,19,68,14,1455,226,409,.553,21,63,.333,205,346,.592,.578,64,92,.696,159,294,453,59,39,86,67,184,537
11277,DET,2021,Delon Wright,28,36,31,1052,136,293,.464,31,89,.348,105,204,.515,.517,71,90,.789,37,127,164,181,58,19,48,45,374
11278,DET,2021,Wayne Ellington,33,46,31,1012,149,338,.441,116,275,.422,33,63,.524,.612,28,35,.800,12,73,85,67,18,9,33,59,442
11279,DET,2021,Sekou Doumbouya,20,56,11,869,107,282,.379,26,115,.226,81,167,.485,.426,45,64,.703,39,104,143,47,24,9,44,94,285
11280,DET,2021,Saben Lee,21,48,7,781,99,210,.471,8,23,.348,91,187,.487,.490,61,89,.685,20,77,97,174,32,13,55,76,267
11281,DET,2021,Frank Jackson,22,40,6,738,134,293,.457,61,150,.407,73,143,.510,.561,61,75,.813,15,71,86,36,15,1,34,53,390
11282,DET,2021,Killian Hayes,19,26,18,670,71,201,.353,20,72,.278,51,129,.395,.403,14,17,.824,6,63,69,138,27,10,83,57,176
11283,DET,2021,Svi Mykhailiuk,23,36,5,634,84,223,.377,57,171,.333,27,52,.519,.504,24,30,.800,11,63,74,57,27,6,39,33,249
11284,DET,2021,Blake Griffin,31,20,20,626,81,222,.365,39,124,.315,42,98,.429,.453,44,62,.710,7,97,104,77,14,2,32,42,245
11285,DET,2021,Cory Joseph,29,19,11,502,89,176,.506,14,38,.368,75,138,.543,.545,36,41,.878,10,50,60,105,22,9,35,41,228
11286,DET,2021,Hamidou Diallo,22,20,4,465,81,173,.468,16,41,.390,65,132,.492,.514,45,68,.662,22,85,107,24,10,12,27,51,223
11287,DET,2021,Tyler Cook,23,28,1,421,68,100,.680,1,2,.500,67,98,.684,.685,17,35,.486,27,66,93,15,8,2,20,33,154
11288,DET,2021,Dennis Smith Jr.,23,20,9,392,56,135,.415,19,54,.352,37,81,.457,.485,14,20,.700,12,41,53,74,20,14,25,33,145
11289,DET,2021,Jahlil Okafor,25,27,2,347,63,102,.618,2,9,.222,61,93,.656,.627,17,24,.708,23,43,66,13,6,5,21,39,145
11290,DET,2021,Derrick Rose,32,15,0,342,79,184,.429,13,39,.333,66,145,.455,.465,42,50,.840,6,23,29,63,18,4,29,17,213
11291,DET,2021,Rodney McGruder,29,16,2,194,37,70,.529,11,24,.458,26,46,.565,.607,6,8,.750,8,14,22,16,8,1,7,12,91
11292,DET,2021,Deividas Sirvydis,20,20,0,133,14,40,.350,10,28,.357,4,12,.333,.475,3,6,.500,0,29,29,5,2,0,5,9,41
11293,DET,2020,Langston Galloway,28,66,6,1702,236,542,.435,132,331,.399,104,211,.493,.557,73,85,.859,33,116,149,101,48,11,40,96,677
11294,DET,2020,Andre Drummond,26,49,48,1654,360,679,.530,1,21,.048,359,658,.546,.531,149,255,.584,226,549,775,138,97,82,174,176,870
11295,DET,2020,Tony Snell,28,59,57,1641,170,382,.445,102,254,.402,68,128,.531,.579,32,32,1.000,9,102,111,127,32,15,31,101,474
11296,DET,2020,Bruce Brown,23,58,43,1634,198,447,.443,33,96,.344,165,351,.470,.480,88,119,.739,61,213,274,230,63,29,100,162,517
11297,DET,2020,Christian Wood,24,62,12,1325,288,508,.567,54,140,.386,234,368,.636,.620,180,242,.744,104,286,390,60,34,54,84,98,810
11298,DET,2020,Derrick Rose,31,50,15,1298,369,753,.490,45,147,.306,324,606,.535,.520,121,139,.871,27,94,121,278,40,16,126,49,904
11299,DET,2020,Svi Mykhailiuk,22,56,27,1265,166,405,.410,115,285,.404,51,120,.425,.552,57,70,.814,17,87,104,106,41,4,61,87,504
11300,DET,2020,Markieff Morris,30,44,16,988,175,389,.450,75,189,.397,100,200,.500,.546,61,79,.772,24,149,173,69,26,11,70,104,486
11301,DET,2020,Luke Kennard,23,28,25,922,151,342,.442,73,183,.399,78,159,.491,.548,67,75,.893,9,89,98,115,12,6,43,65,442
11302,DET,2020,Thon Maker,22,60,14,776,93,193,.482,22,64,.344,71,129,.550,.539,73,110,.664,54,113,167,43,25,39,45,102,281
11303,DET,2020,Sekou Doumbouya,19,38,19,754,92,236,.390,28,98,.286,64,138,.464,.449,31,46,.674,20,98,118,19,20,8,35,80,243
11304,DET,2020,Blake Griffin,30,18,18,512,88,250,.352,27,111,.243,61,139,.439,.406,76,98,.776,17,67,84,59,7,7,40,27,279
11305,DET,2020,Reggie Jackson,29,14,10,381,76,198,.384,31,82,.378,45,116,.388,.462,26,33,.788,11,30,41,72,8,1,23,21,209
11306,DET,2020,Tim Frazier,29,27,11,355,34,94,.362,10,30,.333,24,64,.375,.415,19,24,.792,9,24,33,93,14,4,36,42,97
11307,DET,2020,Brandon Knight,28,9,3,221,31,81,.383,26,67,.388,5,14,.357,.543,16,21,.762,1,20,21,38,5,1,22,20,104
11308,DET,2020,John Henson,29,11,6,188,34,51,.667,2,5,.400,32,46,.696,.686,6,13,.462,14,34,48,11,8,10,15,23,76
11309,DET,2020,Jordan McRae,28,4,0,98,14,43,.326,3,16,.188,11,27,.407,.360,16,22,.727,0,15,15,7,0,0,5,10,47
11310,DET,2020,Louis King,20,10,0,62,8,21,.381,4,11,.364,4,10,.400,.476,0,3,.000,1,9,10,5,2,0,2,10,20
11311,DET,2020,Khyri Thomas,23,8,0,61,5,17,.294,5,14,.357,0,3,.000,.441,2,4,.500,1,0,1,3,3,0,3,9,17
11312,DET,2020,Jordan Bone,22,10,0,53,5,20,.250,2,10,.200,3,10,.300,.300,0,0,,0,4,4,8,1,0,2,6,12
11313,DET,2020,Donta Hall,22,4,0,48,1,4,.250,0,0,,1,4,.250,.250,4,6,.667,6,9,15,2,1,1,2,9,6
11314,DET,2020,Derrick Walton,24,3,0,26,1,3,.333,1,3,.333,0,0,,.500,0,0,,0,1,1,5,3,0,1,2,3
11315,DET,2019,Andre Drummond,25,79,79,2647,561,1052,.533,5,38,.132,556,1014,.548,.536,243,412,.590,423,809,1232,112,136,138,175,272,1370
11316,DET,2019,Blake Griffin,29,75,75,2622,619,1341,.462,189,522,.362,430,819,.525,.532,414,550,.753,100,465,565,402,52,28,253,199,1841
11317,DET,2019,Reggie Jackson,28,82,82,2289,441,1047,.421,174,471,.369,267,576,.464,.504,204,236,.864,45,171,216,344,55,9,148,208,1260
11318,DET,2019,Langston Galloway,27,80,4,1745,228,587,.388,135,380,.355,93,207,.449,.503,81,96,.844,49,122,171,85,37,8,24,135,672
11319,DET,2019,Bruce Brown,22,74,56,1449,125,314,.398,24,93,.258,101,221,.457,.436,45,60,.750,48,137,185,91,40,36,46,178,319
11320,DET,2019,Luke Kennard,22,63,10,1437,228,520,.438,106,269,.394,122,251,.486,.540,51,61,.836,12,171,183,114,26,10,57,92,613
11321,DET,2019,Reggie Bullock,27,44,44,1355,182,441,.413,114,294,.388,68,147,.463,.542,56,64,.875,20,103,123,109,24,5,54,79,534
11322,DET,2019,Ish Smith,30,56,0,1251,205,489,.419,44,135,.326,161,354,.455,.464,47,62,.758,23,122,145,203,28,11,61,109,501
11323,DET,2019,Stanley Johnson,22,48,7,961,133,349,.381,51,181,.282,82,168,.488,.454,41,51,.804,25,150,175,60,48,13,55,92,358
11324,DET,2019,Zaza Pachulia,34,68,3,878,85,193,.440,0,4,.000,85,189,.450,.440,97,124,.782,99,166,265,91,31,17,57,151,267
11325,DET,2019,Wayne Ellington,31,28,26,764,115,273,.421,81,217,.373,34,56,.607,.570,25,33,.758,8,52,60,43,30,3,26,52,336
11326,DET,2019,José Calderón,37,49,0,632,45,120,.375,14,57,.246,31,63,.492,.433,9,11,.818,11,49,60,115,16,3,35,64,113
11327,DET,2019,Glenn Robinson III,25,47,18,610,74,176,.420,18,62,.290,56,114,.491,.472,32,40,.800,17,54,71,21,14,8,18,45,198
11328,DET,2019,Thon Maker,21,29,5,563,50,134,.373,23,75,.307,27,59,.458,.459,36,47,.766,24,82,106,27,11,33,24,50,159
11329,DET,2019,Jon Leuer,29,41,1,402,66,113,.584,1,11,.091,65,102,.637,.588,23,31,.742,27,70,97,14,12,4,23,60,156
11330,DET,2019,Khyri Thomas,22,26,0,195,22,69,.319,10,35,.286,12,34,.353,.391,7,11,.636,4,16,20,8,7,5,4,22,61
11331,DET,2019,Henry Ellenson,22,2,0,25,4,10,.400,2,4,.500,2,6,.333,.500,2,2,1.000,0,9,9,1,0,0,0,2,12
11332,DET,2019,Svi Mykhailiuk,21,3,0,20,2,8,.250,2,4,.500,0,4,.000,.375,0,0,,1,1,2,4,1,0,1,0,6
11333,DET,2019,Kalin Lucas,29,1,0,6,0,1,.000,0,1,.000,0,0,,.000,2,2,1.000,0,3,3,1,0,0,0,1,2
11334,DET,2019,Zach Lofton,26,1,0,4,0,1,.000,0,1,.000,0,0,,.000,0,0,,0,0,0,0,1,0,1,0,0
11335,DET,2018,Andre Drummond,24,78,78,2625,466,881,.529,0,11,.000,466,870,.536,.529,239,395,.605,399,848,1247,237,114,127,200,250,1171
11336,DET,2018,Ish Smith,29,82,35,2043,389,801,.486,35,101,.347,354,700,.506,.507,81,116,.698,27,197,224,360,64,20,108,140,894
11337,DET,2018,Stanley Johnson,21,69,50,1894,210,560,.375,67,234,.286,143,326,.439,.435,112,145,.772,33,219,252,112,95,14,77,169,599
11338,DET,2018,Anthony Tolliver,32,79,14,1757,219,472,.464,159,365,.436,60,107,.561,.632,106,133,.797,50,191,241,90,32,21,58,144,703
11339,DET,2018,Reggie Bullock,26,62,52,1732,267,546,.489,125,281,.445,142,265,.536,.603,39,49,.796,27,127,154,95,47,13,47,70,698
11340,DET,2018,Tobias Harris,25,48,48,1563,320,709,.451,113,276,.409,207,433,.478,.531,115,136,.846,36,208,244,94,34,15,51,91,868
11341,DET,2018,Luke Kennard,21,73,9,1463,206,465,.443,81,195,.415,125,270,.463,.530,65,76,.855,21,155,176,124,44,13,69,86,558
11342,DET,2018,Avery Bradley,27,40,40,1268,233,570,.409,74,194,.381,159,376,.423,.474,61,80,.763,19,75,94,83,46,7,93,80,601
11343,DET,2018,Reggie Jackson,27,45,45,1201,246,577,.426,52,169,.308,194,408,.475,.471,112,134,.836,29,96,125,238,27,4,99,87,656
11344,DET,2018,Langston Galloway,26,58,2,863,126,340,.371,75,218,.344,51,122,.418,.481,33,41,.805,13,79,92,58,35,5,18,39,360
11345,DET,2018,Blake Griffin,28,25,25,831,181,418,.433,47,135,.348,134,283,.473,.489,87,111,.784,27,139,166,155,11,9,66,61,496
11346,DET,2018,Eric Moreland,26,67,3,805,66,122,.541,0,0,,66,122,.541,.541,11,29,.379,81,197,278,78,31,51,42,116,143
11347,DET,2018,James Ennis III,27,27,8,551,74,162,.457,21,69,.304,53,93,.570,.522,33,43,.767,20,47,67,22,15,6,18,53,202
11348,DET,2018,Dwight Buycks,28,29,0,427,82,198,.414,15,45,.333,67,153,.438,.452,36,41,.878,12,29,41,59,19,2,39,39,215
11349,DET,2018,Henry Ellenson,21,38,0,329,53,146,.363,20,60,.333,33,86,.384,.432,25,29,.862,10,71,81,20,5,0,18,22,151
11350,DET,2018,Boban Marjanović,29,19,1,171,41,79,.519,0,0,,41,79,.519,.519,36,45,.800,15,42,57,14,4,6,22,28,118
11351,DET,2018,Jon Leuer,28,8,0,136,15,36,.417,0,3,.000,15,33,.455,.417,13,15,.867,7,25,32,5,1,3,7,16,43
11352,DET,2018,Jameer Nelson,35,7,0,116,11,39,.282,1,14,.071,10,25,.400,.295,3,3,1.000,2,6,8,23,4,1,11,14,26
11353,DET,2018,Willie Reed,27,3,0,9,1,1,1.000,0,0,,1,1,1.000,1.000,0,0,,0,1,1,1,0,0,0,3,2
11354,DET,2018,Luis Montero,24,2,0,8,0,1,.000,0,0,,0,1,.000,.000,0,0,,0,2,2,0,0,0,2,0,0
11355,DET,2018,Reggie Hearn,26,3,0,7,1,2,.500,1,2,.500,0,0,,.750,0,0,,0,0,0,0,0,0,0,0,3
11356,DET,2018,Kay Felder,22,2,0,6,1,4,.250,0,1,.000,1,3,.333,.250,0,0,,2,2,4,0,0,0,1,0,2
11357,DET,2017,Tobias Harris,24,82,48,2567,511,1063,.481,109,314,.347,402,749,.537,.532,190,226,.841,63,353,416,142,60,39,96,133,1321
11358,DET,2017,Marcus Morris,27,79,79,2565,421,1007,.418,118,357,.331,303,650,.466,.477,145,185,.784,77,289,366,160,52,25,87,168,1105
11359,DET,2017,Kentavious Caldwell-Pope,23,76,75,2529,370,928,.399,153,437,.350,217,491,.442,.481,154,185,.832,55,193,248,193,89,12,86,118,1047
11360,DET,2017,Andre Drummond,23,81,81,2409,483,911,.530,2,7,.286,481,904,.532,.531,137,355,.386,345,770,1115,90,124,89,152,237,1105
11361,DET,2017,Ish Smith,28,81,32,1955,329,749,.439,28,105,.267,301,644,.467,.458,72,102,.706,21,214,235,418,61,33,112,127,758
11362,DET,2017,Jon Leuer,27,75,34,1944,310,646,.480,49,167,.293,261,479,.545,.518,98,113,.867,102,300,402,111,31,26,66,145,767
11363,DET,2017,Reggie Jackson,26,52,50,1424,284,677,.419,66,184,.359,218,493,.442,.468,118,136,.868,21,93,114,270,35,5,114,129,752
11364,DET,2017,Stanley Johnson,20,77,1,1371,129,365,.353,45,154,.292,84,211,.398,.415,36,53,.679,36,153,189,105,56,24,71,121,339
11365,DET,2017,Aron Baynes,30,75,2,1163,143,279,.513,0,0,,143,279,.513,.513,79,94,.840,111,222,333,32,17,39,50,166,365
11366,DET,2017,Beno Udrih,34,39,0,560,92,197,.467,11,32,.344,81,165,.491,.495,32,34,.941,6,51,57,131,13,0,36,29,227
11367,DET,2017,Reggie Bullock,25,31,5,467,54,128,.422,28,73,.384,26,55,.473,.531,5,7,.714,13,51,64,29,18,3,10,22,141
11368,DET,2017,Darrun Hilliard,23,39,1,381,47,126,.373,12,46,.261,35,80,.438,.421,21,28,.750,2,31,33,33,11,2,28,39,127
11369,DET,2017,Boban Marjanović,28,35,0,293,72,132,.545,0,0,,72,132,.545,.545,47,58,.810,46,84,130,9,6,12,10,25,191
11370,DET,2017,Henry Ellenson,20,19,2,146,23,64,.359,10,35,.286,13,29,.448,.438,4,8,.500,8,33,41,7,1,1,14,6,60
11371,DET,2017,Michael Gbinije,24,9,0,32,1,10,.100,0,4,.000,1,6,.167,.100,2,2,1.000,2,1,3,2,0,0,0,2,4
11372,DET,2016,Marcus Morris,26,80,80,2856,410,945,.434,108,298,.362,302,647,.467,.491,203,271,.749,91,313,404,201,67,23,140,170,1131
11373,DET,2016,Kentavious Caldwell-Pope,22,76,76,2789,403,960,.420,114,369,.309,289,591,.489,.479,185,228,.811,70,212,282,138,110,17,105,167,1105
11374,DET,2016,Andre Drummond,22,81,81,2666,552,1060,.521,2,6,.333,550,1054,.522,.522,208,586,.355,395,803,1198,67,119,112,155,245,1314
11375,DET,2016,Reggie Jackson,25,79,79,2424,540,1244,.434,118,334,.353,422,910,.464,.482,291,337,.864,58,195,253,492,59,11,223,187,1489
11376,DET,2016,Stanley Johnson,19,73,6,1687,225,600,.375,63,205,.307,162,395,.410,.428,80,102,.784,58,248,306,118,55,12,114,178,593
11377,DET,2016,Ersan İlyasova,28,52,52,1434,216,508,.425,78,215,.363,138,293,.471,.502,79,109,.725,99,183,282,55,38,27,59,120,589
11378,DET,2016,Anthony Tolliver,30,72,5,1341,128,332,.386,98,272,.360,30,60,.500,.533,29,47,.617,39,190,229,52,26,16,28,86,383
11379,DET,2016,Aron Baynes,29,81,1,1233,194,384,.505,0,2,.000,194,382,.508,.505,126,165,.764,140,244,384,51,21,52,67,151,514
11380,DET,2016,Steve Blake,35,58,2,986,93,240,.388,52,151,.344,41,89,.461,.496,16,20,.800,9,80,89,200,24,5,81,70,254
11381,DET,2016,Tobias Harris,23,27,25,903,166,348,.477,33,88,.375,133,260,.512,.524,82,90,.911,25,143,168,70,18,12,30,62,447
11382,DET,2016,Reggie Bullock,24,37,0,429,43,98,.439,22,53,.415,21,45,.467,.551,14,15,.933,14,54,68,27,10,2,8,29,122
11383,DET,2016,Brandon Jennings,26,23,1,416,53,143,.371,24,77,.312,29,66,.439,.455,27,38,.711,5,41,46,70,11,2,22,24,157
11384,DET,2016,Darrun Hilliard,22,38,2,383,52,131,.397,19,50,.380,33,81,.407,.469,29,40,.725,5,40,45,27,9,1,19,28,152
11385,DET,2016,Spencer Dinwiddie,22,12,0,159,19,54,.352,1,10,.100,18,44,.409,.361,19,33,.576,4,13,17,22,3,0,7,20,58
11386,DET,2016,Joel Anthony,33,19,0,96,6,10,.600,0,0,,6,10,.600,.600,6,8,.750,8,13,21,1,2,12,2,15,18
11387,DET,2016,Jodie Meeks,28,3,0,43,7,20,.350,4,9,.444,3,11,.273,.450,4,4,1.000,1,4,5,3,0,0,1,2,22
11388,DET,2016,Justin Harper,26,5,0,35,4,10,.400,4,9,.444,0,1,.000,.600,1,2,.500,0,1,1,0,1,0,2,3,13
11389,DET,2015,Kentavious Caldwell-Pope,21,82,82,2587,390,972,.401,153,444,.345,237,528,.449,.480,110,158,.696,46,209,255,109,93,18,94,161,1043
11390,DET,2015,Andre Drummond,21,82,82,2502,494,961,.514,0,2,.000,494,959,.515,.514,142,365,.389,437,667,1104,55,73,153,120,285,1130
11391,DET,2015,Greg Monroe,24,69,57,2137,423,853,.496,0,0,,423,853,.496,.496,252,336,.750,229,475,704,142,78,34,149,148,1098
11392,DET,2015,Caron Butler,34,78,21,1623,161,396,.407,83,219,.379,78,177,.441,.511,55,61,.902,21,175,196,79,43,4,49,120,460
11393,DET,2015,Jodie Meeks,27,60,0,1462,222,534,.416,74,212,.349,148,322,.460,.485,145,160,.906,12,92,104,79,59,6,57,76,663
11394,DET,2015,D.J. Augustin,27,54,13,1287,189,461,.410,49,150,.327,140,311,.450,.463,147,169,.870,13,87,100,265,33,2,110,61,574
11395,DET,2015,Kyle Singler,26,54,40,1287,140,350,.400,76,187,.406,64,163,.393,.509,29,36,.806,23,116,139,67,33,14,42,98,385
11396,DET,2015,Brandon Jennings,25,41,41,1173,218,543,.401,76,211,.360,142,332,.428,.471,120,143,.839,21,83,104,272,44,4,90,64,632
11397,DET,2015,Anthony Tolliver,29,52,11,1160,135,319,.423,82,228,.360,53,91,.582,.552,50,63,.794,45,147,192,49,20,15,40,117,402
11398,DET,2015,Josh Smith,29,28,28,896,153,391,.391,9,37,.243,144,354,.407,.403,52,111,.468,52,150,202,132,37,48,72,82,367
11399,DET,2015,Reggie Jackson,24,27,27,870,183,420,.436,28,83,.337,155,337,.460,.469,82,103,.796,28,98,126,248,20,4,95,73,476
11400,DET,2015,Jonas Jerebko,27,46,0,703,91,198,.460,28,76,.368,63,122,.516,.530,31,36,.861,47,95,142,41,27,11,26,77,241
11401,DET,2015,Tayshaun Prince,34,23,7,571,69,160,.431,11,26,.423,58,134,.433,.466,19,29,.655,25,72,97,38,15,8,16,26,168
11402,DET,2015,Spencer Dinwiddie,21,34,1,455,51,169,.302,12,65,.185,39,104,.375,.337,31,34,.912,4,44,48,104,19,6,33,53,145
11403,DET,2015,Joel Anthony,32,49,0,406,36,62,.581,0,0,,36,62,.581,.581,15,22,.682,32,61,93,5,12,49,12,55,87
11404,DET,2015,John Lucas III,32,21,0,272,42,104,.404,9,29,.310,33,75,.440,.447,5,5,1.000,4,12,16,60,8,0,16,18,98
11405,DET,2015,Cartier Martin,30,23,0,198,15,53,.283,6,33,.182,9,20,.450,.340,0,0,,0,20,20,11,3,1,5,20,36
11406,DET,2015,Shawne Williams,28,19,0,163,19,60,.317,4,26,.154,15,34,.441,.350,7,7,1.000,9,18,27,8,4,4,7,19,49
11407,DET,2015,Quincy Miller,22,4,0,58,5,20,.250,2,11,.182,3,9,.333,.300,0,0,,2,6,8,5,1,2,2,5,12
11408,DET,2015,Gigi Datome,27,3,0,17,5,12,.417,1,4,.250,4,8,.500,.458,0,0,,1,3,4,2,1,0,2,1,11
11409,DET,2014,Josh Smith,28,77,76,2730,517,1233,.419,70,265,.264,447,968,.462,.448,160,301,.532,102,418,520,252,105,110,199,197,1264
11410,DET,2014,Brandon Jennings,24,80,79,2728,423,1135,.373,154,457,.337,269,678,.397,.441,241,321,.751,59,185,244,609,101,8,215,157,1241
11411,DET,2014,Greg Monroe,23,82,82,2690,504,1015,.497,0,1,.000,504,1014,.497,.497,241,367,.657,256,504,760,171,91,47,166,205,1249
11412,DET,2014,Andre Drummond,20,81,81,2619,479,769,.623,0,2,.000,479,767,.625,.623,137,328,.418,440,631,1071,35,101,131,110,273,1095
11413,DET,2014,Kyle Singler,25,82,36,2337,269,602,.447,94,246,.382,175,356,.492,.525,152,184,.826,116,187,303,75,61,38,79,211,784
11414,DET,2014,Rodney Stuckey,27,73,5,1950,372,853,.436,24,88,.273,348,765,.455,.450,244,292,.836,39,130,169,152,54,10,125,131,1012
11415,DET,2014,Kentavious Caldwell-Pope,20,80,41,1583,182,460,.396,59,185,.319,123,275,.447,.460,47,61,.770,38,118,156,55,75,12,28,145,470
11416,DET,2014,Will Bynum,31,56,3,1054,184,430,.428,20,62,.323,164,368,.446,.451,97,121,.802,24,75,99,216,39,7,103,121,485
11417,DET,2014,Jonas Jerebko,26,64,0,741,98,208,.471,31,74,.419,67,134,.500,.546,43,59,.729,51,124,175,39,21,6,43,85,270
11418,DET,2014,Josh Harrellson,24,32,0,317,38,82,.463,12,31,.387,26,51,.510,.537,5,7,.714,30,46,76,15,6,15,10,44,93
11419,DET,2014,Chauncey Billups,37,19,7,309,24,79,.304,14,48,.292,10,31,.323,.392,10,12,.833,4,24,28,42,8,1,25,25,72
11420,DET,2014,Gigi Datome,26,34,0,238,34,97,.351,7,39,.179,27,58,.466,.387,8,10,.800,14,32,46,11,6,1,11,20,83
11421,DET,2014,Peyton Siva,23,24,0,224,18,57,.316,7,25,.280,11,32,.344,.377,11,15,.733,2,12,14,34,9,1,18,27,54
11422,DET,2014,Charlie Villanueva,29,20,0,180,35,92,.380,14,56,.250,21,36,.583,.457,8,14,.571,6,28,34,6,4,5,7,16,92
11423,DET,2014,Tony Mitchell,21,21,0,79,5,12,.417,1,1,1.000,4,11,.364,.458,11,19,.579,15,11,26,2,6,3,4,9,22
11424,DET,2013,Greg Monroe,22,81,81,2687,514,1058,.486,0,4,.000,514,1054,.488,.486,270,392,.689,236,541,777,281,105,55,234,190,1298
11425,DET,2013,Brandon Knight,21,75,75,2365,357,878,.407,120,327,.367,237,551,.430,.475,165,225,.733,54,193,247,303,58,8,205,157,999
11426,DET,2013,Kyle Singler,24,82,74,2293,275,642,.428,70,200,.350,205,442,.464,.483,100,124,.806,109,221,330,77,57,37,98,217,720
11427,DET,2013,Rodney Stuckey,26,76,24,2171,304,748,.406,55,182,.302,249,566,.440,.443,213,272,.783,43,169,212,270,51,17,134,127,876
11428,DET,2013,Jason Maxiell,29,72,71,1789,204,457,.446,0,0,,204,457,.446,.446,90,145,.621,135,274,409,54,32,95,81,172,498
11429,DET,2013,Tayshaun Prince,32,45,45,1457,215,484,.444,23,53,.434,192,431,.445,.468,74,93,.796,43,166,209,111,21,13,54,45,527
11430,DET,2013,Andre Drummond,19,60,10,1243,208,342,.608,1,2,.500,207,340,.609,.610,59,159,.371,169,288,457,30,59,95,57,144,476
11431,DET,2013,Will Bynum,30,65,0,1219,253,540,.469,24,76,.316,229,464,.494,.491,106,131,.809,28,69,97,231,45,5,125,128,636
11432,DET,2013,Charlie Villanueva,28,69,0,1092,175,464,.377,90,259,.347,85,205,.415,.474,27,49,.551,49,192,241,54,31,39,39,96,467
11433,DET,2013,Jonas Jerebko,25,49,2,892,142,316,.449,25,83,.301,117,233,.502,.489,68,88,.773,68,117,185,43,38,8,42,90,377
11434,DET,2013,José Calderón,31,28,28,887,125,237,.527,51,98,.520,74,139,.532,.635,25,28,.893,6,64,70,185,30,2,51,41,326
11435,DET,2013,Khris Middleton,21,27,0,475,62,141,.440,14,45,.311,48,96,.500,.489,27,32,.844,4,46,50,28,15,4,11,53,165
11436,DET,2013,Kim English,24,41,0,407,42,112,.375,14,50,.280,28,62,.452,.438,21,29,.724,8,29,37,26,16,3,19,46,119
11437,DET,2013,Austin Daye,24,24,0,348,43,97,.443,21,40,.525,22,57,.386,.552,15,18,.833,10,53,63,21,5,8,13,43,122
11438,DET,2013,Corey Maggette,33,18,0,257,27,76,.355,5,21,.238,22,55,.400,.388,36,48,.750,5,20,25,19,6,2,17,42,95
11439,DET,2013,Viacheslav Kravtsov,25,25,0,224,33,46,.717,0,0,,33,46,.717,.717,11,37,.297,24,21,45,9,5,9,14,32,77
11440,DET,2012,Brandon Knight,20,66,60,2129,319,769,.415,105,276,.380,214,493,.434,.483,104,137,.759,33,178,211,251,49,10,171,154,847
11441,DET,2012,Tayshaun Prince,31,63,63,2087,336,798,.421,37,104,.356,299,694,.431,.444,89,115,.774,72,209,281,153,27,32,74,77,798
11442,DET,2012,Greg Monroe,21,66,66,2082,407,781,.521,0,1,.000,407,780,.522,.521,201,272,.739,239,398,637,152,83,46,161,180,1015
11443,DET,2012,Rodney Stuckey,25,55,48,1644,256,597,.429,33,104,.317,223,493,.452,.456,267,320,.834,38,104,142,210,44,10,106,124,812
11444,DET,2012,Jonas Jerebko,24,64,13,1468,212,453,.468,32,106,.302,180,347,.519,.503,100,124,.806,96,212,308,43,41,21,66,162,556
11445,DET,2012,Jason Maxiell,28,65,42,1466,183,383,.478,0,2,.000,183,381,.480,.478,58,106,.547,126,207,333,41,32,50,71,151,424
11446,DET,2012,Ben Gordon,28,52,21,1398,234,530,.442,63,147,.429,171,383,.446,.501,117,136,.860,14,107,121,127,34,11,115,114,648
11447,DET,2012,Ben Wallace,37,62,11,980,34,86,.395,1,4,.250,33,82,.402,.401,16,47,.340,81,188,269,43,47,51,34,60,85
11448,DET,2012,Damien Wilkins,32,60,2,922,76,193,.394,7,23,.304,69,170,.406,.412,34,54,.630,22,78,100,44,29,13,30,85,193
11449,DET,2012,Austin Daye,23,41,4,603,73,227,.322,13,62,.210,60,165,.364,.350,35,43,.814,14,77,91,33,22,21,40,62,194
11450,DET,2012,Will Bynum,29,36,0,514,74,194,.381,7,29,.241,67,165,.406,.399,49,64,.766,10,46,56,66,23,3,54,61,204
11451,DET,2012,Walker Russell,29,28,0,357,33,95,.347,4,13,.308,29,82,.354,.368,14,22,.636,7,19,26,58,18,1,33,29,84
11452,DET,2012,Charlie Villanueva,27,13,0,180,35,91,.385,15,45,.333,20,46,.435,.467,6,7,.857,9,39,48,6,7,5,7,25,91
11453,DET,2012,Vernon Macklin,25,23,0,135,19,35,.543,0,0,,19,35,.543,.543,8,14,.571,14,20,34,5,4,4,3,9,46
11454,DET,2011,Tayshaun Prince,30,78,78,2562,473,1001,.473,34,98,.347,439,903,.486,.490,118,168,.702,78,251,329,215,30,41,82,90,1098
11455,DET,2011,Greg Monroe,20,80,48,2222,303,550,.551,0,1,.000,303,549,.552,.551,145,233,.622,248,353,601,105,93,45,81,196,751
11456,DET,2011,Rodney Stuckey,24,70,54,2183,363,827,.439,26,90,.289,337,737,.457,.455,330,381,.866,70,146,216,361,76,10,155,177,1082
11457,DET,2011,Ben Gordon,27,82,27,2131,339,770,.440,107,266,.402,232,504,.460,.510,136,160,.850,41,154,195,171,48,16,141,178,921
11458,DET,2011,Tracy McGrady,31,72,39,1686,227,514,.442,30,88,.341,197,426,.462,.471,90,129,.698,49,202,251,252,66,34,102,101,574
11459,DET,2011,Charlie Villanueva,26,76,11,1666,313,708,.442,125,323,.387,188,385,.488,.530,89,116,.767,50,245,295,48,42,42,66,175,840
11460,DET,2011,Richard Hamilton,32,55,39,1498,288,671,.429,55,144,.382,233,527,.442,.470,146,172,.849,24,102,126,171,39,4,88,95,777
11461,DET,2011,Austin Daye,22,72,16,1446,193,471,.410,69,172,.401,124,299,.415,.483,82,108,.759,64,210,274,78,39,39,59,165,537
11462,DET,2011,Ben Wallace,36,54,49,1238,67,149,.450,1,2,.500,66,147,.449,.453,19,57,.333,129,221,350,72,54,54,44,81,154
11463,DET,2011,Will Bynum,28,61,5,1125,182,406,.448,16,50,.320,166,356,.466,.468,102,122,.836,15,59,74,195,52,4,83,113,482
11464,DET,2011,Chris Wilcox,28,57,29,995,187,322,.581,0,1,.000,187,321,.583,.581,50,89,.562,95,176,271,43,29,17,43,145,424
11465,DET,2011,Jason Maxiell,27,57,14,930,93,189,.492,0,0,,93,189,.492,.492,51,99,.515,66,107,173,17,24,21,44,92,237
11466,DET,2011,DaJuan Summers,23,22,1,199,28,69,.406,9,21,.429,19,48,.396,.471,9,20,.450,2,10,12,2,3,1,13,21,74
11467,DET,2010,Rodney Stuckey,23,73,67,2499,449,1109,.405,18,79,.228,431,1030,.418,.413,299,359,.833,67,214,281,348,101,12,163,205,1215
11468,DET,2010,Jonas Jerebko,22,80,73,2232,290,603,.481,36,115,.313,254,488,.520,.511,125,176,.710,194,284,478,58,79,29,82,230,741
11469,DET,2010,Ben Wallace,35,69,67,1975,158,292,.541,0,2,.000,158,290,.545,.541,65,160,.406,245,352,597,105,86,84,64,131,381
11470,DET,2010,Charlie Villanueva,25,78,16,1848,363,827,.439,99,282,.351,264,545,.484,.499,106,130,.815,85,280,365,53,48,55,74,223,931
11471,DET,2010,Ben Gordon,26,62,17,1730,291,699,.416,75,234,.321,216,465,.465,.470,198,230,.861,26,93,119,166,49,6,118,147,855
11472,DET,2010,Will Bynum,27,63,20,1667,237,534,.444,12,55,.218,225,479,.470,.455,142,178,.798,24,118,142,283,55,7,115,143,628
11473,DET,2010,Tayshaun Prince,29,49,49,1664,282,580,.486,27,73,.370,255,507,.503,.509,70,98,.714,71,177,248,161,34,22,60,77,661
11474,DET,2010,Richard Hamilton,31,46,46,1552,293,717,.409,41,138,.297,252,579,.435,.437,204,241,.846,30,92,122,202,30,3,115,115,831
11475,DET,2010,Jason Maxiell,26,76,29,1550,212,415,.511,0,1,.000,212,414,.512,.511,89,155,.574,161,240,401,39,36,38,68,175,513
11476,DET,2010,Austin Daye,21,69,4,915,137,295,.464,29,95,.305,108,200,.540,.514,46,56,.821,34,140,174,34,25,26,48,114,349
11477,DET,2010,Kwame Brown,27,48,1,660,62,124,.500,0,1,.000,62,123,.504,.500,33,98,.337,53,124,177,22,15,12,43,93,157
11478,DET,2010,Chucky Atkins,35,40,11,644,57,157,.363,22,73,.301,35,84,.417,.433,25,27,.926,5,24,29,91,17,0,32,53,161
11479,DET,2010,Chris Wilcox,27,34,10,441,63,120,.525,0,0,,63,120,.525,.525,26,52,.500,44,73,117,13,13,12,38,64,152
11480,DET,2010,DaJuan Summers,22,44,0,405,46,130,.354,15,42,.357,31,88,.352,.412,27,38,.711,14,31,45,16,8,7,16,52,134
11481,DET,2009,Tayshaun Prince,28,82,82,3057,459,1020,.450,56,141,.397,403,879,.458,.477,189,243,.778,128,348,476,253,44,51,101,104,1163
11482,DET,2009,Rodney Stuckey,22,79,65,2517,401,913,.439,23,78,.295,378,835,.453,.452,233,290,.803,69,206,275,387,78,11,173,217,1058
11483,DET,2009,Richard Hamilton,30,67,51,2279,466,1043,.447,70,190,.368,396,853,.464,.480,223,263,.848,44,163,207,297,40,4,133,176,1225
11484,DET,2009,Rasheed Wallace,34,66,63,2123,302,720,.419,113,319,.354,189,401,.471,.498,78,101,.772,56,434,490,91,62,86,59,197,795
11485,DET,2009,Allen Iverson,33,54,50,1970,330,794,.416,26,91,.286,304,703,.432,.432,253,322,.786,27,138,165,263,85,5,136,83,939
11486,DET,2009,Antonio McDyess,34,62,30,1866,268,525,.510,0,0,,268,525,.510,.510,60,86,.698,185,422,607,83,41,50,51,191,596
11487,DET,2009,Jason Maxiell,25,78,4,1408,184,320,.575,0,1,.000,184,319,.577,.575,84,158,.532,169,155,324,24,25,63,45,157,452
11488,DET,2009,Arron Afflalo,23,74,8,1234,131,300,.437,43,107,.402,88,193,.456,.508,58,71,.817,30,104,134,44,28,13,43,144,363
11489,DET,2009,Kwame Brown,26,58,30,999,90,169,.533,0,0,,90,169,.533,.533,63,122,.516,91,199,290,32,24,24,50,138,243
11490,DET,2009,Amir Johnson,21,62,24,911,97,163,.595,0,0,,97,163,.595,.595,23,35,.657,102,130,232,20,20,60,33,171,217
11491,DET,2009,Will Bynum,26,57,1,803,156,342,.456,3,19,.158,153,323,.474,.461,95,119,.798,19,56,75,157,34,2,76,85,410
11492,DET,2009,Walter Herrmann,29,59,0,630,82,207,.396,41,120,.342,41,87,.471,.495,19,25,.760,28,79,107,22,7,4,17,43,224
11493,DET,2009,Chauncey Billups,32,2,2,70,7,21,.333,2,7,.286,5,14,.357,.381,9,10,.900,1,9,10,15,3,1,4,3,25
11494,DET,2009,Alex Acker,26,7,0,20,4,11,.364,0,4,.000,4,7,.571,.364,1,2,.500,0,2,2,1,2,1,0,0,9
11495,DET,2009,Walter Sharpe,22,8,0,20,4,11,.364,0,2,.000,4,9,.444,.364,0,2,.000,0,3,3,0,0,2,0,3,8
11496,DET,2008,Tayshaun Prince,27,82,82,2694,421,940,.448,53,146,.363,368,794,.463,.476,185,241,.768,109,289,398,268,42,33,91,90,1080
11497,DET,2008,Chauncey Billups,31,78,78,2522,393,877,.448,137,342,.401,256,535,.479,.526,401,437,.918,42,170,212,529,101,17,160,130,1324
11498,DET,2008,Richard Hamilton,29,72,72,2424,499,1030,.484,62,141,.440,437,889,.492,.515,184,221,.833,75,160,235,299,73,10,132,171,1244
11499,DET,2008,Rasheed Wallace,33,77,76,2346,376,870,.432,112,315,.356,264,555,.476,.497,115,150,.767,84,427,511,137,91,129,86,213,979
11500,DET,2008,Antonio McDyess,33,78,78,2285,293,600,.488,0,2,.000,293,598,.490,.488,97,156,.622,204,462,666,89,61,53,75,246,683
11501,DET,2008,Jason Maxiell,24,82,7,1768,240,446,.538,0,1,.000,240,445,.539,.538,171,270,.633,177,256,433,46,21,94,71,183,651
11502,DET,2008,Jarvis Hayes,26,82,1,1287,217,504,.431,73,194,.376,144,310,.465,.503,45,60,.750,35,143,178,62,47,6,47,137,552
11503,DET,2008,Rodney Stuckey,21,57,2,1081,153,382,.401,3,16,.188,150,366,.410,.404,127,156,.814,32,97,129,160,49,6,78,113,436
11504,DET,2008,Arron Afflalo,22,75,9,970,99,241,.411,10,48,.208,89,193,.461,.432,68,87,.782,36,101,137,52,31,8,34,83,276
11505,DET,2008,Amir Johnson,20,62,0,764,92,165,.558,0,0,,92,165,.558,.558,37,55,.673,87,148,235,29,24,82,39,141,221
11506,DET,2008,Ronald Murray,28,19,2,347,57,139,.410,6,27,.222,51,112,.455,.432,22,37,.595,13,23,36,64,13,1,31,19,142
11507,DET,2008,Juan Dixon,29,17,0,244,47,98,.480,13,33,.394,34,65,.523,.546,3,7,.429,6,22,28,32,0,0,19,24,110
11508,DET,2008,Nazr Mohammed,30,21,0,228,28,59,.475,0,1,.000,28,58,.483,.475,13,30,.433,29,44,73,6,7,8,11,36,69
11509,DET,2008,Theo Ratliff,34,16,3,223,18,40,.450,0,0,,18,40,.450,.450,12,18,.667,19,31,50,7,4,18,9,29,48
11510,DET,2008,Lindsey Hunter,37,24,0,215,22,64,.344,7,26,.269,15,38,.395,.398,7,9,.778,4,9,13,33,13,2,13,30,58
11511,DET,2008,Walter Herrmann,28,28,0,199,31,79,.392,11,38,.289,20,41,.488,.462,12,15,.800,12,25,37,14,3,1,8,12,85
11512,DET,2008,Primož Brezec,28,17,0,98,10,13,.769,0,0,,10,13,.769,.769,7,14,.500,7,12,19,4,2,2,5,23,27
11513,DET,2008,Cheikh Samb,23,4,0,31,3,4,.750,0,0,,3,4,.750,.750,1,2,.500,3,4,7,0,1,2,1,8,7
11514,DET,2008,Ronald Dupree,27,1,0,3,0,0,,0,0,,0,0,,,0,0,,0,0,0,0,0,0,0,0,0
11515,DET,2007,Tayshaun Prince,26,82,82,3001,459,997,.460,81,210,.386,378,787,.480,.501,172,224,.768,144,285,429,227,51,55,98,116,1171
11516,DET,2007,Richard Hamilton,28,75,75,2763,547,1170,.468,44,129,.341,503,1041,.483,.486,347,403,.861,75,207,282,285,59,15,159,232,1485
11517,DET,2007,Chauncey Billups,30,70,70,2533,348,815,.427,109,316,.345,239,499,.479,.494,386,437,.883,23,214,237,502,84,17,140,161,1191
11518,DET,2007,Rasheed Wallace,32,75,72,2419,357,843,.423,104,296,.351,253,547,.463,.485,108,137,.788,90,453,543,127,75,118,94,225,926
11519,DET,2007,Antonio McDyess,32,82,3,1729,284,540,.526,0,0,,284,540,.526,.526,96,139,.691,165,331,496,72,61,65,75,240,664
11520,DET,2007,Ronald Murray,27,69,18,1477,177,438,.404,24,83,.289,153,355,.431,.432,87,120,.725,26,87,113,187,49,13,90,96,465
11521,DET,2007,Carlos Delfino,24,82,1,1372,156,376,.415,46,138,.333,110,238,.462,.476,70,89,.787,67,199,266,88,46,8,61,97,428
11522,DET,2007,Chris Webber,33,43,42,1277,200,409,.489,2,6,.333,198,403,.491,.491,84,132,.636,87,201,288,127,42,26,74,107,486
11523,DET,2007,Jason Maxiell,23,67,8,943,131,262,.500,0,0,,131,262,.500,.500,72,137,.526,88,98,186,14,30,60,53,110,334
11524,DET,2007,Nazr Mohammed,29,51,33,773,118,222,.532,0,0,,118,222,.532,.532,50,82,.610,89,140,229,9,27,40,43,133,286
11525,DET,2007,Lindsey Hunter,36,52,0,745,94,244,.385,38,119,.319,56,125,.448,.463,30,33,.909,9,38,47,93,34,7,35,56,256
11526,DET,2007,Dale Davis,37,46,6,464,33,74,.446,0,0,,33,74,.446,.446,17,26,.654,59,78,137,12,10,34,15,59,83
11527,DET,2007,Will Blalock,23,14,0,166,9,30,.300,1,5,.200,8,25,.320,.317,6,6,1.000,6,9,15,17,5,0,12,9,25
11528,DET,2007,Amir Johnson,19,8,0,124,18,33,.545,0,3,.000,18,30,.600,.545,11,14,.786,15,22,37,3,5,13,9,19,47
11529,DET,2007,Ronald Dupree,26,19,0,94,11,31,.355,0,0,,11,31,.355,.355,3,9,.333,5,12,17,5,5,1,3,12,25
11530,DET,2006,Chauncey Billups,29,81,81,2925,423,1012,.418,184,425,.433,239,587,.407,.509,465,520,.894,41,211,252,699,71,8,170,160,1495
11531,DET,2006,Tayshaun Prince,25,82,82,2898,455,999,.455,64,183,.350,391,816,.479,.487,182,238,.765,104,242,346,186,62,39,91,96,1156
11532,DET,2006,Ben Wallace,31,82,82,2890,237,465,.510,0,4,.000,237,461,.514,.510,123,296,.416,301,622,923,158,146,181,88,164,597
11533,DET,2006,Richard Hamilton,27,80,80,2825,649,1322,.491,55,120,.458,594,1202,.494,.512,256,303,.845,84,172,256,275,52,16,173,207,1609
11534,DET,2006,Rasheed Wallace,31,80,80,2780,459,1067,.430,155,434,.357,304,633,.480,.503,136,183,.743,90,457,547,182,82,130,85,232,1209
11535,DET,2006,Antonio McDyess,31,82,0,1733,285,560,.509,0,2,.000,285,558,.511,.509,68,122,.557,156,280,436,90,46,48,76,220,638
11536,DET,2006,Maurice Evans,27,80,1,1139,154,341,.452,43,116,.371,111,225,.493,.515,52,65,.800,76,87,163,60,41,15,39,122,403
11537,DET,2006,Carlos Delfino,23,68,1,726,91,226,.403,20,60,.333,71,166,.428,.447,45,67,.672,28,85,113,44,21,15,36,86,247
11538,DET,2006,Carlos Arroyo,26,50,0,600,57,157,.363,2,6,.333,55,151,.364,.369,42,58,.724,24,46,70,155,19,3,45,77,158
11539,DET,2006,Tony Delk,32,23,0,378,71,160,.444,20,47,.426,51,113,.451,.506,18,25,.720,13,38,51,33,13,1,19,28,180
11540,DET,2006,Lindsey Hunter,35,30,1,353,37,100,.370,11,43,.256,26,57,.456,.425,2,4,.500,10,30,40,62,19,1,20,44,87
11541,DET,2006,Dale Davis,36,28,2,178,9,24,.375,0,1,.000,9,23,.391,.375,8,15,.533,21,32,53,6,0,9,4,23,26
11542,DET,2006,Jason Maxiell,22,26,0,159,23,54,.426,0,0,,23,54,.426,.426,14,42,.333,12,16,28,3,4,5,11,14,60
11543,DET,2006,Darko Miličić,20,25,0,140,17,33,.515,0,2,.000,17,31,.548,.515,3,8,.375,10,18,28,9,3,15,15,25,37
11544,DET,2006,Amir Johnson,18,3,0,39,7,10,.700,2,3,.667,5,7,.714,.800,4,4,1.000,3,1,4,3,0,2,4,7,20
11545,DET,2006,Alex Acker,23,5,0,35,4,16,.250,1,5,.200,3,11,.273,.281,0,0,,1,4,5,4,1,0,4,4,9
11546,DET,2006,Kelvin Cato,31,4,0,34,5,12,.417,0,0,,5,12,.417,.417,0,0,,1,6,7,2,0,2,2,4,10
11547,DET,2005,Tayshaun Prince,24,82,82,3039,469,963,.487,47,138,.341,422,825,.512,.511,221,274,.807,133,302,435,247,56,71,135,161,1206
11548,DET,2005,Richard Hamilton,26,76,76,2926,510,1160,.440,36,118,.305,474,1042,.455,.455,368,429,.858,74,221,295,372,77,13,217,232,1424
11549,DET,2005,Chauncey Billups,28,80,80,2866,404,913,.442,165,387,.426,239,526,.454,.533,343,382,.898,48,223,271,464,81,9,180,194,1316
11550,DET,2005,Rasheed Wallace,30,79,79,2687,467,1062,.440,75,236,.318,392,826,.475,.475,136,195,.697,174,470,644,142,65,115,127,236,1145
11551,DET,2005,Ben Wallace,30,74,74,2671,295,651,.453,1,9,.111,294,642,.458,.454,130,304,.428,292,610,902,123,106,176,82,159,721
11552,DET,2005,Antonio McDyess,30,77,8,1797,307,598,.513,0,1,.000,307,597,.514,.513,126,192,.656,177,305,482,71,46,52,93,204,740
11553,DET,2005,Lindsey Hunter,34,76,3,1144,108,302,.358,23,84,.274,85,218,.390,.396,46,58,.793,38,85,123,130,68,13,68,125,285
11554,DET,2005,Carlos Arroyo,25,40,0,706,74,197,.376,1,12,.083,73,185,.395,.378,66,86,.767,15,43,58,128,24,1,52,76,215
11555,DET,2005,Ronald Dupree,24,47,0,472,61,127,.480,1,2,.500,60,125,.480,.484,29,47,.617,34,61,95,24,7,10,22,60,152
11556,DET,2005,Carlos Delfino,22,30,4,459,42,117,.359,9,35,.257,33,82,.402,.397,23,40,.575,13,42,55,38,22,6,23,44,116
11557,DET,2005,Elden Campbell,36,30,1,340,39,116,.336,0,2,.000,39,114,.342,.336,40,51,.784,25,57,82,16,8,6,28,47,118
11558,DET,2005,Darvin Ham,31,47,0,275,17,37,.459,0,0,,17,37,.459,.459,12,31,.387,19,16,35,5,6,7,8,39,46
11559,DET,2005,Darko Miličić,19,37,2,254,25,76,.329,0,0,,25,76,.329,.329,17,24,.708,3,40,43,7,2,17,16,31,67
11560,DET,2005,Smush Parker,23,11,1,110,11,28,.393,2,9,.222,9,19,.474,.429,9,13,.692,2,7,9,11,3,0,10,13,33
11561,DET,2005,Horace Jenkins,30,15,0,104,15,45,.333,0,9,.000,15,36,.417,.333,12,13,.923,3,6,9,9,5,1,7,6,42
11562,DET,2005,Anthony Goldwire,33,9,0,55,4,15,.267,3,9,.333,1,6,.167,.367,7,8,.875,1,7,8,0,0,0,1,5,18
11563,DET,2005,Derrick Coleman,37,5,0,50,3,14,.214,0,2,.000,3,12,.250,.214,3,3,1.000,3,12,15,0,0,0,2,6,9
11564,DET,2004,Ben Wallace,29,81,81,3050,315,748,.421,1,8,.125,314,740,.424,.422,142,290,.490,324,682,1006,138,143,246,123,162,773
11565,DET,2004,Richard Hamilton,25,78,78,2772,530,1166,.455,18,68,.265,512,1098,.466,.462,297,342,.868,78,201,279,310,103,17,210,222,1375
11566,DET,2004,Chauncey Billups,27,78,78,2758,392,996,.394,130,335,.388,262,661,.396,.459,404,460,.878,35,241,276,446,84,8,189,177,1318
11567,DET,2004,Tayshaun Prince,23,82,80,2701,338,723,.467,57,157,.363,281,566,.496,.507,108,141,.766,93,297,390,191,63,69,119,149,841
11568,DET,2004,Mehmet Okur,24,71,33,1580,251,542,.463,18,48,.375,233,494,.472,.480,162,209,.775,160,261,421,69,36,63,101,138,682
11569,DET,2004,Corliss Williamson,30,79,0,1574,304,602,.505,0,0,,304,602,.505,.505,144,197,.731,88,168,256,57,30,20,113,204,752
11570,DET,2004,Elden Campbell,35,65,27,892,138,314,.439,0,0,,138,314,.439,.439,85,124,.685,52,157,209,45,21,50,63,137,361
11571,DET,2004,Chucky Atkins,29,40,0,751,88,235,.374,42,130,.323,46,105,.438,.464,31,43,.721,6,42,48,95,19,1,48,60,249
11572,DET,2004,Bob Sura,30,53,0,707,71,173,.410,9,36,.250,62,137,.453,.436,48,69,.696,30,73,103,89,37,9,39,86,199
11573,DET,2004,Rasheed Wallace,29,22,21,673,121,281,.431,22,69,.319,99,212,.467,.470,38,54,.704,32,123,155,40,24,45,29,59,302
11574,DET,2004,Lindsey Hunter,33,33,8,661,49,143,.343,14,50,.280,35,93,.376,.392,5,8,.625,13,54,67,85,39,6,34,45,117
11575,DET,2004,Mike James,28,26,0,512,59,147,.401,20,55,.364,39,92,.424,.469,27,32,.844,8,50,58,95,26,1,41,43,165
11576,DET,2004,Darvin Ham,30,54,2,484,37,75,.493,1,2,.500,36,73,.493,.500,21,35,.600,47,46,93,16,13,8,31,63,96
11577,DET,2004,Tremaine Fowlkes,27,36,0,261,15,48,.313,1,8,.125,14,40,.350,.323,13,18,.722,18,35,53,14,9,3,12,37,44
11578,DET,2004,Željko Rebrača,31,21,2,222,22,54,.407,0,0,,22,54,.407,.407,22,28,.786,19,30,49,4,5,9,13,45,66
11579,DET,2004,Darko Miličić,18,34,0,159,17,65,.262,0,1,.000,17,64,.266,.262,14,24,.583,11,32,43,7,7,15,13,33,48
11580,DET,2004,Hubert Davis,33,3,0,23,0,2,.000,0,1,.000,0,1,.000,.000,0,0,,0,0,0,1,0,0,1,4,0
11581,DET,2003,Ben Wallace,28,73,73,2873,210,437,.481,1,6,.167,209,431,.485,.482,85,189,.450,293,833,1126,120,104,230,88,179,506
11582,DET,2003,Clifford Robinson,36,81,69,2825,372,935,.398,87,259,.336,285,676,.422,.444,161,238,.676,81,237,318,268,87,88,158,259,992
11583,DET,2003,Richard Hamilton,24,82,82,2640,570,1286,.443,32,119,.269,538,1167,.461,.456,440,528,.833,88,230,318,208,64,13,200,249,1612
11584,DET,2003,Chauncey Billups,26,74,74,2327,366,870,.421,149,380,.392,217,490,.443,.506,318,362,.878,38,235,273,287,63,15,134,136,1199
11585,DET,2003,Corliss Williamson,29,82,1,2061,374,826,.453,2,11,.182,372,815,.456,.454,237,300,.790,147,211,358,104,44,27,126,238,987
11586,DET,2003,Michael Curry,34,78,77,1555,92,229,.402,16,54,.296,76,175,.434,.437,36,45,.800,16,111,127,104,44,4,43,163,236
11587,DET,2003,Jon Barry,33,80,0,1473,191,424,.450,87,214,.407,104,210,.495,.553,86,100,.860,33,147,180,206,63,14,81,104,555
11588,DET,2003,Chucky Atkins,28,65,7,1398,168,465,.361,86,242,.355,82,223,.368,.454,40,49,.816,21,75,96,175,27,4,77,108,462
11589,DET,2003,Mehmet Okur,23,72,9,1366,180,423,.426,38,112,.339,142,311,.457,.470,96,131,.733,117,218,335,71,25,39,66,167,494
11590,DET,2003,Željko Rebrača,30,30,12,488,80,145,.552,0,0,,80,145,.552,.552,38,48,.792,27,65,92,9,6,17,29,79,198
11591,DET,2003,Tayshaun Prince,22,42,5,435,53,118,.449,20,47,.426,33,71,.465,.534,11,17,.647,5,40,45,24,10,14,21,25,137
11592,DET,2003,Hubert Davis,32,43,1,328,31,79,.392,12,36,.333,19,43,.442,.468,5,6,.833,6,30,36,29,5,0,11,23,79
11593,DET,2003,Danny Manning,36,13,0,89,13,32,.406,3,8,.375,10,24,.417,.453,5,6,.833,7,11,18,7,9,3,7,11,34
11594,DET,2003,Pepe Sánchez,25,9,0,37,0,5,.000,0,0,,0,5,.000,.000,0,0,,4,2,6,8,5,0,2,3,0
11595,DET,2003,Don Reid,29,1,0,10,0,3,.000,0,0,,0,3,.000,.000,1,2,.500,0,0,0,0,0,0,0,4,1
11596,DET,2002,Ben Wallace,27,80,80,2921,255,480,.531,0,3,.000,255,477,.535,.531,99,234,.423,318,721,1039,115,138,278,70,178,609
11597,DET,2002,Clifford Robinson,35,80,80,2855,454,1069,.425,115,304,.378,339,765,.443,.478,143,206,.694,79,307,386,202,89,95,151,243,1166
11598,DET,2002,Jerry Stackhouse,27,76,76,2685,524,1319,.397,86,300,.287,438,1019,.430,.430,495,577,.858,77,238,315,403,77,37,266,163,1629
11599,DET,2002,Chucky Atkins,27,79,62,2285,368,790,.466,138,336,.411,230,454,.507,.553,83,120,.692,31,127,158,263,72,11,128,177,957
11600,DET,2002,Jon Barry,32,82,6,1985,255,522,.489,121,258,.469,134,264,.508,.604,108,116,.931,42,192,234,274,94,20,111,134,739
11601,DET,2002,Michael Curry,33,82,75,1912,125,276,.453,7,26,.269,118,250,.472,.466,72,91,.791,15,153,168,127,47,10,60,207,329
11602,DET,2002,Corliss Williamson,28,78,7,1701,411,806,.510,1,5,.200,410,801,.512,.511,240,298,.805,117,202,319,94,49,26,137,226,1063
11603,DET,2002,Željko Rebrača,29,74,4,1179,189,374,.505,0,0,,189,374,.505,.505,135,175,.771,84,206,290,38,28,73,84,192,513
11604,DET,2002,Damon Jones,25,67,0,1083,114,284,.401,69,186,.371,45,98,.459,.523,43,59,.729,13,90,103,140,23,1,61,83,340
11605,DET,2002,Dana Barros,34,29,20,582,74,192,.385,24,71,.338,50,121,.413,.448,21,27,.778,1,56,57,78,14,2,33,37,193
11606,DET,2002,Mikki Moore,26,30,0,217,29,61,.475,1,2,.500,28,59,.475,.484,20,26,.769,22,31,53,11,7,9,14,35,79
11607,DET,2002,Rodney White,21,16,0,129,21,60,.350,2,9,.222,19,51,.373,.367,12,14,.857,2,16,18,12,9,2,14,6,56
11608,DET,2002,Victor Alexander,32,15,0,97,18,51,.353,0,2,.000,18,49,.367,.353,4,8,.500,7,22,29,6,0,1,5,6,40
11609,DET,2002,Brian Cardinal,24,8,0,43,6,13,.462,3,7,.429,3,6,.500,.577,2,2,1.000,2,4,6,2,1,0,0,5,17
11610,DET,2002,Ratko Varda,22,1,0,6,2,3,.667,0,0,,2,3,.667,.667,1,1,1.000,0,1,1,0,0,0,1,3,5
11611,DET,2001,Jerry Stackhouse,26,80,80,3215,774,1927,.402,166,473,.351,608,1454,.418,.445,666,810,.822,99,216,315,410,97,54,326,160,2380
11612,DET,2001,Ben Wallace,26,80,80,2760,215,439,.490,1,4,.250,214,435,.492,.491,80,238,.336,303,749,1052,123,107,186,117,192,511
11613,DET,2001,Chucky Atkins,26,81,75,2363,380,952,.399,121,339,.357,259,613,.423,.463,90,130,.692,28,145,173,330,67,5,149,184,971
11614,DET,2001,Joe Smith,25,69,59,1941,308,765,.403,0,5,.000,308,760,.405,.403,231,287,.805,160,331,491,79,47,50,88,258,847
11615,DET,2001,Michael Curry,32,68,58,1485,145,319,.455,4,9,.444,141,310,.455,.461,62,73,.849,21,100,121,132,27,3,61,173,356
11616,DET,2001,Mateen Cleaves,23,78,8,1268,160,400,.400,5,17,.294,155,383,.405,.406,97,137,.708,26,106,132,207,49,1,139,153,422
11617,DET,2001,Mikki Moore,25,81,2,1154,132,268,.493,0,1,.000,132,267,.494,.493,95,130,.731,121,195,316,33,24,61,74,202,359
11618,DET,2001,Dana Barros,33,60,0,1079,183,412,.444,44,105,.419,139,307,.453,.498,68,80,.850,6,88,94,110,30,2,60,63,478
11619,DET,2001,Jerome Williams,27,33,2,804,88,201,.438,0,2,.000,88,199,.442,.438,65,90,.722,98,180,278,32,39,10,47,81,241
11620,DET,2001,Corliss Williamson,27,27,9,800,172,322,.534,0,0,,172,322,.534,.534,67,107,.626,53,115,168,28,35,8,45,87,411
11621,DET,2001,Billy Owens,31,45,14,793,88,230,.383,3,20,.150,85,210,.405,.389,19,40,.475,84,121,205,55,32,12,39,93,198
11622,DET,2001,Jud Buechler,32,57,3,737,76,164,.463,32,77,.416,44,87,.506,.561,9,12,.750,20,74,94,39,21,10,25,83,193
11623,DET,2001,Eric Montross,29,42,20,568,50,121,.413,0,0,,50,121,.413,.413,7,26,.269,43,101,144,15,8,23,37,100,107
11624,DET,2001,John Wallace,26,40,0,527,100,236,.424,2,15,.133,98,221,.443,.428,35,45,.778,25,58,83,23,13,16,36,72,237
11625,DET,2001,Cedric Ceballos,31,13,0,166,28,71,.394,11,40,.275,17,31,.548,.472,8,10,.800,7,19,26,7,6,3,9,19,75
11626,DET,2001,Brian Cardinal,23,15,0,126,10,31,.323,0,5,.000,10,26,.385,.323,11,18,.611,8,15,23,3,7,2,9,27,31
11627,DET,2001,Kornél Dávid,29,10,0,69,10,22,.455,0,0,,10,22,.455,.455,0,0,,6,13,19,3,4,1,4,8,20
11628,DET,2000,Jerry Stackhouse,25,82,82,3148,619,1447,.428,83,288,.288,536,1159,.462,.456,618,758,.815,118,197,315,365,103,36,311,188,1939
11629,DET,2000,Lindsey Hunter,29,82,82,2919,379,892,.425,168,389,.432,211,503,.419,.519,117,154,.760,35,215,250,327,129,22,145,216,1043
11630,DET,2000,Grant Hill,27,74,74,2776,696,1422,.489,34,98,.347,662,1324,.500,.501,480,604,.795,97,393,490,385,103,43,240,190,1906
11631,DET,2000,Christian Laettner,30,82,82,2443,379,801,.473,7,24,.292,372,777,.479,.478,237,292,.812,175,378,553,186,83,45,186,326,1002
11632,DET,2000,Jerome Williams,26,82,1,2102,257,456,.564,0,3,.000,257,453,.567,.564,175,284,.616,277,512,789,68,95,21,105,196,689
11633,DET,2000,Terry Mills,32,82,78,1842,214,488,.439,95,242,.393,119,246,.484,.536,25,34,.735,50,340,390,85,38,24,46,242,548
11634,DET,2000,Michael Curry,31,82,3,1611,182,379,.480,1,5,.200,181,374,.484,.482,141,168,.839,21,83,104,87,33,5,73,209,506
11635,DET,2000,John Crotty,30,69,0,937,106,251,.422,33,80,.413,73,171,.427,.488,80,93,.860,17,58,75,128,27,5,54,104,325
11636,DET,2000,Jud Buechler,31,58,5,657,55,156,.353,18,83,.217,37,73,.507,.410,2,7,.286,30,61,91,33,25,16,13,50,130
11637,DET,2000,Mikki Moore,24,29,0,488,87,140,.621,0,0,,87,140,.621,.621,54,68,.794,44,68,112,17,9,31,23,104,228
11638,DET,2000,Eric Montross,28,51,0,332,17,55,.309,0,0,,17,55,.309,.309,6,12,.500,18,54,72,7,6,9,22,81,40
11639,DET,2000,Loy Vaught,31,43,0,292,32,89,.360,0,3,.000,32,86,.372,.360,11,16,.688,26,65,91,11,6,4,11,45,75
11640,DET,2000,Don Reid,26,21,3,165,16,34,.471,0,0,,16,34,.471,.471,3,6,.500,5,20,25,1,5,12,11,45,35
11641,DET,2000,Jermaine Jackson,23,7,0,73,1,11,.091,0,1,.000,1,10,.100,.091,5,8,.625,1,10,11,4,3,0,7,7,7
11642,DET,2000,Marcus Brown,25,6,0,45,4,14,.286,0,7,.000,4,7,.571,.286,2,2,1.000,3,4,7,3,0,0,3,8,10
11643,DET,1999,Grant Hill,26,50,50,1852,384,802,.479,0,14,.000,384,788,.487,.479,285,379,.752,65,290,355,300,80,27,184,114,1053
11644,DET,1999,Lindsey Hunter,28,49,49,1755,228,524,.435,59,153,.386,169,371,.456,.491,67,89,.753,26,142,168,193,86,8,92,126,582
11645,DET,1999,Jerry Stackhouse,24,42,9,1188,181,488,.371,35,126,.278,146,362,.403,.407,210,247,.850,26,81,107,118,34,19,121,79,607
11646,DET,1999,Bison Dele,29,49,48,1177,216,431,.501,0,1,.000,216,430,.502,.501,81,118,.686,92,180,272,71,38,40,111,181,513
11647,DET,1999,Jerome Williams,25,50,10,1154,124,248,.500,0,0,,124,248,.500,.500,107,159,.673,158,191,349,23,63,7,41,108,355
11648,DET,1999,Joe Dumars,35,38,38,1116,144,350,.411,89,221,.403,55,129,.426,.539,51,61,.836,12,56,68,134,23,2,53,51,428
11649,DET,1999,Jud Buechler,30,50,0,1056,100,240,.417,61,148,.412,39,92,.424,.544,13,18,.722,29,104,133,57,37,13,21,83,274
11650,DET,1999,Don Reid,25,47,30,935,97,174,.557,0,0,,97,174,.557,.557,48,79,.608,66,104,170,33,27,43,36,156,242
11651,DET,1999,Eric Montross,27,46,2,577,42,80,.525,0,1,.000,42,79,.532,.525,11,32,.344,45,94,139,14,12,27,16,107,95
11652,DET,1999,Loy Vaught,30,37,10,481,59,155,.381,0,1,.000,59,154,.383,.381,9,14,.643,36,110,146,11,15,6,17,54,127
11653,DET,1999,Christian Laettner,29,16,0,337,38,106,.358,1,3,.333,37,103,.359,.363,44,57,.772,21,33,54,24,15,12,19,30,121
11654,DET,1999,Charles O'Bannon,23,18,1,165,24,56,.429,0,1,.000,24,55,.436,.429,8,8,1.000,18,16,34,12,2,3,8,22,56
11655,DET,1999,Khalid Reeves,26,11,0,112,8,21,.381,1,3,.333,7,18,.389,.405,8,14,.571,3,4,7,11,4,0,7,13,25
11656,DET,1999,Mark Macon,29,7,3,69,4,20,.200,1,3,.333,3,17,.176,.225,0,0,,3,2,5,4,5,1,6,6,9
11657,DET,1999,Corey Beck,27,8,0,30,4,8,.500,0,0,,4,8,.500,.500,2,2,1.000,3,2,5,0,2,0,2,5,10
11658,DET,1999,Steve Henson,30,4,0,25,1,2,.500,0,0,,1,2,.500,.500,2,2,1.000,0,0,0,3,1,0,3,1,4
11659,DET,1999,Korleone Young,20,3,0,15,5,10,.500,1,4,.250,4,6,.667,.550,2,2,1.000,2,2,4,1,0,0,1,3,13
11660,DET,1999,Mikki Moore,23,2,0,6,1,1,1.000,0,0,,1,1,1.000,1.000,2,2,1.000,0,1,1,0,0,0,0,0,4
11661,DET,1998,Grant Hill,25,81,81,3294,615,1361,.452,3,21,.143,612,1340,.457,.453,479,647,.740,93,530,623,551,143,53,285,196,1712
11662,DET,1998,Bison Dele,28,78,78,2619,531,1040,.511,1,3,.333,530,1037,.511,.511,198,280,.707,223,472,695,94,67,55,181,252,1261
11663,DET,1998,Lindsey Hunter,27,71,67,2505,316,826,.383,85,265,.321,231,561,.412,.434,145,196,.740,61,186,247,224,123,10,110,174,862
11664,DET,1998,Joe Dumars,34,72,72,2326,329,791,.416,158,426,.371,171,365,.468,.516,127,154,.825,14,90,104,253,44,2,84,99,943
11665,DET,1998,Jerry Stackhouse,23,57,15,1797,296,692,.428,31,149,.208,265,543,.488,.450,273,349,.782,77,113,190,174,58,38,150,119,896
11666,DET,1998,Malik Sealy,27,77,10,1641,216,505,.428,9,41,.220,207,464,.446,.437,150,182,.824,48,171,219,100,65,20,79,156,591
11667,DET,1998,Jerome Williams,24,77,3,1305,151,288,.524,0,1,.000,151,287,.526,.524,108,166,.651,170,209,379,48,51,10,60,144,410
11668,DET,1998,Don Reid,24,68,44,994,94,176,.534,0,0,,94,176,.534,.534,50,71,.704,77,98,175,26,25,55,28,183,238
11669,DET,1998,Grant Long,31,40,17,739,50,117,.427,0,4,.000,50,113,.442,.427,41,57,.719,57,93,150,25,29,12,22,91,141
11670,DET,1998,Rick Mahorn,39,59,0,707,59,129,.457,0,0,,59,129,.457,.457,23,34,.676,65,130,195,15,14,7,37,123,141
11671,DET,1998,Theo Ratliff,24,24,12,586,57,111,.514,0,0,,57,111,.514,.514,43,63,.683,46,75,121,15,12,55,34,83,157
11672,DET,1998,Aaron McKie,25,24,1,472,43,104,.413,3,17,.176,40,87,.460,.428,20,23,.870,24,44,68,38,23,1,24,47,109
11673,DET,1998,Eric Montross,26,28,10,354,31,68,.456,0,0,,31,68,.456,.456,9,21,.429,41,66,107,4,6,15,14,66,71
11674,DET,1998,Scot Pollard,22,33,0,317,35,70,.500,0,0,,35,70,.500,.500,19,23,.826,34,40,74,9,8,10,12,48,89
11675,DET,1998,Charles O'Bannon,22,30,0,234,26,69,.377,0,3,.000,26,66,.394,.377,12,15,.800,14,19,33,17,9,1,9,15,64
11676,DET,1998,Steve Henson,29,23,0,65,13,26,.500,3,8,.375,10,18,.556,.558,7,7,1.000,0,2,2,4,1,0,6,9,36
11677,DET,1997,Grant Hill,24,80,80,3147,625,1259,.496,10,33,.303,615,1226,.502,.500,450,633,.711,123,598,721,583,144,48,259,186,1710
11678,DET,1997,Lindsey Hunter,26,82,76,3023,421,1042,.404,166,468,.355,255,574,.444,.484,158,203,.778,59,174,233,154,129,24,96,206,1166
11679,DET,1997,Joe Dumars,33,79,79,2923,385,875,.440,166,384,.432,219,491,.446,.535,222,256,.867,38,153,191,318,57,1,128,97,1158
11680,DET,1997,Otis Thorpe,34,79,79,2661,419,787,.532,0,2,.000,419,785,.534,.532,198,303,.653,226,396,622,133,59,17,145,298,1036
11681,DET,1997,Terry Mills,29,79,5,1997,312,702,.444,175,415,.422,137,287,.477,.569,58,70,.829,68,309,377,99,35,27,85,161,857
11682,DET,1997,Theo Ratliff,23,76,38,1292,179,337,.531,0,0,,179,337,.531,.531,81,116,.698,109,147,256,13,29,111,56,181,439
11683,DET,1997,Michael Curry,28,81,2,1217,99,221,.448,23,77,.299,76,144,.528,.500,97,108,.898,23,96,119,43,31,12,28,128,318
11684,DET,1997,Grant Long,30,65,24,1166,123,275,.447,17,47,.362,106,228,.465,.478,63,84,.750,88,134,222,39,43,6,48,106,326
11685,DET,1997,Aaron McKie,24,42,3,850,97,209,.464,18,48,.375,79,161,.491,.507,51,61,.836,27,101,128,77,43,7,42,69,263
11686,DET,1997,Don Reid,23,47,14,462,54,112,.482,0,1,.000,54,111,.486,.482,24,32,.750,36,65,101,14,16,15,23,105,132
11687,DET,1997,Litterial Green,26,45,0,311,30,64,.469,0,10,.000,30,54,.556,.469,30,47,.638,6,16,22,41,16,1,15,27,90
11688,DET,1997,Stacey Augmon,28,20,3,292,31,77,.403,0,0,,31,77,.403,.403,28,41,.683,14,35,49,15,10,10,27,29,90
11689,DET,1997,Rick Mahorn,38,22,7,218,20,54,.370,0,1,.000,20,53,.377,.370,16,22,.727,19,34,53,6,4,3,10,34,56
11690,DET,1997,Jerome Williams,23,33,0,177,20,51,.392,0,0,,20,51,.392,.392,9,17,.529,22,28,50,7,13,1,13,18,49
11691,DET,1997,Kenny Smith,31,9,0,64,8,20,.400,5,10,.500,3,10,.300,.525,2,2,1.000,0,5,5,10,1,0,3,2,23
11692,DET,1997,Randolph Childress,24,4,0,30,4,10,.400,2,3,.667,2,7,.286,.500,0,0,,0,1,1,2,2,0,5,5,10
11693,DET,1996,Grant Hill,23,80,80,3260,564,1221,.462,5,26,.192,559,1195,.468,.464,485,646,.751,127,656,783,548,100,48,263,242,1618
11694,DET,1996,Allan Houston,24,82,75,3072,564,1244,.453,191,447,.427,373,797,.468,.530,298,362,.823,54,246,300,250,61,16,233,233,1617
11695,DET,1996,Otis Thorpe,33,82,82,2841,452,853,.530,0,4,.000,452,849,.532,.530,257,362,.710,211,477,688,158,53,39,195,300,1161
11696,DET,1996,Joe Dumars,32,67,40,2193,255,598,.426,121,298,.406,134,300,.447,.528,162,197,.822,28,110,138,265,43,3,97,106,793
11697,DET,1996,Lindsey Hunter,25,80,48,2138,239,628,.381,117,289,.405,122,339,.360,.474,84,120,.700,44,150,194,188,84,18,80,185,679
11698,DET,1996,Terry Mills,28,82,5,1656,283,675,.419,82,207,.396,201,468,.429,.480,121,157,.771,108,244,352,98,42,20,98,197,769
11699,DET,1996,Theo Ratliff,22,75,2,1305,128,230,.557,0,1,.000,128,229,.559,.557,85,120,.708,110,187,297,13,16,116,56,144,341
11700,DET,1996,Don Reid,22,69,46,997,106,187,.567,0,0,,106,187,.567,.567,51,77,.662,78,125,203,11,47,40,41,199,263
11701,DET,1996,Michael Curry,27,41,1,749,70,151,.464,20,50,.400,50,101,.495,.530,41,58,.707,25,55,80,26,23,2,23,89,201
11702,DET,1996,Mark West,35,47,21,682,61,126,.484,0,0,,61,126,.484,.484,28,45,.622,49,84,133,6,6,37,35,135,150
11703,DET,1996,Lou Roe,23,49,2,372,32,90,.356,2,9,.222,30,81,.370,.367,24,32,.750,30,48,78,15,10,8,17,42,90
11704,DET,1996,Mark Macon,26,23,0,287,29,67,.433,7,15,.467,22,52,.423,.485,9,11,.818,10,12,22,16,15,0,9,34,74
11705,DET,1996,Eric Leckner,29,18,8,155,18,29,.621,0,0,,18,29,.621,.621,8,13,.615,8,26,34,1,2,4,11,30,44
11706,DET,1996,Steve Bardo,27,9,0,123,9,23,.391,0,4,.000,9,19,.474,.391,4,6,.667,2,20,22,15,4,1,5,17,22
11707,DET,1995,Grant Hill,22,70,69,2678,508,1064,.477,4,27,.148,504,1037,.486,.479,374,511,.732,125,320,445,353,124,62,202,203,1394
11708,DET,1995,Joe Dumars,31,67,67,2544,417,970,.430,103,338,.305,314,632,.497,.483,277,344,.805,47,111,158,368,72,7,219,153,1214
11709,DET,1995,Terry Mills,27,72,69,2514,417,933,.447,109,285,.382,308,648,.475,.505,175,219,.799,124,434,558,160,68,33,144,253,1118
11710,DET,1995,Allan Houston,23,76,39,1996,398,859,.463,158,373,.424,240,486,.494,.555,147,171,.860,29,138,167,164,61,14,113,182,1101
11711,DET,1995,Rafael Addison,30,79,16,1776,279,586,.476,24,83,.289,255,503,.507,.497,74,99,.747,67,175,242,109,53,25,76,236,656
11712,DET,1995,Oliver Miller,24,64,22,1558,232,418,.555,3,13,.231,229,405,.565,.559,78,124,.629,162,313,475,93,60,116,115,217,545
11713,DET,1995,Mark West,34,67,58,1543,217,390,.556,0,0,,217,390,.556,.556,66,138,.478,160,248,408,18,27,102,85,247,500
11714,DET,1995,Johnny Dawkins,31,50,9,1170,125,270,.463,25,73,.342,100,197,.508,.509,50,55,.909,28,85,113,205,52,1,86,74,325
11715,DET,1995,Lindsey Hunter,24,42,26,944,119,318,.374,36,108,.333,83,210,.395,.431,40,55,.727,24,51,75,159,51,7,79,94,314
11716,DET,1995,Mark Macon,25,55,6,721,101,265,.381,20,62,.323,81,203,.399,.419,54,68,.794,29,47,76,63,67,1,41,97,276
11717,DET,1995,Negele Knight,27,44,17,665,78,199,.392,11,28,.393,67,171,.392,.420,14,21,.667,20,38,58,116,20,5,45,65,181
11718,DET,1995,Eric Leckner,28,57,11,623,87,165,.527,0,2,.000,87,163,.534,.527,51,72,.708,47,127,174,14,15,15,39,122,225
11719,DET,1995,Bill Curley,22,53,1,595,58,134,.433,0,0,,58,134,.433,.433,27,36,.750,54,70,124,25,21,21,25,128,143
11720,DET,1995,Ivano Newbill,24,34,0,331,16,45,.356,0,0,,16,45,.356,.356,8,22,.364,40,41,81,17,12,11,12,60,40
11721,DET,1995,Walter Bond,25,5,0,51,3,12,.250,1,4,.250,2,8,.250,.292,3,4,.750,1,4,5,7,1,0,3,10,10
11722,DET,1995,Mike Peplowski,24,6,0,21,5,5,1.000,0,0,,5,5,1.000,1.000,1,2,.500,1,2,3,1,1,0,2,10,11
11723,DET,1994,Terry Mills,26,80,74,2773,588,1151,.511,24,73,.329,564,1078,.523,.521,181,227,.797,193,479,672,177,64,62,153,309,1381
11724,DET,1994,Joe Dumars,30,69,69,2591,505,1118,.452,124,320,.388,381,798,.477,.507,276,330,.836,35,116,151,261,63,4,159,118,1410
11725,DET,1994,Sean Elliott,25,73,73,2409,360,791,.455,26,87,.299,334,704,.474,.472,139,173,.803,68,195,263,197,54,27,129,174,885
11726,DET,1994,Lindsey Hunter,23,82,26,2172,335,893,.375,69,207,.333,266,686,.388,.414,104,142,.732,47,142,189,390,121,10,184,174,843
11727,DET,1994,Isiah Thomas,32,58,56,1750,318,763,.417,39,126,.310,279,637,.438,.442,181,258,.702,46,113,159,399,68,6,202,126,856
11728,DET,1994,Greg Anderson,29,77,47,1624,201,370,.543,1,3,.333,200,367,.545,.545,88,154,.571,183,388,571,51,55,68,94,234,491
11729,DET,1994,Allan Houston,22,79,20,1519,272,671,.405,35,117,.299,237,554,.428,.431,89,108,.824,19,101,120,100,34,13,99,165,668
11730,DET,1994,Olden Polynice,29,37,36,1350,222,406,.547,0,1,.000,222,405,.548,.547,42,92,.457,148,308,456,22,24,36,49,108,486
11731,DET,1994,David Wood,29,78,3,1182,119,259,.459,22,49,.449,97,210,.462,.502,62,82,.756,104,135,239,51,39,19,35,201,322
11732,DET,1994,Charles Jones,36,42,0,877,36,78,.462,0,1,.000,36,77,.468,.462,19,34,.559,89,146,235,29,14,43,12,136,91
11733,DET,1994,Pete Chilcutt,25,30,0,391,51,120,.425,3,14,.214,48,106,.453,.438,10,13,.769,29,71,100,15,10,11,18,48,115
11734,DET,1994,Mark Macon,24,35,1,370,55,139,.396,2,7,.286,53,132,.402,.403,15,24,.625,15,19,34,40,33,0,26,56,127
11735,DET,1994,Marcus Liberty,25,35,0,274,36,116,.310,10,27,.370,26,89,.292,.353,18,37,.486,26,30,56,15,11,4,22,29,100
11736,DET,1994,Bill Laimbeer,36,11,5,248,47,90,.522,3,9,.333,44,81,.543,.539,11,13,.846,9,47,56,14,6,4,10,30,108
11737,DET,1994,Ben Coleman,32,9,0,77,12,25,.480,0,0,,12,25,.480,.480,4,8,.500,10,16,26,0,2,2,7,9,28
11738,DET,1994,Tod Murphy,30,7,0,57,6,12,.500,0,0,,6,12,.500,.500,3,6,.500,4,5,9,3,2,0,1,8,15
11739,DET,1994,Dan O'Sullivan,25,13,0,56,4,12,.333,0,0,,4,12,.333,.333,9,12,.750,2,8,10,3,0,0,3,10,17
11740,DET,1994,Tracy Moore,28,3,0,10,2,3,.667,0,0,,2,3,.667,.667,2,2,1.000,0,1,1,0,2,0,0,0,6
11741,DET,1993,Joe Dumars,29,77,77,3094,677,1454,.466,112,299,.375,565,1155,.489,.504,343,397,.864,63,85,148,308,78,7,138,141,1809
11742,DET,1993,Isiah Thomas,31,79,79,2922,526,1258,.418,61,198,.308,465,1060,.439,.442,278,377,.737,71,161,232,671,123,18,284,222,1391
11743,DET,1993,Dennis Rodman,31,62,55,2410,183,429,.427,15,73,.205,168,356,.472,.444,87,163,.534,367,765,1132,102,48,45,103,201,468
11744,DET,1993,Terry Mills,25,81,46,2183,494,1072,.461,10,36,.278,484,1036,.467,.465,201,254,.791,176,296,472,111,44,50,142,282,1199
11745,DET,1993,Bill Laimbeer,35,79,41,1933,292,574,.509,10,27,.370,282,547,.516,.517,93,104,.894,110,309,419,127,46,40,59,212,687
11746,DET,1993,Orlando Woolridge,33,50,47,1477,271,566,.479,0,9,.000,271,557,.487,.479,113,168,.673,84,92,176,112,26,25,73,114,655
11747,DET,1993,Olden Polynice,28,67,18,1299,210,429,.490,0,1,.000,210,428,.491,.490,66,142,.465,181,237,418,29,31,21,54,126,486
11748,DET,1993,Mark Aguirre,33,51,15,1056,187,422,.443,30,83,.361,157,339,.463,.479,99,129,.767,43,109,152,105,16,7,68,101,503
11749,DET,1993,Alvin Robertson,30,30,22,941,108,249,.434,23,67,.343,85,182,.467,.480,40,58,.690,60,72,132,107,65,9,56,98,279
11750,DET,1993,Danny Young,30,65,2,836,69,167,.413,22,68,.324,47,99,.475,.479,28,32,.875,13,34,47,119,31,5,30,36,188
11751,DET,1993,Gerald Glass,25,56,5,777,134,312,.429,7,31,.226,127,281,.452,.441,21,33,.636,60,79,139,68,30,18,30,98,296
11752,DET,1993,Melvin Newbern,25,33,1,311,42,113,.372,1,8,.125,41,105,.390,.376,34,60,.567,19,18,37,57,23,1,32,42,119
11753,DET,1993,Mark Randall,25,35,0,240,40,79,.506,1,7,.143,39,72,.542,.513,16,26,.615,27,28,55,10,4,2,16,32,97
11754,DET,1993,Darrell Walker,31,9,2,144,3,19,.158,0,1,.000,3,18,.167,.158,2,6,.333,4,15,19,9,10,0,13,12,8
11755,DET,1993,Isaiah Morris,23,25,0,102,26,57,.456,0,0,,26,57,.456,.456,3,4,.750,6,6,12,4,3,1,8,14,55
11756,DET,1993,Jeff Ruland,34,11,0,55,5,11,.455,0,0,,5,11,.455,.455,2,4,.500,9,9,18,2,2,0,6,16,12
11757,DET,1992,Dennis Rodman,30,82,80,3301,342,635,.539,32,101,.317,310,534,.581,.564,84,140,.600,523,1007,1530,191,68,70,140,248,800
11758,DET,1992,Joe Dumars,28,82,82,3192,587,1311,.448,49,120,.408,538,1191,.452,.466,412,475,.867,82,106,188,375,71,12,193,145,1635
11759,DET,1992,Isiah Thomas,30,78,78,2918,564,1264,.446,25,86,.291,539,1178,.458,.456,292,378,.772,68,179,247,560,118,15,252,194,1445
11760,DET,1992,Bill Laimbeer,34,81,46,2234,342,727,.470,32,85,.376,310,642,.483,.492,67,75,.893,104,347,451,160,51,54,102,225,783
11761,DET,1992,Orlando Woolridge,32,82,61,2113,452,907,.498,1,9,.111,451,898,.502,.499,241,353,.683,109,151,260,88,41,33,133,154,1146
11762,DET,1992,John Salley,27,72,38,1774,249,486,.512,0,3,.000,249,483,.516,.512,186,260,.715,106,190,296,116,49,110,102,222,684
11763,DET,1992,Mark Aguirre,32,75,12,1582,339,787,.431,15,71,.211,324,716,.453,.440,158,230,.687,67,169,236,126,51,11,105,171,851
11764,DET,1992,Darrell Walker,30,74,4,1541,161,381,.423,0,10,.000,161,371,.434,.423,65,105,.619,85,153,238,205,63,18,79,134,387
11765,DET,1992,William Bedford,28,32,8,363,50,121,.413,0,1,.000,50,120,.417,.413,14,22,.636,24,39,63,12,6,18,15,56,114
11766,DET,1992,Brad Sellers,29,43,1,226,41,88,.466,0,1,.000,41,87,.471,.466,20,26,.769,15,27,42,14,1,10,15,20,102
11767,DET,1992,Lance Blanks,25,43,0,189,25,55,.455,6,16,.375,19,39,.487,.509,8,11,.727,9,13,22,19,14,1,14,26,64
11768,DET,1992,Charles Thomas,22,36,0,156,18,51,.353,2,17,.118,16,34,.471,.373,10,15,.667,6,16,22,22,4,1,17,20,48
11769,DET,1992,Bob McCann,27,26,0,129,13,33,.394,0,1,.000,13,32,.406,.394,4,13,.308,12,18,30,6,6,4,7,23,30
11770,DET,1992,Gerald Henderson,36,8,0,62,8,21,.381,3,5,.600,5,16,.313,.452,5,5,1.000,0,6,6,5,3,0,4,8,24
11771,DET,1991,Joe Dumars,27,80,80,3046,622,1292,.481,14,45,.311,608,1247,.488,.487,371,417,.890,62,125,187,443,89,7,189,135,1629
11772,DET,1991,Dennis Rodman,29,82,77,2747,276,560,.493,6,30,.200,270,530,.509,.498,111,176,.631,361,665,1026,85,65,55,94,281,669
11773,DET,1991,Bill Laimbeer,33,82,81,2668,372,778,.478,37,125,.296,335,653,.513,.502,123,147,.837,173,564,737,157,38,56,98,242,904
11774,DET,1991,Vinnie Johnson,34,82,28,2390,406,936,.434,11,34,.324,395,902,.438,.440,135,209,.646,110,170,280,271,75,15,118,166,958
11775,DET,1991,Mark Aguirre,31,78,13,2006,420,909,.462,24,78,.308,396,831,.477,.475,240,317,.757,134,240,374,139,47,20,128,209,1104
11776,DET,1991,James Edwards,35,72,70,1903,383,792,.484,1,2,.500,382,790,.484,.484,215,295,.729,91,186,277,65,12,30,126,249,982
11777,DET,1991,Isiah Thomas,29,48,46,1657,289,665,.435,19,65,.292,270,600,.450,.449,179,229,.782,35,125,160,446,75,10,185,118,776
11778,DET,1991,John Salley,26,74,1,1649,179,377,.475,0,1,.000,179,376,.476,.475,186,256,.727,137,190,327,70,52,112,91,240,544
11779,DET,1991,William Bedford,27,60,4,562,106,242,.438,5,13,.385,101,229,.441,.448,55,78,.705,55,76,131,32,2,36,32,76,272
11780,DET,1991,Gerald Henderson,35,23,10,392,50,117,.427,7,21,.333,43,96,.448,.457,16,21,.762,8,29,37,62,12,2,28,43,123
11781,DET,1991,John Long,34,25,0,256,35,85,.412,2,6,.333,33,79,.418,.424,24,25,.960,9,23,32,18,9,2,14,17,96
11782,DET,1991,Lance Blanks,24,38,0,214,26,61,.426,2,16,.125,24,45,.533,.443,10,14,.714,4,16,20,26,9,2,18,35,64
11783,DET,1991,Tree Rollins,35,37,0,202,14,33,.424,0,0,,14,33,.424,.424,8,14,.571,13,29,42,4,2,20,15,35,36
11784,DET,1991,Scott Hastings,30,27,0,113,16,28,.571,3,4,.750,13,24,.542,.625,13,13,1.000,14,14,28,7,0,0,7,23,48
11785,DET,1990,Isiah Thomas,28,81,81,2993,579,1322,.438,42,136,.309,537,1186,.453,.454,292,377,.775,74,234,308,765,139,19,322,206,1492
11786,DET,1990,Bill Laimbeer,32,81,81,2675,380,785,.484,57,158,.361,323,627,.515,.520,164,192,.854,166,614,780,171,57,84,98,278,981
11787,DET,1990,Joe Dumars,26,75,71,2578,508,1058,.480,22,55,.400,486,1003,.485,.491,297,330,.900,60,152,212,368,63,2,145,129,1335
11788,DET,1990,Dennis Rodman,28,82,43,2377,288,496,.581,1,9,.111,287,487,.589,.582,142,217,.654,336,456,792,72,52,60,90,276,719
11789,DET,1990,James Edwards,34,82,70,2283,462,928,.498,0,3,.000,462,925,.499,.498,265,354,.749,112,233,345,63,23,37,133,295,1189
11790,DET,1990,Mark Aguirre,30,78,40,2005,438,898,.488,31,93,.333,407,805,.506,.505,192,254,.756,117,188,305,145,34,19,121,201,1099
11791,DET,1990,Vinnie Johnson,33,82,12,1972,334,775,.431,5,34,.147,329,741,.444,.434,131,196,.668,108,148,256,255,71,13,123,143,804
11792,DET,1990,John Salley,25,82,12,1914,209,408,.512,1,4,.250,208,404,.515,.513,174,244,.713,154,285,439,67,51,153,97,282,593
11793,DET,1990,Gerald Henderson,34,46,0,335,42,83,.506,14,31,.452,28,52,.538,.590,10,13,.769,8,23,31,61,8,2,16,36,108
11794,DET,1990,William Bedford,26,42,0,246,54,125,.432,1,6,.167,53,119,.445,.436,9,22,.409,15,43,58,4,3,17,21,39,118
11795,DET,1990,Dave Greenwood,32,37,0,205,22,52,.423,0,0,,22,52,.423,.423,16,29,.552,24,54,78,12,4,9,16,40,60
11796,DET,1990,Scott Hastings,29,40,0,166,10,33,.303,3,12,.250,7,21,.333,.348,19,22,.864,7,25,32,8,3,3,7,31,42
11797,DET,1990,Stan Kimbrough,23,10,0,50,7,16,.438,0,0,,7,16,.438,.438,2,2,1.000,4,3,7,5,4,0,4,4,16
11798,DET,1990,Ralph Lewis,26,4,0,6,0,1,.000,0,0,,0,1,.000,.000,0,0,,0,0,0,0,0,0,1,1,0
11799,DET,1989,Isiah Thomas,27,80,76,2924,569,1227,.464,33,121,.273,536,1106,.485,.477,287,351,.818,49,224,273,663,133,20,298,209,1458
11800,DET,1989,Bill Laimbeer,31,81,81,2640,449,900,.499,30,86,.349,419,814,.515,.516,178,212,.840,138,638,776,177,51,100,129,259,1106
11801,DET,1989,Joe Dumars,25,69,67,2408,456,903,.505,14,29,.483,442,874,.506,.513,260,306,.850,57,115,172,390,63,5,178,103,1186
11802,DET,1989,Dennis Rodman,27,82,8,2208,316,531,.595,6,26,.231,310,505,.614,.601,97,155,.626,327,445,772,99,55,76,126,292,735
11803,DET,1989,Vinnie Johnson,32,82,21,2073,462,996,.464,13,44,.295,449,952,.472,.470,193,263,.734,109,146,255,242,74,17,105,155,1130
11804,DET,1989,Rick Mahorn,30,72,61,1795,203,393,.517,0,2,.000,203,391,.519,.517,116,155,.748,141,355,496,59,40,66,97,206,522
11805,DET,1989,John Salley,24,67,21,1458,166,333,.498,0,2,.000,166,331,.502,.498,135,195,.692,134,201,335,75,40,72,100,197,467
11806,DET,1989,Adrian Dantley,33,42,42,1341,258,495,.521,0,0,,258,495,.521,.521,256,305,.839,53,111,164,93,23,6,81,99,772
11807,DET,1989,James Edwards,33,76,1,1254,211,422,.500,0,2,.000,211,420,.502,.500,133,194,.686,68,163,231,49,11,31,72,226,555
11808,DET,1989,Mark Aguirre,29,36,32,1068,213,441,.483,22,75,.293,191,366,.522,.508,110,149,.738,56,95,151,89,16,7,68,101,558
11809,DET,1989,Micheal Williams,22,49,0,358,47,129,.364,2,9,.222,45,120,.375,.372,31,47,.660,9,18,27,70,13,3,42,44,127
11810,DET,1989,John Long,32,24,0,152,19,40,.475,0,0,,19,40,.475,.475,11,13,.846,2,9,11,15,0,2,9,16,49
11811,DET,1989,Fennis Dembo,23,31,0,74,14,42,.333,0,4,.000,14,38,.368,.333,8,10,.800,8,15,23,5,1,0,7,15,36
11812,DET,1989,Darryl Dawkins,32,14,0,48,9,19,.474,0,0,,9,19,.474,.474,9,18,.500,3,4,7,1,0,1,4,13,27
11813,DET,1989,Pace Mannion,28,5,0,14,2,2,1.000,0,0,,2,2,1.000,1.000,0,0,,0,3,3,0,1,0,0,3,4
11814,DET,1989,Jim Rowinski,28,6,0,8,0,2,.000,0,0,,0,2,.000,.000,4,4,1.000,0,2,2,0,0,0,0,0,4
11815,DET,1989,Steve Harris,25,3,0,7,1,4,.250,0,0,,1,4,.250,.250,2,2,1.000,0,2,2,0,1,0,0,1,4
11816,DET,1988,Isiah Thomas,26,81,81,2927,621,1341,.463,30,97,.309,591,1244,.475,.474,305,394,.774,64,214,278,678,141,17,273,217,1577
11817,DET,1988,Bill Laimbeer,30,82,82,2897,455,923,.493,13,39,.333,442,884,.500,.500,187,214,.874,165,667,832,199,66,78,136,284,1110
11818,DET,1988,Joe Dumars,24,82,82,2732,453,960,.472,4,19,.211,449,941,.477,.474,251,308,.815,63,137,200,387,87,15,172,155,1161
11819,DET,1988,Dennis Rodman,26,82,32,2147,398,709,.561,5,17,.294,393,692,.568,.565,152,284,.535,318,397,715,110,75,45,156,273,953
11820,DET,1988,Adrian Dantley,32,69,50,2144,444,863,.514,0,2,.000,444,861,.516,.514,492,572,.860,84,143,227,171,39,10,135,144,1380
11821,DET,1988,John Salley,23,82,16,2003,258,456,.566,0,0,,258,456,.566,.566,185,261,.709,166,236,402,113,53,137,120,294,701
11822,DET,1988,Rick Mahorn,29,67,64,1963,276,481,.574,1,2,.500,275,479,.574,.575,164,217,.756,159,406,565,60,43,42,119,262,717
11823,DET,1988,Vinnie Johnson,31,82,1,1935,425,959,.443,5,24,.208,420,935,.449,.446,147,217,.677,90,141,231,267,58,18,152,164,1002
11824,DET,1988,James Edwards,32,26,2,328,48,101,.475,0,0,,48,101,.475,.475,45,61,.738,22,55,77,5,2,5,22,57,141
11825,DET,1988,Ralph Lewis,24,50,0,310,27,87,.310,0,1,.000,27,86,.314,.310,29,48,.604,17,34,51,14,13,4,19,36,83
11826,DET,1988,William Bedford,24,38,0,298,44,101,.436,0,0,,44,101,.436,.436,13,23,.565,27,38,65,4,8,17,19,47,101
11827,DET,1988,Chuck Nevitt,28,17,0,63,7,21,.333,0,0,,7,21,.333,.333,3,6,.500,4,14,18,0,1,5,2,12,17
11828,DET,1988,Ron Moore,26,9,0,25,4,13,.308,0,0,,4,13,.308,.308,2,4,.500,2,0,2,1,2,0,3,8,10
11829,DET,1988,Darryl Dawkins,31,2,0,7,1,2,.500,0,0,,1,2,.500,.500,2,3,.667,0,0,0,1,0,1,3,4,4
11830,DET,1988,Walker Russell,27,1,0,1,0,1,.000,0,1,.000,0,0,,.000,0,0,,0,0,0,1,0,0,0,0,0
11831,DET,1987,Isiah Thomas,25,81,81,3013,626,1353,.463,19,98,.194,607,1255,.484,.470,400,521,.768,82,237,319,813,153,20,343,251,1671
11832,DET,1987,Bill Laimbeer,29,82,82,2854,506,1010,.501,6,21,.286,500,989,.506,.504,245,274,.894,243,712,955,151,72,69,120,283,1263
11833,DET,1987,Adrian Dantley,31,81,81,2736,601,1126,.534,1,6,.167,600,1120,.536,.534,539,664,.812,104,228,332,162,63,7,181,193,1742
11834,DET,1987,Joe Dumars,23,79,75,2439,369,749,.493,9,22,.409,360,727,.495,.499,184,246,.748,50,117,167,352,83,5,171,194,931
11835,DET,1987,Vinnie Johnson,30,78,8,2166,533,1154,.462,4,14,.286,529,1140,.464,.464,158,201,.786,123,134,257,300,92,16,133,159,1228
11836,DET,1987,Sidney Green,26,80,69,1792,256,542,.472,0,2,.000,256,540,.474,.472,119,177,.672,196,457,653,62,41,50,127,197,631
11837,DET,1987,John Salley,22,82,2,1463,163,290,.562,0,1,.000,163,289,.564,.562,105,171,.614,108,188,296,54,44,125,74,256,431
11838,DET,1987,Rick Mahorn,28,63,6,1278,144,322,.447,0,0,,144,322,.447,.447,96,117,.821,93,282,375,38,32,50,73,221,384
11839,DET,1987,Dennis Rodman,25,77,1,1155,213,391,.545,0,1,.000,213,390,.546,.545,74,126,.587,163,169,332,56,38,48,93,166,500
11840,DET,1987,Tony Campbell,24,40,0,332,57,145,.393,0,3,.000,57,142,.401,.393,24,39,.615,21,37,58,19,12,1,34,40,138
11841,DET,1987,Kurt Nimphius,28,28,5,277,36,78,.462,0,1,.000,36,77,.468,.462,24,32,.750,22,32,54,7,4,13,16,38,96
11842,DET,1987,Chuck Nevitt,27,41,0,267,31,63,.492,0,0,,31,63,.492,.492,14,24,.583,36,47,83,4,7,30,21,73,76
11843,DET,1987,Jeff Taylor,27,12,0,44,6,10,.600,0,0,,6,10,.600,.600,9,10,.900,1,3,4,3,2,1,8,4,21
11844,DET,1987,Cozell McQueen,25,3,0,7,3,3,1.000,0,0,,3,3,1.000,1.000,0,0,,3,5,8,0,0,1,0,1,6
11845,DET,1987,John Schweitz,26,3,0,7,0,1,.000,0,0,,0,1,.000,.000,0,0,,0,1,1,0,0,0,2,2,0
11846,DET,1986,Bill Laimbeer,28,82,82,2891,545,1107,.492,4,14,.286,541,1093,.495,.494,266,319,.834,305,770,1075,146,59,65,133,291,1360
11847,DET,1986,Isiah Thomas,24,77,77,2790,609,1248,.488,26,84,.310,583,1164,.501,.498,365,462,.790,83,194,277,830,171,20,289,245,1609
11848,DET,1986,Kelly Tripucka,26,81,81,2626,615,1236,.498,12,25,.480,603,1211,.498,.502,380,444,.856,116,232,348,265,93,10,183,167,1622
11849,DET,1986,Earl Cureton,28,80,19,2017,285,564,.505,0,2,.000,285,562,.507,.505,117,211,.555,198,306,504,137,58,58,150,239,687
11850,DET,1986,Vinnie Johnson,29,79,12,1978,465,996,.467,2,13,.154,463,983,.471,.468,165,214,.771,119,107,226,269,80,23,88,180,1097
11851,DET,1986,Joe Dumars,22,82,45,1957,287,597,.481,5,16,.313,282,581,.485,.485,190,238,.798,60,59,119,390,66,11,158,200,769
11852,DET,1986,Rick Mahorn,27,80,12,1442,157,345,.455,0,1,.000,157,344,.456,.455,81,119,.681,121,291,412,64,40,61,109,261,395
11853,DET,1986,Kent Benson,31,72,51,1344,201,415,.484,1,2,.500,200,413,.484,.486,66,83,.795,118,258,376,80,58,51,58,196,469
11854,DET,1986,Tony Campbell,23,82,1,1292,294,608,.484,2,9,.222,292,599,.487,.485,58,73,.795,83,153,236,45,62,7,86,164,648
11855,DET,1986,John Long,29,62,30,1176,264,548,.482,3,16,.188,261,532,.491,.484,89,104,.856,47,51,98,82,41,13,59,92,620
11856,DET,1986,Mike Gibson,25,32,0,161,20,51,.392,0,0,,20,51,.392,.392,8,11,.727,15,25,40,5,8,4,6,35,48
11857,DET,1986,Chuck Nevitt,26,25,0,101,12,32,.375,0,0,,12,32,.375,.375,15,20,.750,10,15,25,5,2,17,7,29,39
11858,DET,1986,Ron Crevier,27,2,0,3,0,2,.000,0,0,,0,2,.000,.000,0,2,.000,1,0,1,0,0,0,0,2,0
11859,DET,1986,Walker Russell,25,1,0,2,0,1,.000,0,0,,0,1,.000,.000,0,0,,0,0,0,1,0,0,0,0,0
11860,DET,1985,Isiah Thomas,23,81,81,3089,646,1410,.458,29,113,.257,617,1297,.476,.468,399,493,.809,114,247,361,1123,187,25,302,288,1720
11861,DET,1985,Bill Laimbeer,27,82,82,2892,595,1177,.506,4,18,.222,591,1159,.510,.507,244,306,.797,295,718,1013,154,69,71,129,308,1438
11862,DET,1985,Vinnie Johnson,28,82,16,2093,428,942,.454,5,27,.185,423,915,.462,.457,190,247,.769,134,118,252,325,71,20,135,205,1051
11863,DET,1985,Terry Tyler,28,82,53,2004,422,855,.494,0,8,.000,422,847,.498,.494,106,148,.716,148,275,423,63,49,90,76,192,950
11864,DET,1985,John Long,28,66,55,1820,431,885,.487,5,15,.333,426,870,.490,.490,106,123,.862,81,109,190,130,71,14,98,139,973
11865,DET,1985,Kelly Tripucka,25,55,43,1675,396,831,.477,2,5,.400,394,826,.477,.478,255,288,.885,66,152,218,135,49,14,118,118,1049
11866,DET,1985,Earl Cureton,27,81,1,1642,207,428,.484,0,3,.000,207,425,.487,.484,82,144,.569,169,250,419,83,56,42,114,216,496
11867,DET,1985,Dan Roundfield,31,56,43,1492,236,505,.467,0,2,.000,236,503,.469,.467,139,178,.781,175,278,453,102,26,54,123,147,611
11868,DET,1985,Kent Benson,30,72,35,1401,201,397,.506,0,3,.000,201,394,.510,.506,76,94,.809,103,221,324,93,53,44,68,207,478
11869,DET,1985,Tony Campbell,22,56,0,625,130,262,.496,0,1,.000,130,261,.498,.496,56,70,.800,41,48,89,24,28,3,69,107,316
11870,DET,1985,Brook Steppe,25,54,0,486,83,178,.466,0,1,.000,83,177,.469,.466,87,104,.837,25,32,57,36,16,4,43,61,253
11871,DET,1985,Major Jones,31,47,0,418,48,87,.552,0,0,,48,87,.552,.552,33,51,.647,48,80,128,15,9,14,35,58,129
11872,DET,1985,David Thirdkill,24,10,1,115,12,23,.522,0,1,.000,12,22,.545,.522,5,11,.455,4,4,8,1,3,2,12,16,29
11873,DET,1985,Lorenzo Romar,26,5,0,35,2,8,.250,0,2,.000,2,6,.333,.250,5,5,1.000,0,0,0,10,4,0,5,5,9
11874,DET,1985,Sidney Lowe,25,6,0,31,2,7,.286,0,0,,2,7,.286,.286,0,0,,0,1,1,8,0,0,2,5,4
11875,DET,1985,Dale Wilkinson,24,2,0,7,0,2,.000,0,0,,0,2,.000,.000,0,0,,0,1,1,0,0,0,0,2,0
11876,DET,1985,Terry Teagle,24,2,0,5,1,2,.500,0,0,,1,2,.500,.500,0,0,,0,0,0,0,0,0,1,2,2
11877,DET,1984,Isiah Thomas,22,82,82,3007,669,1448,.462,22,65,.338,647,1383,.468,.470,388,529,.733,103,224,327,914,204,33,307,324,1748
11878,DET,1984,Bill Laimbeer,26,82,82,2864,553,1044,.530,0,11,.000,553,1033,.535,.530,316,365,.866,329,674,1003,149,49,84,151,273,1422
11879,DET,1984,John Long,27,82,82,2514,545,1155,.472,1,5,.200,544,1150,.473,.472,243,275,.884,139,150,289,205,93,18,143,199,1334
11880,DET,1984,Kelly Tripucka,24,76,75,2493,595,1296,.459,2,17,.118,593,1279,.464,.460,426,523,.815,119,187,306,228,65,17,190,190,1618
11881,DET,1984,Vinnie Johnson,27,82,0,1909,426,901,.473,4,19,.211,422,882,.478,.475,207,275,.753,130,107,237,271,44,19,135,196,1063
11882,DET,1984,Cliff Levingston,23,80,24,1746,229,436,.525,0,3,.000,229,433,.529,.525,125,186,.672,234,311,545,109,44,78,77,281,583
11883,DET,1984,Kent Benson,29,82,58,1734,248,451,.550,0,1,.000,248,450,.551,.550,83,101,.822,117,292,409,130,71,53,79,230,579
11884,DET,1984,Terry Tyler,27,82,7,1602,313,691,.453,2,13,.154,311,678,.459,.454,94,132,.712,104,181,285,76,63,59,78,151,722
11885,DET,1984,Earl Cureton,26,73,0,907,81,177,.458,0,1,.000,81,176,.460,.458,31,59,.525,86,201,287,36,24,31,55,143,193
11886,DET,1984,Ray Tolbert,25,49,0,475,64,121,.529,0,1,.000,64,120,.533,.529,23,45,.511,45,53,98,26,12,20,26,88,151
11887,DET,1984,David Thirdkill,23,46,0,291,31,72,.431,0,1,.000,31,71,.437,.431,15,31,.484,9,22,31,27,10,3,19,44,77
11888,DET,1984,Lionel Hollins,30,32,0,216,24,63,.381,0,2,.000,24,61,.393,.381,11,13,.846,4,18,22,62,13,1,24,26,59
11889,DET,1984,Walker Russell,23,16,0,119,14,42,.333,1,2,.500,13,40,.325,.345,12,13,.923,6,13,19,22,4,0,9,25,41
11890,DET,1984,Ken Austin,22,7,0,28,6,13,.462,0,0,,6,13,.462,.462,0,0,,2,1,3,1,1,1,3,7,12
11891,DET,1983,Isiah Thomas,21,81,81,3093,725,1537,.472,36,125,.288,689,1412,.488,.483,368,518,.710,105,223,328,634,199,29,326,318,1854
11892,DET,1983,Bill Laimbeer,25,82,82,2871,436,877,.497,2,13,.154,434,864,.502,.498,245,310,.790,282,711,993,263,51,118,176,320,1119
11893,DET,1983,Terry Tyler,26,82,56,2543,421,880,.478,2,15,.133,419,865,.484,.480,146,196,.745,180,360,540,157,103,160,120,221,990
11894,DET,1983,Vinnie Johnson,26,82,51,2511,520,1013,.513,11,40,.275,509,973,.523,.519,245,315,.778,167,186,353,301,93,49,152,263,1296
11895,DET,1983,Kelly Tripucka,23,58,58,2252,565,1156,.489,14,37,.378,551,1119,.492,.495,392,464,.845,126,138,264,237,67,20,187,157,1536
11896,DET,1983,John Long,26,70,30,1485,312,692,.451,2,7,.286,310,685,.453,.452,111,146,.760,56,124,180,105,44,12,144,130,737
11897,DET,1983,Edgar Jones,26,49,25,1036,145,294,.493,2,6,.333,143,288,.497,.497,117,172,.680,80,191,271,69,28,77,103,160,409
11898,DET,1983,Cliff Levingston,22,62,5,879,131,270,.485,0,1,.000,131,269,.487,.485,84,147,.571,104,128,232,52,23,36,73,125,346
11899,DET,1983,Walker Russell,22,68,1,757,67,184,.364,2,18,.111,65,166,.392,.370,47,58,.810,19,54,73,131,16,1,92,71,183
11900,DET,1983,Tom Owens,33,49,4,725,81,192,.422,0,0,,81,192,.422,.422,45,66,.682,66,120,186,44,12,14,48,115,207
11901,DET,1983,Kent Benson,28,21,15,599,85,182,.467,0,1,.000,85,181,.470,.467,38,50,.760,53,102,155,49,14,17,35,61,208
11902,DET,1983,Ray Tolbert,24,28,0,395,57,124,.460,0,1,.000,57,123,.463,.460,28,59,.475,26,65,91,19,10,23,32,56,142
11903,DET,1983,Ricky Pierce,23,39,1,265,33,88,.375,1,7,.143,32,81,.395,.381,18,32,.563,15,20,35,14,8,4,18,42,85
11904,DET,1983,Scott May,28,9,1,155,21,50,.420,0,0,,21,50,.420,.420,17,21,.810,10,16,26,12,5,2,13,24,59
11905,DET,1983,Jim Johnstone,22,16,0,137,9,20,.450,0,0,,9,20,.450,.450,6,15,.400,11,19,30,10,2,6,11,24,24
11906,DET,1983,James Wilkes,24,9,0,129,11,34,.324,0,1,.000,11,33,.333,.324,12,15,.800,9,10,19,10,3,1,5,22,34
11907,DET,1983,Jim Zoet,29,7,0,30,1,5,.200,0,0,,1,5,.200,.200,0,0,,3,5,8,1,1,3,4,9,2
11908,DET,1983,Jim Smith,24,4,0,18,3,4,.750,0,0,,3,4,.750,.750,2,4,.500,0,5,5,0,0,0,0,4,8
11909,DET,1982,Kelly Tripucka,22,82,82,3077,636,1281,.496,5,22,.227,631,1259,.501,.498,495,621,.797,219,224,443,270,89,16,280,241,1772
11910,DET,1982,Kent Benson,27,75,72,2467,405,802,.505,3,11,.273,402,791,.508,.507,127,158,.804,219,434,653,159,66,98,160,214,940
11911,DET,1982,Isiah Thomas,20,72,72,2433,453,1068,.424,17,59,.288,436,1009,.432,.432,302,429,.704,57,152,209,565,150,17,299,253,1225
11912,DET,1982,John Long,25,69,66,2211,637,1294,.492,2,15,.133,635,1279,.496,.493,238,275,.865,95,162,257,148,65,25,167,173,1514
11913,DET,1982,Terry Tyler,25,82,0,1989,336,643,.523,1,4,.250,335,639,.524,.523,142,192,.740,154,339,493,126,77,160,121,182,815
11914,DET,1982,Ron Lee,29,81,7,1467,88,246,.358,18,59,.305,70,187,.374,.394,84,119,.706,35,120,155,312,116,20,123,221,278
11915,DET,1982,Vinnie Johnson,25,67,15,1191,208,422,.493,3,11,.273,205,411,.499,.496,98,130,.754,75,69,144,160,50,23,91,93,517
11916,DET,1982,Phil Hubbard,25,52,38,1104,207,410,.505,0,3,.000,207,407,.509,.505,106,163,.650,101,171,272,67,38,16,99,176,520
11917,DET,1982,Bill Laimbeer,24,30,30,935,146,283,.516,1,7,.143,145,276,.525,.518,91,112,.813,110,230,340,55,17,34,60,126,384
11918,DET,1982,Edgar Jones,25,48,19,802,142,259,.548,1,2,.500,141,257,.549,.550,90,129,.698,70,137,207,40,28,92,66,149,375
11919,DET,1982,Paul Mokeski,25,39,3,523,49,111,.441,0,1,.000,49,110,.445,.441,25,33,.758,35,87,122,24,13,23,39,103,123
11920,DET,1982,Kenny Carr,26,28,6,444,77,168,.458,0,1,.000,77,167,.461,.458,53,82,.646,53,84,137,23,6,6,40,69,207
11921,DET,1982,Steve Hayes,26,26,0,412,46,93,.495,0,0,,46,93,.495,.495,25,41,.610,32,68,100,24,3,18,17,54,117
11922,DET,1982,Alan Hardy,24,38,0,310,62,136,.456,0,5,.000,62,131,.473,.456,18,29,.621,14,20,34,20,9,4,20,32,142
11923,DET,1982,Jeff Judkins,25,30,0,251,31,81,.383,1,10,.100,30,71,.423,.389,16,26,.615,14,20,34,14,6,5,9,33,79
11924,DET,1982,Greg Kelser,24,11,0,183,35,86,.407,0,3,.000,35,83,.422,.407,27,41,.659,13,26,39,12,5,7,22,32,97
11925,DET,1982,Glenn Hagan,26,4,0,25,3,7,.429,0,0,,3,7,.429,.429,1,1,1.000,2,2,4,8,3,0,1,7,7
11926,DET,1982,Larry Wright,27,1,0,6,0,1,.000,0,0,,0,1,.000,.000,0,0,,0,0,0,0,0,0,1,2,0
11927,DET,1981,Terry Tyler,24,82,,2549,476,895,.532,0,8,.000,476,887,.537,.532,148,250,.592,198,369,567,136,112,180,163,215,1100
11928,DET,1981,Phil Hubbard,24,80,,2289,433,880,.492,1,3,.333,432,877,.493,.493,294,426,.690,236,350,586,150,80,20,229,317,1161
11929,DET,1981,Keith Herron,24,80,,2270,432,954,.453,2,11,.182,430,943,.456,.454,228,267,.854,98,113,211,148,91,26,153,154,1094
11930,DET,1981,Kent Benson,26,59,,1956,364,770,.473,0,4,.000,364,766,.475,.473,196,254,.772,124,276,400,172,72,67,190,184,924
11931,DET,1981,Ron Lee,28,82,,1829,113,323,.350,2,13,.154,111,310,.358,.353,113,156,.724,65,155,220,362,166,29,173,260,341
11932,DET,1981,Paul Mokeski,24,80,,1815,224,458,.489,0,1,.000,224,457,.490,.489,120,200,.600,141,277,418,135,38,73,160,267,568
11933,DET,1981,John Long,24,59,,1750,441,957,.461,2,11,.182,439,946,.464,.462,160,184,.870,95,102,197,106,95,22,151,164,1044
11934,DET,1981,Wayne Robinson,22,81,,1592,234,509,.460,0,6,.000,234,503,.465,.460,175,240,.729,117,177,294,112,46,24,149,186,643
11935,DET,1981,Larry Drew,22,76,,1581,197,484,.407,4,17,.235,193,467,.413,.411,106,133,.797,24,96,120,249,88,7,166,125,504
11936,DET,1981,Larry Wright,26,45,,997,140,303,.462,2,7,.286,138,296,.466,.465,53,66,.803,26,62,88,153,42,7,74,114,335
11937,DET,1981,Greg Kelser,23,25,,654,120,285,.421,0,2,.000,120,283,.424,.421,68,106,.642,53,67,120,45,34,29,78,89,308
11938,DET,1981,Tony Fuller,22,15,,248,24,66,.364,0,1,.000,24,65,.369,.364,12,16,.750,13,29,42,28,10,1,23,25,60
11939,DET,1981,Bob McAdoo,29,6,,168,30,82,.366,0,0,,30,82,.366,.366,12,20,.600,9,32,41,20,8,7,18,16,72
11940,DET,1981,Norman Black,23,3,,28,3,10,.300,0,0,,3,10,.300,.300,2,8,.250,0,2,2,2,1,0,1,2,8
11941,DET,1981,Edmund Lawrence,28,3,,19,5,8,.625,0,0,,5,8,.625,.625,2,4,.500,2,2,4,1,1,0,1,6,12
11942,DET,1981,Lee Johnson,23,2,,10,0,2,.000,0,0,,0,2,.000,.000,0,0,,0,2,2,0,0,0,0,1,0
11943,DET,1980,Terry Tyler,23,82,,2670,430,925,.465,2,12,.167,428,913,.469,.466,143,187,.765,228,399,627,129,107,220,175,237,1005
11944,DET,1980,John Long,23,69,,2364,588,1164,.505,1,12,.083,587,1152,.510,.506,160,194,.825,152,185,337,206,129,26,206,221,1337
11945,DET,1980,Bob McAdoo,28,58,,2097,492,1025,.480,3,24,.125,489,1001,.489,.481,235,322,.730,100,367,467,200,73,65,238,178,1222
11946,DET,1980,Leon Douglas,25,70,,1782,221,455,.486,0,1,.000,221,454,.487,.486,125,185,.676,171,330,501,121,30,62,127,249,567
11947,DET,1980,Eric Money,24,55,,1467,259,510,.508,0,0,,259,510,.508,.508,81,104,.779,28,69,97,238,53,10,143,135,599
11948,DET,1980,Bob Lanier,31,37,,1392,319,584,.546,0,5,.000,319,579,.551,.546,164,210,.781,108,265,373,122,38,60,113,130,802
11949,DET,1980,Terry Duerod,23,67,,1331,282,598,.472,15,53,.283,267,545,.490,.484,45,66,.682,29,69,98,117,41,11,79,102,624
11950,DET,1980,Greg Kelser,22,50,,1233,280,593,.472,3,15,.200,277,578,.479,.475,146,203,.719,124,152,276,108,60,34,140,176,709
11951,DET,1980,Phil Hubbard,23,64,,1189,210,451,.466,0,2,.000,210,449,.468,.466,165,220,.750,114,206,320,70,48,10,120,202,585
11952,DET,1980,Roy Hamilton,22,72,,1116,115,287,.401,0,2,.000,115,285,.404,.401,103,150,.687,45,62,107,192,48,5,118,82,333
11953,DET,1980,Jim McElroy,26,36,,1012,162,356,.455,3,14,.214,159,342,.465,.459,95,119,.798,12,38,50,162,25,14,88,78,422
11954,DET,1980,Ron Lee,27,31,,803,84,214,.393,22,56,.393,62,158,.392,.444,35,53,.660,29,61,90,174,84,13,68,107,225
11955,DET,1980,Kent Benson,25,17,,502,86,187,.460,1,4,.250,85,183,.464,.463,33,44,.750,30,90,120,51,19,18,51,68,206
11956,DET,1980,Earl Evans,24,36,,381,63,140,.450,7,18,.389,56,122,.459,.475,24,42,.571,26,49,75,37,14,1,36,64,157
11957,DET,1980,John Shumate,27,9,,228,35,65,.538,0,0,,35,65,.538,.538,17,25,.680,18,52,70,9,9,5,14,16,87
11958,DET,1980,Steve Malovic,23,10,,162,8,25,.320,0,0,,8,25,.320,.320,10,14,.714,9,19,28,14,2,5,9,16,26
11959,DET,1980,Jackie Robinson,24,7,,51,9,17,.529,0,1,.000,9,16,.563,.529,9,11,.818,3,2,5,0,3,3,2,8,27
11960,MEM,2024,Jaren Jackson Jr.,24,66,66,2124,516,1162,.444,117,366,.320,399,796,.501,.494,337,417,.808,85,280,365,154,80,106,160,235,1486
11961,MEM,2024,Santi Aldama,23,61,35,1618,247,568,.435,106,304,.349,141,264,.534,.528,54,87,.621,72,280,352,138,43,54,69,89,654
11962,MEM,2024,Desmond Bane,25,42,42,1443,360,776,.464,137,360,.381,223,416,.536,.552,140,161,.870,36,149,185,230,43,22,112,120,997
11963,MEM,2024,Vince Williams Jr.,23,52,33,1436,169,379,.446,79,209,.378,90,170,.529,.550,104,130,.800,59,231,290,175,47,34,92,135,521
11964,MEM,2024,GG Jackson II,19,48,18,1233,241,563,.428,102,286,.357,139,277,.502,.519,115,153,.752,53,143,196,59,28,24,65,64,699
11965,MEM,2024,John Konchar,27,55,23,1173,88,208,.423,38,120,.317,50,88,.568,.514,21,25,.840,72,185,257,110,51,51,46,76,235
11966,MEM,2024,David Roddy,22,48,13,1114,155,386,.402,47,156,.301,108,230,.470,.462,46,67,.687,51,149,200,76,25,11,54,68,403
11967,MEM,2024,Ziaire Williams,22,51,15,1038,150,378,.397,58,189,.307,92,189,.487,.474,62,75,.827,35,145,180,75,36,9,66,85,420
11968,MEM,2024,Luke Kennard,27,39,22,999,141,315,.448,107,238,.450,34,77,.442,.617,40,45,.889,11,102,113,136,20,2,54,39,429
11969,MEM,2024,Jake LaRavia,22,35,6,806,118,303,.389,53,156,.340,65,147,.442,.477,90,109,.826,51,77,128,58,29,12,45,69,379
11970,MEM,2024,Bismack Biyombo,31,30,27,718,67,119,.563,0,0,,67,119,.563,.563,22,46,.478,57,134,191,51,10,34,38,82,156
11971,MEM,2024,Xavier Tillman Sr.,25,34,13,700,87,213,.408,12,53,.226,75,160,.469,.437,18,43,.419,56,101,157,57,42,35,29,60,204
11972,MEM,2024,Jacob Gilyard,25,37,14,654,60,144,.417,51,120,.425,9,24,.375,.594,2,2,1.000,8,35,43,131,27,5,29,35,173
11973,MEM,2024,Marcus Smart,29,20,20,605,102,237,.430,42,134,.313,60,103,.583,.519,43,56,.768,6,47,53,86,41,5,62,53,289
11974,MEM,2024,Trey Jemison,24,23,14,572,75,136,.551,0,0,,75,136,.551,.551,21,25,.840,64,69,133,27,12,28,33,69,171
11975,MEM,2024,Scotty Pippen Jr.,23,21,16,527,100,203,.493,30,72,.417,70,131,.534,.567,41,55,.745,22,45,67,98,36,10,56,60,271
11976,MEM,2024,Jordan Goodwin,25,17,12,497,66,189,.349,19,61,.311,47,128,.367,.399,19,30,.633,48,88,136,77,25,9,27,33,170
11977,MEM,2024,Lamar Stevens,26,19,2,437,87,195,.446,11,38,.289,76,157,.484,.474,34,43,.791,24,72,96,20,17,17,15,31,219
11978,MEM,2024,Derrick Rose,35,24,7,399,76,165,.461,15,41,.366,61,124,.492,.506,24,27,.889,7,38,45,78,8,2,31,21,191
11979,MEM,2024,Ja Morant,24,9,9,318,80,170,.471,14,51,.275,66,119,.555,.512,52,64,.813,6,44,50,73,7,5,27,19,226
11980,MEM,2024,Zavier Simpson,26,7,0,161,17,54,.315,5,17,.294,12,37,.324,.361,3,4,.750,4,16,20,25,7,3,10,11,42
11981,MEM,2024,Jaylen Nowell,24,9,1,156,22,55,.400,4,23,.174,18,32,.563,.436,3,3,1.000,3,11,14,16,3,0,5,13,51
11982,MEM,2024,DeJon Jarreau,26,9,0,150,17,50,.340,4,13,.308,13,37,.351,.380,5,11,.455,8,36,44,26,6,2,9,14,43
11983,MEM,2024,Brandon Clarke,27,6,1,134,33,59,.559,1,6,.167,32,53,.604,.568,1,7,.143,13,19,32,9,5,6,3,8,68
11984,MEM,2024,Timmy Allen,24,5,0,125,6,23,.261,0,7,.000,6,16,.375,.261,1,2,.500,4,13,17,5,4,0,2,18,13
11985,MEM,2024,Mãozinha Pereira,23,7,1,122,18,35,.514,5,13,.385,13,22,.591,.586,7,10,.700,11,26,37,2,6,4,5,10,48
11986,MEM,2024,Matthew Hurt,23,8,0,113,12,34,.353,5,20,.250,7,14,.500,.426,3,3,1.000,9,7,16,4,3,3,2,8,32
11987,MEM,2024,Kenneth Lofton Jr.,21,15,0,99,14,37,.378,3,10,.300,11,27,.407,.419,8,15,.533,2,13,15,14,3,3,6,15,39
11988,MEM,2024,Yuta Watanabe,29,5,0,82,6,19,.316,1,10,.100,5,9,.556,.342,0,2,.000,0,9,9,5,3,0,3,5,13
11989,MEM,2024,Wenyen Gabriel,26,5,0,81,8,22,.364,1,6,.167,7,16,.438,.386,0,5,.000,7,18,25,3,2,2,8,10,17
11990,MEM,2024,Tosan Evbuomwan,22,4,0,74,4,15,.267,2,8,.250,2,7,.286,.333,0,0,,8,6,14,6,0,1,1,5,10
11991,MEM,2024,Jack White,26,4,0,64,2,16,.125,2,10,.200,0,6,.000,.188,0,0,,4,8,12,1,4,1,2,3,6
11992,MEM,2024,Shaquille Harrison,30,3,0,6,1,2,.500,0,0,,1,2,.500,.500,0,0,,0,2,2,0,0,1,0,0,2
11993,MEM,2023,Dillon Brooks,27,73,73,2214,392,991,.396,143,439,.326,249,552,.451,.468,120,154,.779,45,199,244,189,65,16,104,240,1047
11994,MEM,2023,Ja Morant,23,61,59,1948,566,1214,.466,92,300,.307,474,914,.519,.504,372,497,.748,61,296,357,493,66,16,206,100,1596
11995,MEM,2023,Tyus Jones,26,80,22,1940,311,710,.438,121,326,.371,190,384,.495,.523,80,100,.800,28,172,200,417,83,6,74,32,823
11996,MEM,2023,Desmond Bane,24,58,58,1841,450,939,.479,166,407,.408,284,532,.534,.568,181,205,.883,43,248,291,254,56,22,126,150,1247
11997,MEM,2023,Jaren Jackson Jr.,23,63,63,1787,416,822,.506,100,282,.355,316,540,.585,.567,241,306,.788,108,318,426,60,65,189,107,227,1173
11998,MEM,2023,Santi Aldama,22,77,20,1682,247,525,.470,94,266,.353,153,259,.591,.560,108,144,.750,85,286,371,97,45,48,60,143,696
11999,MEM,2023,John Konchar,26,72,23,1494,138,320,.431,60,177,.339,78,143,.545,.525,28,36,.778,64,246,310,100,77,25,37,112,364
12000,MEM,2023,David Roddy,21,70,4,1258,180,420,.429,65,212,.307,115,208,.553,.506,41,65,.631,50,143,193,59,29,19,57,107,466
12001,MEM,2023,Xavier Tillman Sr.,24,61,29,1180,188,306,.614,4,15,.267,184,291,.632,.621,49,89,.551,121,186,307,96,58,29,44,97,429
12002,MEM,2023,Steven Adams,29,42,42,1133,157,263,.597,0,1,.000,157,262,.599,.597,47,129,.364,214,271,485,97,36,46,79,98,361
12003,MEM,2023,Brandon Clarke,26,56,8,1090,229,349,.656,1,6,.167,228,343,.665,.658,99,137,.723,92,218,310,72,34,37,55,131,558
12004,MEM,2023,Luke Kennard,26,24,3,590,90,171,.526,74,137,.540,16,34,.471,.743,18,19,.947,9,66,75,54,13,1,16,35,272
12005,MEM,2023,Ziaire Williams,21,37,4,561,84,196,.429,25,97,.258,59,99,.596,.492,17,22,.773,16,63,79,35,14,6,37,58,210
12006,MEM,2023,Jake LaRavia,21,35,0,414,37,95,.389,24,71,.338,13,24,.542,.516,7,9,.778,19,44,63,21,12,4,18,49,105
12007,MEM,2023,Kennedy Chandler,20,36,0,281,35,83,.422,2,15,.133,33,68,.485,.434,6,13,.462,9,29,38,58,12,5,18,15,78
12008,MEM,2023,Kenneth Lofton Jr.,20,24,1,176,49,93,.527,6,17,.353,43,76,.566,.559,16,27,.593,19,32,51,20,5,2,12,28,120
12009,MEM,2023,Vince Williams Jr.,22,15,1,105,12,40,.300,4,28,.143,8,12,.667,.350,2,2,1.000,4,11,15,4,6,2,5,12,30
12010,MEM,2023,Danny Green,35,3,0,43,3,11,.273,3,8,.375,0,3,.000,.409,0,0,,1,3,4,2,1,0,3,6,9
12011,MEM,2023,Jacob Gilyard,24,1,0,41,1,3,.333,1,3,.333,0,0,,.500,0,0,,0,4,4,7,3,0,2,3,3
12012,MEM,2022,Desmond Bane,23,76,76,2266,508,1101,.461,228,523,.436,280,578,.484,.565,140,155,.903,46,288,334,208,92,29,111,196,1384
12013,MEM,2022,Jaren Jackson Jr.,22,78,78,2126,430,1036,.415,128,401,.319,302,635,.476,.477,284,345,.823,119,335,454,86,73,177,130,272,1272
12014,MEM,2022,Steven Adams,28,76,75,1999,210,384,.547,0,1,.000,210,383,.548,.547,108,199,.543,349,411,760,256,65,60,115,153,528
12015,MEM,2022,Ja Morant,22,57,57,1889,580,1177,.493,88,256,.344,492,921,.534,.530,316,415,.761,77,248,325,384,66,22,196,86,1564
12016,MEM,2022,De'Anthony Melton,23,73,15,1657,281,695,.404,139,372,.374,142,323,.440,.504,90,120,.750,64,264,328,194,104,39,112,128,791
12017,MEM,2022,Tyus Jones,25,73,23,1549,249,552,.451,80,205,.390,169,347,.487,.524,54,66,.818,17,159,176,324,66,2,46,32,632
12018,MEM,2022,Kyle Anderson,28,69,11,1484,209,469,.446,36,109,.330,173,360,.481,.484,67,105,.638,69,299,368,183,77,45,71,108,521
12019,MEM,2022,Ziaire Williams,20,62,31,1346,191,424,.450,76,242,.314,115,182,.632,.540,43,55,.782,26,103,129,65,35,12,41,113,501
12020,MEM,2022,John Konchar,25,72,7,1292,135,262,.515,52,126,.413,83,136,.610,.615,27,49,.551,87,242,329,109,45,22,29,90,349
12021,MEM,2022,Brandon Clarke,25,64,1,1246,288,447,.644,5,22,.227,283,425,.666,.650,85,130,.654,135,207,342,86,39,68,34,122,666
12022,MEM,2022,Dillon Brooks,26,32,31,885,227,526,.432,46,149,.309,181,377,.480,.475,90,106,.849,29,73,102,88,36,8,50,105,590
12023,MEM,2022,Xavier Tillman Sr.,23,53,2,701,98,216,.454,10,49,.204,88,167,.527,.477,46,71,.648,66,95,161,62,49,15,34,63,252
12024,MEM,2022,Killian Tillie,23,36,3,461,43,127,.339,27,86,.314,16,41,.390,.445,5,8,.625,21,39,60,22,23,15,13,58,118
12025,MEM,2022,Santi Aldama,21,32,0,360,53,132,.402,6,48,.125,47,84,.560,.424,20,32,.625,33,54,87,21,6,10,16,36,132
12026,MEM,2022,Jarrett Culver,22,37,0,338,51,135,.378,12,47,.255,39,88,.443,.422,16,34,.471,13,35,48,33,20,5,20,42,130
12027,MEM,2022,Yves Pons,22,12,0,71,5,16,.313,3,9,.333,2,7,.286,.406,0,2,.000,5,7,12,1,1,4,1,6,13
12028,MEM,2022,Sam Merrill,25,6,0,58,8,24,.333,7,23,.304,1,1,1.000,.479,2,4,.500,1,6,7,4,0,0,2,3,25
12029,MEM,2022,Dakota Mathias,26,6,0,16,2,6,.333,2,6,.333,0,0,,.500,0,0,,0,2,2,1,1,0,0,1,6
12030,MEM,2022,Shaq Buchanan,25,2,0,10,1,4,.250,0,2,.000,1,2,.500,.250,0,0,,1,1,2,2,1,0,2,1,2
12031,MEM,2022,DaQuan Jeffries,24,3,0,9,1,2,.500,0,1,.000,1,1,1.000,.500,0,0,,0,2,2,1,0,0,0,1,2
12032,MEM,2022,Xavier Sneed,24,2,0,8,0,2,.000,0,2,.000,0,0,,.000,0,0,,1,1,2,0,0,0,0,2,0
12033,MEM,2022,Jon Teske,24,3,0,8,0,1,.000,0,0,,0,1,.000,.000,0,2,.000,0,2,2,1,1,0,0,1,0
12034,MEM,2022,Tyrell Terry,21,2,0,3,1,1,1.000,0,0,,1,1,1.000,1.000,0,0,,0,0,0,0,0,0,0,1,2
12035,MEM,2021,Ja Morant,21,63,63,2053,430,957,.449,73,241,.303,357,716,.499,.487,271,372,.728,59,193,252,465,57,13,203,87,1204
12036,MEM,2021,Dillon Brooks,25,67,67,1997,432,1031,.419,128,372,.344,304,659,.461,.481,159,195,.815,53,143,196,157,78,26,119,237,1151
12037,MEM,2021,Kyle Anderson,27,69,69,1887,308,658,.468,94,261,.360,214,397,.539,.540,144,184,.783,52,344,396,250,84,57,86,120,854
12038,MEM,2021,Jonas Valančiūnas,28,62,61,1755,440,743,.592,21,57,.368,419,686,.611,.606,157,203,.773,253,523,776,112,35,57,100,179,1058
12039,MEM,2021,Desmond Bane,22,68,17,1519,234,499,.469,117,271,.432,117,228,.513,.586,40,49,.816,31,179,210,118,41,16,59,125,625
12040,MEM,2021,Brandon Clarke,24,59,16,1415,256,495,.517,20,77,.260,236,418,.565,.537,78,113,.690,97,231,328,95,60,51,33,84,610
12041,MEM,2021,Grayson Allen,25,50,38,1259,173,414,.418,107,274,.391,66,140,.471,.547,79,91,.868,19,141,160,108,46,8,48,71,532
12042,MEM,2021,Tyus Jones,24,70,9,1222,178,413,.431,45,140,.321,133,273,.487,.485,41,45,.911,21,119,140,259,64,6,48,31,442
12043,MEM,2021,Xavier Tillman Sr.,22,59,12,1085,167,299,.559,22,65,.338,145,234,.620,.595,34,53,.642,74,182,256,75,44,33,45,116,390
12044,MEM,2021,De'Anthony Melton,22,52,1,1045,172,393,.438,87,211,.412,85,182,.467,.548,41,51,.804,30,131,161,132,60,31,66,85,472
12045,MEM,2021,John Konchar,24,43,0,575,69,138,.500,21,56,.375,48,82,.585,.576,25,30,.833,35,93,128,47,30,9,18,40,184
12046,MEM,2021,Justise Winslow,24,26,1,507,74,210,.352,10,54,.185,64,156,.410,.376,20,35,.571,18,100,118,50,15,12,37,47,178
12047,MEM,2021,Gorgui Dieng,31,22,1,371,56,108,.519,23,48,.479,33,60,.550,.625,38,43,.884,28,70,98,29,17,14,22,38,173
12048,MEM,2021,Jaren Jackson Jr.,21,11,4,258,53,125,.424,17,60,.283,36,65,.554,.492,35,42,.833,17,45,62,12,12,18,15,42,158
12049,MEM,2021,Killian Tillie,22,18,1,182,19,57,.333,10,33,.303,9,24,.375,.421,9,11,.818,6,18,24,8,5,8,2,20,57
12050,MEM,2021,Sean McDermott,24,18,0,158,13,33,.394,5,22,.227,8,11,.727,.470,8,8,1.000,6,13,19,4,2,3,4,8,39
12051,MEM,2021,Tim Frazier,30,5,0,62,3,20,.150,0,8,.000,3,12,.250,.150,2,6,.333,0,8,8,16,2,1,4,7,8
12052,MEM,2021,Jontay Porter,21,11,0,54,8,15,.533,3,8,.375,5,7,.714,.633,3,5,.600,4,10,14,1,3,1,7,12,22
12053,MEM,2020,Dillon Brooks,24,73,73,2112,435,1068,.407,147,411,.358,288,657,.438,.476,164,203,.808,68,175,243,150,63,27,124,278,1181
12054,MEM,2020,Ja Morant,20,67,67,2074,447,937,.477,60,179,.335,387,758,.511,.509,239,308,.776,51,208,259,488,58,18,220,110,1193
12055,MEM,2020,Jonas Valančiūnas,27,70,70,1845,432,739,.585,32,91,.352,400,648,.617,.606,148,200,.740,213,575,788,131,30,76,127,185,1044
12056,MEM,2020,Jaren Jackson Jr.,20,57,57,1622,353,753,.469,145,368,.394,208,385,.540,.565,139,186,.747,55,207,262,78,40,92,99,232,990
12057,MEM,2020,Kyle Anderson,26,67,28,1330,157,331,.474,24,85,.282,133,246,.541,.511,52,78,.667,58,227,285,162,54,37,66,111,390
12058,MEM,2020,Jae Crowder,29,45,45,1322,147,399,.368,78,266,.293,69,133,.519,.466,75,95,.789,40,237,277,125,47,14,54,85,447
12059,MEM,2020,Brandon Clarke,23,58,4,1300,296,479,.618,23,64,.359,273,415,.658,.642,85,112,.759,92,253,345,81,32,48,55,100,700
12060,MEM,2020,Tyus Jones,23,65,6,1232,197,429,.459,47,124,.379,150,305,.492,.514,43,58,.741,9,94,103,285,59,6,55,44,484
12061,MEM,2020,De'Anthony Melton,21,60,8,1167,161,401,.401,40,140,.286,121,261,.464,.451,93,121,.769,43,177,220,175,77,20,84,109,455
12062,MEM,2020,Solomon Hill,28,48,3,901,96,233,.412,56,147,.381,40,86,.465,.532,26,38,.684,24,120,144,94,31,7,40,73,274
12063,MEM,2020,Grayson Allen,24,38,0,718,117,251,.466,57,141,.404,60,110,.545,.580,39,45,.867,8,77,85,52,10,2,33,53,330
12064,MEM,2020,Marko Gudurić,24,44,0,484,62,157,.395,25,83,.301,37,74,.500,.475,24,26,.923,14,59,73,45,12,8,36,34,173
12065,MEM,2020,Josh Jackson,22,22,0,381,70,159,.440,23,72,.319,47,87,.540,.513,35,50,.700,11,55,66,35,18,9,28,40,198
12066,MEM,2020,Gorgui Dieng,30,17,0,318,42,87,.483,8,32,.250,34,55,.618,.529,31,42,.738,18,80,98,15,14,17,16,35,123
12067,MEM,2020,Anthony Tolliver,34,13,4,236,19,48,.396,17,41,.415,2,7,.286,.573,7,8,.875,5,28,33,10,7,1,9,14,62
12068,MEM,2020,Bruno Caboclo,24,22,0,192,28,69,.406,4,25,.160,24,44,.545,.435,2,3,.667,17,27,44,10,10,12,7,23,62
12069,MEM,2020,John Konchar,23,19,0,181,24,37,.649,5,10,.500,19,27,.704,.716,1,2,.500,18,29,47,22,7,3,7,7,54
12070,MEM,2020,Yuta Watanabe,25,18,0,105,15,34,.441,3,8,.375,12,26,.462,.485,3,8,.375,7,13,20,5,5,1,2,9,36
12071,MEM,2020,Jordan Bell,25,2,0,21,3,7,.429,2,3,.667,1,4,.250,.571,2,2,1.000,2,1,3,2,1,0,3,2,10
12072,MEM,2020,Jarrod Uthoff,26,4,0,14,1,7,.143,0,4,.000,1,3,.333,.143,2,2,1.000,1,0,1,0,1,0,0,1,4
12073,MEM,2020,Dusty Hannahs,26,2,0,13,4,9,.444,2,3,.667,2,6,.333,.556,2,2,1.000,0,1,1,0,0,0,0,1,12
12074,MEM,2019,Mike Conley,31,70,70,2342,490,1120,.438,155,426,.364,335,694,.483,.507,343,406,.845,40,199,239,449,94,22,130,123,1478
12075,MEM,2019,Marc Gasol,34,53,53,1788,303,683,.444,76,221,.344,227,462,.491,.499,152,201,.756,56,399,455,248,60,63,119,147,834
12076,MEM,2019,Garrett Temple,32,49,49,1530,166,387,.429,74,210,.352,92,177,.520,.525,57,76,.750,18,134,152,69,50,25,54,134,463
12077,MEM,2019,Jaren Jackson Jr.,19,58,56,1515,298,589,.506,51,142,.359,247,447,.553,.549,151,197,.766,73,199,272,64,52,82,98,220,798
12078,MEM,2019,Justin Holiday,29,44,39,1282,149,383,.389,65,195,.333,84,188,.447,.474,54,60,.900,27,127,154,61,54,15,57,85,417
12079,MEM,2019,Kyle Anderson,25,43,40,1281,150,276,.543,9,34,.265,141,242,.583,.560,37,64,.578,48,203,251,128,54,37,58,112,346
12080,MEM,2019,Shelvin Mack,28,53,3,1204,161,389,.414,46,128,.359,115,261,.441,.473,53,75,.707,18,84,102,182,45,4,62,81,421
12081,MEM,2019,JaMychal Green,28,41,4,900,151,312,.484,38,96,.396,113,216,.523,.545,63,80,.788,72,180,252,36,33,26,64,123,403
12082,MEM,2019,Delon Wright,26,26,11,802,115,265,.434,20,78,.256,95,187,.508,.472,66,89,.742,29,112,141,138,42,15,40,50,316
12083,MEM,2019,Bruno Caboclo,23,34,19,800,96,225,.427,48,130,.369,48,95,.505,.533,42,50,.840,42,116,158,50,14,33,38,81,282
12084,MEM,2019,Ivan Rabb,21,49,13,721,116,212,.547,3,15,.200,113,197,.574,.554,49,69,.710,70,136,206,54,17,14,35,90,284
12085,MEM,2019,Joakim Noah,33,42,1,693,110,213,.516,0,1,.000,110,212,.519,.516,78,109,.716,58,180,238,89,20,31,50,96,298
12086,MEM,2019,Jevon Carter,23,39,3,577,56,185,.303,34,102,.333,22,83,.265,.395,26,32,.813,14,52,66,69,26,11,33,55,172
12087,MEM,2019,Jonas Valančiūnas,26,19,17,527,152,279,.545,5,18,.278,147,261,.563,.554,70,91,.769,52,151,203,41,6,30,51,64,379
12088,MEM,2019,Omri Casspi,30,36,0,520,86,161,.534,15,43,.349,71,118,.602,.581,39,58,.672,17,98,115,26,20,9,23,35,226
12089,MEM,2019,Chandler Parsons,30,25,3,496,68,182,.374,29,94,.309,39,88,.443,.453,22,25,.880,4,66,70,43,19,5,32,45,187
12090,MEM,2019,Wayne Selden,24,32,0,455,65,161,.404,20,63,.317,45,98,.459,.466,22,29,.759,16,28,44,36,10,6,23,48,172
12091,MEM,2019,Tyler Dorsey,22,21,11,447,75,175,.429,34,93,.366,41,82,.500,.526,22,35,.629,18,52,70,39,7,1,17,33,206
12092,MEM,2019,Avery Bradley,28,14,14,442,87,188,.463,28,73,.384,59,115,.513,.537,23,25,.920,8,36,44,56,14,0,28,34,225
12093,MEM,2019,MarShon Brooks,30,29,0,387,76,169,.450,15,54,.278,61,115,.530,.494,23,33,.697,12,33,45,25,9,4,21,33,190
12094,MEM,2019,Dillon Brooks,23,18,0,330,49,122,.402,15,40,.375,34,82,.415,.463,22,30,.733,9,22,31,16,10,4,19,50,135
12095,MEM,2019,C.J. Miles,31,13,0,294,42,105,.400,24,66,.364,18,39,.462,.514,13,14,.929,1,26,27,14,8,5,9,17,121
12096,MEM,2019,Julian Washburn,27,18,3,254,16,48,.333,5,24,.208,11,24,.458,.385,3,4,.750,8,33,41,14,13,2,7,16,40
12097,MEM,2019,Yuta Watanabe,24,15,0,174,15,51,.294,2,16,.125,13,35,.371,.314,7,10,.700,4,27,31,8,4,1,6,11,39
12098,MEM,2019,Tyler Zeller,29,4,1,82,16,28,.571,0,0,,16,28,.571,.571,14,18,.778,9,9,18,3,1,3,4,16,46
12099,MEM,2019,Dusty Hannahs,25,2,0,26,3,12,.250,0,5,.000,3,7,.429,.250,2,2,1.000,0,1,1,5,1,0,1,1,8
12100,MEM,2019,D.J. Stephens,28,1,0,7,1,2,.500,0,0,,1,2,.500,.500,0,0,,0,0,0,0,1,0,1,0,2
12101,MEM,2019,Andrew Harrison,24,1,0,5,1,2,.500,0,1,.000,1,1,1.000,.500,0,0,,0,0,0,0,0,0,0,1,2
12102,MEM,2018,Marc Gasol,33,73,73,2408,434,1033,.420,109,320,.341,325,713,.456,.473,281,337,.834,78,514,592,305,54,101,194,185,1258
12103,MEM,2018,Dillon Brooks,22,82,74,2350,340,772,.440,94,264,.356,246,508,.484,.501,124,166,.747,49,208,257,135,73,17,124,233,898
12104,MEM,2018,Jarell Martin,23,73,36,1661,221,496,.446,34,98,.347,187,398,.470,.480,89,116,.767,97,221,318,73,39,49,86,211,565
12105,MEM,2018,Tyreke Evans,28,52,32,1607,366,809,.452,114,286,.399,252,523,.482,.523,164,209,.785,44,221,265,269,57,17,117,96,1010
12106,MEM,2018,JaMychal Green,27,55,54,1542,223,488,.457,43,127,.339,180,361,.499,.501,80,111,.721,147,317,464,79,32,25,76,153,569
12107,MEM,2018,Mario Chalmers,31,66,10,1421,168,443,.379,53,191,.277,115,252,.456,.439,118,138,.855,13,144,157,197,79,14,117,179,507
12108,MEM,2018,Andrew Harrison,23,56,46,1326,181,429,.422,47,142,.331,134,287,.467,.477,124,159,.780,23,108,131,177,38,26,81,138,533
12109,MEM,2018,Ben McLemore,24,56,17,1091,157,373,.421,55,159,.346,102,214,.477,.495,53,64,.828,34,105,139,51,38,15,61,139,422
12110,MEM,2018,James Ennis III,27,45,14,1053,108,222,.486,30,84,.357,78,138,.565,.554,64,73,.877,53,104,157,49,32,12,38,81,310
12111,MEM,2018,Deyonta Davis,21,62,6,943,161,265,.608,0,0,,161,265,.608,.608,38,57,.667,75,175,250,40,15,39,32,125,360
12112,MEM,2018,Wayne Selden,23,35,9,692,116,269,.431,49,122,.402,67,147,.456,.522,44,59,.746,16,40,56,66,18,5,54,59,325
12113,MEM,2018,Chandler Parsons,29,36,8,691,108,234,.462,51,121,.421,57,113,.504,.571,17,27,.630,14,76,90,69,18,11,35,53,284
12114,MEM,2018,Kobi Simmons,20,32,12,643,80,189,.423,11,39,.282,69,150,.460,.452,25,25,1.000,14,36,50,68,18,5,44,61,196
12115,MEM,2018,Ivan Rabb,20,36,5,516,86,152,.566,0,0,,86,152,.566,.566,29,36,.806,53,105,158,32,12,13,35,55,201
12116,MEM,2018,Myke Henry,25,20,0,378,41,109,.376,19,58,.328,22,51,.431,.463,6,10,.600,10,28,38,22,31,6,19,28,107
12117,MEM,2018,Mike Conley,30,12,12,373,64,168,.381,24,77,.312,40,91,.440,.452,53,66,.803,0,27,27,49,12,3,18,24,205
12118,MEM,2018,Brandan Wright,30,27,1,366,57,99,.576,0,0,,57,99,.576,.576,21,33,.636,32,61,93,13,13,25,8,29,135
12119,MEM,2018,MarShon Brooks,29,7,1,193,51,102,.500,19,32,.594,32,70,.457,.593,20,23,.870,8,13,21,25,11,3,16,6,141
12120,MEM,2018,Briante Weber,25,5,0,119,10,21,.476,0,2,.000,10,19,.526,.476,4,6,.667,5,12,17,9,8,2,8,10,24
12121,MEM,2018,Xavier Rathan-Mayes,23,5,0,118,12,42,.286,1,14,.071,11,28,.393,.298,4,9,.444,0,5,5,18,6,3,11,18,29
12122,MEM,2018,Omari Johnson,28,4,0,75,9,21,.429,4,12,.333,5,9,.556,.524,0,0,,4,7,11,7,2,0,3,6,22
12123,MEM,2018,Marquis Teague,24,3,0,74,4,16,.250,1,4,.250,3,12,.250,.281,2,5,.400,1,5,6,13,4,0,3,5,11
12124,MEM,2018,Brice Johnson,23,9,0,60,13,31,.419,0,0,,13,31,.419,.419,1,3,.333,7,11,18,1,3,4,1,6,27
12125,MEM,2018,Vince Hunter,23,4,0,7,3,5,.600,0,0,,3,5,.600,.600,0,0,,2,1,3,0,0,1,1,0,6
12126,MEM,2017,Marc Gasol,32,74,74,2531,532,1160,.459,104,268,.388,428,892,.480,.503,278,332,.837,60,404,464,338,67,99,166,171,1446
12127,MEM,2017,Mike Conley,29,69,68,2292,464,1009,.460,171,419,.408,293,590,.497,.545,316,368,.859,31,210,241,433,92,19,156,126,1415
12128,MEM,2017,JaMychal Green,26,77,75,2101,250,500,.500,55,145,.379,195,355,.549,.555,134,167,.802,167,377,544,84,47,34,94,248,689
12129,MEM,2017,Tony Allen,35,71,66,1914,274,595,.461,15,54,.278,259,541,.479,.473,80,130,.615,166,225,391,98,115,29,100,178,643
12130,MEM,2017,Vince Carter,40,73,15,1799,193,490,.394,112,296,.378,81,194,.418,.508,88,115,.765,36,191,227,133,60,36,50,163,586
12131,MEM,2017,Zach Randolph,35,73,5,1786,433,964,.449,21,94,.223,412,870,.474,.460,141,193,.731,182,416,598,122,38,10,99,136,1028
12132,MEM,2017,James Ennis III,26,64,28,1501,146,321,.455,51,137,.372,95,184,.516,.534,86,110,.782,69,190,259,64,46,19,59,165,429
12133,MEM,2017,Andrew Harrison,22,72,18,1474,117,360,.325,43,156,.276,74,204,.363,.385,148,194,.763,23,113,136,198,53,21,85,194,425
12134,MEM,2017,Troy Daniels,25,67,3,1183,185,495,.374,138,355,.389,47,140,.336,.513,43,54,.796,22,78,100,46,20,4,45,90,551
12135,MEM,2017,Chandler Parsons,28,34,34,675,75,222,.338,25,93,.269,50,129,.388,.394,35,43,.814,6,78,84,55,20,5,24,52,210
12136,MEM,2017,Jarell Martin,22,42,3,558,58,151,.384,9,25,.360,49,126,.389,.414,40,50,.800,42,120,162,8,17,9,28,91,165
12137,MEM,2017,Brandan Wright,29,28,5,447,83,135,.615,0,1,.000,83,134,.619,.615,23,35,.657,31,47,78,15,11,20,10,42,189
12138,MEM,2017,Troy Williams,22,24,13,418,51,123,.415,10,41,.244,41,82,.500,.455,15,25,.600,6,39,45,19,24,9,26,42,127
12139,MEM,2017,Wade Baldwin,20,33,1,405,36,115,.313,3,22,.136,33,93,.355,.326,31,37,.838,11,35,46,61,18,7,39,40,106
12140,MEM,2017,Toney Douglas,30,24,0,394,43,117,.368,7,42,.167,36,75,.480,.397,24,29,.828,13,48,61,56,18,5,21,50,117
12141,MEM,2017,Deyonta Davis,20,36,0,238,24,47,.511,0,0,,24,47,.511,.511,10,18,.556,20,40,60,2,3,17,8,40,58
12142,MEM,2017,Wayne Selden,22,11,2,189,20,50,.400,3,21,.143,17,29,.586,.430,12,18,.667,1,10,11,12,4,1,9,12,55
12143,MEM,2016,Matt Barnes,35,76,45,2190,264,693,.381,119,370,.322,145,323,.449,.467,111,138,.804,84,336,420,163,78,57,121,234,758
12144,MEM,2016,Zach Randolph,34,68,53,2016,431,907,.475,6,26,.231,425,881,.482,.479,172,216,.796,179,350,529,142,43,13,105,146,1040
12145,MEM,2016,Marc Gasol,31,52,52,1791,328,707,.464,2,3,.667,326,704,.463,.465,203,245,.829,58,304,362,196,50,70,118,141,861
12146,MEM,2016,Mike Conley,28,56,56,1761,294,696,.422,78,215,.363,216,481,.449,.478,191,229,.834,26,138,164,342,67,16,84,100,857
12147,MEM,2016,Tony Allen,34,64,57,1620,215,469,.458,15,42,.357,200,427,.468,.474,90,138,.652,104,192,296,70,110,18,78,175,535
12148,MEM,2016,Jeff Green,29,53,31,1544,240,557,.431,42,136,.309,198,421,.470,.469,124,155,.800,55,186,241,98,40,19,69,102,646
12149,MEM,2016,Courtney Lee,30,51,37,1489,192,419,.458,51,138,.370,141,281,.502,.519,76,92,.826,19,99,118,76,52,16,49,79,511
12150,MEM,2016,JaMychal Green,25,78,15,1446,230,495,.465,15,45,.333,215,450,.478,.480,103,137,.752,139,234,373,67,46,33,83,189,578
12151,MEM,2016,Mario Chalmers,29,55,7,1253,172,412,.417,45,138,.326,127,274,.464,.472,206,249,.827,23,120,143,211,80,12,101,165,595
12152,MEM,2016,Vince Carter,39,60,3,1005,133,343,.388,59,169,.349,74,174,.425,.474,70,84,.833,31,115,146,56,38,16,35,101,395
12153,MEM,2016,Lance Stephenson,25,26,3,692,146,308,.474,11,31,.355,135,277,.487,.492,66,81,.815,21,94,115,73,19,6,46,56,369
12154,MEM,2016,Ryan Hollins,31,32,9,412,45,72,.625,0,0,,45,72,.625,.625,26,42,.619,40,47,87,10,6,20,21,58,116
12155,MEM,2016,Jarell Martin,21,27,0,380,54,116,.466,0,2,.000,54,114,.474,.466,45,62,.726,39,47,86,15,8,7,19,58,153
12156,MEM,2016,P.J. Hairston,23,18,9,375,46,132,.348,16,69,.232,30,63,.476,.409,16,22,.727,7,39,46,9,8,4,17,31,124
12157,MEM,2016,Chris Andersen,37,20,14,366,34,62,.548,2,9,.222,32,53,.604,.565,22,32,.688,33,56,89,9,14,10,7,25,92
12158,MEM,2016,Jordan Farmar,29,12,10,291,42,100,.420,16,45,.356,26,55,.473,.500,10,10,1.000,4,21,25,37,15,2,18,22,110
12159,MEM,2016,Xavier Munford,23,14,0,244,32,77,.416,9,23,.391,23,54,.426,.474,7,14,.500,3,28,31,22,13,3,15,25,80
12160,MEM,2016,Ray McCallum,24,10,3,219,28,79,.354,10,26,.385,18,53,.340,.418,3,5,.600,2,14,16,27,7,3,13,15,69
12161,MEM,2016,Brandan Wright,28,12,2,212,35,52,.673,0,0,,35,52,.673,.673,13,24,.542,14,29,43,6,5,15,10,21,83
12162,MEM,2016,Briante Weber,23,6,4,166,13,38,.342,0,5,.000,13,33,.394,.342,3,4,.750,8,16,24,20,9,3,9,11,29
12163,MEM,2016,Beno Udrih,33,8,0,120,20,46,.435,4,11,.364,16,35,.457,.478,3,3,1.000,2,7,9,26,3,1,11,11,47
12164,MEM,2016,Russ Smith,24,15,0,66,7,22,.318,1,5,.200,6,17,.353,.341,8,13,.615,1,8,9,11,5,1,7,5,23
12165,MEM,2016,Alex Stepheson,28,4,0,61,8,26,.308,0,0,,8,26,.308,.308,4,10,.400,18,8,26,2,1,3,0,8,20
12166,MEM,2016,Elliot Williams,26,5,0,45,2,10,.200,1,4,.250,1,6,.167,.250,3,4,.750,1,3,4,4,0,0,1,2,8
12167,MEM,2016,James Ennis III,25,10,0,40,4,13,.308,2,8,.250,2,5,.400,.385,6,10,.600,4,3,7,2,4,2,2,1,16
12168,MEM,2016,Jordan Adams,21,2,0,15,2,6,.333,0,1,.000,2,5,.400,.333,3,5,.600,0,2,2,3,3,0,2,2,7
12169,MEM,2016,Bryce Cotton,23,5,0,6,2,2,1.000,0,0,,2,2,1.000,1.000,0,0,,0,0,0,0,0,0,0,0,4
12170,MEM,2016,Jarnell Stokes,22,2,0,4,0,0,,0,0,,0,0,,,0,0,,1,1,2,0,0,0,0,0,0
12171,MEM,2015,Marc Gasol,30,81,81,2687,530,1072,.494,3,17,.176,527,1055,.500,.496,350,440,.795,115,515,630,307,70,131,176,208,1413
12172,MEM,2015,Courtney Lee,29,77,74,2354,288,643,.448,90,224,.402,198,419,.473,.518,111,129,.860,21,157,178,151,75,12,78,129,777
12173,MEM,2015,Zach Randolph,33,71,71,2304,454,932,.487,7,20,.350,447,912,.490,.491,228,298,.765,225,522,747,153,69,14,156,175,1143
12174,MEM,2015,Mike Conley,27,70,70,2225,393,882,.446,107,277,.386,286,605,.473,.506,214,249,.859,29,180,209,375,89,14,156,139,1107
12175,MEM,2015,Tony Allen,33,63,41,1648,225,455,.495,10,29,.345,215,426,.505,.505,79,126,.627,103,177,280,86,129,30,86,166,539
12176,MEM,2015,Beno Udrih,32,79,12,1494,246,505,.487,26,97,.268,220,408,.539,.513,87,102,.853,20,123,143,220,46,8,89,88,605
12177,MEM,2015,Jeff Green,28,45,37,1361,210,492,.427,50,138,.362,160,354,.452,.478,118,143,.825,43,144,187,81,26,21,52,81,588
12178,MEM,2015,Kosta Koufos,25,81,3,1348,182,358,.508,0,0,,182,358,.508,.508,55,85,.647,121,305,426,37,29,63,69,148,419
12179,MEM,2015,Vince Carter,38,66,1,1091,135,406,.333,69,232,.297,66,174,.379,.417,45,57,.789,27,106,133,79,43,14,43,102,384
12180,MEM,2015,Nick Calathes,25,58,0,838,104,247,.421,11,43,.256,93,204,.456,.443,24,45,.533,19,87,106,146,63,5,61,100,243
12181,MEM,2015,Jon Leuer,25,63,6,824,121,273,.443,7,29,.241,114,244,.467,.456,37,59,.627,50,157,207,46,17,9,35,86,286
12182,MEM,2015,Tayshaun Prince,34,26,9,628,75,183,.410,15,33,.455,60,150,.400,.451,25,30,.833,21,62,83,37,9,6,15,22,190
12183,MEM,2015,Quincy Pondexter,26,30,2,540,48,135,.356,17,73,.233,31,62,.500,.419,21,30,.700,20,37,57,28,5,5,10,47,134
12184,MEM,2015,Jordan Adams,20,30,0,248,35,86,.407,10,25,.400,25,61,.410,.465,14,23,.609,9,19,28,16,16,7,14,24,94
12185,MEM,2015,JaMychal Green,24,20,1,139,23,40,.575,0,4,.000,23,36,.639,.575,8,10,.800,16,23,39,4,5,3,12,19,54
12186,MEM,2015,Jarnell Stokes,21,19,2,126,21,37,.568,0,0,,21,37,.568,.568,15,28,.536,16,18,34,4,5,5,7,25,57
12187,MEM,2015,Russ Smith,23,6,0,36,6,15,.400,1,5,.200,5,10,.500,.433,12,13,.923,1,2,3,6,3,0,5,7,25
12188,MEM,2015,Tyrus Thomas,28,2,0,7,1,1,1.000,0,0,,1,1,1.000,1.000,2,2,1.000,0,0,0,1,0,0,0,0,4
12189,MEM,2015,Kalin Lucas,25,1,0,6,0,1,.000,0,0,,0,1,.000,.000,0,0,,0,0,0,0,1,0,0,1,0
12190,MEM,2014,Zach Randolph,32,79,79,2705,560,1198,.467,2,20,.100,558,1178,.474,.468,250,337,.742,265,530,795,200,54,23,183,210,1372
12191,MEM,2014,Mike Conley,26,73,73,2446,463,1030,.450,105,291,.361,358,739,.484,.500,225,276,.815,41,172,213,441,110,13,150,141,1256
12192,MEM,2014,Marc Gasol,29,59,59,1970,336,711,.473,2,11,.182,334,700,.477,.474,185,241,.768,84,340,424,215,59,76,111,150,859
12193,MEM,2014,Tayshaun Prince,33,76,76,1948,200,492,.407,20,69,.290,180,423,.426,.427,34,60,.567,32,202,234,119,39,19,41,63,454
12194,MEM,2014,Mike Miller,33,82,4,1707,213,443,.481,107,233,.459,106,210,.505,.602,46,56,.821,30,177,207,130,26,5,77,95,579
12195,MEM,2014,Courtney Lee,28,49,47,1469,205,431,.476,49,142,.345,156,289,.540,.532,81,90,.900,21,117,138,83,45,19,48,90,540
12196,MEM,2014,Kosta Koufos,24,80,22,1349,227,459,.495,0,0,,227,459,.495,.495,60,93,.645,160,258,418,39,32,71,67,182,514
12197,MEM,2014,Tony Allen,32,55,28,1278,204,413,.494,11,47,.234,193,366,.527,.507,76,121,.628,79,129,208,94,90,19,90,121,495
12198,MEM,2014,Nick Calathes,24,71,7,1173,142,311,.457,19,61,.311,123,250,.492,.487,44,72,.611,23,114,137,207,66,8,101,117,347
12199,MEM,2014,Ed Davis,24,63,4,956,155,290,.534,0,0,,155,290,.534,.534,47,89,.528,92,168,260,27,17,43,40,114,357
12200,MEM,2014,James Johnson,26,52,4,956,143,308,.464,22,87,.253,121,221,.548,.500,76,90,.844,60,106,166,111,42,57,66,102,384
12201,MEM,2014,Jerryd Bayless,25,31,5,650,90,239,.377,25,83,.301,65,156,.417,.429,45,57,.789,8,51,59,66,20,5,22,72,250
12202,MEM,2014,Jon Leuer,24,49,0,642,121,246,.492,23,49,.469,98,197,.497,.539,37,47,.787,37,121,158,20,18,13,27,63,302
12203,MEM,2014,Quincy Pondexter,25,15,2,270,31,79,.392,11,34,.324,20,45,.444,.462,21,26,.808,10,16,26,20,5,1,15,18,94
12204,MEM,2014,Jamaal Franklin,22,21,0,161,16,39,.410,5,11,.455,11,28,.393,.474,2,2,1.000,4,19,23,6,4,2,11,23,39
12205,MEM,2014,Darius Morris,23,5,0,66,6,16,.375,2,7,.286,4,9,.444,.438,1,3,.333,4,4,8,8,3,0,6,3,15
12206,MEM,2014,Beno Udrih,31,10,0,55,10,18,.556,2,2,1.000,8,16,.500,.611,5,6,.833,0,2,2,6,1,1,5,4,27
12207,MEM,2014,Seth Curry,23,1,0,4,0,0,,0,0,,0,0,,,0,0,,0,0,0,0,0,0,0,0,0
12208,MEM,2013,Marc Gasol,28,80,80,2796,429,869,.494,1,14,.071,428,855,.501,.494,268,316,.848,184,438,622,318,80,139,157,255,1127
12209,MEM,2013,Mike Conley,25,80,80,2757,414,940,.440,106,293,.362,308,647,.476,.497,234,282,.830,43,182,225,487,174,24,189,171,1168
12210,MEM,2013,Zach Randolph,31,76,75,2607,471,1024,.460,2,23,.087,469,1001,.469,.461,225,300,.750,310,544,854,108,61,31,150,180,1169
12211,MEM,2013,Tony Allen,31,79,79,2109,284,638,.445,3,24,.125,281,614,.458,.447,134,187,.717,121,242,363,98,119,44,94,211,705
12212,MEM,2013,Jerryd Bayless,24,80,4,1765,260,621,.419,71,201,.353,189,420,.450,.476,102,122,.836,22,154,176,264,59,17,120,168,693
12213,MEM,2013,Rudy Gay,26,42,42,1541,281,688,.408,40,129,.310,241,559,.431,.438,121,156,.776,56,193,249,108,56,31,104,87,723
12214,MEM,2013,Quincy Pondexter,24,59,1,1243,128,299,.428,60,152,.395,68,147,.463,.528,59,75,.787,43,89,132,61,35,6,42,95,375
12215,MEM,2013,Tayshaun Prince,32,37,36,1174,144,336,.429,15,41,.366,129,295,.437,.451,22,37,.595,29,126,155,85,27,12,35,41,325
12216,MEM,2013,Darrell Arthur,24,59,3,970,162,359,.451,5,18,.278,157,341,.460,.458,33,46,.717,68,101,169,33,24,33,43,126,362
12217,MEM,2013,Wayne Ellington,25,40,4,676,81,199,.407,41,97,.423,40,102,.392,.510,15,16,.938,5,47,52,42,16,1,24,38,218
12218,MEM,2013,Marreese Speights,25,40,2,579,106,247,.429,2,5,.400,104,242,.430,.433,48,67,.716,76,113,189,18,10,27,35,86,262
12219,MEM,2013,Ed Davis,23,36,4,544,74,143,.517,0,0,,74,143,.517,.517,37,65,.569,57,103,160,8,13,47,18,80,185
12220,MEM,2013,Austin Daye,24,31,0,328,47,111,.423,20,58,.345,27,53,.509,.514,11,16,.688,6,54,60,21,9,14,16,39,125
12221,MEM,2013,Tony Wroten,19,35,0,272,33,86,.384,4,16,.250,29,70,.414,.407,21,29,.724,13,15,28,43,8,4,29,34,91
12222,MEM,2013,Chris Johnson,22,8,0,102,11,25,.440,6,18,.333,5,7,.714,.560,1,2,.500,5,6,11,2,4,0,3,5,29
12223,MEM,2013,Jon Leuer,23,19,0,96,15,24,.625,0,0,,15,24,.625,.625,4,7,.571,8,16,24,3,4,0,3,10,34
12224,MEM,2013,Hamed Haddadi,27,13,0,87,7,21,.333,0,0,,7,21,.333,.333,1,2,.500,10,14,24,4,1,6,4,15,15
12225,MEM,2013,Keyon Dooling,32,7,0,82,10,21,.476,5,12,.417,5,9,.556,.595,6,7,.857,0,1,1,8,1,0,5,8,31
12226,MEM,2013,Josh Selby,21,10,0,59,6,22,.273,1,6,.167,5,16,.313,.295,7,11,.636,0,5,5,4,2,0,7,7,20
12227,MEM,2013,Dexter Pittman,24,7,0,20,1,6,.167,0,0,,1,6,.167,.167,0,3,.000,3,2,5,0,0,0,1,4,2
12228,MEM,2012,Rudy Gay,25,65,65,2422,485,1067,.455,54,173,.312,431,894,.482,.480,208,263,.791,130,287,417,147,95,55,161,138,1232
12229,MEM,2012,Marc Gasol,27,65,65,2370,357,740,.482,1,12,.083,356,728,.489,.483,237,317,.748,120,459,579,204,62,121,121,201,952
12230,MEM,2012,Mike Conley,24,62,61,2174,296,684,.433,60,159,.377,236,525,.450,.477,136,158,.861,22,134,156,404,136,11,125,133,788
12231,MEM,2012,O.J. Mayo,24,66,0,1771,300,736,.408,100,275,.364,200,461,.434,.476,133,172,.773,30,180,210,169,71,23,124,137,833
12232,MEM,2012,Tony Allen,30,58,57,1525,210,448,.469,8,26,.308,202,422,.479,.478,140,175,.800,98,135,233,79,104,33,94,142,568
12233,MEM,2012,Marreese Speights,24,60,54,1345,221,488,.453,0,3,.000,221,485,.456,.453,84,109,.771,133,241,374,48,21,29,74,147,526
12234,MEM,2012,Dante Cunningham,24,64,5,1124,144,279,.516,0,2,.000,144,277,.520,.516,45,69,.652,91,155,246,37,42,34,29,98,333
12235,MEM,2012,Quincy Pondexter,23,64,8,1002,108,239,.452,22,73,.301,86,166,.518,.498,33,53,.623,55,71,126,27,27,5,30,90,271
12236,MEM,2012,Zach Randolph,30,28,8,735,132,285,.463,2,8,.250,130,277,.469,.467,58,88,.659,78,147,225,48,21,4,40,57,324
12237,MEM,2012,Jeremy Pargo,25,44,5,424,50,150,.333,10,38,.263,40,112,.357,.367,16,27,.593,12,25,37,55,15,0,46,46,126
12238,MEM,2012,Sam Young,26,21,2,240,32,83,.386,0,9,.000,32,74,.432,.386,10,12,.833,14,27,41,9,11,2,9,12,74
12239,MEM,2012,Josh Selby,20,28,0,237,25,72,.347,2,15,.133,23,57,.404,.361,11,14,.786,2,13,15,30,7,0,29,17,63
12240,MEM,2012,Gilbert Arenas,30,17,0,211,26,64,.406,13,39,.333,13,25,.520,.508,7,10,.700,2,16,18,18,11,1,12,35,72
12241,MEM,2012,Hamed Haddadi,26,35,0,206,26,48,.542,0,1,.000,26,47,.553,.542,18,26,.692,28,43,71,8,1,26,21,43,70
12242,MEM,2012,Josh Davis,31,15,0,130,10,27,.370,4,13,.308,6,14,.429,.444,4,8,.500,16,11,27,6,7,1,3,19,28
12243,MEM,2012,Lester Hudson,27,3,0,20,3,11,.273,1,3,.333,2,8,.250,.318,2,3,.667,0,0,0,1,0,0,2,0,9
12244,MEM,2012,Brian Skinner,35,1,0,4,0,1,.000,0,0,,0,1,.000,.000,0,0,,0,0,0,0,0,0,0,1,0
12245,MEM,2011,Mike Conley,23,81,81,2872,423,953,.444,80,217,.369,343,736,.466,.486,181,247,.733,32,215,247,528,144,18,176,182,1107
12246,MEM,2011,Zach Randolph,29,75,74,2724,598,1188,.503,8,43,.186,590,1145,.515,.507,300,396,.758,326,588,914,163,63,25,151,175,1504
12247,MEM,2011,Marc Gasol,26,81,81,2586,364,691,.527,3,7,.429,361,684,.528,.529,220,294,.748,154,415,569,200,74,136,146,265,951
12248,MEM,2011,Rudy Gay,24,54,54,2152,409,869,.471,57,144,.396,352,725,.486,.503,194,241,.805,82,254,336,153,91,58,135,131,1069
12249,MEM,2011,O.J. Mayo,23,71,17,1869,304,747,.407,96,264,.364,208,483,.431,.471,99,131,.756,35,135,170,145,73,26,99,127,803
12250,MEM,2011,Darrell Arthur,22,80,9,1609,310,624,.497,0,6,.000,310,618,.502,.497,109,134,.813,115,227,342,53,52,63,88,228,729
12251,MEM,2011,Sam Young,25,78,46,1577,233,494,.472,17,50,.340,216,444,.486,.489,89,116,.767,40,147,187,71,68,23,61,120,572
12252,MEM,2011,Tony Allen,29,72,31,1494,251,492,.510,4,23,.174,247,469,.527,.514,137,182,.753,70,123,193,104,129,44,86,161,643
12253,MEM,2011,Greivis Vásquez,24,70,1,860,95,233,.408,25,86,.291,70,147,.476,.461,34,44,.773,12,61,73,151,22,4,70,83,249
12254,MEM,2011,Shane Battier,32,23,0,557,43,101,.426,14,42,.333,29,59,.492,.495,15,17,.882,32,60,92,32,16,10,16,31,115
12255,MEM,2011,Xavier Henry,19,38,16,527,65,160,.406,2,17,.118,63,143,.441,.413,33,52,.635,9,28,37,18,11,3,13,48,165
12256,MEM,2011,Hasheem Thabeet,23,45,0,369,17,39,.436,0,0,,17,39,.436,.436,19,35,.543,24,51,75,4,9,15,17,73,53
12257,MEM,2011,Hamed Haddadi,25,31,0,168,30,58,.517,0,1,.000,30,57,.526,.517,15,23,.652,24,44,68,5,2,13,11,29,75
12258,MEM,2011,Leon Powe,27,16,0,141,30,60,.500,0,2,.000,30,58,.517,.500,28,46,.609,8,17,25,5,3,1,7,24,88
12259,MEM,2011,Jason Williams,35,11,0,124,9,29,.310,3,15,.200,6,14,.429,.362,0,0,,0,8,8,28,3,1,7,2,21
12260,MEM,2011,Ish Smith,22,15,0,113,11,32,.344,0,2,.000,11,30,.367,.344,5,11,.455,1,4,5,15,5,0,8,11,27
12261,MEM,2011,Acie Law,26,11,0,94,3,19,.158,0,6,.000,3,13,.231,.158,6,10,.600,3,8,11,14,4,0,10,10,12
12262,MEM,2011,DeMarre Carroll,24,7,0,39,4,9,.444,0,0,,4,9,.444,.444,2,2,1.000,2,6,8,2,1,1,0,5,10
12263,MEM,2011,Rodney Carney,26,2,0,5,1,3,.333,0,1,.000,1,2,.500,.333,0,0,,1,0,1,0,1,0,0,0,2
12264,MEM,2010,Rudy Gay,23,80,80,3175,600,1288,.466,66,202,.327,534,1086,.492,.491,301,400,.753,115,357,472,153,118,64,169,201,1567
12265,MEM,2010,O.J. Mayo,22,82,82,3113,542,1183,.458,136,355,.383,406,828,.490,.516,212,262,.809,61,250,311,242,98,17,176,174,1432
12266,MEM,2010,Zach Randolph,28,81,81,3051,652,1336,.488,15,52,.288,637,1284,.496,.494,362,465,.778,330,620,950,149,80,34,174,226,1681
12267,MEM,2010,Mike Conley,22,80,80,2569,369,830,.445,82,212,.387,287,618,.464,.494,139,187,.743,30,161,191,425,109,12,170,178,959
12268,MEM,2010,Marc Gasol,25,69,69,2469,378,651,.581,0,1,.000,378,650,.582,.581,252,376,.670,208,432,640,165,69,109,135,254,1008
12269,MEM,2010,Sam Young,24,80,1,1321,224,497,.451,11,56,.196,213,441,.483,.462,136,175,.777,77,124,201,52,34,20,94,106,595
12270,MEM,2010,Hasheem Thabeet,22,68,13,883,77,131,.588,0,0,,77,131,.588,.588,54,93,.581,85,158,243,11,15,89,43,162,208
12271,MEM,2010,Marcus Williams,24,62,1,872,104,271,.384,24,81,.296,80,190,.421,.428,37,55,.673,13,80,93,161,32,1,74,43,269
12272,MEM,2010,DeMarre Carroll,23,71,1,795,88,222,.396,0,6,.000,88,216,.407,.396,33,53,.623,53,97,150,33,28,9,24,107,209
12273,MEM,2010,Jamaal Tinsley,31,38,1,589,52,140,.371,7,39,.179,45,101,.446,.396,22,27,.815,11,55,66,108,33,5,63,67,133
12274,MEM,2010,Darrell Arthur,21,32,1,457,63,146,.432,0,1,.000,63,145,.434,.432,17,30,.567,37,73,110,15,14,14,22,60,143
12275,MEM,2010,Hamed Haddadi,24,36,0,240,24,62,.387,0,3,.000,24,59,.407,.387,14,19,.737,26,49,75,10,1,14,20,57,62
12276,MEM,2010,Steven Hunter,28,21,0,158,17,43,.395,0,0,,17,43,.395,.395,19,36,.528,18,24,42,0,1,10,9,10,53
12277,MEM,2010,Ronnie Brewer,24,5,0,80,3,13,.231,0,0,,3,13,.231,.231,4,5,.800,1,6,7,3,6,0,2,0,10
12278,MEM,2010,Allen Iverson,34,3,0,67,15,26,.577,1,1,1.000,14,25,.560,.596,6,12,.500,1,3,4,11,1,0,7,5,37
12279,MEM,2010,Lester Hudson,25,9,0,61,14,35,.400,2,11,.182,12,24,.500,.429,6,7,.857,4,6,10,5,5,1,5,5,36
12280,MEM,2010,Trey Gilder,25,2,0,5,1,1,1.000,0,0,,1,1,1.000,1.000,0,0,,0,1,1,0,1,0,0,0,2
12281,MEM,2009,O.J. Mayo,21,82,82,3120,562,1283,.438,145,378,.384,417,905,.461,.495,247,281,.879,56,252,308,262,91,13,226,204,1516
12282,MEM,2009,Rudy Gay,22,79,78,2945,572,1262,.453,85,242,.351,487,1020,.477,.487,264,344,.767,109,328,437,135,98,59,203,221,1493
12283,MEM,2009,Marc Gasol,24,82,75,2521,350,661,.530,0,1,.000,350,660,.530,.530,275,375,.733,201,404,605,143,63,90,164,265,975
12284,MEM,2009,Mike Conley,21,82,61,2508,323,730,.442,88,217,.406,235,513,.458,.503,161,197,.817,25,251,276,354,90,8,143,146,895
12285,MEM,2009,Hakim Warrick,26,82,7,2029,340,693,.491,5,23,.217,335,670,.500,.494,266,374,.711,129,277,406,66,48,39,98,170,951
12286,MEM,2009,Darrell Arthur,20,76,64,1464,191,436,.438,0,2,.000,191,434,.440,.438,40,60,.667,108,238,346,43,52,52,47,206,422
12287,MEM,2009,Quinton Ross,27,68,7,1164,99,259,.382,33,88,.375,66,171,.386,.446,34,42,.810,29,97,126,47,32,14,36,114,265
12288,MEM,2009,Kyle Lowry,22,49,21,1071,112,272,.412,17,69,.246,95,203,.468,.443,129,161,.801,13,98,111,178,48,8,79,89,370
12289,MEM,2009,Darko Miličić,23,61,15,1034,137,266,.515,0,0,,137,266,.515,.515,59,105,.562,83,181,264,34,22,51,48,134,333
12290,MEM,2009,Greg Buckner,32,63,0,878,61,159,.384,13,51,.255,48,108,.444,.425,20,25,.800,32,98,130,57,29,8,38,108,155
12291,MEM,2009,Marko Jarić,30,53,0,605,48,145,.331,11,28,.393,37,117,.316,.369,29,41,.707,23,42,65,74,29,11,49,62,136
12292,MEM,2009,Darius Miles,27,34,0,298,48,99,.485,1,6,.167,47,93,.505,.490,23,31,.742,19,38,57,17,11,20,21,32,120
12293,MEM,2009,Hamed Haddadi,23,19,0,120,15,31,.484,0,0,,15,31,.484,.484,18,30,.600,16,31,47,8,1,12,9,20,48
12294,MEM,2009,Javaris Crittenton,21,7,0,44,7,15,.467,0,1,.000,7,14,.500,.467,5,11,.455,4,2,6,5,1,0,3,5,19
12295,MEM,2009,Adonal Foyle,33,1,0,3,0,0,,0,0,,0,0,,,0,0,,0,0,0,0,0,0,0,1,0
12296,MEM,2008,Rudy Gay,21,81,81,3000,625,1355,.461,134,387,.346,491,968,.507,.511,248,316,.785,140,359,499,158,111,79,190,230,1632
12297,MEM,2008,Mike Miller,27,70,70,2474,414,824,.502,155,359,.432,259,465,.557,.596,164,212,.774,51,416,467,240,35,16,182,145,1147
12298,MEM,2008,Juan Carlos Navarro,27,82,30,2117,308,766,.402,156,432,.361,152,334,.455,.504,124,146,.849,34,176,210,177,48,1,134,94,896
12299,MEM,2008,Kyle Lowry,21,82,9,2089,256,592,.432,36,140,.257,220,452,.487,.463,243,348,.698,41,209,250,296,92,22,127,185,791
12300,MEM,2008,Hakim Warrick,25,75,30,1754,328,653,.502,13,48,.271,315,605,.521,.512,183,260,.704,123,233,356,53,36,28,85,156,852
12301,MEM,2008,Darko Miličić,22,70,64,1663,219,500,.438,0,1,.000,219,499,.439,.438,67,121,.554,127,297,424,58,32,114,101,185,505
12302,MEM,2008,Pau Gasol,27,39,39,1433,279,557,.501,4,15,.267,275,542,.507,.504,176,215,.819,94,248,342,116,16,56,80,85,738
12303,MEM,2008,Mike Conley,20,53,46,1381,189,442,.428,30,91,.330,159,351,.453,.462,90,123,.732,21,118,139,222,44,2,89,85,498
12304,MEM,2008,Damon Stoudamire,34,29,29,624,77,194,.397,36,94,.383,41,100,.410,.490,21,26,.808,14,57,71,112,19,0,50,46,211
12305,MEM,2008,Stromile Swift,28,35,4,549,93,177,.525,0,2,.000,93,175,.531,.525,52,81,.642,46,83,129,22,10,36,39,74,238
12306,MEM,2008,Casey Jacobsen,26,53,0,547,39,115,.339,16,72,.222,23,43,.535,.409,13,17,.765,12,53,65,20,5,1,16,34,107
12307,MEM,2008,Javaris Crittenton,20,28,0,508,72,180,.400,9,34,.265,63,146,.432,.425,53,76,.697,20,69,89,33,12,2,33,35,206
12308,MEM,2008,Jason Collins,29,31,3,488,30,59,.508,0,1,.000,30,58,.517,.508,20,38,.526,29,60,89,6,12,17,25,84,80
12309,MEM,2008,Brian Cardinal,30,37,1,440,43,126,.341,25,81,.309,18,45,.400,.440,13,19,.684,26,70,96,22,10,2,23,62,124
12310,MEM,2008,Andre Brown,26,33,1,286,39,78,.500,0,0,,39,78,.500,.500,22,49,.449,37,55,92,8,7,4,14,38,100
12311,MEM,2008,Kwame Brown,25,15,1,204,19,39,.487,0,0,,19,39,.487,.487,14,34,.412,20,37,57,17,6,4,14,24,52
12312,MEM,2008,Bobby Jones,24,9,2,137,14,36,.389,3,13,.231,11,23,.478,.431,9,10,.900,10,17,27,11,5,2,5,17,40
12313,MEM,2008,Tarence Kinsey,23,11,0,96,16,38,.421,3,7,.429,13,31,.419,.461,5,6,.833,3,9,12,2,3,0,3,11,40
12314,MEM,2008,Jeremy Richardson,23,3,0,15,0,6,.000,0,2,.000,0,4,.000,.000,0,0,,0,1,1,1,0,0,1,2,0
12315,MEM,2007,Mike Miller,26,70,69,2740,465,1010,.460,202,498,.406,263,512,.514,.560,161,203,.793,52,326,378,298,54,18,179,138,1293
12316,MEM,2007,Hakim Warrick,24,82,43,2152,373,712,.524,0,8,.000,373,704,.530,.524,299,388,.771,130,290,420,75,43,30,161,232,1045
12317,MEM,2007,Pau Gasol,26,59,59,2133,462,858,.538,3,11,.273,459,847,.542,.540,299,400,.748,149,432,581,201,29,126,162,137,1226
12318,MEM,2007,Rudy Gay,20,78,43,2103,321,760,.422,52,143,.364,269,617,.436,.457,152,209,.727,93,255,348,100,71,74,140,192,846
12319,MEM,2007,Chucky Atkins,32,75,23,2064,310,715,.434,116,306,.379,194,409,.474,.515,252,311,.810,18,121,139,346,50,4,127,136,988
12320,MEM,2007,Dahntay Jones,26,78,25,1671,220,461,.477,5,12,.417,215,449,.479,.483,138,174,.793,47,106,153,68,39,22,92,192,583
12321,MEM,2007,Damon Stoudamire,33,62,51,1501,171,437,.391,59,175,.337,112,262,.427,.459,66,83,.795,31,108,139,299,47,2,101,95,467
12322,MEM,2007,Stromile Swift,27,54,18,1029,161,346,.465,0,5,.000,161,341,.472,.465,97,134,.724,85,165,250,17,30,62,69,146,419
12323,MEM,2007,Lawrence Roberts,24,54,18,969,94,208,.452,0,2,.000,94,206,.456,.452,95,131,.725,101,160,261,30,36,13,36,133,283
12324,MEM,2007,Tarence Kinsey,22,48,12,967,139,304,.457,13,46,.283,126,258,.488,.479,78,98,.796,29,68,97,41,53,1,46,57,369
12325,MEM,2007,Alexander Johnson,23,59,19,753,91,169,.538,0,0,,91,169,.538,.538,78,118,.661,50,131,181,17,25,35,47,137,260
12326,MEM,2007,Eddie Jones,35,29,14,561,57,151,.377,22,74,.297,35,77,.455,.450,25,34,.735,14,47,61,33,22,2,23,54,161
12327,MEM,2007,Junior Harrington,26,29,8,543,57,137,.416,7,26,.269,50,111,.450,.442,31,46,.674,12,56,68,89,21,5,52,79,152
12328,MEM,2007,Brian Cardinal,29,28,1,313,42,85,.494,18,44,.409,24,41,.585,.600,25,27,.926,13,46,59,31,22,1,23,42,127
12329,MEM,2007,Jake Tsakalidis,27,23,7,258,20,50,.400,0,0,,20,50,.400,.400,14,24,.583,24,40,64,2,7,11,21,34,54
12330,MEM,2007,Kyle Lowry,20,10,0,175,14,38,.368,3,8,.375,11,30,.367,.408,25,28,.893,12,19,31,32,14,1,12,20,56
12331,MEM,2007,Scott Padgett,30,7,0,33,1,7,.143,0,4,.000,1,3,.333,.143,0,2,.000,5,4,9,0,1,0,1,2,2
12332,MEM,2007,Will Conroy,24,3,0,17,0,0,,0,0,,0,0,,,0,0,,1,1,2,1,0,0,0,1,0
12333,MEM,2006,Pau Gasol,25,80,80,3135,600,1194,.503,3,12,.250,597,1182,.505,.504,425,617,.689,191,522,713,371,46,153,235,184,1628
12334,MEM,2006,Shane Battier,27,81,81,2839,303,621,.488,65,165,.394,238,456,.522,.540,147,208,.707,164,265,429,136,92,114,90,223,818
12335,MEM,2006,Eddie Jones,34,75,75,2437,292,722,.404,133,374,.356,159,348,.457,.497,168,215,.781,35,244,279,177,131,27,93,201,885
12336,MEM,2006,Mike Miller,25,74,9,2268,354,760,.466,138,339,.407,216,421,.513,.557,168,210,.800,42,355,397,200,52,27,140,173,1014
12337,MEM,2006,Bobby Jackson,32,71,15,1775,286,748,.382,129,332,.389,157,416,.377,.469,107,146,.733,44,179,223,195,61,1,101,155,808
12338,MEM,2006,Lorenzen Wright,30,78,58,1689,194,406,.478,0,2,.000,194,404,.480,.478,66,117,.564,142,253,395,48,52,46,67,201,454
12339,MEM,2006,Chucky Atkins,31,43,39,1161,160,399,.401,64,182,.352,96,217,.442,.481,107,132,.811,11,64,75,129,29,2,57,94,491
12340,MEM,2006,Dahntay Jones,25,71,4,967,109,263,.414,3,21,.143,106,242,.438,.420,60,93,.645,20,84,104,39,38,15,50,108,281
12341,MEM,2006,Damon Stoudamire,32,27,27,862,114,287,.397,36,104,.346,78,183,.426,.460,53,62,.855,23,72,95,128,19,1,55,49,317
12342,MEM,2006,Jake Tsakalidis,26,51,19,732,100,165,.606,0,0,,100,165,.606,.606,57,87,.655,78,134,212,13,14,32,39,107,257
12343,MEM,2006,Hakim Warrick,23,68,2,724,101,228,.443,0,0,,101,228,.443,.443,76,115,.661,43,101,144,30,14,21,56,113,278
12344,MEM,2006,Antonio Burks,25,57,1,570,51,144,.354,1,6,.167,50,138,.362,.358,10,23,.435,4,33,37,76,20,0,36,45,113
12345,MEM,2006,Brian Cardinal,28,36,0,402,46,111,.414,13,29,.448,33,82,.402,.473,19,27,.704,11,44,55,33,23,0,27,65,124
12346,MEM,2006,Lawrence Roberts,23,33,0,181,20,44,.455,0,2,.000,20,42,.476,.455,11,23,.478,26,23,49,5,8,2,5,30,51
12347,MEM,2006,Anthony Roberson,22,16,0,88,14,31,.452,5,10,.500,9,21,.429,.532,2,2,1.000,0,6,6,5,1,0,3,6,35
12348,MEM,2006,John Thomas,30,3,0,25,2,2,1.000,0,0,,2,2,1.000,1.000,0,0,,0,0,0,1,0,1,2,3,4
12349,MEM,2005,Shane Battier,26,80,72,2516,271,613,.442,70,177,.395,201,436,.461,.499,180,228,.789,158,255,413,126,91,77,75,201,792
12350,MEM,2005,Lorenzen Wright,29,80,77,2287,320,683,.469,0,3,.000,320,680,.471,.469,131,198,.662,177,436,613,87,58,69,100,251,771
12351,MEM,2005,Mike Miller,24,76,51,2278,387,766,.505,140,323,.433,247,443,.558,.597,108,150,.720,36,264,300,220,54,23,127,197,1022
12352,MEM,2005,Jason Williams,29,71,68,1952,266,644,.413,107,330,.324,159,314,.506,.496,80,101,.792,19,103,122,399,75,5,130,91,719
12353,MEM,2005,Earl Watson,25,80,14,1808,236,554,.426,52,163,.319,184,391,.471,.473,91,138,.659,35,129,164,359,83,19,167,184,615
12354,MEM,2005,Pau Gasol,24,56,53,1790,357,695,.514,1,6,.167,356,689,.517,.514,282,367,.768,130,280,410,135,37,93,137,146,997
12355,MEM,2005,Bonzi Wells,28,69,19,1489,272,617,.441,36,104,.346,236,513,.460,.470,141,188,.750,49,180,229,80,85,27,90,165,721
12356,MEM,2005,Brian Cardinal,27,58,16,1433,160,432,.370,44,125,.352,116,307,.378,.421,158,181,.873,63,162,225,114,88,19,83,172,522
12357,MEM,2005,James Posey,28,50,18,1382,127,356,.357,55,178,.309,72,178,.404,.434,96,111,.865,45,174,219,88,48,23,69,134,405
12358,MEM,2005,Stromile Swift,25,60,14,1279,219,488,.449,0,4,.000,219,484,.452,.449,166,219,.758,92,181,273,43,41,92,90,182,604
12359,MEM,2005,Dahntay Jones,24,52,7,649,83,190,.437,23,60,.383,60,130,.462,.497,44,64,.688,11,58,69,21,13,11,29,81,233
12360,MEM,2005,Ryan Humphrey,25,35,0,317,42,103,.408,0,2,.000,42,101,.416,.408,18,37,.486,50,37,87,6,10,1,23,35,102
12361,MEM,2005,Jake Tsakalidis,25,31,1,278,32,64,.500,0,0,,32,64,.500,.500,14,18,.778,21,35,56,10,3,16,12,42,78
12362,MEM,2005,Antonio Burks,24,24,0,219,28,60,.467,3,11,.273,25,49,.510,.492,14,19,.737,1,11,12,28,13,1,12,25,73
12363,MEM,2005,Andre Emmett,22,8,0,28,2,6,.333,0,0,,2,6,.333,.333,3,5,.600,0,2,2,0,0,0,1,4,7
12364,MEM,2004,Pau Gasol,23,78,78,2458,506,1049,.482,4,15,.267,502,1034,.485,.484,365,511,.714,206,394,600,198,44,132,187,185,1381
12365,MEM,2004,James Posey,27,82,82,2451,368,770,.478,112,290,.386,256,480,.533,.551,278,335,.830,92,311,403,122,137,40,112,248,1126
12366,MEM,2004,Jason Williams,28,72,68,2115,290,713,.407,120,364,.330,170,349,.487,.491,82,98,.837,25,122,147,492,92,5,136,97,782
12367,MEM,2004,Shane Battier,25,79,1,1947,242,543,.446,65,186,.349,177,357,.496,.506,120,164,.732,102,201,303,101,101,58,56,187,669
12368,MEM,2004,Mike Miller,23,65,65,1770,270,616,.438,80,215,.372,190,401,.474,.503,102,141,.723,42,174,216,232,59,14,107,162,722
12369,MEM,2004,Lorenzen Wright,28,65,46,1674,257,586,.439,0,5,.000,257,581,.442,.439,96,131,.733,144,301,445,71,45,58,77,192,610
12370,MEM,2004,Earl Watson,24,81,14,1669,172,464,.371,26,106,.245,146,358,.408,.399,90,138,.652,49,129,178,402,91,19,146,175,460
12371,MEM,2004,Bo Outlaw,32,82,1,1606,159,312,.510,0,4,.000,159,308,.516,.510,61,116,.526,125,217,342,90,73,70,69,170,379
12372,MEM,2004,Stromile Swift,24,77,10,1528,268,571,.469,1,4,.250,267,567,.471,.470,190,262,.725,141,237,378,38,56,118,88,188,727
12373,MEM,2004,Bonzi Wells,27,59,17,1468,295,675,.437,21,61,.344,274,614,.446,.453,117,156,.750,57,142,199,104,71,16,129,159,728
12374,MEM,2004,Jake Tsakalidis,24,40,28,533,67,133,.504,0,0,,67,133,.504,.504,36,61,.590,37,91,128,18,9,22,23,79,170
12375,MEM,2004,Wesley Person,32,16,0,284,33,107,.308,11,43,.256,22,64,.344,.360,6,8,.750,2,16,18,23,5,2,16,11,83
12376,MEM,2004,Theron Smith,23,20,0,178,16,43,.372,6,12,.500,10,31,.323,.442,6,8,.750,13,28,41,7,5,5,14,18,44
12377,MEM,2004,Dahntay Jones,23,20,0,154,15,53,.283,1,4,.250,14,49,.286,.292,5,11,.455,7,16,23,12,5,6,12,23,36
12378,MEM,2004,Troy Bell,23,6,0,34,4,18,.222,0,4,.000,4,14,.286,.222,3,3,1.000,3,1,4,4,1,0,6,6,11
12379,MEM,2004,Ryan Humphrey,24,2,0,11,1,4,.250,0,1,.000,1,3,.333,.250,0,0,,2,1,3,1,1,0,2,3,2
12380,MEM,2003,Pau Gasol,22,82,82,2948,569,1116,.510,1,10,.100,568,1106,.514,.510,416,565,.736,192,528,720,229,34,148,213,220,1555
12381,MEM,2003,Jason Williams,27,76,76,2407,333,859,.388,143,404,.354,190,455,.418,.471,110,131,.840,25,187,212,631,91,10,168,130,919
12382,MEM,2003,Shane Battier,24,78,47,2383,275,569,.483,86,216,.398,189,353,.535,.559,120,145,.828,128,217,345,105,102,88,68,207,756
12383,MEM,2003,Lorenzen Wright,27,70,49,1982,325,716,.454,0,5,.000,325,711,.457,.454,147,223,.659,170,358,528,80,51,54,110,209,797
12384,MEM,2003,Wesley Person,31,66,44,1941,274,601,.456,100,231,.433,174,370,.470,.539,79,97,.814,24,168,192,112,42,19,56,64,727
12385,MEM,2003,Stromile Swift,23,67,26,1478,235,489,.481,0,2,.000,235,487,.483,.481,177,245,.722,114,270,384,45,55,104,99,152,647
12386,MEM,2003,Earl Watson,23,79,2,1366,170,391,.435,31,91,.341,139,300,.463,.474,62,86,.721,46,118,164,225,89,14,88,138,433
12387,MEM,2003,Drew Gooden,21,51,29,1329,255,576,.443,14,46,.304,241,530,.455,.455,92,132,.697,105,190,295,63,38,22,105,121,616
12388,MEM,2003,Mike Batiste,25,75,2,1248,197,467,.422,18,81,.222,179,386,.464,.441,69,88,.784,82,175,257,52,42,16,69,120,481
12389,MEM,2003,Gordan Giriček,25,49,35,1187,207,478,.433,46,130,.354,161,348,.463,.481,88,107,.822,18,90,108,70,22,6,94,104,548
12390,MEM,2003,Brevin Knight,27,55,4,928,97,228,.425,2,8,.250,95,220,.432,.430,20,37,.541,15,66,81,233,69,2,94,123,216
12391,MEM,2003,Mike Miller,22,16,13,360,77,151,.510,22,44,.500,55,107,.514,.583,29,36,.806,6,49,55,31,6,5,26,34,205
12392,MEM,2003,Ryan Humphrey,23,13,0,122,12,35,.343,0,0,,12,35,.343,.343,5,11,.455,4,26,30,4,5,2,2,18,29
12393,MEM,2003,Michael Dickerson,27,6,1,87,10,24,.417,4,11,.364,6,13,.462,.500,5,5,1.000,1,5,6,8,5,1,6,16,29
12394,MEM,2003,Cezary Trybański,23,15,0,86,5,20,.250,0,0,,5,20,.250,.250,4,10,.400,6,8,14,1,0,6,8,13,14
12395,MEM,2003,Robert Archibald,22,12,0,72,6,20,.300,0,0,,6,20,.300,.300,7,18,.389,6,11,17,3,0,3,7,9,19
12396,MEM,2003,Chris Owens,23,1,0,6,2,3,.667,0,0,,2,3,.667,.667,0,0,,1,0,1,0,0,0,1,0,4
12397,MEM,2002,Shane Battier,23,78,78,3097,412,961,.429,103,276,.373,309,685,.451,.482,198,283,.700,180,238,418,216,121,81,155,215,1125
12398,MEM,2002,Pau Gasol,21,82,79,3007,551,1064,.518,1,5,.200,550,1059,.519,.518,338,477,.709,238,492,730,223,41,169,224,195,1441
12399,MEM,2002,Jason Williams,26,65,65,2236,376,985,.382,127,430,.295,249,555,.449,.446,80,101,.792,22,173,195,519,111,7,214,102,959
12400,MEM,2002,Grant Long,35,66,56,1868,164,385,.426,3,17,.176,161,368,.438,.430,86,123,.699,31,200,231,136,63,12,103,123,417
12401,MEM,2002,Stromile Swift,22,68,14,1805,293,611,.480,0,3,.000,293,608,.482,.480,217,305,.711,161,269,430,50,53,113,122,178,803
12402,MEM,2002,Rodney Buford,24,63,21,1769,258,593,.435,17,70,.243,241,523,.461,.449,58,80,.725,52,220,272,71,42,12,63,110,591
12403,MEM,2002,Lorenzen Wright,26,43,33,1251,223,486,.459,0,2,.000,223,484,.461,.459,70,123,.569,130,275,405,44,30,23,72,126,516
12404,MEM,2002,Tony Massenburg,34,73,31,1247,159,349,.456,1,1,1.000,158,348,.454,.457,84,117,.718,100,224,324,26,30,31,65,174,403
12405,MEM,2002,Brevin Knight,26,53,11,1151,141,334,.422,2,8,.250,139,326,.426,.425,87,115,.757,11,98,109,302,79,7,111,135,371
12406,MEM,2002,Will Solomon,23,62,4,872,113,331,.341,46,162,.284,67,169,.396,.411,49,73,.671,12,56,68,92,35,7,62,76,321
12407,MEM,2002,Eddie Gill,23,23,5,384,39,92,.424,7,22,.318,32,70,.457,.462,31,39,.795,7,21,28,49,11,3,34,38,116
12408,MEM,2002,Antonis Fotsis,20,28,1,320,42,104,.404,7,23,.304,35,81,.432,.438,17,20,.850,25,37,62,10,9,11,21,22,108
12409,MEM,2002,Isaac Austin,32,21,8,307,36,92,.391,0,3,.000,36,89,.404,.391,4,4,1.000,11,60,71,13,9,5,11,36,76
12410,MEM,2002,Nick Anderson,34,15,0,219,21,76,.276,13,48,.271,8,28,.286,.362,5,9,.556,1,32,33,14,6,6,14,17,60
12411,MEM,2002,Michael Dickerson,26,4,4,124,15,48,.313,8,21,.381,7,27,.259,.396,5,6,.833,3,9,12,9,3,1,8,12,43
12412,MEM,2002,Isaac Fontaine,26,6,0,75,3,14,.214,1,5,.200,2,9,.222,.250,4,6,.667,0,5,5,4,0,0,4,6,11
12413,MEM,2002,Elliot Perry,32,2,0,48,5,10,.500,0,0,,5,10,.500,.500,1,2,.500,0,4,4,7,3,0,7,6,11
12414,VAN,2001,Shareef Abdur-Rahim,24,81,81,3241,604,1280,.472,12,64,.188,592,1216,.487,.477,443,531,.834,175,560,735,250,90,77,231,238,1663
12415,VAN,2001,Mike Bibby,22,82,82,3190,525,1157,.454,108,285,.379,417,872,.478,.500,143,188,.761,47,257,304,685,107,12,248,148,1301
12416,VAN,2001,Michael Dickerson,25,70,69,2618,425,1020,.417,86,230,.374,339,790,.429,.459,206,270,.763,70,159,229,233,62,27,162,207,1142
12417,VAN,2001,Bryant Reeves,27,75,48,1832,254,552,.460,1,4,.250,253,548,.462,.461,113,142,.796,132,320,452,80,43,54,90,243,622
12418,VAN,2001,Grant Long,34,66,27,1507,140,319,.439,4,15,.267,136,304,.447,.445,112,157,.713,76,198,274,83,72,15,62,160,396
12419,VAN,2001,Damon Jones,24,71,10,1415,170,416,.409,84,231,.364,86,185,.465,.510,37,52,.712,16,108,124,224,36,1,76,58,461
12420,VAN,2001,Stromile Swift,21,80,6,1312,153,339,.451,0,4,.000,153,335,.457,.451,85,141,.603,109,175,284,28,62,82,64,160,391
12421,VAN,2001,Othella Harrington,27,44,40,1267,180,386,.466,0,3,.000,180,383,.470,.466,120,154,.779,102,187,289,36,19,26,104,136,480
12422,VAN,2001,Isaac Austin,31,52,16,845,96,270,.356,6,24,.250,90,246,.366,.367,28,40,.700,50,172,222,58,20,23,54,94,226
12423,VAN,2001,Tony Massenburg,33,52,20,823,92,199,.462,0,0,,92,199,.462,.462,49,70,.700,75,135,210,9,10,28,48,122,233
12424,VAN,2001,Kevin Edwards,35,46,5,634,56,170,.329,5,19,.263,51,151,.338,.344,43,53,.811,23,59,82,52,29,8,37,46,160
12425,VAN,2001,Mahmoud Abdul-Rauf,31,41,0,486,120,246,.488,4,14,.286,116,232,.500,.496,22,29,.759,5,20,25,76,9,1,26,50,266
12426,VAN,2001,Erick Strickland,27,22,0,409,41,136,.301,14,48,.292,27,88,.307,.353,44,51,.863,9,67,76,66,22,1,27,42,140
12427,VAN,2001,Doug West,33,15,6,171,11,38,.289,0,2,.000,11,36,.306,.289,6,7,.857,4,11,15,14,3,4,4,21,28
12428,VAN,2001,Brent Price,32,6,0,30,3,11,.273,1,4,.250,2,7,.286,.318,6,7,.857,1,3,4,5,2,0,4,8,13
12429,VAN,2000,Shareef Abdur-Rahim,23,82,82,3223,594,1277,.465,29,96,.302,565,1181,.478,.477,446,551,.809,218,607,825,271,89,87,249,244,1663
12430,VAN,2000,Mike Bibby,21,82,82,3155,459,1031,.445,77,212,.363,382,819,.466,.483,195,250,.780,73,233,306,665,132,15,247,171,1190
12431,VAN,2000,Michael Dickerson,24,82,82,3103,554,1270,.436,119,291,.409,435,979,.444,.483,269,324,.830,78,201,279,208,116,45,165,226,1496
12432,VAN,2000,Othella Harrington,26,82,82,2677,420,830,.506,0,2,.000,420,828,.507,.506,236,298,.792,196,367,563,97,36,58,217,287,1076
12433,VAN,2000,Bryant Reeves,26,69,67,1773,252,562,.448,0,4,.000,252,558,.452,.448,107,165,.648,126,264,390,82,33,38,119,245,611
12434,VAN,2000,Dennis Scott,31,66,0,1263,125,333,.375,71,189,.376,54,144,.375,.482,48,57,.842,16,90,106,69,28,9,30,104,369
12435,VAN,2000,Grant Long,33,42,1,920,74,167,.443,0,4,.000,74,163,.454,.443,55,71,.775,86,148,234,43,45,10,49,108,203
12436,VAN,2000,Cherokee Parks,27,56,14,808,72,145,.497,0,1,.000,72,144,.500,.497,24,37,.649,55,128,183,35,29,45,28,115,168
12437,VAN,2000,Felipe López,25,65,0,781,111,261,.425,3,18,.167,108,243,.444,.431,67,109,.615,59,65,124,44,32,17,53,94,292
12438,VAN,2000,Doug West,32,38,0,581,59,145,.407,0,3,.000,59,142,.415,.407,34,40,.850,18,53,71,43,12,8,19,80,152
12439,VAN,2000,Brent Price,31,41,0,424,41,119,.345,25,68,.368,16,51,.314,.450,34,39,.872,8,29,37,69,17,1,47,63,141
12440,VAN,2000,Milt Palacio,21,53,0,394,43,98,.439,0,2,.000,43,96,.448,.439,22,37,.595,17,34,51,48,20,0,44,32,108
12441,VAN,2000,Obinna Ekezie,24,39,0,351,41,88,.466,0,0,,41,88,.466,.466,43,64,.672,34,58,92,8,9,4,26,61,125
12442,VAN,2000,Antoine Carr,38,21,0,221,28,64,.438,0,0,,28,64,.438,.438,11,14,.786,8,24,32,7,3,6,9,42,67
12443,VAN,2000,Joe Stephens,27,13,0,181,19,51,.373,0,8,.000,19,43,.442,.373,3,4,.750,13,23,36,11,7,3,6,9,41
12444,VAN,1999,Shareef Abdur-Rahim,22,50,50,2021,386,893,.432,11,36,.306,375,857,.438,.438,369,439,.841,114,260,374,172,69,55,186,137,1152
12445,VAN,1999,Mike Bibby,20,50,50,1758,260,605,.430,15,74,.203,245,531,.461,.442,127,169,.751,30,106,136,325,78,5,146,122,662
12446,VAN,1999,Felipe López,24,47,32,1218,169,379,.446,12,44,.273,157,335,.469,.462,87,135,.644,69,97,166,62,49,14,82,128,437
12447,VAN,1999,Tony Massenburg,31,43,35,1143,189,388,.487,0,2,.000,189,386,.490,.487,103,155,.665,83,174,257,23,26,39,64,108,481
12448,VAN,1999,Cherokee Parks,26,48,41,1118,118,275,.429,0,1,.000,118,274,.431,.429,30,55,.545,75,168,243,36,28,28,49,114,266
12449,VAN,1999,Michael Smith,26,48,10,1098,77,144,.535,0,1,.000,77,143,.538,.535,76,128,.594,135,215,350,48,46,18,60,107,230
12450,VAN,1999,Bryant Reeves,25,25,14,702,102,251,.406,0,1,.000,102,250,.408,.406,67,116,.578,50,88,138,37,13,8,47,103,271
12451,VAN,1999,Pete Chilcutt,30,46,0,697,63,172,.366,26,68,.382,37,104,.356,.442,14,17,.824,29,88,117,30,22,12,28,52,166
12452,VAN,1999,DeJuan Wheat,25,46,0,590,73,193,.378,22,60,.367,51,133,.383,.435,40,55,.727,11,34,45,102,26,2,48,59,208
12453,VAN,1999,Sam Mack,28,19,15,577,86,212,.406,42,108,.389,44,104,.423,.505,28,30,.933,7,46,53,23,20,1,20,53,242
12454,VAN,1999,J.R. Henderson,22,30,0,331,35,96,.365,2,5,.400,33,91,.363,.375,25,45,.556,20,27,47,22,9,4,18,29,97
12455,VAN,1999,Doug West,31,14,2,294,31,65,.477,0,2,.000,31,63,.492,.477,19,25,.760,5,20,25,19,16,7,12,38,81
12456,VAN,1999,Terry Dehere,27,22,0,271,27,74,.365,15,34,.441,12,40,.300,.466,5,7,.714,5,17,22,26,5,3,14,28,74
12457,VAN,1999,Lee Mayberry,28,9,0,126,7,19,.368,2,10,.200,5,9,.556,.421,4,5,.800,0,3,3,23,7,0,11,13,20
12458,VAN,1999,Rodrick Rhodes,25,10,1,123,11,44,.250,1,7,.143,10,37,.270,.261,11,19,.579,7,6,13,10,4,2,15,16,34
12459,VAN,1999,Carl Herrera,32,4,0,42,3,13,.231,0,0,,3,13,.231,.231,0,2,.000,5,3,8,3,0,0,4,3,6
12460,VAN,1999,Jason Sasser,25,6,0,39,5,11,.455,0,0,,5,11,.455,.455,1,2,.500,2,5,7,2,2,0,2,4,11
12461,VAN,1999,Makhtar N'Diaye,25,4,0,27,1,4,.250,0,0,,1,4,.250,.250,3,4,.750,3,2,5,1,0,1,1,9,5
12462,VAN,1998,Shareef Abdur-Rahim,21,82,82,2950,653,1347,.485,21,51,.412,632,1296,.488,.493,502,640,.784,227,354,581,213,89,76,257,201,1829
12463,VAN,1998,Bryant Reeves,24,74,74,2527,492,941,.523,0,4,.000,492,937,.525,.523,223,316,.706,196,389,585,155,39,80,156,278,1207
12464,VAN,1998,Blue Edwards,32,81,20,1968,326,742,.439,40,120,.333,286,622,.460,.466,180,215,.837,61,156,217,201,86,27,134,183,872
12465,VAN,1998,Antonio Daniels,22,74,50,1956,228,548,.416,11,52,.212,217,496,.438,.426,112,170,.659,22,121,143,334,55,10,164,88,579
12466,VAN,1998,Lee Mayberry,27,79,32,1835,131,349,.375,63,180,.350,68,169,.402,.466,38,51,.745,19,95,114,349,65,10,113,164,363
12467,VAN,1998,Otis Thorpe,35,47,46,1574,205,430,.477,0,4,.000,205,426,.481,.477,118,170,.694,100,271,371,161,30,23,115,158,528
12468,VAN,1998,George Lynch,27,82,0,1493,248,516,.481,9,30,.300,239,486,.492,.489,111,158,.703,147,215,362,122,65,41,104,161,616
12469,VAN,1998,Pete Chilcutt,29,82,0,1420,156,359,.435,54,130,.415,102,229,.445,.510,39,59,.661,77,229,306,104,53,37,62,158,405
12470,VAN,1998,Sam Mack,27,57,54,1414,222,559,.397,110,269,.409,112,290,.386,.496,62,77,.805,30,103,133,101,41,11,69,117,616
12471,VAN,1998,Tony Massenburg,30,61,13,894,148,309,.479,0,0,,148,309,.479,.479,100,137,.730,80,152,232,21,25,24,60,123,396
12472,VAN,1998,Michael Smith,25,30,29,706,67,133,.504,0,1,.000,67,132,.508,.504,48,73,.658,85,121,206,59,26,6,36,60,182
12473,VAN,1998,Bobby Hurley,26,27,0,458,46,123,.374,1,7,.143,45,116,.388,.378,29,39,.744,5,25,30,97,10,0,44,43,122
12474,VAN,1998,Ivano Newbill,27,28,2,249,20,57,.351,1,1,1.000,19,56,.339,.360,17,30,.567,24,45,69,9,10,3,17,38,58
12475,VAN,1998,Anthony Peeler,28,8,8,202,35,72,.486,5,19,.263,30,53,.566,.521,4,6,.667,6,14,20,23,9,0,6,16,79
12476,VAN,1998,Chris Robinson,23,16,0,143,23,63,.365,7,24,.292,16,39,.410,.421,1,2,.500,0,13,13,10,7,1,15,21,54
12477,VAN,1998,Larry Robinson,30,6,0,41,6,19,.316,3,6,.500,3,13,.231,.395,2,2,1.000,2,10,12,1,4,0,2,0,17
12478,VAN,1997,Shareef Abdur-Rahim,20,80,71,2802,550,1214,.453,7,27,.259,543,1187,.457,.456,387,519,.746,216,339,555,175,79,79,225,199,1494
12479,VAN,1997,Bryant Reeves,23,75,75,2777,498,1025,.486,1,11,.091,497,1014,.490,.486,216,307,.704,174,436,610,160,29,67,175,270,1213
12480,VAN,1997,Anthony Peeler,27,72,57,2291,402,1011,.398,128,343,.373,274,668,.410,.461,109,133,.820,54,193,247,256,105,17,157,168,1041
12481,VAN,1997,Lee Mayberry,26,80,38,1952,149,370,.403,83,221,.376,66,149,.443,.515,29,46,.630,29,105,134,329,60,8,90,159,410
12482,VAN,1997,Greg Anthony,29,65,44,1863,199,507,.393,88,238,.370,111,269,.413,.479,130,178,.730,25,159,184,407,129,4,129,122,616
12483,VAN,1997,Roy Rogers,23,82,50,1848,244,483,.505,1,1,1.000,243,482,.504,.506,54,94,.574,139,247,386,46,21,163,86,214,543
12484,VAN,1997,Blue Edwards,31,61,12,1439,182,458,.397,25,89,.281,157,369,.425,.425,89,109,.817,49,140,189,114,38,20,81,135,478
12485,VAN,1997,Lawrence Moten,24,67,18,1214,171,441,.388,41,141,.291,130,300,.433,.434,64,99,.646,43,76,119,129,48,24,81,83,447
12486,VAN,1997,George Lynch,26,41,27,1059,137,291,.471,8,31,.258,129,260,.496,.485,60,97,.619,98,163,261,76,63,17,64,97,342
12487,VAN,1997,Chris Robinson,22,41,6,681,69,182,.379,34,89,.382,35,93,.376,.473,16,26,.615,23,48,71,65,28,9,34,85,188
12488,VAN,1997,Pete Chilcutt,28,54,1,662,72,165,.436,25,69,.362,47,96,.490,.512,13,22,.591,67,89,156,47,26,17,28,52,182
12489,VAN,1997,Aaron Williams,25,32,1,553,82,143,.573,0,1,.000,82,142,.577,.573,33,49,.673,60,78,138,15,16,26,28,72,197
12490,VAN,1997,Eric Mobley,26,28,8,307,28,63,.444,0,0,,28,63,.444,.444,16,30,.533,30,28,58,14,5,10,29,44,72
12491,VAN,1997,Rich Manning,26,16,1,128,18,48,.375,2,3,.667,16,45,.356,.396,6,8,.750,8,15,23,2,3,1,5,18,44
12492,VAN,1997,Eric Leckner,30,19,1,115,14,30,.467,0,0,,14,30,.467,.467,6,12,.500,5,30,35,4,3,2,10,32,34
12493,VAN,1997,Moochie Norris,23,8,0,89,4,22,.182,2,10,.200,2,12,.167,.227,2,5,.400,3,9,12,23,4,0,5,5,12
12494,VAN,1996,Blue Edwards,30,82,82,2773,401,956,.419,84,245,.343,317,711,.446,.463,157,208,.755,98,248,346,212,118,46,170,243,1043
12495,VAN,1996,Bryant Reeves,22,77,63,2460,401,877,.457,0,3,.000,401,874,.459,.457,219,299,.732,178,392,570,109,43,55,157,226,1021
12496,VAN,1996,Greg Anthony,28,69,68,2096,324,781,.415,90,271,.332,234,510,.459,.472,229,297,.771,29,145,174,476,116,11,160,137,967
12497,VAN,1996,Chris King,26,80,66,1930,250,585,.427,44,113,.389,206,472,.436,.465,90,136,.662,102,183,285,104,68,33,103,163,634
12498,VAN,1996,Byron Scott,34,80,0,1894,271,676,.401,74,221,.335,197,455,.433,.456,203,243,.835,40,152,192,123,63,22,100,126,819
12499,VAN,1996,Anthony Avent,26,71,32,1586,179,466,.384,0,0,,179,466,.384,.384,57,77,.740,108,247,355,69,30,42,107,202,415
12500,VAN,1996,Eric Murdock,27,64,14,1480,220,521,.422,39,122,.320,181,399,.454,.460,106,131,.809,21,134,155,292,129,9,120,124,585
12501,VAN,1996,Ashraf Amaya,24,54,34,1104,121,252,.480,0,1,.000,121,251,.482,.480,97,149,.651,114,189,303,33,22,10,57,151,339
12502,VAN,1996,Gerald Wilkins,32,28,14,738,77,205,.376,14,64,.219,63,141,.447,.410,20,23,.870,22,43,65,68,22,2,37,55,188
12503,VAN,1996,Eric Mobley,25,34,1,611,72,131,.550,1,2,.500,71,129,.550,.553,37,83,.446,51,77,128,22,13,23,49,82,182
12504,VAN,1996,Lawrence Moten,23,44,3,573,112,247,.453,18,55,.327,94,192,.490,.490,49,75,.653,36,25,61,50,29,8,44,54,291
12505,VAN,1996,Kenny Gattison,31,25,14,570,91,190,.479,0,0,,91,190,.479,.479,47,78,.603,35,79,114,14,10,11,40,75,229
12506,VAN,1996,Doug Edwards,25,31,0,519,32,91,.352,0,4,.000,32,87,.368,.352,29,38,.763,35,52,87,39,10,18,29,51,93
12507,VAN,1996,Antonio Harvey,25,18,6,410,39,95,.411,0,2,.000,39,93,.419,.411,20,43,.465,27,67,94,9,14,21,18,38,98
12508,VAN,1996,Benoit Benjamin,31,13,13,404,71,161,.441,0,0,,71,161,.441,.441,39,56,.696,31,72,103,16,10,15,34,40,181
12509,VAN,1996,Darrick Martin,24,24,0,402,59,131,.450,5,22,.227,54,109,.495,.469,38,46,.826,13,25,38,61,27,1,37,47,161
12510,VAN,1996,Rich Manning,25,29,0,311,49,113,.434,0,1,.000,49,112,.438,.434,9,14,.643,16,39,55,7,3,6,17,37,107
12511,VAN,1996,Cuonzo Martin,24,4,0,19,3,5,.600,3,3,1.000,0,2,.000,.900,0,2,.000,1,1,2,2,1,0,1,1,9
12512,DEN,2024,Nikola Jokić,28,79,79,2737,822,1411,.583,83,231,.359,739,1180,.626,.612,358,438,.817,223,753,976,708,108,68,237,194,2085
12513,DEN,2024,Michael Porter Jr.,25,81,81,2565,522,1079,.484,220,554,.397,302,525,.575,.586,92,110,.836,106,459,565,122,42,53,92,148,1356
12514,DEN,2024,Kentavious Caldwell-Pope,30,76,76,2402,270,587,.460,125,308,.406,145,279,.520,.566,101,113,.894,31,152,183,183,98,42,75,151,766
12515,DEN,2024,Aaron Gordon,28,73,73,2297,398,716,.556,40,138,.290,358,578,.619,.584,177,269,.658,174,297,471,259,56,45,105,142,1013
12516,DEN,2024,Jamal Murray,26,59,59,1861,474,986,.481,145,341,.425,329,645,.510,.554,157,184,.853,42,200,242,384,57,39,125,104,1250
12517,DEN,2024,Reggie Jackson,33,82,23,1817,326,756,.431,102,284,.359,224,472,.475,.499,79,98,.806,33,122,155,308,44,13,106,149,833
12518,DEN,2024,Christian Braun,22,82,4,1655,222,483,.460,63,164,.384,159,319,.498,.525,93,134,.694,79,227,306,132,42,35,55,137,600
12519,DEN,2024,Peyton Watson,21,80,4,1488,208,447,.465,45,152,.296,163,295,.553,.516,71,106,.670,56,202,258,86,42,88,58,143,532
12520,DEN,2024,Justin Holiday,34,58,9,862,88,194,.454,55,136,.404,33,58,.569,.595,3,4,.750,9,62,71,67,36,9,14,69,234
12521,DEN,2024,Zeke Nnaji,23,58,0,576,69,149,.463,6,23,.261,63,126,.500,.483,42,62,.677,61,65,126,32,15,38,27,81,186
12522,DEN,2024,Julian Strawther,21,50,0,545,82,222,.369,41,138,.297,41,84,.488,.462,22,31,.710,5,56,61,47,17,7,23,54,227
12523,DEN,2024,DeAndre Jordan,35,36,2,396,58,93,.624,0,0,,58,93,.624,.624,26,53,.491,54,103,157,26,6,16,23,56,142
12524,DEN,2024,Collin Gillespie,24,24,0,225,32,69,.464,15,38,.395,17,31,.548,.572,8,12,.667,1,20,21,27,13,0,14,24,87
12525,DEN,2024,Jalen Pickett,24,27,0,122,15,35,.429,9,25,.360,6,10,.600,.557,3,4,.750,1,13,14,21,4,0,9,13,42
12526,DEN,2024,Braxton Key,26,20,0,60,7,17,.412,2,5,.400,5,12,.417,.471,6,8,.750,3,15,18,9,2,1,1,5,22
12527,DEN,2024,Jay Huff,25,20,0,49,9,15,.600,3,9,.333,6,6,1.000,.700,2,2,1.000,2,9,11,2,2,3,1,9,23
12528,DEN,2024,Hunter Tyson,23,18,0,48,8,20,.400,4,14,.286,4,6,.667,.500,0,0,,1,8,9,2,1,0,2,10,20
12529,DEN,2023,Kentavious Caldwell-Pope,29,76,76,2381,292,632,.462,135,319,.423,157,313,.502,.569,103,125,.824,35,173,208,183,112,35,86,145,822
12530,DEN,2023,Nikola Jokić,27,69,69,2323,646,1022,.632,57,149,.383,589,873,.675,.660,341,415,.822,167,650,817,678,87,47,247,174,1690
12531,DEN,2023,Bruce Brown,26,80,31,2280,358,741,.483,91,254,.358,267,487,.548,.545,116,153,.758,63,265,328,268,87,51,123,190,923
12532,DEN,2023,Jamal Murray,25,65,65,2133,473,1041,.454,172,432,.398,301,609,.494,.537,180,216,.833,48,209,257,400,66,16,145,103,1298
12533,DEN,2023,Aaron Gordon,27,68,68,2055,429,761,.564,60,173,.347,369,588,.628,.603,191,314,.608,164,282,446,203,54,51,98,129,1109
12534,DEN,2023,Michael Porter Jr.,24,62,62,1798,398,817,.487,188,454,.414,210,363,.579,.602,96,120,.800,64,277,341,65,37,29,68,119,1080
12535,DEN,2023,Christian Braun,21,76,6,1181,143,289,.495,34,96,.354,109,193,.565,.554,40,64,.625,48,133,181,59,41,17,35,101,360
12536,DEN,2023,Jeff Green,36,56,4,1091,160,328,.488,30,104,.288,130,224,.580,.534,87,117,.744,38,106,144,69,18,17,46,99,437
12537,DEN,2023,Vlatko Čančar,25,60,9,889,108,227,.476,43,115,.374,65,112,.580,.570,38,41,.927,24,104,128,80,22,14,37,84,297
12538,DEN,2023,Bones Hyland,22,42,1,820,173,434,.399,91,241,.378,82,193,.425,.503,71,82,.866,10,76,86,125,28,13,67,66,508
12539,DEN,2023,Zeke Nnaji,22,53,5,728,110,196,.561,17,65,.262,93,131,.710,.605,40,62,.645,65,73,138,18,17,23,31,105,277
12540,DEN,2023,DeAndre Jordan,34,39,8,586,88,115,.765,1,1,1.000,87,114,.763,.770,22,48,.458,52,150,202,34,12,23,48,71,199
12541,DEN,2023,Ish Smith,34,43,0,398,52,131,.397,2,12,.167,50,119,.420,.405,2,4,.500,5,49,54,100,8,7,44,33,108
12542,DEN,2023,Reggie Jackson,32,16,2,319,49,128,.383,19,68,.279,30,60,.500,.457,10,12,.833,3,25,28,50,9,1,19,22,127
12543,DEN,2023,Davon Reed,27,35,1,315,25,80,.313,16,44,.364,9,36,.250,.413,15,20,.750,9,46,55,19,13,4,20,36,81
12544,DEN,2023,Thomas Bryant,25,18,1,205,33,68,.485,4,9,.444,29,59,.492,.515,13,18,.722,19,41,60,2,2,7,10,25,83
12545,DEN,2023,Peyton Watson,20,23,2,186,29,59,.492,6,14,.429,23,45,.511,.542,11,20,.550,8,29,37,11,2,11,8,14,75
12546,DEN,2023,Jack White,25,17,0,66,8,19,.421,3,9,.333,5,10,.500,.500,2,3,.667,6,11,17,4,3,2,2,9,21
12547,DEN,2022,Nikola Jokić,26,74,74,2476,764,1311,.583,97,288,.337,667,1023,.652,.620,379,468,.810,206,813,1019,584,109,63,281,191,2004
12548,DEN,2022,Aaron Gordon,26,75,75,2376,434,834,.520,87,260,.335,347,574,.605,.573,171,230,.743,125,314,439,188,44,44,133,148,1126
12549,DEN,2022,Will Barton,31,71,71,2277,392,896,.438,157,430,.365,235,466,.504,.525,102,127,.803,44,296,340,276,55,31,127,114,1043
12550,DEN,2022,Monte Morris,26,75,74,2239,374,773,.484,124,314,.395,250,459,.545,.564,73,84,.869,27,199,226,333,56,14,78,92,945
12551,DEN,2022,Jeff Green,35,75,63,1849,277,529,.524,53,168,.315,224,361,.620,.574,165,198,.833,41,190,231,96,28,27,71,151,772
12552,DEN,2022,Austin Rivers,29,67,18,1480,146,350,.417,79,231,.342,67,119,.563,.530,32,44,.727,19,95,114,90,51,6,54,121,403
12553,DEN,2022,Bones Hyland,21,69,4,1310,230,571,.403,131,358,.366,99,213,.465,.518,107,125,.856,14,174,188,191,41,20,86,153,698
12554,DEN,2022,Facundo Campazzo,30,65,4,1184,107,296,.361,58,193,.301,49,103,.476,.459,60,78,.769,23,94,117,220,63,23,67,124,332
12555,DEN,2022,JaMychal Green,31,67,8,1085,159,327,.486,33,124,.266,126,203,.621,.537,81,93,.871,81,200,281,59,43,26,57,158,432
12556,DEN,2022,Zeke Nnaji,21,41,1,698,96,186,.516,37,80,.463,59,106,.557,.616,41,65,.631,56,91,147,17,16,13,23,79,270
12557,DEN,2022,Davon Reed,26,48,5,668,81,161,.503,37,86,.430,44,75,.587,.618,10,15,.667,14,94,108,53,24,9,16,63,209
12558,DEN,2022,Bryn Forbes,28,35,1,610,103,243,.424,59,144,.410,44,99,.444,.545,35,38,.921,6,24,30,34,8,2,23,53,300
12559,DEN,2022,DeMarcus Cousins,31,31,2,431,94,206,.456,24,74,.324,70,132,.530,.515,64,87,.736,50,122,172,53,19,13,69,93,276
12560,DEN,2022,PJ Dozier,25,18,0,340,36,99,.364,15,48,.313,21,51,.412,.439,10,13,.769,14,49,63,29,11,6,13,33,97
12561,DEN,2022,Michael Porter Jr.,23,9,9,265,37,103,.359,10,48,.208,27,55,.491,.408,5,9,.556,9,50,59,17,10,2,12,16,89
12562,DEN,2022,Vlatko Čančar,24,15,1,176,23,41,.561,7,12,.583,16,29,.552,.646,9,14,.643,8,23,31,17,2,3,9,18,62
12563,DEN,2022,Markus Howard,22,31,0,176,39,101,.386,28,70,.400,11,31,.355,.525,20,23,.870,2,10,12,7,9,0,7,17,126
12564,DEN,2022,Bol Bol,22,14,0,81,15,27,.556,1,4,.250,14,23,.609,.574,2,5,.400,4,16,20,5,1,2,4,4,33
12565,DEN,2022,Petr Cornelie,26,13,0,38,5,15,.333,1,8,.125,4,7,.571,.367,3,4,.750,7,7,14,3,1,1,4,7,14
12566,DEN,2022,Rayjon Tucker,24,3,0,29,1,2,.500,1,2,.500,0,0,,.750,3,4,.750,1,3,4,4,1,0,0,3,6
12567,DEN,2022,James Ennis III,31,3,0,14,2,6,.333,0,2,.000,2,4,.500,.333,0,1,.000,1,1,2,3,0,0,1,1,4
12568,DEN,2022,Carlik Jones,24,2,0,4,1,2,.500,0,0,,1,2,.500,.500,0,0,,0,0,0,0,0,0,0,0,2
12569,DEN,2021,Nikola Jokić,25,72,72,2488,732,1293,.566,92,237,.388,640,1056,.606,.602,342,394,.868,205,575,780,599,95,48,222,192,1898
12570,DEN,2021,Michael Porter Jr.,22,61,54,1912,443,817,.542,170,382,.445,273,435,.628,.646,106,134,.791,91,354,445,70,40,54,77,126,1162
12571,DEN,2021,Will Barton,30,56,52,1736,259,608,.426,98,257,.381,161,351,.459,.507,95,121,.785,39,187,226,181,50,23,96,95,711
12572,DEN,2021,Jamal Murray,23,48,48,1704,378,792,.477,129,316,.408,249,476,.523,.559,133,153,.869,37,157,194,231,64,13,108,95,1018
12573,DEN,2021,Facundo Campazzo,29,65,19,1425,120,315,.381,76,216,.352,44,99,.444,.502,80,91,.879,22,112,134,232,79,14,73,132,396
12574,DEN,2021,Monte Morris,25,47,13,1196,186,387,.481,51,134,.381,135,253,.534,.547,58,73,.795,11,85,96,150,34,13,34,48,481
12575,DEN,2021,Paul Millsap,35,56,36,1162,191,401,.476,49,143,.343,142,258,.550,.537,71,98,.724,76,186,262,98,51,36,51,111,502
12576,DEN,2021,JaMychal Green,30,58,5,1120,173,374,.463,79,198,.399,94,176,.534,.568,46,57,.807,85,192,277,53,26,22,53,144,471
12577,DEN,2021,PJ Dozier,24,50,6,1088,148,355,.417,47,149,.315,101,206,.490,.483,42,66,.636,35,147,182,92,31,22,46,86,385
12578,DEN,2021,Aaron Gordon,25,25,25,648,103,206,.500,17,64,.266,86,142,.606,.541,31,44,.705,38,80,118,56,17,14,30,40,254
12579,DEN,2021,Gary Harris,26,19,19,581,69,156,.442,24,75,.320,45,81,.556,.519,22,30,.733,13,34,47,32,17,4,14,37,184
12580,DEN,2021,Austin Rivers,28,15,5,403,46,110,.418,27,72,.375,19,38,.500,.541,12,17,.706,3,32,35,39,18,2,14,32,131
12581,DEN,2021,Zeke Nnaji,20,42,1,397,50,104,.481,24,59,.407,26,45,.578,.596,12,15,.800,14,51,65,10,8,4,7,29,136
12582,DEN,2021,Vlatko Čančar,23,41,1,281,33,72,.458,9,33,.273,24,39,.615,.521,10,13,.769,11,39,50,14,11,2,14,18,85
12583,DEN,2021,Shaquille Harrison,27,17,0,277,20,58,.345,3,14,.214,17,44,.386,.371,13,16,.813,4,35,39,16,15,5,6,30,56
12584,DEN,2021,Isaiah Hartenstein,22,30,0,272,41,80,.513,0,0,,41,80,.513,.513,22,36,.611,40,45,85,15,11,20,21,59,104
12585,DEN,2021,R.J. Hampton,19,25,0,233,25,60,.417,5,18,.278,20,42,.476,.458,9,12,.750,10,40,50,14,5,2,11,22,64
12586,DEN,2021,Markus Howard,21,37,1,205,40,106,.377,18,65,.277,22,41,.537,.462,7,9,.778,1,20,21,18,4,1,18,23,105
12587,DEN,2021,JaVale McGee,33,13,1,175,32,67,.478,0,4,.000,32,63,.508,.478,8,12,.667,23,46,69,6,3,14,15,41,72
12588,DEN,2021,Bol Bol,21,32,2,160,25,58,.431,9,24,.375,16,34,.471,.509,10,15,.667,0,24,24,7,3,10,13,14,69
12589,DEN,2021,Greg Whittington,27,4,0,12,0,3,.000,0,2,.000,0,1,.000,.000,0,0,,0,0,0,0,0,0,0,0,0
12590,DEN,2021,Gary Clark,26,2,0,4,0,0,,0,0,,0,0,,,0,0,,0,1,1,0,0,0,0,0,0
12591,DEN,2020,Nikola Jokić,24,73,73,2336,565,1071,.528,80,255,.314,485,816,.594,.565,246,301,.817,166,545,711,512,85,44,226,222,1456
12592,DEN,2020,Will Barton,29,58,58,1916,332,738,.450,108,288,.375,224,450,.498,.523,102,133,.767,76,289,365,212,61,29,88,121,874
12593,DEN,2020,Jamal Murray,22,59,59,1904,408,894,.456,112,324,.346,296,570,.519,.519,163,185,.881,45,191,236,284,67,17,127,102,1091
12594,DEN,2020,Jerami Grant,25,71,24,1892,303,634,.478,98,252,.389,205,382,.537,.555,147,196,.750,58,190,248,88,50,57,63,154,851
12595,DEN,2020,Gary Harris,25,56,55,1780,218,519,.420,70,210,.333,148,309,.479,.487,75,92,.815,26,137,163,118,76,14,60,116,581
12596,DEN,2020,Monte Morris,24,73,12,1636,260,566,.459,65,172,.378,195,394,.495,.517,75,89,.843,24,113,137,255,55,17,53,73,660
12597,DEN,2020,Paul Millsap,34,51,48,1240,211,438,.482,54,124,.435,157,314,.500,.543,115,141,.816,98,195,293,83,44,30,70,150,591
12598,DEN,2020,Torrey Craig,29,58,27,1072,124,269,.461,45,138,.326,79,131,.603,.545,22,36,.611,63,126,189,47,23,36,25,135,315
12599,DEN,2020,Mason Plumlee,29,61,1,1057,177,288,.615,0,5,.000,177,283,.625,.615,83,155,.535,98,219,317,154,33,38,82,143,437
12600,DEN,2020,Michael Porter Jr.,21,55,8,903,195,383,.509,62,147,.422,133,236,.564,.590,60,72,.833,66,193,259,46,27,25,49,100,512
12601,DEN,2020,Malik Beasley,23,41,0,746,117,301,.389,58,161,.360,59,140,.421,.485,33,38,.868,9,68,77,48,31,6,36,50,325
12602,DEN,2020,Juancho Hernangómez,24,34,0,422,38,110,.345,15,60,.250,23,50,.460,.414,16,25,.640,24,71,95,22,5,5,18,29,107
12603,DEN,2020,PJ Dozier,23,29,0,412,65,157,.414,17,49,.347,48,108,.444,.468,21,29,.724,10,45,55,63,14,6,27,45,168
12604,DEN,2020,Keita Bates-Diop,24,7,0,98,13,28,.464,3,9,.333,10,19,.526,.518,8,10,.800,4,13,17,0,2,4,3,7,37
12605,DEN,2020,Bol Bol,20,7,0,87,14,28,.500,4,9,.444,10,19,.526,.571,8,10,.800,5,14,19,6,2,6,10,11,40
12606,DEN,2020,Troy Daniels,28,6,0,76,10,28,.357,6,20,.300,4,8,.500,.464,0,0,,0,6,6,3,3,0,3,7,26
12607,DEN,2020,Vlatko Čančar,22,14,0,45,6,15,.400,1,6,.167,5,9,.556,.433,4,4,1.000,5,5,10,3,1,1,3,7,17
12608,DEN,2020,Jarred Vanderbilt,20,9,0,41,5,7,.714,0,0,,5,7,.714,.714,0,0,,3,5,8,2,3,1,7,6,10
12609,DEN,2020,Jordan McRae,28,4,0,32,2,6,.333,2,4,.500,0,2,.000,.500,3,4,.750,1,4,5,4,2,1,0,2,9
12610,DEN,2020,Noah Vonleh,24,7,0,30,5,6,.833,1,1,1.000,4,5,.800,.917,2,4,.500,3,5,8,2,0,0,2,4,13
12611,DEN,2020,Tyler Cook,22,2,0,19,1,2,.500,0,0,,1,2,.500,.500,2,2,1.000,2,2,4,0,2,0,2,1,4
12612,DEN,2019,Nikola Jokić,23,80,80,2504,616,1206,.511,83,270,.307,533,936,.569,.545,289,352,.821,228,637,865,580,108,55,248,228,1604
12613,DEN,2019,Jamal Murray,21,75,74,2447,513,1173,.437,152,414,.367,361,759,.476,.502,189,223,.848,65,252,317,363,67,27,158,153,1367
12614,DEN,2019,Monte Morris,23,82,6,1970,346,702,.493,94,227,.414,252,475,.531,.560,65,81,.802,35,159,194,297,73,4,52,102,851
12615,DEN,2019,Paul Millsap,33,70,65,1895,322,665,.484,58,159,.365,264,506,.522,.528,181,249,.727,153,352,505,141,83,54,95,183,883
12616,DEN,2019,Malik Beasley,22,81,18,1879,349,737,.474,163,405,.402,186,332,.560,.584,56,66,.848,35,165,200,97,55,10,55,116,917
12617,DEN,2019,Mason Plumlee,28,82,17,1731,262,442,.593,2,10,.200,260,432,.602,.595,111,198,.561,165,359,524,243,66,76,126,252,637
12618,DEN,2019,Gary Harris,24,57,48,1639,270,637,.424,82,242,.339,188,395,.476,.488,115,144,.799,41,119,160,127,55,19,68,113,737
12619,DEN,2019,Torrey Craig,28,75,37,1503,160,362,.442,61,188,.324,99,174,.569,.526,49,70,.700,89,174,263,72,37,46,44,175,430
12620,DEN,2019,Juancho Hernangómez,23,70,25,1358,138,314,.439,66,181,.365,72,133,.541,.545,66,86,.767,64,201,265,55,27,24,37,94,408
12621,DEN,2019,Will Barton,28,43,38,1189,185,460,.402,67,196,.342,118,264,.447,.475,57,74,.770,32,167,199,124,18,22,65,82,494
12622,DEN,2019,Trey Lyles,23,64,2,1120,207,495,.418,51,200,.255,156,295,.529,.470,81,116,.698,44,202,246,87,30,23,68,93,546
12623,DEN,2019,Isaiah Thomas,29,12,0,181,34,99,.343,12,43,.279,22,56,.393,.404,17,27,.630,5,8,13,23,5,1,18,17,97
12624,DEN,2019,Tyler Lydon,22,25,0,94,9,18,.500,4,10,.400,5,8,.625,.611,1,3,.333,7,11,18,6,2,0,4,10,23
12625,DEN,2019,Jarred Vanderbilt,19,17,0,69,9,19,.474,0,1,.000,9,18,.500,.474,6,10,.600,7,16,23,3,6,1,8,8,24
12626,DEN,2019,Brandon Goodwin,23,16,0,57,6,23,.261,2,6,.333,4,17,.235,.304,9,11,.818,1,2,3,14,0,0,3,7,23
12627,DEN,2019,Nick Young,33,4,0,37,3,9,.333,3,8,.375,0,1,.000,.500,0,0,,0,1,1,2,0,1,2,4,9
12628,DEN,2019,Thomas Welsh,22,11,0,36,7,13,.538,3,7,.429,4,6,.667,.654,1,2,.500,0,4,4,5,0,0,1,3,18
12629,DEN,2019,DeVaughn Akoon-Purcell,25,7,0,22,3,10,.300,0,4,.000,3,6,.500,.300,1,2,.500,1,3,4,6,2,0,2,4,7
12630,DEN,2018,Will Barton,27,81,40,2683,465,1028,.452,156,422,.370,309,606,.510,.528,182,226,.805,70,339,409,331,82,52,149,168,1268
12631,DEN,2018,Jamal Murray,20,81,80,2565,479,1062,.451,165,436,.378,314,626,.502,.529,229,253,.905,82,215,297,274,79,28,172,173,1352
12632,DEN,2018,Nikola Jokić,22,75,73,2443,504,1010,.499,111,280,.396,393,730,.538,.554,266,313,.850,195,608,803,458,90,61,210,212,1385
12633,DEN,2018,Wilson Chandler,30,74,71,2346,281,631,.445,88,246,.358,193,385,.501,.515,88,114,.772,102,296,398,159,43,39,92,156,738
12634,DEN,2018,Gary Harris,23,67,65,2304,440,908,.485,156,394,.396,284,514,.553,.570,134,162,.827,37,139,176,194,122,15,119,119,1170
12635,DEN,2018,Mason Plumlee,27,74,26,1439,221,368,.601,0,1,.000,221,367,.602,.601,82,179,.458,132,268,400,142,49,81,103,184,524
12636,DEN,2018,Trey Lyles,22,73,2,1391,270,550,.491,83,218,.381,187,332,.563,.566,101,143,.706,55,292,347,91,30,34,61,111,724
12637,DEN,2018,Paul Millsap,32,38,37,1143,202,435,.464,39,113,.345,163,322,.506,.509,112,161,.696,65,180,245,105,39,44,73,99,555
12638,DEN,2018,Emmanuel Mudiay,21,42,0,752,129,322,.401,38,102,.373,91,220,.414,.460,63,78,.808,16,78,94,121,21,4,72,47,359
12639,DEN,2018,Torrey Craig,27,39,5,629,62,137,.453,17,58,.293,45,79,.570,.515,22,35,.629,40,87,127,25,12,15,20,63,163
12640,DEN,2018,Malik Beasley,21,62,0,583,73,178,.410,28,82,.341,45,96,.469,.489,22,33,.667,14,57,71,31,15,7,24,36,196
12641,DEN,2018,Devin Harris,34,27,0,533,69,170,.406,35,102,.343,34,68,.500,.509,49,58,.845,3,39,42,67,14,4,27,55,222
12642,DEN,2018,Kenneth Faried,28,32,7,461,76,148,.514,0,1,.000,76,147,.517,.514,36,51,.706,68,85,153,18,12,13,23,51,188
12643,DEN,2018,Juancho Hernangómez,22,25,3,277,29,75,.387,14,50,.280,15,25,.600,.480,10,12,.833,18,36,54,12,6,3,9,25,82
12644,DEN,2018,Richard Jefferson,37,20,0,163,12,27,.444,2,7,.286,10,20,.500,.481,4,7,.571,2,15,17,15,2,1,5,11,30
12645,DEN,2018,Darrell Arthur,29,19,1,141,22,47,.468,8,23,.348,14,24,.583,.553,2,3,.667,3,12,15,9,8,3,15,22,54
12646,DEN,2018,Monte Morris,22,3,0,25,4,6,.667,0,1,.000,4,5,.800,.667,2,2,1.000,0,2,2,7,3,0,1,1,10
12647,DEN,2018,Tyler Lydon,21,1,0,2,0,0,,0,0,,0,0,,,0,0,,0,0,0,0,0,0,0,0,0
12648,DEN,2017,Wilson Chandler,29,71,33,2197,433,939,.461,110,326,.337,323,613,.527,.520,141,194,.727,103,357,460,141,51,30,114,172,1117
12649,DEN,2017,Danilo Gallinari,28,63,63,2134,335,750,.447,126,324,.389,209,426,.491,.531,349,387,.902,39,286,325,135,40,15,82,93,1145
12650,DEN,2017,Jameer Nelson,34,75,39,2045,268,604,.444,106,273,.388,162,331,.489,.531,45,63,.714,28,164,192,385,54,8,128,197,687
12651,DEN,2017,Nikola Jokić,21,73,59,2038,494,854,.578,45,139,.324,449,715,.628,.605,188,228,.825,212,506,718,359,61,55,171,214,1221
12652,DEN,2017,Gary Harris,22,57,56,1782,320,637,.502,107,255,.420,213,382,.558,.586,104,134,.776,48,130,178,164,71,8,76,92,851
12653,DEN,2017,Jamal Murray,19,82,10,1764,295,730,.404,115,344,.334,180,386,.466,.483,106,120,.883,41,173,214,170,51,24,113,124,811
12654,DEN,2017,Will Barton,26,60,19,1705,295,666,.443,87,235,.370,208,431,.483,.508,143,190,.753,58,201,259,206,48,28,97,110,820
12655,DEN,2017,Emmanuel Mudiay,20,55,41,1406,208,551,.377,56,178,.315,152,373,.408,.428,131,167,.784,29,149,178,217,41,13,123,95,603
12656,DEN,2017,Kenneth Faried,27,61,34,1296,228,416,.548,0,6,.000,228,410,.556,.548,131,189,.693,183,279,462,55,43,40,59,124,587
12657,DEN,2017,Juancho Hernangómez,21,62,9,842,101,224,.451,46,113,.407,55,111,.495,.554,57,76,.750,43,144,187,29,30,12,31,62,305
12658,DEN,2017,Jusuf Nurkić,22,45,29,807,151,298,.507,0,0,,151,298,.507,.507,56,113,.496,89,171,260,60,25,36,81,88,358
12659,DEN,2017,Darrell Arthur,28,41,7,639,95,215,.442,53,117,.453,42,98,.429,.565,19,22,.864,25,87,112,42,19,21,36,76,262
12660,DEN,2017,Mason Plumlee,26,27,10,632,99,181,.547,0,1,.000,99,180,.550,.547,47,76,.618,50,123,173,70,19,29,46,77,245
12661,DEN,2017,Malik Beasley,20,22,1,165,33,73,.452,9,28,.321,24,45,.533,.514,8,10,.800,5,12,17,11,7,0,8,10,83
12662,DEN,2017,Mike Miller,36,20,0,151,9,23,.391,8,20,.400,1,3,.333,.565,2,2,1.000,2,36,38,22,2,0,13,9,28
12663,DEN,2017,Alonzo Gee,29,13,0,89,3,14,.214,0,3,.000,3,11,.273,.214,5,9,.556,4,11,15,6,5,1,4,14,11
12664,DEN,2017,Johnny O'Bryant,23,7,0,46,7,15,.467,2,3,.667,5,12,.417,.533,4,4,1.000,5,6,11,2,0,1,3,4,20
12665,DEN,2017,Roy Hibbert,30,6,0,11,2,3,.667,0,0,,2,3,.667,.667,0,0,,1,1,2,1,0,2,1,3,4
12666,DEN,2017,Jarnell Stokes,23,2,0,7,1,1,1.000,0,0,,1,1,1.000,1.000,1,2,.500,1,1,2,2,1,0,0,3,3
12667,DEN,2016,Gary Harris,21,76,76,2439,359,765,.469,105,297,.354,254,468,.543,.538,109,133,.820,54,166,220,147,97,18,98,143,932
12668,DEN,2016,Will Barton,25,82,1,2353,425,983,.432,112,325,.345,313,658,.476,.489,216,268,.806,59,417,476,203,71,39,139,147,1178
12669,DEN,2016,Emmanuel Mudiay,19,68,66,2068,329,905,.364,74,232,.319,255,673,.379,.404,140,209,.670,32,200,232,372,65,35,217,141,872
12670,DEN,2016,Danilo Gallinari,27,53,53,1839,287,700,.410,87,239,.364,200,461,.434,.472,375,432,.868,52,229,281,135,42,19,77,87,1036
12671,DEN,2016,Nikola Jokić,20,80,55,1733,307,600,.512,28,84,.333,279,516,.541,.535,154,190,.811,181,379,560,189,79,50,104,208,796
12672,DEN,2016,Kenneth Faried,26,67,64,1694,349,626,.558,1,2,.500,348,624,.558,.558,136,222,.613,235,346,581,79,32,60,91,169,835
12673,DEN,2016,Darrell Arthur,27,70,16,1516,221,489,.452,45,117,.385,176,372,.473,.498,40,53,.755,86,207,293,96,53,48,66,185,527
12674,DEN,2016,Randy Foye,32,54,7,1070,117,333,.351,50,169,.296,67,164,.409,.426,39,47,.830,16,89,105,112,26,16,58,83,323
12675,DEN,2016,Joffrey Lauvergne,24,59,15,1041,195,380,.513,13,53,.245,182,327,.557,.530,62,69,.899,77,213,290,56,13,15,54,115,465
12676,DEN,2016,Jameer Nelson,33,39,15,1036,113,307,.368,43,144,.299,70,163,.429,.438,30,35,.857,19,96,115,190,25,5,66,100,299
12677,DEN,2016,D.J. Augustin,28,28,0,659,102,229,.445,44,107,.411,58,122,.475,.541,77,94,.819,3,49,52,132,25,2,54,44,325
12678,DEN,2016,Jusuf Nurkić,21,32,3,547,101,242,.417,0,3,.000,101,239,.423,.417,61,99,.616,65,110,175,40,24,44,55,91,263
12679,DEN,2016,JaKarr Sampson,22,26,22,469,54,115,.470,8,29,.276,46,86,.535,.504,18,25,.720,16,45,61,16,12,17,19,51,134
12680,DEN,2016,Mike Miller,35,47,2,373,22,62,.355,19,52,.365,3,10,.300,.508,0,0,,6,47,53,40,13,4,17,53,63
12681,DEN,2016,J.J. Hickson,27,20,9,305,55,109,.505,0,0,,55,109,.505,.505,27,59,.458,22,65,87,16,10,12,16,35,137
12682,DEN,2016,Axel Toupane,23,21,0,305,25,70,.357,13,40,.325,12,30,.400,.450,13,17,.765,8,23,31,15,7,6,6,40,76
12683,DEN,2016,Kostas Papanikolaou,25,26,6,294,24,66,.364,10,32,.313,14,34,.412,.439,9,14,.643,8,32,40,16,13,5,21,24,67
12684,DEN,2016,Sean Kilpatrick,26,8,0,82,8,21,.381,4,17,.235,4,4,1.000,.476,7,8,.875,2,4,6,3,2,0,4,7,27
12685,DEN,2016,Erick Green,24,3,0,7,0,1,.000,0,1,.000,0,0,,.000,0,0,,0,1,1,1,0,0,0,0,0
12686,DEN,2015,Ty Lawson,27,75,75,2665,404,926,.436,70,205,.341,334,721,.463,.474,265,363,.730,42,192,234,720,92,9,185,128,1143
12687,DEN,2015,Wilson Chandler,27,78,75,2471,418,975,.429,139,406,.342,279,569,.490,.500,110,142,.775,96,379,475,134,58,29,110,231,1085
12688,DEN,2015,Kenneth Faried,25,75,71,2086,373,736,.507,1,8,.125,372,728,.511,.507,199,288,.691,242,426,668,89,62,57,118,211,946
12689,DEN,2015,Arron Afflalo,29,53,53,1750,281,657,.428,82,243,.337,199,414,.481,.490,127,151,.841,21,159,180,101,32,5,83,108,771
12690,DEN,2015,Danilo Gallinari,26,59,27,1426,228,568,.401,107,301,.355,121,267,.453,.496,171,191,.895,31,187,218,83,47,20,57,94,734
12691,DEN,2015,J.J. Hickson,26,73,8,1411,218,459,.475,0,2,.000,218,457,.477,.475,116,201,.577,150,302,452,57,36,35,96,136,552
12692,DEN,2015,Jusuf Nurkić,20,62,27,1103,171,383,.446,0,2,.000,171,381,.449,.446,84,132,.636,125,257,382,50,52,68,86,207,426
12693,DEN,2015,Randy Foye,31,50,21,1087,148,402,.368,94,263,.357,54,139,.388,.485,45,55,.818,9,76,85,119,34,11,60,97,435
12694,DEN,2015,Darrell Arthur,26,58,4,988,155,384,.404,26,110,.236,129,274,.471,.438,46,59,.780,53,118,171,57,48,26,47,146,382
12695,DEN,2015,Timofey Mozgov,28,35,35,897,117,232,.504,2,6,.333,115,226,.509,.509,63,86,.733,91,181,272,16,15,41,47,114,299
12696,DEN,2015,Gary Harris,20,55,6,719,66,217,.304,21,103,.204,45,114,.395,.353,35,47,.745,21,43,64,29,39,7,38,71,188
12697,DEN,2015,Jameer Nelson,32,34,5,702,135,300,.450,46,130,.354,89,170,.524,.527,11,19,.579,16,50,66,125,25,4,61,70,327
12698,DEN,2015,Will Barton,24,28,0,683,112,253,.443,19,67,.284,93,186,.500,.480,64,79,.810,23,105,128,54,34,15,44,50,307
12699,DEN,2015,Alonzo Gee,27,39,0,511,66,137,.482,10,24,.417,56,113,.496,.518,48,65,.738,29,41,70,19,28,6,25,42,190
12700,DEN,2015,Nate Robinson,30,33,1,465,71,204,.348,24,92,.261,47,112,.420,.407,26,40,.650,14,25,39,77,14,3,22,68,192
12701,DEN,2015,Erick Green,23,43,1,410,61,162,.377,14,47,.298,47,115,.409,.420,10,12,.833,7,24,31,39,12,0,14,26,146
12702,DEN,2015,Joffrey Lauvergne,23,24,1,268,36,89,.404,3,16,.188,33,73,.452,.421,18,28,.643,27,50,77,13,8,10,22,43,93
12703,DEN,2015,JaVale McGee,27,17,0,195,34,61,.557,0,0,,34,61,.557,.557,20,29,.690,14,34,48,1,2,19,13,28,88
12704,DEN,2015,Ian Clark,23,7,0,31,4,11,.364,1,5,.200,3,6,.500,.409,4,4,1.000,0,3,3,2,3,1,2,8,13
12705,DEN,2015,Jamaal Franklin,23,3,0,13,1,2,.500,1,2,.500,0,0,,.750,0,0,,1,1,2,3,0,1,3,4,3
12706,DEN,2014,Randy Foye,30,81,78,2485,361,875,.413,189,498,.380,172,377,.456,.521,157,185,.849,36,196,232,287,67,39,145,205,1068
12707,DEN,2014,Ty Lawson,26,62,61,2222,347,806,.431,72,202,.356,275,604,.455,.475,324,406,.798,40,175,215,543,100,10,200,113,1090
12708,DEN,2014,Kenneth Faried,24,80,77,2178,447,820,.545,0,3,.000,447,817,.547,.545,202,311,.650,238,446,684,96,70,69,135,193,1096
12709,DEN,2014,Wilson Chandler,26,62,55,1927,307,738,.416,122,351,.348,185,387,.478,.499,110,152,.724,58,236,294,114,46,31,79,193,846
12710,DEN,2014,J.J. Hickson,25,69,52,1859,332,654,.508,0,8,.000,332,646,.514,.508,150,290,.517,206,426,632,96,47,51,128,177,814
12711,DEN,2014,Timofey Mozgov,27,82,30,1770,285,545,.523,4,24,.167,281,521,.539,.527,196,260,.754,171,357,528,62,27,100,122,213,770
12712,DEN,2014,Evan Fournier,21,76,4,1503,228,544,.419,89,237,.376,139,307,.453,.501,93,123,.756,34,168,202,112,34,7,100,179,638
12713,DEN,2014,Darrell Arthur,25,68,1,1161,162,410,.395,24,64,.375,138,346,.399,.424,53,62,.855,52,158,210,61,39,47,58,185,401
12714,DEN,2014,Nate Robinson,29,44,1,866,164,383,.428,58,154,.377,106,229,.463,.504,71,85,.835,21,60,81,112,36,4,58,92,457
12715,DEN,2014,Aaron Brooks,29,29,12,841,129,318,.406,42,116,.362,87,202,.431,.472,46,51,.902,20,58,78,150,27,7,66,70,346
12716,DEN,2014,Quincy Miller,21,52,16,789,94,256,.367,30,94,.319,64,162,.395,.426,39,55,.709,36,111,147,26,22,32,48,70,257
12717,DEN,2014,Jordan Hamilton,23,39,11,670,99,254,.390,45,129,.349,54,125,.432,.478,23,31,.742,23,110,133,34,31,13,27,31,266
12718,DEN,2014,Andre Miller,37,30,2,570,66,144,.458,9,18,.500,57,126,.452,.490,35,47,.745,16,57,73,100,15,7,33,32,176
12719,DEN,2014,Anthony Randolph,24,43,5,527,68,176,.386,18,61,.295,50,115,.435,.438,52,69,.754,20,102,122,32,26,19,39,64,206
12720,DEN,2014,Jan Veselý,23,21,0,306,41,81,.506,0,0,,41,81,.506,.506,11,26,.423,28,50,78,11,27,16,14,57,93
12721,DEN,2014,JaVale McGee,26,5,5,79,17,38,.447,0,0,,17,38,.447,.447,1,1,1.000,10,7,17,2,1,7,8,16,35
12722,DEN,2013,Andre Iguodala,29,80,80,2779,396,879,.451,91,287,.317,305,592,.515,.502,155,270,.574,82,341,423,433,139,52,206,127,1038
12723,DEN,2013,Ty Lawson,25,73,71,2513,448,971,.461,85,232,.366,363,739,.491,.505,235,311,.756,36,162,198,501,107,8,182,135,1216
12724,DEN,2013,Danilo Gallinari,24,71,71,2309,364,871,.418,135,362,.373,229,509,.450,.495,286,348,.822,65,302,367,176,64,36,111,130,1149
12725,DEN,2013,Kenneth Faried,23,80,80,2248,380,689,.552,0,0,,380,689,.552,.552,163,266,.613,260,474,734,77,81,83,113,234,923
12726,DEN,2013,Andre Miller,36,82,11,2151,303,632,.479,17,64,.266,286,568,.504,.493,163,194,.840,60,178,238,484,73,11,172,159,786
12727,DEN,2013,Corey Brewer,26,82,2,2003,375,883,.425,91,307,.296,284,576,.493,.476,149,216,.690,55,180,235,124,118,23,102,154,990
12728,DEN,2013,Kosta Koufos,23,81,81,1817,295,508,.581,0,1,.000,295,507,.582,.581,58,104,.558,211,351,562,32,44,103,53,246,648
12729,DEN,2013,JaVale McGee,25,79,0,1433,303,527,.575,1,1,1.000,302,526,.574,.576,110,186,.591,158,223,381,24,30,157,90,184,717
12730,DEN,2013,Wilson Chandler,25,43,8,1079,210,455,.462,52,126,.413,158,329,.480,.519,88,111,.793,45,173,218,58,45,12,60,119,560
12731,DEN,2013,Evan Fournier,20,38,4,428,75,152,.493,22,54,.407,53,98,.541,.566,30,39,.769,6,29,35,44,19,1,32,65,202
12732,DEN,2013,Jordan Hamilton,22,40,1,397,84,201,.418,27,73,.370,57,128,.445,.485,13,26,.500,32,63,95,23,15,8,19,24,208
12733,DEN,2013,Timofey Mozgov,26,41,1,366,44,87,.506,0,2,.000,44,85,.518,.506,20,26,.769,50,57,107,9,6,18,25,57,108
12734,DEN,2013,Anthony Randolph,23,39,0,329,56,114,.491,0,8,.000,56,106,.528,.491,31,45,.689,29,66,95,12,19,21,37,41,143
12735,DEN,2013,Julyan Stone,24,4,0,28,2,2,1.000,0,0,,2,2,1.000,1.000,3,4,.750,2,1,3,2,1,0,2,4,7
12736,DEN,2013,Quincy Miller,20,7,0,26,4,12,.333,0,1,.000,4,11,.364,.333,1,2,.500,1,1,2,3,1,0,1,3,9
12737,DEN,2012,Ty Lawson,24,61,61,2124,374,767,.488,73,200,.365,301,567,.531,.535,178,216,.824,54,173,227,401,82,6,149,94,999
12738,DEN,2012,Arron Afflalo,26,62,62,2086,329,699,.471,88,221,.398,241,478,.504,.534,197,247,.798,40,157,197,149,36,13,85,134,943
12739,DEN,2012,Andre Miller,35,66,7,1809,242,552,.438,18,83,.217,224,469,.478,.455,137,169,.811,53,168,221,441,63,9,177,133,639
12740,DEN,2012,Al Harrington,31,64,1,1761,345,773,.446,101,303,.333,244,470,.519,.512,119,176,.676,72,318,390,88,58,12,112,181,910
12741,DEN,2012,Danilo Gallinari,23,43,40,1351,193,466,.414,60,183,.328,133,283,.470,.479,182,209,.871,28,174,202,116,42,23,68,86,628
12742,DEN,2012,Corey Brewer,25,59,17,1287,201,463,.434,33,127,.260,168,336,.500,.470,90,130,.692,43,107,150,88,72,17,56,113,525
12743,DEN,2012,Kenneth Faried,22,46,39,1037,181,309,.586,0,0,,181,309,.586,.586,109,164,.665,142,210,352,36,34,47,54,116,471
12744,DEN,2012,Nenê,29,28,27,826,143,281,.509,0,2,.000,143,279,.513,.509,90,133,.677,43,165,208,61,36,25,77,69,376
12745,DEN,2012,Kosta Koufos,22,48,24,792,115,192,.599,0,0,,115,192,.599,.599,33,55,.600,95,163,258,15,24,41,33,96,263
12746,DEN,2012,Rudy Fernández,26,31,1,710,99,225,.440,40,122,.328,59,103,.573,.529,30,43,.698,9,56,65,75,31,3,40,37,268
12747,DEN,2012,Timofey Mozgov,25,44,35,687,100,190,.526,0,0,,100,190,.526,.526,39,57,.684,53,126,179,22,15,42,53,86,239
12748,DEN,2012,Chris Andersen,33,32,1,486,59,108,.546,0,0,,59,108,.546,.546,50,82,.610,48,100,148,6,19,46,17,52,168
12749,DEN,2012,JaVale McGee,24,20,5,411,93,152,.612,0,0,,93,152,.612,.612,19,51,.373,36,79,115,6,10,31,19,48,205
12750,DEN,2012,Jordan Hamilton,21,26,2,258,48,111,.432,17,47,.362,31,64,.484,.509,2,5,.400,11,51,62,20,4,3,16,15,115
12751,DEN,2012,Wilson Chandler,24,8,6,215,31,79,.392,3,12,.250,28,67,.418,.411,10,12,.833,6,35,41,17,6,6,18,18,75
12752,DEN,2012,Julyan Stone,23,22,2,179,13,31,.419,2,11,.182,11,20,.550,.452,8,11,.727,5,20,25,37,8,6,11,18,36
12753,DEN,2012,DeMarre Carroll,25,4,0,21,6,6,1.000,0,0,,6,6,1.000,1.000,0,0,,0,3,3,3,0,0,2,1,12
12754,DEN,2011,Arron Afflalo,25,69,69,2324,312,627,.498,105,248,.423,207,379,.546,.581,138,163,.847,45,206,251,168,34,31,71,153,867
12755,DEN,2011,Nenê,28,75,75,2291,402,654,.615,1,5,.200,401,649,.618,.615,286,402,.711,145,426,571,149,84,73,134,238,1091
12756,DEN,2011,Ty Lawson,23,80,31,2103,346,688,.503,69,171,.404,277,517,.536,.553,172,225,.764,67,142,209,377,80,4,137,133,933
12757,DEN,2011,J.R. Smith,25,79,6,1968,341,784,.435,124,318,.390,217,466,.466,.514,163,221,.738,45,277,322,175,92,16,100,173,969
12758,DEN,2011,Carmelo Anthony,26,50,50,1774,437,967,.452,42,126,.333,395,841,.470,.474,343,417,.823,77,305,382,140,43,31,142,134,1259
12759,DEN,2011,Al Harrington,30,73,3,1665,281,675,.416,117,328,.357,164,347,.473,.503,86,117,.735,76,256,332,101,39,10,106,202,765
12760,DEN,2011,Chauncey Billups,34,51,51,1646,235,536,.438,105,238,.441,130,298,.436,.536,265,287,.923,12,113,125,271,52,12,129,94,840
12761,DEN,2011,Kenyon Martin,33,48,48,1233,185,362,.511,2,9,.222,183,353,.518,.514,42,72,.583,67,230,297,109,43,35,59,136,414
12762,DEN,2011,Gary Forbes,25,63,11,791,124,273,.454,19,58,.328,105,215,.488,.489,59,87,.678,28,88,116,49,23,6,46,77,326
12763,DEN,2011,Chris Andersen,32,45,0,732,82,137,.599,0,1,.000,82,136,.603,.599,86,135,.637,75,144,219,20,23,58,25,79,250
12764,DEN,2011,Shelden Williams,27,42,32,713,82,181,.453,0,0,,82,181,.453,.453,34,46,.739,74,149,223,19,18,22,37,92,198
12765,DEN,2011,Raymond Felton,26,21,0,663,88,204,.431,28,61,.459,60,143,.420,.500,37,60,.617,8,67,75,137,28,0,45,37,241
12766,DEN,2011,Wilson Chandler,23,21,19,642,101,241,.419,26,75,.347,75,166,.452,.473,34,42,.810,13,92,105,34,14,24,37,47,262
12767,DEN,2011,Danilo Gallinari,22,14,12,433,54,131,.412,20,54,.370,34,77,.442,.489,78,101,.772,11,65,76,22,13,9,25,27,206
12768,DEN,2011,Melvin Ely,32,30,2,366,28,51,.549,0,0,,28,51,.549,.549,13,21,.619,27,47,74,14,4,11,14,50,69
12769,DEN,2011,Anthony Carter,35,14,0,153,10,30,.333,4,12,.333,6,18,.333,.400,2,2,1.000,0,12,12,26,9,1,14,19,26
12770,DEN,2011,Kosta Koufos,21,11,1,98,21,42,.500,0,0,,21,42,.500,.500,12,19,.632,15,18,33,0,2,5,6,9,54
12771,DEN,2011,Timofey Mozgov,24,11,0,66,11,21,.524,0,0,,11,21,.524,.524,6,8,.750,5,12,17,0,1,2,3,8,28
12772,DEN,2011,Renaldo Balkman,26,5,0,44,5,9,.556,0,0,,5,9,.556,.556,3,4,.750,1,3,4,2,3,2,0,11,13
12773,DEN,2010,Nenê,27,82,82,2755,421,717,.587,0,2,.000,421,715,.589,.587,293,416,.704,166,461,627,203,115,82,125,281,1135
12774,DEN,2010,Carmelo Anthony,25,69,69,2634,688,1502,.458,59,187,.316,629,1315,.478,.478,508,612,.830,152,302,454,222,88,30,209,225,1943
12775,DEN,2010,Chauncey Billups,33,73,73,2490,402,962,.418,157,407,.386,245,555,.441,.499,466,512,.910,25,203,228,409,82,9,177,153,1427
12776,DEN,2010,Arron Afflalo,24,82,75,2221,272,585,.465,108,249,.434,164,336,.488,.557,72,98,.735,59,193,252,138,46,30,74,225,724
12777,DEN,2010,J.R. Smith,24,75,0,2082,428,1033,.414,158,467,.338,270,566,.477,.491,142,201,.706,28,206,234,183,99,20,139,174,1156
12778,DEN,2010,Kenyon Martin,32,58,58,1986,283,620,.456,8,29,.276,275,591,.465,.463,93,167,.557,142,404,546,109,72,61,91,186,667
12779,DEN,2010,Chris Andersen,31,76,0,1695,142,251,.566,0,3,.000,142,248,.573,.566,164,236,.695,147,336,483,33,42,143,59,171,448
12780,DEN,2010,Ty Lawson,22,65,8,1318,201,390,.515,34,83,.410,167,307,.544,.559,106,140,.757,42,82,124,203,48,2,82,89,542
12781,DEN,2010,Anthony Carter,34,54,7,859,76,181,.420,17,63,.270,59,118,.500,.467,11,13,.846,17,72,89,160,39,13,58,72,180
12782,DEN,2010,Joey Graham,27,63,18,759,105,202,.520,2,13,.154,103,189,.545,.525,54,73,.740,39,84,123,22,23,7,43,104,266
12783,DEN,2010,Malik Allen,31,51,3,456,46,116,.397,1,6,.167,45,110,.409,.401,12,13,.923,36,46,82,16,11,5,22,68,105
12784,DEN,2010,Johan Petro,24,36,16,436,54,101,.535,0,1,.000,54,100,.540,.535,14,21,.667,32,97,129,14,10,13,23,80,122
12785,DEN,2010,Renaldo Balkman,25,13,1,91,6,18,.333,0,7,.000,6,11,.545,.333,2,6,.333,4,19,23,7,8,2,6,16,14
12786,DEN,2009,Chauncey Billups,32,77,77,2719,403,959,.420,160,390,.410,243,569,.427,.504,409,448,.913,31,198,229,491,90,17,173,158,1375
12787,DEN,2009,Nenê,26,77,76,2510,428,709,.604,1,5,.200,427,704,.607,.604,266,368,.723,183,415,598,108,95,101,147,278,1123
12788,DEN,2009,Carmelo Anthony,24,66,66,2277,535,1207,.443,63,170,.371,472,1037,.455,.469,371,468,.793,106,344,450,222,75,24,199,195,1504
12789,DEN,2009,J.R. Smith,23,81,18,2245,424,950,.446,180,453,.397,244,497,.491,.541,205,272,.754,43,254,297,227,78,14,150,190,1233
12790,DEN,2009,Kenyon Martin,31,66,66,2111,318,648,.491,14,38,.368,304,610,.498,.502,119,197,.604,81,314,395,132,96,74,104,201,769
12791,DEN,2009,Linas Kleiza,24,82,7,1824,289,646,.447,87,267,.326,202,379,.533,.515,148,204,.725,92,235,327,64,31,14,82,155,813
12792,DEN,2009,Anthony Carter,33,78,5,1787,167,386,.433,21,88,.239,146,298,.490,.460,57,78,.731,40,165,205,364,96,13,155,142,412
12793,DEN,2009,Chris Andersen,30,71,1,1460,160,292,.548,2,10,.200,158,282,.560,.551,130,181,.718,163,279,442,31,41,175,69,174,452
12794,DEN,2009,Dahntay Jones,28,79,71,1426,154,336,.458,11,17,.647,143,319,.448,.475,110,151,.728,58,110,168,78,49,19,68,199,429
12795,DEN,2009,Renaldo Balkman,24,53,10,780,110,197,.558,2,7,.286,108,190,.568,.563,42,65,.646,86,117,203,34,47,23,35,98,264
12796,DEN,2009,Johan Petro,23,27,10,217,27,63,.429,0,1,.000,27,62,.435,.429,6,14,.429,15,48,63,10,3,10,13,56,60
12797,DEN,2009,Allen Iverson,33,3,3,123,18,40,.450,2,8,.250,16,32,.500,.475,18,25,.720,3,5,8,20,3,1,10,3,56
12798,DEN,2009,Chucky Atkins,34,14,0,115,9,27,.333,5,17,.294,4,10,.400,.426,4,4,1.000,0,6,6,28,2,1,10,5,27
12799,DEN,2009,Sonny Weems,22,12,0,55,8,25,.320,0,3,.000,8,22,.364,.320,3,8,.375,0,4,4,3,1,0,6,8,19
12800,DEN,2009,Jason Hart,30,11,0,36,5,10,.500,0,2,.000,5,8,.625,.500,3,4,.750,1,3,4,5,0,0,3,4,13
12801,DEN,2009,Cheikh Samb,24,6,0,24,2,13,.154,0,1,.000,2,12,.167,.154,0,0,,2,7,9,1,2,5,2,4,4
12802,DEN,2009,Juwan Howard,35,3,0,22,1,2,.500,0,0,,1,2,.500,.500,0,0,,1,3,4,2,1,1,0,4,2
12803,DEN,2008,Allen Iverson,32,82,82,3424,712,1556,.458,95,275,.345,617,1281,.482,.488,645,797,.809,47,196,243,586,160,12,245,109,2164
12804,DEN,2008,Carmelo Anthony,23,77,77,2806,728,1481,.492,58,164,.354,670,1317,.509,.511,464,590,.786,178,393,571,259,98,39,253,253,1978
12805,DEN,2008,Marcus Camby,33,79,79,2758,286,635,.450,6,20,.300,280,615,.455,.455,143,202,.708,230,807,1037,259,85,285,118,216,721
12806,DEN,2008,Kenyon Martin,30,71,71,2159,376,699,.538,2,11,.182,374,688,.544,.539,123,212,.580,105,356,461,90,88,85,91,235,877
12807,DEN,2008,Anthony Carter,32,70,67,1960,218,476,.458,45,129,.349,173,347,.499,.505,64,85,.753,27,173,200,388,107,28,124,172,545
12808,DEN,2008,Linas Kleiza,23,79,13,1889,311,659,.472,94,277,.339,217,382,.568,.543,164,213,.770,92,241,333,95,44,19,89,181,880
12809,DEN,2008,Eduardo Nájera,31,78,3,1664,174,368,.473,53,147,.361,121,221,.548,.545,63,89,.708,113,224,337,95,69,40,59,199,464
12810,DEN,2008,J.R. Smith,22,74,0,1421,311,674,.461,157,390,.403,154,284,.542,.578,128,178,.719,43,109,152,128,62,12,112,144,907
12811,DEN,2008,Yakhouba Diawara,25,54,14,542,55,134,.410,21,66,.318,34,68,.500,.489,22,31,.710,23,39,62,37,8,3,16,61,153
12812,DEN,2008,Chucky Atkins,33,24,0,352,42,122,.344,25,79,.316,17,43,.395,.447,4,9,.444,3,28,31,47,9,1,10,27,113
12813,DEN,2008,Nenê,25,16,1,266,29,71,.408,0,1,.000,29,70,.414,.408,27,49,.551,30,57,87,15,9,14,21,46,85
12814,DEN,2008,Bobby Jones,24,25,0,222,26,64,.406,9,23,.391,17,41,.415,.477,23,28,.821,11,27,38,11,5,1,14,46,84
12815,DEN,2008,Mike Wilks,28,8,0,122,10,23,.435,2,5,.400,8,18,.444,.478,2,2,1.000,4,8,12,6,5,0,5,9,24
12816,DEN,2008,Steven Hunter,26,19,2,120,15,28,.536,0,0,,15,28,.536,.536,9,20,.450,10,19,29,0,0,6,7,20,39
12817,DEN,2008,Von Wafer,22,21,0,90,10,38,.263,1,15,.067,9,23,.391,.276,6,8,.750,1,9,10,5,2,1,11,4,27
12818,DEN,2008,Jelani McCoy,30,6,1,33,1,1,1.000,0,0,,1,1,1.000,1.000,1,2,.500,1,6,7,0,0,5,4,7,3
12819,DEN,2008,Taurean Green,21,9,0,30,3,9,.333,1,3,.333,2,6,.333,.389,3,4,.750,0,6,6,3,1,0,2,2,10
12820,DEN,2007,Carmelo Anthony,22,65,65,2486,691,1453,.476,40,149,.268,651,1304,.499,.489,459,568,.808,143,248,391,249,77,23,234,203,1881
12821,DEN,2007,Marcus Camby,32,70,70,2369,312,659,.473,0,2,.000,312,657,.475,.473,161,221,.729,164,652,816,223,87,231,122,183,785
12822,DEN,2007,Allen Iverson,31,50,49,2121,430,947,.454,50,144,.347,380,803,.473,.480,331,436,.759,16,136,152,359,90,12,202,74,1241
12823,DEN,2007,Nenê,24,64,42,1715,294,516,.570,0,1,.000,294,515,.571,.570,195,283,.689,150,299,449,77,62,59,127,209,783
12824,DEN,2007,Eduardo Nájera,30,75,36,1658,204,354,.576,1,12,.083,203,342,.594,.578,88,123,.715,131,179,310,64,73,26,56,207,497
12825,DEN,2007,Steve Blake,26,49,40,1642,164,380,.432,48,140,.343,116,240,.483,.495,32,44,.727,14,110,124,324,51,5,101,72,408
12826,DEN,2007,Linas Kleiza,22,79,14,1488,200,474,.422,83,221,.376,117,253,.462,.509,115,135,.852,77,189,266,45,28,14,79,200,598
12827,DEN,2007,J.R. Smith,21,63,24,1471,284,644,.441,149,382,.390,135,262,.515,.557,102,126,.810,30,113,143,91,49,9,85,147,819
12828,DEN,2007,Yakhouba Diawara,24,64,19,1177,100,292,.342,49,170,.288,51,122,.418,.426,35,53,.660,27,83,110,55,30,7,37,132,284
12829,DEN,2007,Reggie Evans,26,66,11,1127,117,215,.544,0,0,,117,215,.544,.544,91,183,.497,156,304,460,45,42,16,95,144,325
12830,DEN,2007,Earl Boykins,30,31,4,877,156,378,.413,41,110,.373,115,268,.429,.467,119,131,.908,23,40,63,132,25,2,52,31,472
12831,DEN,2007,Andre Miller,30,23,23,822,117,248,.472,4,16,.250,113,232,.487,.480,62,85,.729,25,79,104,209,37,4,70,58,300
12832,DEN,2007,DerMarr Johnson,26,39,7,419,50,154,.325,19,88,.216,31,66,.470,.386,16,21,.762,10,47,57,17,16,12,27,39,135
12833,DEN,2007,Joe Smith,31,11,0,148,23,48,.479,0,1,.000,23,47,.489,.479,10,12,.833,13,27,40,3,6,7,13,23,56
12834,DEN,2007,Jamal Sampson,23,22,3,125,9,14,.643,0,1,.000,9,13,.692,.643,6,14,.429,15,33,48,5,2,7,10,17,24
12835,DEN,2007,Kenyon Martin,29,2,2,63,8,16,.500,0,1,.000,8,15,.533,.500,3,12,.250,6,14,20,1,0,0,5,10,19
12836,DEN,2007,Julius Hodge,23,4,1,37,2,5,.400,0,0,,2,5,.400,.400,2,2,1.000,1,2,3,10,3,0,1,3,6
12837,DEN,2007,Anthony Carter,31,2,0,37,3,8,.375,0,2,.000,3,6,.500,.375,0,0,,0,3,3,11,0,1,6,4,6
12838,DEN,2006,Carmelo Anthony,21,80,80,2941,756,1572,.481,37,152,.243,719,1420,.506,.493,573,709,.808,122,272,394,216,88,42,218,229,2122
12839,DEN,2006,Andre Miller,29,82,82,2937,404,872,.463,5,27,.185,399,845,.472,.466,313,424,.738,92,259,351,674,106,18,256,213,1126
12840,DEN,2006,Marcus Camby,31,56,54,1857,302,649,.465,1,11,.091,301,638,.472,.466,111,156,.712,132,536,668,115,79,184,92,158,716
12841,DEN,2006,Greg Buckner,29,73,27,1758,181,417,.434,86,243,.354,95,174,.546,.537,43,55,.782,31,178,209,127,87,20,52,180,491
12842,DEN,2006,Francisco Elson,29,72,54,1579,151,284,.532,1,5,.200,150,279,.538,.533,49,74,.662,99,240,339,47,54,45,65,211,352
12843,DEN,2006,Kenyon Martin,28,56,49,1546,297,600,.495,5,22,.227,292,578,.505,.499,121,170,.712,93,260,353,79,43,52,72,171,720
12844,DEN,2006,Earl Boykins,29,60,0,1542,271,661,.410,62,179,.346,209,482,.434,.457,152,174,.874,21,60,81,230,48,4,83,73,756
12845,DEN,2006,Eduardo Nájera,29,64,3,1449,127,301,.422,4,12,.333,123,289,.426,.429,89,114,.781,128,197,325,52,53,34,54,165,347
12846,DEN,2006,Earl Watson,26,46,10,975,121,282,.429,68,172,.395,53,110,.482,.550,37,59,.627,17,69,86,160,37,7,75,95,347
12847,DEN,2006,DerMarr Johnson,25,58,21,924,132,306,.431,56,160,.350,76,146,.521,.523,34,42,.810,19,77,96,55,25,26,46,86,354
12848,DEN,2006,Ruben Patterson,30,26,20,736,139,256,.543,1,6,.167,138,250,.552,.545,65,112,.580,45,45,90,67,34,9,68,71,344
12849,DEN,2006,Reggie Evans,25,26,2,605,43,95,.453,0,0,,43,95,.453,.453,49,97,.505,57,169,226,15,16,5,44,71,135
12850,DEN,2006,Linas Kleiza,21,61,2,519,77,173,.445,2,13,.154,75,160,.469,.451,57,81,.704,38,78,116,15,10,13,16,87,213
12851,DEN,2006,Howard Eisley,33,19,0,282,30,86,.349,12,38,.316,18,48,.375,.419,20,24,.833,2,17,19,44,8,2,18,23,92
12852,DEN,2006,Voshon Lenard,32,12,6,238,42,103,.408,10,35,.286,32,68,.471,.456,5,13,.385,2,26,28,18,8,2,11,21,99
12853,DEN,2006,Julius Hodge,22,14,0,33,5,13,.385,0,0,,5,13,.385,.385,3,8,.375,5,2,7,6,2,0,8,7,13
12854,DEN,2006,Nenê,23,1,0,3,0,1,.000,0,0,,0,1,.000,.000,0,0,,0,0,0,0,0,0,2,1,0
12855,DEN,2006,Bryon Russell,35,1,0,3,0,0,,0,0,,0,0,,,0,0,,0,1,1,1,0,0,0,0,0
12856,DEN,2006,Charles Smith,30,1,0,2,0,1,.000,0,1,.000,0,0,,.000,0,0,,0,0,0,0,0,0,0,1,0
12857,DEN,2005,Andre Miller,28,82,82,2852,427,895,.477,6,39,.154,421,856,.492,.480,253,302,.838,100,238,338,569,121,8,220,204,1113
12858,DEN,2005,Carmelo Anthony,20,75,75,2608,530,1230,.431,42,158,.266,488,1072,.455,.448,456,573,.796,141,285,426,194,68,30,224,229,1558
12859,DEN,2005,Kenyon Martin,27,70,67,2272,444,907,.490,0,12,.000,444,895,.496,.490,199,308,.646,146,365,511,170,100,78,149,228,1087
12860,DEN,2005,Earl Boykins,28,82,5,2162,340,824,.413,56,166,.337,284,658,.432,.447,279,303,.921,37,106,143,372,78,12,121,122,1015
12861,DEN,2005,Marcus Camby,30,66,66,2015,279,600,.465,0,4,.000,279,596,.468,.465,125,173,.723,131,530,661,152,61,199,103,177,683
12862,DEN,2005,Greg Buckner,28,70,41,1522,160,303,.528,49,121,.405,111,182,.610,.609,63,81,.778,66,142,208,133,75,6,49,169,432
12863,DEN,2005,Nenê,22,55,18,1317,194,386,.503,0,2,.000,194,384,.505,.503,140,212,.660,104,221,325,84,50,48,94,167,528
12864,DEN,2005,DerMarr Johnson,24,71,40,1232,185,371,.499,53,148,.358,132,223,.592,.570,80,101,.792,43,108,151,75,43,18,65,140,503
12865,DEN,2005,Bryon Russell,34,70,2,1026,95,252,.377,56,149,.376,39,103,.379,.488,61,77,.792,50,122,172,72,44,11,35,130,307
12866,DEN,2005,Francisco Elson,28,67,11,939,101,216,.468,1,3,.333,100,213,.469,.470,45,79,.570,61,140,201,34,34,41,40,129,248
12867,DEN,2005,Eduardo Nájera,28,26,0,575,75,150,.500,0,6,.000,75,144,.521,.500,29,46,.630,49,76,125,28,23,14,29,77,179
12868,DEN,2005,Rodney White,24,42,2,531,98,227,.432,19,44,.432,79,183,.432,.474,21,34,.618,20,54,74,36,30,10,27,51,236
12869,DEN,2005,Wesley Person,33,25,0,461,82,169,.485,33,68,.485,49,101,.485,.583,5,9,.556,2,59,61,28,13,4,10,24,202
12870,DEN,2005,Nikoloz Tskitishvili,21,23,0,158,15,51,.294,0,7,.000,15,44,.341,.294,4,7,.571,11,18,29,4,8,8,14,24,34
12871,DEN,2005,Voshon Lenard,31,3,1,54,10,26,.385,4,12,.333,6,14,.429,.462,5,8,.625,0,6,6,6,1,0,2,2,29
12872,DEN,2005,Mark Pope,32,9,0,27,2,6,.333,0,0,,2,6,.333,.333,0,0,,5,3,8,1,1,2,1,5,4
12873,DEN,2005,Luis Flores,23,1,0,4,1,2,.500,1,1,1.000,0,1,.000,.750,0,0,,1,0,1,0,0,0,0,0,3
12874,DEN,2004,Carmelo Anthony,19,82,82,2995,624,1465,.426,69,214,.322,555,1251,.444,.449,408,525,.777,183,315,498,227,97,41,247,225,1725
12875,DEN,2004,Andre Miller,27,82,82,2838,430,941,.457,12,65,.185,418,876,.477,.463,342,411,.832,127,239,366,501,142,25,215,194,1214
12876,DEN,2004,Nenê,21,77,77,2504,334,630,.530,0,2,.000,334,628,.532,.530,240,352,.682,154,349,503,168,116,41,183,280,908
12877,DEN,2004,Voshon Lenard,30,73,70,2233,394,933,.422,106,289,.367,288,644,.447,.479,144,182,.791,46,154,200,151,61,12,101,177,1038
12878,DEN,2004,Marcus Camby,29,72,72,2162,262,549,.477,0,2,.000,262,547,.479,.477,98,136,.721,211,516,727,132,86,187,98,239,622
12879,DEN,2004,Earl Boykins,27,82,3,1849,321,766,.419,55,171,.322,266,595,.447,.455,142,162,.877,42,101,143,295,51,3,100,84,839
12880,DEN,2004,Jon Barry,34,57,9,1101,120,297,.404,51,138,.370,69,159,.434,.490,60,71,.845,25,98,123,147,57,8,53,66,351
12881,DEN,2004,Chris Andersen,25,71,0,1029,90,203,.443,0,1,.000,90,202,.446,.443,63,107,.589,89,209,298,35,34,114,48,119,243
12882,DEN,2004,Rodney White,23,72,0,985,215,468,.459,33,87,.379,182,381,.478,.495,78,104,.750,44,121,165,60,32,20,78,105,541
12883,DEN,2004,Francisco Elson,27,62,14,875,94,199,.472,0,1,.000,94,198,.475,.472,30,45,.667,65,138,203,32,35,39,35,145,218
12884,DEN,2004,Ryan Bowen,28,52,1,392,18,53,.340,0,0,,18,53,.340,.340,10,12,.833,39,48,87,18,18,16,6,47,46
12885,DEN,2004,Michael Doleac,26,26,0,344,40,97,.412,0,0,,40,97,.412,.412,14,16,.875,28,48,76,14,6,6,11,58,94
12886,DEN,2004,Nikoloz Tskitishvili,20,39,0,307,40,122,.328,3,11,.273,37,111,.333,.340,23,29,.793,24,39,63,10,6,8,17,50,106
12887,DEN,2004,Jeff Trepagnier,24,11,0,96,10,38,.263,2,4,.500,8,34,.235,.289,3,6,.500,6,9,15,4,3,0,6,7,25
12888,DEN,2004,Mark Pope,31,4,0,20,1,2,.500,0,0,,1,2,.500,.500,0,1,.000,0,3,3,0,1,0,3,8,2
12889,DEN,2003,Juwan Howard,29,77,77,2730,567,1261,.450,2,4,.500,565,1257,.449,.450,282,351,.803,181,404,585,234,77,27,189,239,1418
12890,DEN,2003,Nenê,20,80,53,2258,321,619,.519,0,3,.000,321,616,.521,.519,197,341,.578,208,283,491,149,127,65,181,295,839
12891,DEN,2003,Junior Harrington,22,82,51,2003,169,467,.362,7,28,.250,162,439,.369,.369,73,112,.652,44,206,250,277,80,15,157,250,418
12892,DEN,2003,Donnell Harvey,22,77,27,1613,246,551,.446,1,7,.143,245,544,.450,.447,118,176,.670,125,284,409,100,48,27,123,203,611
12893,DEN,2003,Rodney White,22,72,19,1563,260,638,.408,32,134,.239,228,504,.452,.433,98,125,.784,43,170,213,121,45,32,156,134,650
12894,DEN,2003,Vincent Yarbrough,21,59,39,1381,168,428,.393,21,78,.269,147,350,.420,.417,49,62,.790,36,126,162,130,57,33,81,145,406
12895,DEN,2003,Nikoloz Tskitishvili,19,81,16,1320,115,393,.293,37,152,.243,78,241,.324,.340,48,65,.738,64,117,181,91,31,29,84,136,315
12896,DEN,2003,Ryan Bowen,27,62,31,996,97,197,.492,2,7,.286,95,190,.500,.497,27,41,.659,78,79,157,54,65,29,43,82,223
12897,DEN,2003,Chris Andersen,24,59,3,907,114,285,.400,0,1,.000,114,284,.401,.400,77,140,.550,109,165,274,32,30,60,60,90,305
12898,DEN,2003,Mark Blount,27,54,24,885,105,267,.393,0,0,,105,267,.393,.393,71,99,.717,62,121,183,35,22,51,70,112,281
12899,DEN,2003,James Posey,26,25,24,872,121,324,.373,24,88,.273,97,236,.411,.410,86,102,.843,38,107,145,78,29,6,66,63,352
12900,DEN,2003,Chris Whitney,31,29,20,762,94,261,.360,43,128,.336,51,133,.383,.443,46,57,.807,1,45,46,124,17,1,55,77,277
12901,DEN,2003,Shammond Williams,27,27,9,712,94,241,.390,37,102,.363,57,139,.410,.467,30,45,.667,12,49,61,138,16,3,53,56,255
12902,DEN,2003,Marcus Camby,28,29,9,616,93,227,.410,2,5,.400,91,222,.410,.414,33,50,.660,75,133,208,47,20,40,27,69,221
12903,DEN,2003,Kenny Satterfield,21,22,6,420,51,165,.309,5,28,.179,46,137,.336,.324,16,23,.696,12,23,35,53,18,2,36,30,123
12904,DEN,2003,Predrag Savović,26,27,0,256,29,93,.312,4,26,.154,25,67,.373,.333,21,29,.724,9,16,25,22,14,1,21,33,83
12905,DEN,2003,John Crotty,33,12,0,180,14,41,.341,4,13,.308,10,28,.357,.390,9,15,.600,1,14,15,29,3,0,9,16,41
12906,DEN,2003,Jeff Trepagnier,23,8,0,97,17,40,.425,4,8,.500,13,32,.406,.475,7,7,1.000,8,8,16,6,8,0,8,5,45
12907,DEN,2003,Adam Harrington,22,6,0,74,7,20,.350,4,11,.364,3,9,.333,.450,1,2,.500,1,5,6,10,1,0,0,6,19
12908,DEN,2003,Devin Brown,24,3,2,71,7,25,.280,0,1,.000,7,24,.292,.280,4,6,.667,4,7,11,5,4,1,4,11,18
12909,DEN,2003,Mark Bryant,37,3,0,14,0,1,.000,0,0,,0,1,.000,.000,1,2,.500,1,1,2,2,0,0,2,4,1
12910,DEN,2002,James Posey,25,73,63,2238,277,736,.376,67,237,.283,210,499,.421,.422,161,203,.793,109,320,429,180,114,39,127,224,782
12911,DEN,2002,George McCloud,34,69,26,1830,206,576,.358,60,222,.270,146,354,.412,.410,132,163,.810,67,184,251,204,58,19,144,175,604
12912,DEN,2002,Nick Van Exel,30,45,44,1739,372,912,.408,85,252,.337,287,660,.435,.454,136,174,.782,19,150,169,365,30,7,116,69,965
12913,DEN,2002,Ryan Bowen,26,75,21,1686,147,307,.479,1,12,.083,146,295,.495,.480,69,92,.750,134,165,299,52,75,41,41,171,364
12914,DEN,2002,Raef LaFrentz,25,51,51,1668,307,659,.466,75,173,.434,232,486,.477,.523,70,105,.667,117,262,379,60,31,153,60,173,759
12915,DEN,2002,Voshon Lenard,28,71,19,1665,315,769,.410,89,240,.371,226,529,.427,.467,94,120,.783,38,145,183,130,59,25,91,105,813
12916,DEN,2002,Calbert Cheaney,30,68,47,1631,224,466,.481,0,4,.000,224,462,.485,.481,46,67,.687,57,183,240,110,34,21,70,156,494
12917,DEN,2002,Avery Johnson,36,51,13,1200,186,383,.486,0,5,.000,186,378,.492,.486,109,146,.747,14,50,64,258,35,8,67,69,481
12918,DEN,2002,Juwan Howard,28,28,28,976,192,420,.457,0,1,.000,192,419,.458,.457,117,152,.770,85,137,222,76,18,17,74,95,501
12919,DEN,2002,Zendon Hamilton,26,54,15,848,103,245,.420,0,0,,103,245,.420,.420,118,181,.652,110,143,253,14,21,18,60,104,324
12920,DEN,2002,Scott Williams,33,41,16,737,86,217,.396,0,2,.000,86,215,.400,.396,30,41,.732,82,127,209,13,17,33,35,98,202
12921,DEN,2002,Donnell Harvey,21,29,4,679,94,191,.492,0,0,,94,191,.492,.492,44,68,.647,68,113,181,32,17,19,25,88,232
12922,DEN,2002,Kenny Satterfield,20,36,4,560,73,199,.367,7,27,.259,66,172,.384,.384,36,46,.783,17,35,52,108,31,1,53,43,189
12923,DEN,2002,Tariq Abdul-Wahad,27,20,12,417,55,145,.379,1,2,.500,54,143,.378,.383,24,32,.750,39,39,78,22,18,9,24,51,135
12924,DEN,2002,Mengke Bateer,26,27,10,408,53,132,.402,4,12,.333,49,120,.408,.417,29,37,.784,32,64,96,22,10,5,32,94,139
12925,DEN,2002,Tim Hardaway,35,14,14,325,47,126,.373,28,75,.373,19,51,.373,.484,12,19,.632,1,26,27,77,17,2,38,25,134
12926,DEN,2002,Carlos Arroyo,22,20,1,275,36,82,.439,0,2,.000,36,80,.450,.439,9,12,.750,9,19,28,49,5,1,11,18,81
12927,DEN,2002,Chris Andersen,23,24,1,262,25,74,.338,0,4,.000,25,70,.357,.338,22,28,.786,38,38,76,7,7,28,13,35,72
12928,DEN,2002,Shawnelle Scott,29,21,10,252,37,75,.493,0,0,,37,75,.493,.493,8,20,.400,53,50,103,8,3,6,15,49,82
12929,DEN,2002,Antonio McDyess,27,10,10,236,43,75,.573,0,0,,43,75,.573,.573,27,33,.818,18,37,55,18,10,8,20,20,113
12930,DEN,2002,Isaiah Rider,30,10,1,173,37,81,.457,6,15,.400,31,66,.470,.494,13,17,.765,10,23,33,12,3,2,14,11,93
12931,DEN,2001,Nick Van Exel,29,71,70,2688,460,1112,.414,135,358,.377,325,754,.431,.474,204,249,.819,44,197,241,600,61,18,165,109,1259
12932,DEN,2001,Antonio McDyess,26,70,70,2555,577,1165,.495,0,0,,577,1165,.495,.495,304,434,.700,240,605,845,146,43,102,162,220,1458
12933,DEN,2001,Raef LaFrentz,24,78,74,2457,387,812,.477,51,139,.367,336,673,.499,.508,183,262,.698,173,434,607,107,37,206,97,290,1008
12934,DEN,2001,Voshon Lenard,27,80,58,2331,336,846,.397,147,382,.385,189,464,.407,.484,153,192,.797,47,184,231,190,65,18,102,170,972
12935,DEN,2001,James Posey,24,82,82,2255,243,590,.412,65,217,.300,178,373,.477,.467,115,141,.816,125,306,431,163,93,40,102,226,666
12936,DEN,2001,George McCloud,33,76,8,2007,250,655,.382,77,234,.329,173,421,.411,.440,152,181,.840,55,169,224,279,53,27,117,165,729
12937,DEN,2001,Robert Pack,31,74,11,1260,181,426,.425,12,31,.387,169,395,.428,.439,105,137,.766,30,107,137,293,65,1,135,114,479
12938,DEN,2001,Kevin Willis,38,43,13,1059,180,421,.428,1,4,.250,179,417,.429,.429,52,66,.788,109,200,309,29,38,31,47,138,413
12939,DEN,2001,Keon Clark,25,35,3,752,82,199,.412,0,0,,82,199,.412,.412,63,105,.600,58,128,186,34,16,44,48,101,227
12940,DEN,2001,Ryan Bowen,25,57,0,696,80,144,.556,4,11,.364,76,133,.571,.569,27,44,.614,62,51,113,30,37,12,24,95,191
12941,DEN,2001,Mark Strickland,30,46,2,517,82,185,.443,0,1,.000,82,184,.446,.443,37,59,.627,43,77,120,17,12,19,24,58,201
12942,DEN,2001,Tariq Abdul-Wahad,26,29,12,420,43,111,.387,4,10,.400,39,101,.386,.405,21,36,.583,14,45,59,22,14,13,34,54,111
12943,DEN,2001,Terry Davis,33,19,1,228,12,25,.480,0,0,,12,25,.480,.480,9,22,.409,24,29,53,7,1,1,5,34,33
12944,DEN,2001,Anthony Goldwire,29,20,0,201,30,80,.375,9,34,.265,21,46,.457,.431,13,17,.765,1,11,12,34,9,0,15,13,82
12945,DEN,2001,Calbert Cheaney,29,9,5,153,10,30,.333,0,0,,10,30,.333,.333,1,2,.500,5,15,20,9,4,2,5,14,21
12946,DEN,2001,Tracy Murray,29,13,0,135,17,55,.309,7,23,.304,10,32,.313,.373,9,10,.900,4,18,22,9,4,1,6,8,50
12947,DEN,2001,Dan McClintock,23,6,1,58,9,18,.500,0,0,,9,18,.500,.500,0,5,.000,10,7,17,1,0,2,3,11,18
12948,DEN,2001,Garth Joseph,27,2,0,8,0,3,.000,0,0,,0,3,.000,.000,0,2,.000,0,0,0,0,0,1,1,0,0
12949,DEN,2000,Nick Van Exel,28,79,79,2950,473,1213,.390,133,401,.332,340,812,.419,.445,196,240,.817,34,277,311,714,68,11,221,148,1275
12950,DEN,2000,Antonio McDyess,25,81,81,2698,614,1211,.507,0,2,.000,614,1209,.508,.507,323,516,.626,234,451,685,159,69,139,230,316,1551
12951,DEN,2000,Raef LaFrentz,23,81,80,2435,392,879,.446,60,183,.328,332,696,.477,.480,162,236,.686,170,471,641,97,42,180,96,292,1006
12952,DEN,2000,George McCloud,32,78,11,2118,266,638,.417,107,283,.378,159,355,.448,.501,148,181,.818,72,213,285,246,48,26,134,180,787
12953,DEN,2000,James Posey,23,81,77,2052,230,536,.429,82,220,.373,148,316,.468,.506,120,150,.800,85,232,317,146,98,33,95,207,662
12954,DEN,2000,Keon Clark,24,81,20,1850,286,528,.542,1,8,.125,285,520,.548,.543,121,176,.688,162,343,505,71,45,114,125,231,694
12955,DEN,2000,Ron Mercer,23,37,37,1408,272,612,.444,15,39,.385,257,573,.449,.457,119,151,.788,29,123,152,104,33,15,87,75,678
12956,DEN,2000,Chris Gatling,32,40,0,770,155,340,.456,11,47,.234,144,293,.491,.472,95,128,.742,63,142,205,31,34,13,64,104,416
12957,DEN,2000,Bryant Stith,29,45,6,691,86,189,.455,17,56,.304,69,133,.519,.500,64,77,.831,23,61,84,61,18,12,33,56,253
12958,DEN,2000,Chris Herren,24,45,1,597,45,124,.363,24,67,.358,21,57,.368,.460,27,40,.675,12,40,52,111,15,2,42,74,141
12959,DEN,2000,Ryan Bowen,24,52,0,589,46,117,.393,1,9,.111,45,108,.417,.397,38,53,.717,75,39,114,20,39,13,14,95,131
12960,DEN,2000,Tariq Abdul-Wahad,25,15,10,373,51,131,.389,1,2,.500,50,129,.388,.393,31,42,.738,24,28,52,26,6,12,19,31,134
12961,DEN,2000,Roy Rogers,26,40,0,355,35,88,.398,0,1,.000,35,87,.402,.398,19,41,.463,33,47,80,9,2,38,10,36,89
12962,DEN,2000,Popeye Jones,29,40,1,330,44,104,.423,2,3,.667,42,101,.416,.433,14,19,.737,41,62,103,19,3,6,13,50,104
12963,DEN,2000,Cory Alexander,26,29,2,329,28,98,.286,9,35,.257,19,63,.302,.332,17,22,.773,8,34,42,58,24,2,28,39,82
12964,DEN,2000,Chauncey Billups,23,13,5,305,34,101,.337,7,41,.171,27,60,.450,.371,37,44,.841,8,26,34,39,10,2,24,27,112
12965,DEN,2000,Johnny Taylor,25,1,0,5,0,2,.000,0,0,,0,2,.000,.000,0,0,,0,1,1,0,0,0,0,1,0
12966,DEN,1999,Antonio McDyess,24,50,50,1937,415,882,.471,1,9,.111,414,873,.474,.471,230,338,.680,168,369,537,82,73,115,138,175,1061
12967,DEN,1999,Nick Van Exel,27,50,50,1802,306,769,.398,72,234,.308,234,535,.437,.445,142,175,.811,14,99,113,368,40,3,121,90,826
12968,DEN,1999,Chauncey Billups,22,45,41,1488,191,495,.386,85,235,.362,106,260,.408,.472,157,172,.913,24,72,96,173,58,14,98,115,624
12969,DEN,1999,Danny Fortson,22,50,38,1417,191,386,.495,0,3,.000,191,383,.499,.495,168,231,.727,210,371,581,32,31,22,77,212,550
12970,DEN,1999,Bryant Stith,28,46,32,1194,114,290,.393,31,106,.292,83,184,.451,.447,61,71,.859,30,77,107,82,28,15,45,65,320
12971,DEN,1999,Eric Williams,26,38,8,780,80,219,.365,6,26,.231,74,193,.383,.379,111,139,.799,34,47,81,37,27,8,49,76,277
12972,DEN,1999,Cory Alexander,25,36,4,778,97,260,.373,30,105,.286,67,155,.432,.431,37,44,.841,7,67,74,119,35,5,69,77,261
12973,DEN,1999,Eric Washington,24,38,6,761,73,184,.397,37,97,.381,36,87,.414,.497,22,32,.688,35,54,89,30,25,18,34,87,205
12974,DEN,1999,Johnny Taylor,24,36,9,724,82,198,.414,26,68,.382,56,130,.431,.480,17,23,.739,30,71,101,24,28,17,34,97,207
12975,DEN,1999,Keon Clark,23,28,0,409,36,80,.450,0,1,.000,36,79,.456,.450,21,37,.568,36,60,96,10,10,31,21,52,93
12976,DEN,1999,Raef LaFrentz,22,12,12,387,59,129,.457,12,31,.387,47,98,.480,.504,36,48,.750,33,58,91,8,9,17,9,38,166
12977,DEN,1999,Carl Herrera,32,24,0,265,27,63,.429,0,1,.000,27,62,.435,.429,5,9,.556,20,34,54,1,12,7,12,38,59
12978,DEN,1999,Loren Meyer,26,14,0,70,7,28,.250,1,5,.200,6,23,.261,.268,1,2,.500,4,12,16,1,0,3,4,22,16
12979,DEN,1999,Monty Williams,27,1,0,6,0,2,.000,0,0,,0,2,.000,.000,1,2,.500,0,0,0,0,0,0,0,0,1
12980,DEN,1999,Kelly McCarty,23,2,0,4,2,3,.667,0,0,,2,3,.667,.667,0,0,,2,1,3,0,0,0,2,0,4
12981,DEN,1999,Tyson Wheeler,23,1,0,3,1,1,1.000,1,1,1.000,0,0,,1.500,1,2,.500,0,0,0,2,0,0,0,1,4
12982,DEN,1998,Dean Garrett,31,82,82,2632,242,565,.428,0,0,,242,565,.428,.428,114,176,.648,227,417,644,90,57,133,84,197,598
12983,DEN,1998,LaPhonso Ellis,27,76,71,2575,410,1007,.407,57,201,.284,353,806,.438,.435,206,256,.805,146,398,544,213,65,49,173,226,1083
12984,DEN,1998,Anthony Goldwire,26,82,32,2212,269,636,.423,63,164,.384,206,472,.436,.472,150,186,.806,40,107,147,277,86,7,85,149,751
12985,DEN,1998,Johnny Newman,34,74,15,2176,344,799,.431,36,105,.343,308,694,.444,.453,365,445,.820,50,91,141,138,77,24,147,208,1089
12986,DEN,1998,Bobby Jackson,24,68,53,2042,310,791,.392,21,81,.259,289,710,.407,.405,149,183,.814,78,224,302,317,105,11,184,160,790
12987,DEN,1998,Danny Fortson,21,80,23,1811,276,611,.452,1,3,.333,275,608,.452,.453,263,339,.776,182,266,448,76,44,30,157,314,816
12988,DEN,1998,Eric Washington,23,66,36,1539,201,498,.404,44,137,.321,157,361,.435,.448,65,83,.783,47,80,127,78,53,25,72,143,511
12989,DEN,1998,Tony Battie,21,65,49,1506,234,525,.446,3,14,.214,231,511,.452,.449,73,104,.702,138,213,351,60,54,69,98,199,544
12990,DEN,1998,Cory Alexander,24,23,19,797,111,255,.435,46,112,.411,65,143,.455,.525,55,65,.846,10,89,99,138,45,6,65,45,323
12991,DEN,1998,Bryant Stith,27,31,15,718,75,225,.333,10,48,.208,65,177,.367,.356,75,86,.872,15,50,65,50,21,8,35,52,235
12992,DEN,1998,Joe Wolf,33,57,8,621,40,121,.331,2,10,.200,38,111,.342,.339,5,10,.500,36,90,126,30,20,7,22,92,87
12993,DEN,1998,Priest Lauderdale,24,39,0,345,53,127,.417,0,0,,53,127,.417,.417,38,69,.551,27,73,100,21,7,17,46,63,144
12994,DEN,1998,Harold Ellis,27,27,3,344,62,111,.559,0,4,.000,62,107,.579,.559,40,63,.635,27,23,50,18,19,4,19,53,164
12995,DEN,1998,Kiwane Lemorris Garris,23,28,0,225,22,65,.338,5,14,.357,17,51,.333,.377,19,25,.760,3,16,19,28,7,1,15,22,68
12996,DEN,1998,Eric Williams,25,4,4,145,24,61,.393,0,0,,24,61,.393,.393,31,45,.689,10,11,21,12,4,0,9,9,79
12997,DEN,1998,George Zídek,24,6,0,42,4,15,.267,0,0,,4,15,.267,.267,10,12,.833,4,9,13,1,0,2,3,5,18
12998,DEN,1997,Dale Ellis,36,82,51,2940,477,1151,.414,192,528,.364,285,623,.457,.498,215,263,.817,99,194,293,165,60,7,146,178,1361
12999,DEN,1997,Ervin Johnson,29,82,82,2599,243,467,.520,0,2,.000,243,465,.523,.520,96,156,.615,231,682,913,71,65,227,118,288,582
13000,DEN,1997,Antonio McDyess,22,74,73,2565,536,1157,.463,6,35,.171,530,1122,.472,.466,274,387,.708,155,382,537,106,62,126,199,276,1352
13001,DEN,1997,LaPhonso Ellis,26,55,49,2002,445,1014,.439,95,259,.367,350,755,.464,.486,218,282,.773,107,279,386,131,44,41,117,181,1203
13002,DEN,1997,Mark Jackson,31,52,52,2001,192,452,.425,48,121,.397,144,331,.435,.478,109,136,.801,71,200,271,641,51,9,172,104,541
13003,DEN,1997,Bryant Stith,26,52,52,1788,251,603,.416,70,182,.385,181,421,.430,.474,202,234,.863,74,143,217,133,60,20,101,119,774
13004,DEN,1997,Tom Hammonds,29,81,8,1758,191,398,.480,0,2,.000,191,396,.482,.480,124,172,.721,135,266,401,64,16,24,88,205,506
13005,DEN,1997,Brooks Thompson,26,65,6,1047,162,405,.400,97,244,.398,65,161,.404,.520,24,38,.632,18,78,96,179,55,2,86,125,445
13006,DEN,1997,Kenny Smith,31,33,3,654,87,206,.422,51,120,.425,36,86,.419,.546,35,41,.854,3,34,37,102,18,0,62,25,260
13007,DEN,1997,Anthony Goldwire,25,27,21,612,69,176,.392,28,71,.394,41,105,.390,.472,31,38,.816,9,37,46,125,14,1,35,46,197
13008,DEN,1997,Ricky Pierce,37,33,10,600,120,260,.462,12,39,.308,108,221,.489,.485,83,92,.902,17,36,53,31,14,5,38,49,335
13009,DEN,1997,Darvin Ham,23,35,3,313,32,61,.525,0,0,,32,61,.525,.525,16,33,.485,29,27,56,14,8,8,21,57,80
13010,DEN,1997,Šarūnas Marčiulionis,32,17,0,255,38,101,.376,11,30,.367,27,71,.380,.431,29,36,.806,12,18,30,25,12,1,40,38,116
13011,DEN,1997,Jerome Allen,24,25,0,251,21,74,.284,7,34,.206,14,40,.350,.331,15,25,.600,12,21,33,43,4,4,13,17,64
13012,DEN,1997,Jeff McInnis,22,13,0,117,23,49,.469,12,26,.462,11,23,.478,.592,7,10,.700,2,4,6,18,2,1,13,16,65
13013,DEN,1997,Eric Murdock,28,12,0,114,15,33,.455,4,10,.400,11,23,.478,.515,11,12,.917,1,10,11,24,9,2,11,9,45
13014,DEN,1997,LaSalle Thompson,35,17,0,105,3,16,.188,0,0,,3,16,.188,.188,1,2,.500,5,21,26,0,3,6,7,26,7
13015,DEN,1997,George Zídek,23,16,0,88,16,33,.485,0,0,,16,33,.485,.485,20,25,.800,10,13,23,5,1,0,4,17,52
13016,DEN,1997,Elmer Bennett,26,5,0,59,4,13,.308,2,6,.333,2,7,.286,.385,2,4,.500,0,3,3,7,2,0,10,6,12
13017,DEN,1997,Jimmy King,23,2,0,22,2,6,.333,0,0,,2,6,.333,.333,2,4,.500,2,0,2,2,3,0,1,2,6
13018,DEN,1997,Melvin Booker,24,5,0,21,2,4,.500,1,2,.500,1,2,.500,.625,0,0,,0,1,1,3,0,0,7,0,5
13019,DEN,1997,Aaron Williams,25,1,0,10,3,5,.600,0,0,,3,5,.600,.600,0,0,,2,3,5,0,0,3,4,0,6
13020,DEN,1997,Vincent Askew,30,1,0,9,2,3,.667,0,0,,2,3,.667,.667,2,2,1.000,0,0,0,0,0,0,4,0,6
13021,DEN,1996,Bryant Stith,25,82,77,2810,379,911,.416,41,148,.277,338,763,.443,.439,320,379,.844,125,275,400,241,114,16,157,187,1119
13022,DEN,1996,Dikembe Mutombo,29,74,74,2713,284,569,.499,0,1,.000,284,568,.500,.499,246,354,.695,249,622,871,108,38,332,150,258,814
13023,DEN,1996,Dale Ellis,35,81,52,2626,459,959,.479,150,364,.412,309,595,.519,.557,136,179,.760,88,227,315,139,57,7,98,191,1204
13024,DEN,1996,Antonio McDyess,21,76,75,2280,427,881,.485,0,4,.000,427,877,.487,.485,166,243,.683,229,343,572,75,54,114,154,250,1020
13025,DEN,1996,Jalen Rose,23,80,37,2134,290,604,.480,32,108,.296,258,496,.520,.507,191,277,.690,46,214,260,495,53,39,234,229,803
13026,DEN,1996,Mahmoud Abdul-Rauf,26,57,53,2029,414,955,.434,121,309,.392,293,646,.454,.497,146,157,.930,26,112,138,389,64,3,115,117,1095
13027,DEN,1996,LaPhonso Ellis,25,45,28,1269,189,432,.438,4,22,.182,185,410,.451,.442,89,148,.601,93,229,322,74,36,33,83,163,471
13028,DEN,1996,Don MacLean,26,56,5,1107,233,547,.426,14,49,.286,219,498,.440,.439,145,198,.732,62,143,205,89,21,5,68,105,625
13029,DEN,1996,Tom Hammonds,28,71,4,1045,127,268,.474,0,0,,127,268,.474,.474,88,115,.765,85,138,223,23,23,13,48,137,342
13030,DEN,1996,Reggie Williams,31,52,5,817,94,254,.370,20,89,.225,74,165,.448,.409,33,39,.846,25,97,122,74,34,21,51,137,241
13031,DEN,1996,Doug Overton,26,55,0,607,67,178,.376,8,26,.308,59,152,.388,.399,40,55,.727,8,55,63,106,13,5,40,49,182
13032,DEN,1996,Matt Fish,26,16,0,117,15,26,.577,0,0,,15,26,.577,.577,10,18,.556,7,11,18,7,3,6,3,16,40
13033,DEN,1996,Greg Grant,29,10,0,109,6,23,.261,2,6,.333,4,17,.235,.304,0,0,,3,4,7,14,2,0,5,7,14
13034,DEN,1996,Randy Woods,25,8,0,72,6,22,.273,5,21,.238,1,1,1.000,.386,2,2,1.000,3,3,6,12,6,1,5,13,19
13035,DEN,1996,Rastko Cvetković,25,14,0,48,5,16,.313,0,1,.000,5,15,.333,.313,0,4,.000,4,7,11,3,2,1,3,11,10
13036,DEN,1996,Reggie Slater,25,4,0,26,6,11,.545,0,0,,6,11,.545,.545,2,5,.400,3,4,7,2,1,1,3,4,14
13037,DEN,1996,Elmore Spencer,26,6,0,21,0,1,.000,0,0,,0,1,.000,.000,0,0,,1,3,4,0,0,0,3,8,0
13038,DEN,1995,Dikembe Mutombo,28,82,82,3100,349,628,.556,0,0,,349,628,.556,.556,248,379,.654,319,710,1029,113,40,321,192,284,946
13039,DEN,1995,Bryant Stith,24,81,51,2329,312,661,.472,20,68,.294,292,593,.492,.487,267,324,.824,95,173,268,153,91,18,110,142,911
13040,DEN,1995,Reggie Williams,30,74,70,2198,388,846,.459,85,266,.320,303,580,.522,.509,132,174,.759,94,235,329,231,114,67,124,264,993
13041,DEN,1995,Rodney Rogers,23,80,77,2142,375,769,.488,50,148,.338,325,621,.523,.520,179,275,.651,132,253,385,161,95,46,173,281,979
13042,DEN,1995,Mahmoud Abdul-Rauf,25,73,43,2082,472,1005,.470,83,215,.386,389,790,.492,.511,138,156,.885,32,105,137,263,77,9,119,126,1165
13043,DEN,1995,Dale Ellis,34,81,3,1996,351,774,.453,106,263,.403,245,511,.479,.522,110,127,.866,56,166,222,57,37,9,81,142,918
13044,DEN,1995,Jalen Rose,22,81,37,1798,227,500,.454,36,114,.316,191,386,.495,.490,173,234,.739,57,160,217,389,65,22,160,206,663
13045,DEN,1995,Bison Dele,25,63,10,1261,196,333,.589,0,0,,196,333,.589,.589,106,162,.654,98,200,298,53,38,43,114,210,498
13046,DEN,1995,Robert Pack,25,42,32,1144,170,395,.430,30,72,.417,140,323,.433,.468,137,175,.783,19,94,113,290,61,6,134,101,507
13047,DEN,1995,Tom Hammonds,27,70,5,956,139,260,.535,0,1,.000,139,259,.537,.535,132,177,.746,55,167,222,36,11,14,56,132,410
13048,DEN,1995,Cliff Levingston,34,57,0,469,55,130,.423,0,1,.000,55,129,.426,.423,19,45,.422,49,75,124,27,13,20,21,91,129
13049,DEN,1995,Reggie Slater,24,25,0,236,40,81,.494,0,0,,40,81,.494,.494,40,55,.727,21,36,57,12,7,3,26,47,120
13050,DEN,1995,Greg Grant,28,14,0,151,10,33,.303,2,7,.286,8,26,.308,.333,9,12,.750,2,7,9,43,6,2,14,20,31
13051,DEN,1995,LaPhonso Ellis,24,6,0,58,9,25,.360,0,0,,9,25,.360,.360,6,6,1.000,7,10,17,4,1,5,5,12,24
13052,DEN,1995,Mark Randall,27,8,0,39,3,10,.300,0,1,.000,3,9,.333,.300,0,0,,4,8,12,1,0,0,1,5,6
13053,DEN,1995,Eldridge Recasner,27,3,0,13,1,6,.167,0,1,.000,1,5,.200,.167,4,4,1.000,0,2,2,1,3,0,2,0,6
13054,DEN,1995,Darnell Mee,23,2,0,8,1,5,.200,1,3,.333,0,2,.000,.300,0,0,,0,1,1,2,1,0,0,0,3
13055,DEN,1994,Bryant Stith,23,82,82,2853,365,811,.450,2,9,.222,363,802,.453,.451,291,351,.829,119,230,349,199,116,16,131,165,1023
13056,DEN,1994,Dikembe Mutombo,27,82,82,2853,365,642,.569,0,1,.000,365,641,.569,.569,256,439,.583,286,685,971,127,59,336,206,262,986
13057,DEN,1994,LaPhonso Ellis,23,79,79,2699,483,963,.502,7,23,.304,476,940,.506,.505,242,359,.674,220,462,682,167,63,80,172,304,1215
13058,DEN,1994,Reggie Williams,29,82,68,2654,418,1014,.412,64,230,.278,354,784,.452,.444,165,225,.733,98,294,392,300,117,66,163,288,1065
13059,DEN,1994,Mahmoud Abdul-Rauf,24,80,78,2617,588,1279,.460,42,133,.316,546,1146,.476,.476,219,229,.956,27,141,168,362,82,10,151,150,1437
13060,DEN,1994,Bison Dele,24,80,1,1507,251,464,.541,0,3,.000,251,461,.544,.541,137,211,.649,138,308,446,50,49,87,104,221,639
13061,DEN,1994,Rodney Rogers,22,79,14,1406,239,545,.439,35,92,.380,204,453,.450,.471,127,189,.672,90,136,226,101,63,48,131,195,640
13062,DEN,1994,Robert Pack,24,66,4,1382,223,503,.443,6,29,.207,217,474,.458,.449,179,236,.758,25,98,123,356,81,9,204,147,631
13063,DEN,1994,Tom Hammonds,26,74,2,877,115,230,.500,0,0,,115,230,.500,.500,71,104,.683,62,137,199,34,20,12,41,91,301
13064,DEN,1994,Darnell Mee,22,38,0,285,28,88,.318,5,24,.208,23,64,.359,.347,12,27,.444,17,18,35,16,15,13,18,34,73
13065,DEN,1994,Kevin Brooks,24,34,0,190,36,99,.364,4,23,.174,32,76,.421,.384,9,10,.900,5,16,21,3,0,2,12,19,85
13066,DEN,1994,Mark Randall,26,28,0,155,17,50,.340,2,14,.143,15,36,.417,.360,22,28,.786,9,13,22,11,8,3,10,18,58
13067,DEN,1994,Mark Macon,24,7,0,126,14,45,.311,0,3,.000,14,42,.333,.311,8,10,.800,3,4,7,11,6,1,14,17,36
13068,DEN,1994,Adonis Jordan,23,6,0,79,6,23,.261,3,10,.300,3,13,.231,.326,0,0,,3,3,6,19,0,1,6,6,15
13069,DEN,1994,Roy Marble,27,5,0,32,2,12,.167,0,0,,2,12,.167,.167,0,3,.000,3,5,8,1,0,2,3,1,4
13070,DEN,1994,Jim Farmer,29,4,0,29,2,6,.333,0,2,.000,2,4,.500,.333,0,0,,0,2,2,4,0,0,5,3,4
13071,DEN,1994,Marcus Liberty,25,3,0,11,4,7,.571,0,1,.000,4,6,.667,.571,1,2,.500,0,5,5,2,0,0,2,5,9
13072,DEN,1993,Dikembe Mutombo,26,82,82,3029,398,781,.510,0,0,,398,781,.510,.510,335,492,.681,344,726,1070,147,43,287,216,284,1131
13073,DEN,1993,LaPhonso Ellis,22,82,82,2749,483,958,.504,2,13,.154,481,945,.509,.505,237,317,.748,274,470,744,151,72,111,153,293,1205
13074,DEN,1993,Reggie Williams,28,79,79,2722,535,1167,.458,33,122,.270,502,1045,.480,.473,238,296,.804,132,296,428,295,126,76,194,284,1341
13075,DEN,1993,Mahmoud Abdul-Rauf,23,81,81,2710,633,1407,.450,70,197,.355,563,1210,.465,.475,217,232,.935,51,174,225,344,84,8,187,179,1553
13076,DEN,1993,Marcus Liberty,24,78,32,1585,252,620,.406,22,59,.373,230,561,.410,.424,102,156,.654,131,204,335,105,64,21,79,143,628
13077,DEN,1993,Robert Pack,23,77,1,1579,285,606,.470,1,8,.125,284,598,.475,.471,239,311,.768,52,108,160,335,81,10,185,182,810
13078,DEN,1993,Mark Macon,23,48,27,1141,158,381,.415,0,6,.000,158,375,.421,.415,42,60,.700,33,70,103,126,69,3,72,135,358
13079,DEN,1993,Bryant Stith,22,39,12,865,124,278,.446,0,4,.000,124,274,.453,.446,99,119,.832,39,85,124,49,24,5,44,82,347
13080,DEN,1993,Todd Lichti,26,48,12,752,124,276,.449,2,6,.333,122,270,.452,.453,81,102,.794,35,67,102,52,28,11,49,60,331
13081,DEN,1993,Gary Plummer,30,60,0,737,106,228,.465,0,3,.000,106,225,.471,.465,69,95,.726,53,120,173,40,14,11,78,141,281
13082,DEN,1993,Scott Hastings,32,76,0,670,57,112,.509,2,8,.250,55,104,.529,.518,40,55,.727,44,93,137,34,12,8,29,115,156
13083,DEN,1993,Kevin Brooks,23,55,2,571,93,233,.399,6,26,.231,87,207,.420,.412,35,40,.875,22,59,81,34,10,2,39,46,227
13084,DEN,1993,Tom Hammonds,25,35,0,571,86,176,.489,0,1,.000,86,175,.491,.489,33,54,.611,33,63,96,16,18,8,31,57,205
13085,DEN,1993,Robert Werdann,22,28,0,149,18,59,.305,0,1,.000,18,58,.310,.305,17,31,.548,23,29,52,7,6,4,12,38,53
13086,DEN,1992,Greg Anderson,27,82,82,2793,389,854,.456,0,4,.000,389,850,.458,.456,167,268,.623,337,604,941,78,88,65,201,263,945
13087,DEN,1992,Dikembe Mutombo,25,71,71,2716,428,869,.493,0,0,,428,869,.493,.493,321,500,.642,316,554,870,156,43,210,252,273,1177
13088,DEN,1992,Reggie Williams,27,81,80,2623,601,1277,.471,56,156,.359,545,1121,.486,.493,216,269,.803,145,260,405,235,148,68,173,270,1474
13089,DEN,1992,Mark Macon,22,76,67,2304,333,889,.375,4,30,.133,329,859,.383,.377,135,185,.730,80,140,220,168,154,14,155,242,805
13090,DEN,1992,Winston Garland,27,78,67,2209,333,750,.444,9,28,.321,324,722,.449,.450,171,199,.859,67,123,190,411,98,22,175,206,846
13091,DEN,1992,Mahmoud Abdul-Rauf,22,81,11,1538,356,845,.421,31,94,.330,325,751,.433,.440,94,108,.870,22,92,114,192,44,4,117,130,837
13092,DEN,1992,Marcus Liberty,23,75,13,1527,275,621,.443,17,50,.340,258,571,.452,.457,131,180,.728,144,164,308,58,66,29,90,165,698
13093,DEN,1992,Todd Lichti,25,68,10,1176,173,376,.460,1,9,.111,172,367,.469,.461,99,118,.839,36,82,118,74,43,12,72,131,446
13094,DEN,1992,Joe Wolf,27,67,0,1160,100,277,.361,1,11,.091,99,266,.372,.363,53,66,.803,97,143,240,61,32,14,60,124,254
13095,DEN,1992,Walter Davis,37,46,0,741,185,403,.459,5,16,.313,180,387,.465,.465,82,94,.872,20,50,70,68,29,1,45,69,457
13096,DEN,1992,Scott Hastings,31,40,4,421,17,50,.340,0,9,.000,17,41,.415,.340,24,28,.857,30,68,98,26,10,15,22,56,58
13097,DEN,1992,Kevin Brooks,22,37,0,270,43,97,.443,2,11,.182,41,86,.477,.454,17,21,.810,13,26,39,11,8,2,18,19,105
13098,DEN,1992,Jerome Lane,25,9,5,141,10,40,.250,0,0,,10,40,.250,.250,8,19,.421,22,22,44,13,2,1,10,18,28
13099,DEN,1992,Anthony Cook,24,22,0,115,15,25,.600,0,0,,15,25,.600,.600,4,6,.667,13,21,34,2,5,4,3,10,34
13100,DEN,1992,Steve Scheffler,24,7,0,46,4,7,.571,0,0,,4,7,.571,.571,4,6,.667,8,3,11,0,3,0,1,8,12
13101,DEN,1991,Michael Adams,28,66,66,2346,560,1421,.394,167,564,.296,393,857,.459,.453,465,529,.879,58,198,256,693,147,6,240,162,1752
13102,DEN,1991,Blair Rasmussen,28,70,69,2325,405,885,.458,2,5,.400,403,880,.458,.459,63,93,.677,170,508,678,70,52,132,81,307,875
13103,DEN,1991,Orlando Woolridge,31,53,50,1823,490,983,.498,0,4,.000,490,979,.501,.498,350,439,.797,141,220,361,119,69,23,152,145,1330
13104,DEN,1991,Joe Wolf,26,74,38,1593,234,519,.451,2,15,.133,232,504,.460,.453,69,83,.831,136,264,400,107,60,31,95,244,539
13105,DEN,1991,Reggie Williams,26,51,46,1542,323,728,.444,43,131,.328,280,597,.469,.473,131,156,.840,116,131,247,87,93,30,76,189,820
13106,DEN,1991,Mahmoud Abdul-Rauf,21,67,19,1505,417,1009,.413,24,100,.240,393,909,.432,.425,84,98,.857,34,87,121,206,55,4,110,149,942
13107,DEN,1991,Jerome Lane,24,62,25,1383,202,461,.438,1,4,.250,201,457,.440,.439,58,141,.411,280,298,578,123,51,14,105,192,463
13108,DEN,1991,Marcus Liberty,22,76,18,1171,216,513,.421,17,57,.298,199,456,.436,.438,58,92,.630,117,104,221,64,48,19,71,153,507
13109,DEN,1991,Anthony Cook,23,58,25,1121,118,283,.417,0,3,.000,118,280,.421,.417,71,129,.550,134,192,326,26,35,72,50,100,307
13110,DEN,1991,Walter Davis,36,39,13,1044,316,667,.474,10,33,.303,306,634,.483,.481,86,94,.915,52,71,123,84,62,3,63,108,728
13111,DEN,1991,Todd Lichti,24,29,25,860,166,378,.439,14,47,.298,152,331,.459,.458,59,69,.855,49,63,112,72,46,8,33,65,405
13112,DEN,1991,Kenny Battle,26,40,4,682,95,196,.485,3,22,.136,92,174,.529,.492,50,64,.781,62,61,123,47,41,12,36,83,243
13113,DEN,1991,Greg Anderson,26,41,2,659,85,193,.440,0,0,,85,193,.440,.440,44,87,.506,67,170,237,12,25,36,61,107,214
13114,DEN,1991,Jim Farmer,26,25,1,443,99,216,.458,5,22,.227,94,194,.485,.470,46,63,.730,27,36,63,38,13,2,37,58,249
13115,DEN,1991,Terry Mills,23,17,0,279,56,120,.467,0,2,.000,56,118,.475,.467,16,22,.727,31,57,88,16,16,9,18,44,128
13116,DEN,1991,Corey Gaines,25,10,2,226,28,70,.400,5,21,.238,23,49,.469,.436,22,26,.846,4,10,14,91,10,2,23,25,83
13117,DEN,1991,Avery Johnson,25,21,4,217,29,68,.426,0,4,.000,29,64,.453,.426,21,32,.656,9,12,21,77,14,2,27,22,79
13118,DEN,1991,T.R. Dunn,35,17,3,217,21,47,.447,1,4,.250,20,43,.465,.457,9,10,.900,20,22,42,24,12,1,7,30,52
13119,DEN,1991,Tim Legler,24,10,0,148,25,72,.347,3,12,.250,22,60,.367,.368,5,6,.833,8,10,18,12,2,0,4,20,58
13120,DEN,1991,Craig Neal,26,10,0,125,14,35,.400,3,9,.333,11,26,.423,.443,13,22,.591,2,14,16,37,4,0,19,26,44
13121,DEN,1991,Anthony Mason,24,3,0,21,2,4,.500,0,0,,2,4,.500,.500,6,8,.750,3,2,5,0,1,0,0,6,10
13122,DEN,1990,Fat Lever,29,79,79,2832,568,1283,.443,36,87,.414,532,1196,.445,.457,271,337,.804,230,504,734,517,168,13,156,172,1443
13123,DEN,1990,Michael Adams,27,79,74,2690,398,989,.402,158,432,.366,240,557,.431,.482,267,314,.850,49,176,225,495,121,3,141,133,1221
13124,DEN,1990,Alex English,36,80,80,2211,635,1293,.491,2,5,.400,633,1288,.491,.492,161,183,.880,119,167,286,225,51,23,93,130,1433
13125,DEN,1990,Blair Rasmussen,27,81,55,1995,445,895,.497,0,1,.000,445,894,.498,.497,111,134,.828,174,420,594,82,40,104,75,300,1001
13126,DEN,1990,Walter Davis,35,69,0,1635,497,1033,.481,6,46,.130,491,987,.497,.484,207,227,.912,46,133,179,155,59,9,102,160,1207
13127,DEN,1990,Bill Hanzlik,32,81,0,1605,179,396,.452,6,31,.194,173,365,.474,.460,136,183,.743,67,140,207,186,78,29,87,249,500
13128,DEN,1990,Todd Lichti,23,79,4,1326,250,514,.486,0,14,.000,250,500,.500,.486,130,174,.747,49,102,151,116,55,13,95,145,630
13129,DEN,1990,Danny Schayes,30,53,22,1194,163,330,.494,0,4,.000,163,326,.500,.494,225,264,.852,117,225,342,61,41,45,72,200,551
13130,DEN,1990,Tim Kempton,26,71,14,1061,153,312,.490,0,1,.000,153,311,.492,.490,77,114,.675,51,167,218,118,30,9,80,144,383
13131,DEN,1990,Jerome Lane,23,67,46,956,145,309,.469,0,5,.000,145,304,.477,.469,44,120,.367,144,217,361,105,53,17,85,189,334
13132,DEN,1990,Eddie Hughes,29,60,7,892,83,202,.411,20,49,.408,63,153,.412,.460,23,34,.676,15,55,70,116,48,1,39,87,209
13133,DEN,1990,Joe Barry Carroll,31,30,27,719,153,354,.432,0,0,,153,354,.432,.432,52,70,.743,51,142,193,54,28,59,78,70,358
13134,DEN,1990,T.R. Dunn,34,65,2,657,44,97,.454,0,2,.000,44,95,.463,.454,26,39,.667,56,82,138,43,41,4,19,67,114
13135,DEN,1990,Mike Higgins,22,5,0,32,3,8,.375,0,0,,3,8,.375,.375,7,8,.875,1,2,3,2,1,0,1,1,13
13136,DEN,1989,Alex English,35,82,82,2990,924,1881,.491,2,8,.250,922,1873,.492,.492,325,379,.858,148,178,326,383,66,12,198,174,2175
13137,DEN,1989,Michael Adams,26,77,77,2787,468,1082,.433,166,466,.356,302,616,.490,.509,322,393,.819,71,212,283,490,166,11,180,149,1424
13138,DEN,1989,Fat Lever,28,71,71,2745,558,1221,.457,23,66,.348,535,1155,.463,.466,270,344,.785,187,475,662,559,195,20,157,178,1409
13139,DEN,1989,Danny Schayes,29,76,64,1918,317,607,.522,3,9,.333,314,598,.525,.525,332,402,.826,142,358,500,105,42,81,160,320,969
13140,DEN,1989,Wayne Cooper,32,79,72,1864,220,444,.495,1,4,.250,219,440,.498,.497,79,106,.745,212,407,619,78,36,211,73,302,520
13141,DEN,1989,Walter Davis,34,81,0,1857,536,1076,.498,20,69,.290,516,1007,.512,.507,175,199,.879,41,110,151,190,72,5,132,187,1267
13142,DEN,1989,Elston Turner,29,78,12,1746,151,353,.428,2,7,.286,149,346,.431,.431,33,56,.589,109,178,287,144,90,8,60,209,337
13143,DEN,1989,Blair Rasmussen,26,77,22,1308,257,577,.445,0,0,,257,577,.445,.445,69,81,.852,105,182,287,49,29,41,49,194,583
13144,DEN,1989,Bill Hanzlik,31,41,0,701,66,151,.437,1,5,.200,65,146,.445,.440,68,87,.782,18,75,93,86,25,5,53,82,201
13145,DEN,1989,Jerome Lane,22,54,1,550,109,256,.426,0,7,.000,109,249,.438,.426,43,112,.384,87,113,200,60,20,4,50,105,261
13146,DEN,1989,Dave Greenwood,31,29,3,491,62,148,.419,0,0,,62,148,.419,.419,48,71,.676,48,116,164,41,17,28,36,78,172
13147,DEN,1989,Darwin Cook,30,30,4,386,71,163,.436,2,10,.200,69,153,.451,.442,17,22,.773,13,35,48,43,28,6,26,44,161
13148,DEN,1989,Eddie Hughes,28,26,1,224,28,64,.438,7,22,.318,21,42,.500,.492,7,12,.583,6,13,19,35,17,2,11,30,70
13149,DEN,1989,Calvin Natt,32,14,0,168,22,50,.440,0,1,.000,22,49,.449,.440,22,31,.710,12,34,46,7,6,1,11,13,66
13150,DEN,1989,Jay Vincent,29,5,1,95,13,38,.342,1,2,.500,12,36,.333,.355,5,9,.556,2,16,18,5,1,1,5,11,32
13151,DEN,1989,Wayne Engelstad,23,11,0,50,11,29,.379,0,0,,11,29,.379,.379,6,10,.600,5,11,16,7,1,0,3,12,28
13152,DEN,1988,Fat Lever,27,82,82,3061,643,1360,.473,12,57,.211,631,1303,.484,.477,248,316,.785,203,462,665,639,223,21,182,214,1546
13153,DEN,1988,Alex English,34,80,80,2818,843,1704,.495,0,6,.000,843,1698,.496,.495,314,379,.828,166,207,373,377,70,23,181,193,2000
13154,DEN,1988,Michael Adams,25,82,75,2778,416,927,.449,139,379,.367,277,548,.505,.524,166,199,.834,40,183,223,503,168,16,144,138,1137
13155,DEN,1988,Danny Schayes,28,81,74,2166,361,668,.540,0,2,.000,361,666,.542,.540,407,487,.836,200,462,662,106,62,92,155,323,1129
13156,DEN,1988,Blair Rasmussen,25,79,45,1779,435,884,.492,0,0,,435,884,.492,.492,132,170,.776,130,307,437,78,22,81,73,241,1002
13157,DEN,1988,Jay Vincent,28,73,8,1755,446,958,.466,1,4,.250,445,954,.466,.466,231,287,.805,80,229,309,143,46,26,137,198,1124
13158,DEN,1988,T.R. Dunn,32,82,1,1534,70,156,.449,0,1,.000,70,155,.452,.449,40,52,.769,110,130,240,87,101,11,26,152,180
13159,DEN,1988,Bill Hanzlik,30,77,0,1334,109,287,.380,3,16,.188,106,271,.391,.385,129,163,.791,39,132,171,166,64,17,95,185,350
13160,DEN,1988,Wayne Cooper,31,45,32,865,118,270,.437,0,1,.000,118,269,.439,.437,50,67,.746,98,172,270,30,12,94,59,145,286
13161,DEN,1988,Mike Evans,32,56,0,656,139,307,.453,36,91,.396,103,216,.477,.511,30,37,.811,9,39,48,81,34,6,43,78,344
13162,DEN,1988,Calvin Natt,31,27,7,533,102,208,.490,0,1,.000,102,207,.493,.490,54,73,.740,35,61,96,47,13,3,30,43,258
13163,DEN,1988,Otis Smith,24,15,6,191,37,93,.398,0,0,,37,93,.398,.398,21,28,.750,16,14,30,11,5,6,12,23,95
13164,DEN,1988,Maurice Martin,23,26,0,136,23,61,.377,1,4,.250,22,57,.386,.385,10,21,.476,13,11,24,14,6,3,10,21,57
13165,DEN,1988,Michael Brooks,29,16,0,133,20,49,.408,0,0,,20,49,.408,.408,3,4,.750,19,25,44,13,4,1,12,21,43
13166,DEN,1988,Andre Moore,23,7,0,34,7,24,.292,0,0,,7,24,.292,.292,6,6,1.000,5,7,12,5,2,1,3,4,20
13167,DEN,1988,Brad Wright,25,2,0,7,1,5,.200,0,0,,1,5,.200,.200,0,0,,0,1,1,0,0,0,2,3,2
13168,DEN,1987,Alex English,33,82,82,3085,965,1920,.503,4,15,.267,961,1905,.504,.504,411,487,.844,146,198,344,422,73,21,214,216,2345
13169,DEN,1987,Fat Lever,26,82,82,3054,643,1370,.469,22,92,.239,621,1278,.486,.477,244,312,.782,216,513,729,654,201,34,167,219,1552
13170,DEN,1987,Darrell Walker,25,81,25,2020,358,742,.482,0,4,.000,358,738,.485,.482,272,365,.745,157,170,327,282,120,37,187,229,988
13171,DEN,1987,Bill Hanzlik,29,73,10,1990,307,746,.412,22,80,.275,285,666,.428,.426,316,402,.786,79,177,256,280,87,28,132,245,952
13172,DEN,1987,T.R. Dunn,31,81,53,1932,118,276,.428,0,2,.000,118,274,.431,.428,36,55,.655,91,174,265,147,100,21,33,160,272
13173,DEN,1987,Mike Evans,31,81,4,1567,334,729,.458,53,169,.314,281,560,.502,.495,96,123,.780,36,92,128,185,79,12,107,149,817
13174,DEN,1987,Wayne Cooper,30,69,64,1561,235,524,.448,0,3,.000,235,521,.451,.448,79,109,.725,162,311,473,68,13,101,78,257,549
13175,DEN,1987,Danny Schayes,27,76,41,1556,210,405,.519,0,0,,210,405,.519,.519,229,294,.779,120,260,380,85,20,74,95,266,649
13176,DEN,1987,Blair Rasmussen,24,74,23,1421,268,570,.470,0,0,,268,570,.470,.470,169,231,.732,183,282,465,60,24,58,79,224,705
13177,DEN,1987,Mark Alarie,23,64,25,1110,217,443,.490,2,9,.222,215,434,.495,.492,67,101,.663,73,141,214,74,22,28,56,138,503
13178,DEN,1987,Maurice Martin,22,43,0,286,51,135,.378,3,15,.200,48,120,.400,.389,42,66,.636,12,29,41,35,13,6,33,48,147
13179,DEN,1987,Otis Smith,23,28,0,168,33,79,.418,0,2,.000,33,77,.429,.418,12,21,.571,17,17,34,22,1,1,19,30,78
13180,DEN,1987,Calvin Natt,30,1,1,20,4,10,.400,0,0,,4,10,.400,.400,2,2,1.000,2,3,5,2,1,0,1,2,10
13181,DEN,1987,Pete Williams,21,5,0,10,1,2,.500,0,0,,1,2,.500,.500,0,0,,0,1,1,1,0,0,1,1,2
13182,DEN,1986,Alex English,32,81,81,3024,951,1888,.504,1,5,.200,950,1883,.505,.504,511,593,.862,192,213,405,320,73,29,249,235,2414
13183,DEN,1986,Fat Lever,25,78,77,2616,468,1061,.441,12,38,.316,456,1023,.446,.447,132,182,.725,136,284,420,584,178,15,210,204,1080
13184,DEN,1986,T.R. Dunn,30,82,82,2401,172,379,.454,0,1,.000,172,378,.455,.454,68,88,.773,143,234,377,171,155,16,51,228,412
13185,DEN,1986,Wayne Cooper,29,78,78,2112,422,906,.466,3,7,.429,419,899,.466,.467,174,219,.795,190,420,610,81,42,227,117,315,1021
13186,DEN,1986,Calvin Natt,29,69,62,2007,469,930,.504,2,6,.333,467,924,.505,.505,278,347,.801,125,311,436,164,58,13,130,143,1218
13187,DEN,1986,Bill Hanzlik,28,79,0,1982,331,741,.447,8,41,.195,323,700,.461,.452,318,405,.785,88,176,264,316,107,16,165,277,988
13188,DEN,1986,Danny Schayes,26,80,13,1654,221,440,.502,0,1,.000,221,439,.503,.502,216,278,.777,154,285,439,79,42,63,105,298,658
13189,DEN,1986,Mike Evans,30,81,1,1389,304,715,.425,39,176,.222,265,539,.492,.452,126,149,.846,30,71,101,177,61,1,124,159,773
13190,DEN,1986,Elston Turner,26,73,0,1324,165,379,.435,0,9,.000,165,370,.446,.435,39,53,.736,64,137,201,165,70,6,80,150,369
13191,DEN,1986,Pete Williams,20,53,11,573,67,111,.604,0,0,,67,111,.604,.604,17,40,.425,47,99,146,14,19,23,19,68,151
13192,DEN,1986,Willie White,23,43,4,343,74,168,.440,6,21,.286,68,147,.463,.458,19,23,.826,17,27,44,53,18,2,25,24,173
13193,DEN,1986,Blair Rasmussen,23,48,1,330,61,150,.407,0,0,,61,150,.407,.407,31,39,.795,37,60,97,16,3,10,40,63,153
13194,DEN,1985,Alex English,31,81,81,2924,939,1812,.518,1,5,.200,938,1807,.519,.518,383,462,.829,203,255,458,344,101,46,251,259,2262
13195,DEN,1985,Calvin Natt,28,78,76,2657,685,1255,.546,0,3,.000,685,1252,.547,.546,447,564,.793,209,401,610,238,75,33,190,182,1817
13196,DEN,1985,Fat Lever,24,82,82,2559,424,985,.430,6,24,.250,418,961,.435,.434,197,256,.770,147,264,411,613,202,30,203,226,1051
13197,DEN,1985,T.R. Dunn,29,81,81,2290,175,358,.489,0,2,.000,175,356,.492,.489,84,116,.724,169,216,385,153,140,14,65,213,434
13198,DEN,1985,Wayne Cooper,28,80,78,2031,404,856,.472,0,2,.000,404,854,.473,.472,161,235,.685,229,402,631,86,28,197,149,304,969
13199,DEN,1985,Dan Issel,36,77,9,1684,363,791,.459,1,7,.143,362,784,.462,.460,257,319,.806,80,251,331,137,65,31,93,171,984
13200,DEN,1985,Bill Hanzlik,27,80,1,1673,220,522,.421,1,15,.067,219,507,.432,.422,180,238,.756,88,119,207,210,84,26,115,291,621
13201,DEN,1985,Elston Turner,25,81,2,1491,181,388,.466,1,6,.167,180,382,.471,.468,51,65,.785,88,128,216,158,96,7,70,152,414
13202,DEN,1985,Mike Evans,29,81,0,1437,323,661,.489,57,157,.363,266,504,.528,.532,113,131,.863,26,93,119,231,65,12,130,174,816
13203,DEN,1985,Danny Schayes,25,56,0,542,60,129,.465,0,0,,60,129,.465,.465,79,97,.814,48,96,144,38,20,25,44,98,199
13204,DEN,1985,Joe Kopicki,24,42,0,308,50,95,.526,2,3,.667,48,92,.522,.537,43,54,.796,29,57,86,29,13,1,28,58,145
13205,DEN,1985,Willie White,22,39,0,234,52,124,.419,4,11,.364,48,113,.425,.435,21,31,.677,15,21,36,29,5,2,30,24,129
13206,DEN,1984,Alex English,30,82,77,2870,907,1714,.529,1,7,.143,906,1707,.531,.529,352,427,.824,216,248,464,406,83,95,222,252,2167
13207,DEN,1984,Kiki Vandeweghe,25,78,71,2734,895,1603,.558,11,30,.367,884,1573,.562,.562,494,580,.852,84,289,373,238,53,50,156,187,2295
13208,DEN,1984,T.R. Dunn,28,80,74,2705,174,370,.470,0,1,.000,174,369,.472,.470,106,145,.731,195,379,574,228,173,32,97,233,454
13209,DEN,1984,Dan Issel,35,76,66,2076,569,1153,.493,4,19,.211,565,1134,.498,.495,364,428,.850,112,401,513,173,60,44,122,182,1506
13210,DEN,1984,Rob Williams,22,79,66,1924,309,671,.461,15,47,.319,294,624,.471,.472,171,209,.818,54,140,194,464,84,5,169,268,804
13211,DEN,1984,Mike Evans,28,78,5,1687,243,564,.431,32,89,.360,211,475,.444,.459,111,131,.847,23,115,138,288,61,4,117,175,629
13212,DEN,1984,Bill Hanzlik,26,80,14,1469,132,306,.431,3,12,.250,129,294,.439,.436,167,207,.807,66,139,205,252,68,19,109,255,434
13213,DEN,1984,Danny Schayes,24,82,15,1420,183,371,.493,0,2,.000,183,369,.496,.493,215,272,.790,145,288,433,91,32,60,119,308,581
13214,DEN,1984,Richard Anderson,23,78,17,1380,272,638,.426,3,19,.158,269,619,.435,.429,116,150,.773,136,270,406,193,46,28,109,183,663
13215,DEN,1984,Howard Carter,22,55,5,688,145,316,.459,5,19,.263,140,297,.471,.467,47,61,.770,38,48,86,71,19,4,42,81,342
13216,DEN,1984,Kenny Dennard,25,43,0,413,36,99,.364,3,10,.300,33,89,.371,.379,15,24,.625,37,64,101,45,23,8,29,83,90
13217,DEN,1984,Anthony Roberts,28,19,0,197,34,91,.374,0,0,,34,91,.374,.374,13,18,.722,20,31,51,13,5,1,17,43,81
13218,DEN,1984,Dave Robisch,34,19,0,141,13,40,.325,0,0,,13,40,.325,.325,11,13,.846,1,20,21,13,0,1,11,13,37
13219,DEN,1984,Keith Edmonson,23,15,0,101,23,47,.489,0,0,,23,47,.489,.489,18,25,.720,6,12,18,7,4,1,16,16,64
13220,DEN,1983,Alex English,29,82,82,2988,959,1857,.516,2,12,.167,957,1845,.519,.517,406,490,.829,263,338,601,397,116,126,263,235,2326
13221,DEN,1983,Kiki Vandeweghe,24,82,79,2909,841,1537,.547,15,51,.294,826,1486,.556,.552,489,559,.875,124,313,437,203,66,38,177,198,2186
13222,DEN,1983,T.R. Dunn,27,82,80,2640,254,527,.482,0,1,.000,254,526,.483,.482,119,163,.730,231,384,615,189,147,25,113,218,627
13223,DEN,1983,Dan Issel,34,80,80,2431,661,1296,.510,4,19,.211,657,1277,.514,.512,400,479,.835,151,445,596,223,83,43,174,227,1726
13224,DEN,1983,Billy McKinney,27,68,38,1559,266,546,.487,0,7,.000,266,539,.494,.487,136,167,.814,21,100,121,288,39,5,101,142,668
13225,DEN,1983,Bill Hanzlik,25,82,8,1547,187,437,.428,1,7,.143,186,430,.433,.429,125,160,.781,80,156,236,268,75,15,144,220,500
13226,DEN,1983,Rob Williams,21,74,33,1443,191,468,.408,2,15,.133,189,453,.417,.410,131,174,.753,37,99,136,361,89,12,185,221,515
13227,DEN,1983,Glen Gondrezick,27,76,2,1130,134,294,.456,0,3,.000,134,291,.460,.456,82,114,.719,108,193,301,100,80,9,49,161,350
13228,DEN,1983,Dave Robisch,33,61,0,711,96,251,.382,0,1,.000,96,250,.384,.382,92,118,.780,34,117,151,53,10,9,45,61,284
13229,DEN,1983,Mike Evans,27,42,5,695,115,243,.473,0,9,.000,115,234,.491,.473,33,41,.805,4,54,58,113,23,3,71,94,263
13230,DEN,1983,Danny Schayes,23,32,0,646,111,235,.472,0,0,,111,235,.472,.472,71,100,.710,63,123,186,40,15,30,58,109,293
13231,DEN,1983,Rich Kelley,29,38,0,565,59,141,.418,0,0,,59,141,.418,.418,55,70,.786,61,111,172,59,21,18,53,115,173
13232,DEN,1983,James Ray,25,45,3,433,70,153,.458,0,1,.000,70,152,.461,.458,33,51,.647,37,89,126,39,24,19,50,83,173
13233,DEN,1983,Dwight Anderson,22,5,0,33,7,14,.500,0,0,,7,14,.500,.500,7,10,.700,0,2,2,3,1,0,5,7,21
13234,DEN,1982,Alex English,28,82,82,3015,855,1553,.551,0,8,.000,855,1545,.553,.551,372,443,.840,210,348,558,433,87,120,261,261,2082
13235,DEN,1982,Kiki Vandeweghe,23,82,78,2775,706,1260,.560,1,13,.077,705,1247,.565,.561,347,405,.857,149,312,461,247,52,29,189,217,1760
13236,DEN,1982,T.R. Dunn,26,82,80,2519,258,504,.512,0,1,.000,258,503,.513,.512,153,215,.712,211,348,559,188,135,36,123,210,669
13237,DEN,1982,Dan Issel,33,81,81,2472,651,1236,.527,4,6,.667,647,1230,.526,.528,546,655,.834,174,434,608,179,67,55,169,245,1852
13238,DEN,1982,Billy McKinney,26,81,27,1963,369,699,.528,0,17,.000,369,682,.541,.528,137,170,.806,29,113,142,338,69,16,115,186,875
13239,DEN,1982,Glen Gondrezick,26,80,0,1699,250,495,.505,0,3,.000,250,492,.508,.505,160,217,.737,140,283,423,152,92,36,100,229,660
13240,DEN,1982,Kenny Higgs,27,76,49,1696,202,468,.432,4,21,.190,198,447,.443,.436,161,197,.817,23,121,144,395,72,6,156,263,569
13241,DEN,1982,Cedrick Hordges,25,77,1,1372,204,414,.493,3,13,.231,201,401,.501,.496,116,199,.583,119,276,395,65,26,19,111,230,527
13242,DEN,1982,David Thompson,27,61,5,1246,313,644,.486,4,14,.286,309,630,.490,.489,276,339,.814,57,91,148,117,34,29,142,149,906
13243,DEN,1982,John Roche,32,39,2,501,68,150,.453,23,52,.442,45,98,.459,.530,28,38,.737,4,19,23,89,15,2,29,40,187
13244,DEN,1982,James Ray,24,40,4,262,51,116,.440,1,1,1.000,50,115,.435,.444,21,36,.583,18,47,65,26,10,16,37,59,124
13245,DEN,1982,Dave Robisch,32,12,0,257,48,106,.453,0,0,,48,106,.453,.453,48,55,.873,14,49,63,32,3,4,13,29,144
13246,DEN,1982,David Burns,23,6,1,53,5,11,.455,0,0,,5,11,.455,.455,6,9,.667,1,2,3,11,2,0,8,13,16
13247,DEN,1981,Alex English,27,81,,3093,768,1555,.494,3,5,.600,765,1550,.494,.495,390,459,.850,273,373,646,290,106,100,241,255,1929
13248,DEN,1981,Dan Issel,32,80,,2641,614,1220,.503,2,12,.167,612,1208,.507,.504,519,684,.759,229,447,676,158,83,53,130,249,1749
13249,DEN,1981,David Thompson,26,77,,2620,734,1451,.506,10,39,.256,724,1412,.513,.509,489,615,.795,107,180,287,231,53,60,250,231,1967
13250,DEN,1981,Dave Robisch,31,73,,1744,293,642,.456,0,0,,293,642,.456,.456,171,211,.810,130,284,414,129,30,28,69,152,757
13251,DEN,1981,Kenny Higgs,26,72,,1689,209,474,.441,4,34,.118,205,440,.466,.445,140,172,.814,24,121,145,408,101,6,166,243,562
13252,DEN,1981,Cedrick Hordges,24,68,,1599,221,480,.460,0,3,.000,221,477,.463,.460,130,186,.699,120,338,458,104,33,19,120,226,572
13253,DEN,1981,T.R. Dunn,25,82,,1427,146,354,.412,0,2,.000,146,352,.415,.412,79,121,.653,133,168,301,81,66,29,56,141,371
13254,DEN,1981,Kiki Vandeweghe,22,51,,1376,229,537,.426,0,7,.000,229,530,.432,.426,130,159,.818,86,184,270,94,29,24,86,116,588
13255,DEN,1981,Billy McKinney,25,49,,1134,203,412,.493,1,10,.100,202,402,.502,.494,118,140,.843,24,86,110,203,61,7,88,124,525
13256,DEN,1981,Glen Gondrezick,25,73,,1077,155,329,.471,0,2,.000,155,327,.474,.471,112,137,.818,136,171,307,83,91,20,69,185,422
13257,DEN,1981,John Roche,31,26,,611,82,179,.458,9,27,.333,73,152,.480,.483,58,77,.753,5,32,37,140,17,8,52,44,231
13258,DEN,1981,Carl Nicks,22,27,,493,65,149,.436,0,1,.000,65,148,.439,.436,35,59,.593,13,36,49,80,28,2,63,52,165
13259,DEN,1981,Kim Hughes,28,8,,159,11,25,.440,0,0,,11,25,.440,.440,1,2,.500,19,31,50,11,11,14,11,33,23
13260,DEN,1981,James Ray,23,18,,148,15,49,.306,0,1,.000,15,48,.313,.306,7,10,.700,13,24,37,11,4,4,13,31,37
13261,DEN,1981,Ronnie Valentine,23,24,,123,37,98,.378,1,2,.500,36,96,.375,.383,9,19,.474,10,20,30,7,7,4,16,23,84
13262,DEN,1981,Jawann Oldham,23,4,,21,2,6,.333,0,0,,2,6,.333,.333,0,0,,3,2,5,0,0,2,2,3,4
13263,DEN,1980,Dan Issel,31,82,82,2938,715,1416,.505,4,12,.333,711,1404,.506,.506,517,667,.775,236,483,719,198,88,54,163,190,1951
13264,DEN,1980,Bob Wilkerson,25,75,,2381,430,1030,.417,7,34,.206,423,996,.425,.421,166,222,.748,85,231,316,243,93,27,193,194,1033
13265,DEN,1980,John Roche,30,82,,2286,354,741,.478,49,129,.380,305,612,.498,.511,175,202,.866,24,91,115,405,82,12,159,139,932
13266,DEN,1980,George Johnson,23,75,,1938,309,649,.476,2,9,.222,307,640,.480,.478,148,189,.783,190,394,584,157,84,67,148,260,768
13267,DEN,1980,Charlie Scott,31,69,,1860,276,688,.401,2,11,.182,274,677,.405,.403,85,118,.720,51,115,166,250,47,23,163,197,639
13268,DEN,1980,George McGinnis,29,45,,1424,268,584,.459,1,7,.143,267,577,.463,.460,166,307,.541,134,328,462,221,69,17,188,187,703
13269,DEN,1980,David Thompson,25,39,,1239,289,617,.468,7,19,.368,282,598,.472,.474,254,335,.758,56,118,174,124,39,38,116,106,839
13270,DEN,1980,Kim Hughes,27,70,,1208,102,202,.505,0,0,,102,202,.505,.505,15,41,.366,125,201,326,74,66,77,50,184,219
13271,DEN,1980,Gary Garland,22,78,,1106,155,356,.435,6,19,.316,149,337,.442,.444,18,26,.692,50,88,138,145,54,4,73,80,334
13272,DEN,1980,Glen Gondrezick,24,59,,1020,148,286,.517,2,6,.333,146,280,.521,.521,92,121,.760,107,152,259,81,68,16,58,119,390
13273,DEN,1980,Alex English,26,24,,875,207,427,.485,2,3,.667,205,424,.483,.487,96,126,.762,102,123,225,82,28,29,90,78,512
13274,DEN,1980,Tom Boswell,26,18,,522,72,135,.533,1,2,.500,71,133,.534,.537,58,70,.829,40,74,114,46,5,8,39,56,203
13275,DEN,1980,Bo Ellis,25,48,,502,61,136,.449,0,3,.000,61,133,.459,.449,40,53,.755,51,65,116,30,10,24,24,67,162
13276,DEN,1980,Anthony Roberts,24,23,,486,69,181,.381,0,1,.000,69,180,.383,.381,39,60,.650,54,55,109,20,13,3,28,52,177
13277,DEN,1980,Arvid Kramer,23,8,,45,7,22,.318,0,0,,7,22,.318,.318,2,2,1.000,6,6,12,3,0,5,5,8,16
13278,DAL,2024,Luka Dončić,24,70,70,2624,804,1652,.487,284,744,.382,520,908,.573,.573,478,608,.786,59,588,647,686,99,38,282,149,2370
13279,DAL,2024,Tim Hardaway Jr.,31,79,12,2120,392,976,.402,211,597,.353,181,379,.478,.510,144,169,.852,22,232,254,139,42,6,69,106,1139
13280,DAL,2024,Kyrie Irving,31,58,58,2030,562,1131,.497,173,421,.411,389,710,.548,.573,190,210,.905,44,246,290,299,74,28,106,112,1487
13281,DAL,2024,Derrick Jones Jr.,26,76,66,1783,239,495,.483,82,239,.343,157,256,.613,.566,97,136,.713,82,168,250,75,53,51,65,121,657
13282,DAL,2024,Josh Green,23,57,33,1505,179,374,.479,72,187,.385,107,187,.572,.575,39,57,.684,40,144,184,130,47,9,60,107,469
13283,DAL,2024,Dereck Lively II,19,55,42,1294,221,296,.747,0,2,.000,221,294,.752,.747,41,81,.506,135,243,378,60,36,77,50,144,483
13284,DAL,2024,Grant Williams,25,47,33,1242,131,317,.413,79,210,.376,52,107,.486,.538,41,55,.745,46,123,169,81,24,27,53,137,382
13285,DAL,2024,Dante Exum,28,55,17,1088,161,302,.533,53,108,.491,108,194,.557,.621,53,68,.779,25,124,149,157,22,5,49,85,428
13286,DAL,2024,Jaden Hardy,21,73,7,989,195,479,.407,81,224,.362,114,255,.447,.492,59,76,.776,20,111,131,109,22,4,62,80,530
13287,DAL,2024,P.J. Washington,25,29,28,935,127,302,.421,53,169,.314,74,133,.556,.508,32,51,.627,32,147,179,44,34,27,30,57,339
13288,DAL,2024,Maxi Kleber,32,43,7,871,63,146,.432,32,92,.348,31,54,.574,.541,33,47,.702,30,113,143,68,17,30,28,79,191
13289,DAL,2024,Dwight Powell,32,63,9,836,72,106,.679,1,3,.333,71,103,.689,.684,63,89,.708,97,117,214,84,26,20,32,113,208
13290,DAL,2024,Daniel Gafford,25,29,21,623,145,186,.780,0,0,,145,186,.780,.780,34,56,.607,64,137,201,46,21,56,28,80,324
13291,DAL,2024,Seth Curry,33,36,3,457,54,145,.372,29,80,.363,25,65,.385,.472,17,19,.895,15,37,52,30,17,3,16,32,154
13292,DAL,2024,Olivier-Maxence Prosper,21,40,1,336,40,104,.385,13,45,.289,27,59,.458,.447,28,41,.683,25,54,79,22,7,4,8,20,121
13293,DAL,2024,A.J. Lawson,23,42,0,311,54,121,.446,13,50,.260,41,71,.577,.500,15,23,.652,14,36,50,20,10,3,14,22,136
13294,DAL,2024,Richaun Holmes,30,23,2,237,33,59,.559,0,0,,33,59,.559,.559,12,21,.571,33,45,78,15,3,9,12,33,78
13295,DAL,2024,Markieff Morris,34,26,1,216,23,68,.338,15,42,.357,8,26,.308,.449,5,6,.833,4,35,39,16,5,3,12,12,66
13296,DAL,2024,Brandon Williams,24,17,0,113,20,54,.370,3,15,.200,17,39,.436,.398,11,17,.647,4,9,13,17,1,1,7,4,54
13297,DAL,2024,Greg Brown III,22,6,0,40,5,11,.455,1,3,.333,4,8,.500,.500,4,9,.444,3,6,9,4,0,4,4,5,15
13298,DAL,2024,Dexter Dennis,24,4,0,30,10,19,.526,1,8,.125,9,11,.818,.553,1,3,.333,1,8,9,4,0,1,3,1,22
13299,DAL,2024,Alex Fudge,20,2,0,26,5,9,.556,1,3,.333,4,6,.667,.611,0,0,,2,1,3,0,3,0,1,1,11
13300,DAL,2023,Luka Dončić,23,66,66,2391,719,1449,.496,185,541,.342,534,908,.588,.560,515,694,.742,54,515,569,529,90,33,236,166,2138
13301,DAL,2023,Reggie Bullock,31,78,55,2364,192,470,.409,151,397,.380,41,73,.562,.569,26,37,.703,32,251,283,108,54,13,36,166,561
13302,DAL,2023,Tim Hardaway Jr.,30,71,45,2152,340,847,.401,212,550,.385,128,297,.431,.527,127,165,.770,21,230,251,129,49,12,60,120,1019
13303,DAL,2023,Spencer Dinwiddie,29,53,53,1808,316,694,.455,138,341,.405,178,353,.504,.555,170,207,.821,19,144,163,279,39,16,90,124,940
13304,DAL,2023,Christian Wood,27,67,17,1738,396,769,.515,105,279,.376,291,490,.594,.583,217,281,.772,87,404,491,121,30,72,121,169,1114
13305,DAL,2023,Josh Green,22,60,21,1539,205,382,.537,68,169,.402,137,213,.643,.626,68,94,.723,55,127,182,103,42,5,72,156,546
13306,DAL,2023,Dwight Powell,31,76,64,1458,197,269,.732,0,5,.000,197,264,.746,.732,112,168,.667,149,165,314,69,48,26,65,209,506
13307,DAL,2023,Dorian Finney-Smith,29,40,40,1288,129,310,.416,77,217,.355,52,93,.559,.540,30,40,.750,67,121,188,59,38,20,36,80,365
13308,DAL,2023,Maxi Kleber,31,37,5,930,77,169,.456,39,112,.348,38,57,.667,.571,27,38,.711,30,105,135,52,12,30,27,85,220
13309,DAL,2023,Kyrie Irving,30,20,20,763,196,384,.510,58,148,.392,138,236,.585,.586,89,94,.947,21,79,100,120,25,12,37,56,539
13310,DAL,2023,Jaden Hardy,20,48,5,708,146,333,.438,63,156,.404,83,177,.469,.533,65,79,.823,11,78,89,65,17,7,46,64,420
13311,DAL,2023,Frank Ntilikina,24,47,5,607,48,132,.364,17,67,.254,31,65,.477,.428,22,33,.667,7,55,62,58,16,7,29,65,135
13312,DAL,2023,Dāvis Bertāns,30,45,1,492,69,160,.431,55,141,.390,14,19,.737,.603,13,15,.867,10,43,53,21,11,8,10,53,206
13313,DAL,2023,JaVale McGee,35,42,7,355,80,125,.640,2,5,.400,78,120,.650,.648,24,41,.585,30,77,107,11,4,26,36,54,186
13314,DAL,2023,McKinley Wright IV,24,27,1,335,46,98,.469,9,28,.321,37,70,.529,.515,13,19,.684,9,38,47,58,8,5,19,24,114
13315,DAL,2023,Theo Pinson,27,40,1,323,31,87,.356,22,62,.355,9,25,.360,.483,11,13,.846,10,53,63,46,6,1,12,34,95
13316,DAL,2023,Justin Holiday,33,18,2,295,29,79,.367,16,56,.286,13,23,.565,.468,5,8,.625,3,29,32,16,14,9,10,31,79
13317,DAL,2023,Kemba Walker,32,9,1,144,24,57,.421,7,28,.250,17,29,.586,.482,17,21,.810,3,13,16,19,2,2,4,11,72
13318,DAL,2023,A.J. Lawson,22,14,0,106,21,43,.488,10,25,.400,11,18,.611,.605,2,8,.250,6,14,20,2,2,0,3,10,54
13319,DAL,2023,Markieff Morris,33,8,1,70,14,33,.424,8,22,.364,6,11,.545,.545,0,0,,0,12,12,6,1,0,4,15,36
13320,DAL,2023,Facundo Campazzo,31,8,0,52,3,13,.231,3,11,.273,0,2,.000,.346,1,2,.500,0,2,2,9,6,0,3,3,10
13321,DAL,2023,Tyler Dorsey,26,3,0,8,4,5,.800,1,2,.500,3,3,1.000,.900,0,0,,1,1,2,0,0,0,0,0,9
13322,DAL,2023,Chris Silva,26,1,0,3,1,1,1.000,0,0,,1,1,1.000,1.000,0,0,,0,0,0,0,0,0,1,2,2
13323,DAL,2022,Dorian Finney-Smith,28,80,80,2644,326,692,.471,172,435,.395,154,257,.599,.595,56,83,.675,122,253,375,150,88,39,80,183,880
13324,DAL,2022,Jalen Brunson,25,79,61,2524,506,1008,.502,94,252,.373,412,756,.545,.549,179,213,.840,43,266,309,377,66,3,124,151,1285
13325,DAL,2022,Luka Dončić,22,65,65,2301,641,1403,.457,201,569,.353,440,834,.528,.529,364,489,.744,56,537,593,568,75,36,292,145,1847
13326,DAL,2022,Reggie Bullock,30,68,37,1902,201,501,.401,141,392,.360,60,109,.550,.542,40,48,.833,33,208,241,83,41,14,40,111,583
13327,DAL,2022,Dwight Powell,30,82,71,1798,269,401,.671,13,37,.351,256,364,.703,.687,166,212,.783,173,231,404,97,37,39,64,220,717
13328,DAL,2022,Maxi Kleber,30,59,21,1450,141,354,.398,83,255,.325,58,99,.586,.516,46,65,.708,70,280,350,68,30,58,47,137,411
13329,DAL,2022,Tim Hardaway Jr.,29,42,20,1245,209,530,.394,102,304,.336,107,226,.473,.491,78,103,.757,13,143,156,92,38,6,34,74,598
13330,DAL,2022,Josh Green,21,67,3,1039,130,256,.508,28,78,.359,102,178,.573,.563,31,45,.689,52,109,161,79,45,14,44,115,319
13331,DAL,2022,Kristaps Porziņģis,26,34,34,1002,229,508,.451,49,173,.283,180,335,.537,.499,147,170,.865,64,197,261,69,25,59,53,88,654
13332,DAL,2022,Frank Ntilikina,23,58,5,685,89,223,.399,38,111,.342,51,112,.455,.484,24,25,.960,12,67,79,69,27,7,31,61,240
13333,DAL,2022,Spencer Dinwiddie,28,23,7,650,121,243,.498,42,104,.404,79,139,.568,.584,79,109,.725,9,63,72,90,17,6,31,43,363
13334,DAL,2022,Sterling Brown,26,49,3,628,59,155,.381,28,92,.304,31,63,.492,.471,14,15,.933,26,123,149,34,14,7,23,56,160
13335,DAL,2022,Trey Burke,29,42,0,441,84,215,.391,26,82,.317,58,133,.436,.451,20,23,.870,4,29,33,57,12,0,26,39,214
13336,DAL,2022,Marquese Chriss,24,34,0,346,62,134,.463,8,25,.320,54,109,.495,.493,22,33,.667,33,70,103,17,13,12,17,64,154
13337,DAL,2022,Dāvis Bertāns,29,22,0,306,39,104,.375,31,86,.360,8,18,.444,.524,8,10,.800,6,50,56,15,6,6,5,30,117
13338,DAL,2022,Willie Cauley-Stein,28,18,2,177,16,35,.457,1,2,.500,15,33,.455,.471,1,2,.500,13,25,38,9,6,3,7,17,34
13339,DAL,2022,Moses Brown,22,26,1,169,27,50,.540,0,0,,27,50,.540,.540,27,43,.628,16,45,61,1,3,9,14,28,81
13340,DAL,2022,Theo Pinson,26,19,0,148,14,39,.359,10,30,.333,4,9,.444,.487,10,10,1.000,2,19,21,17,5,2,5,12,48
13341,DAL,2022,Boban Marjanović,33,23,0,128,42,70,.600,1,4,.250,41,66,.621,.607,13,22,.591,8,31,39,3,0,3,15,24,98
13342,DAL,2022,Brandon Knight,30,5,0,65,10,25,.400,4,17,.235,6,8,.750,.480,8,8,1.000,0,8,8,8,1,0,4,5,32
13343,DAL,2022,Carlik Jones,24,3,0,19,0,7,.000,0,1,.000,0,6,.000,.000,2,2,1.000,1,2,3,5,1,0,3,0,2
13344,DAL,2022,George King,28,4,0,19,0,5,.000,0,4,.000,0,1,.000,.000,1,2,.500,0,5,5,0,0,0,1,4,1
13345,DAL,2022,Eugene Omoruyi,24,4,0,18,2,5,.400,1,2,.500,1,3,.333,.500,2,4,.500,2,5,7,2,0,0,0,2,7
13346,DAL,2022,Charlie Brown Jr.,24,3,0,15,1,5,.200,0,3,.000,1,2,.500,.200,0,0,,0,1,1,1,2,1,0,2,2
13347,DAL,2022,Isaiah Thomas,32,1,0,13,3,8,.375,0,3,.000,3,5,.600,.375,0,0,,0,0,0,4,0,0,0,0,6
13348,DAL,2022,Moses Wright,23,3,0,13,1,4,.250,0,1,.000,1,3,.333,.250,3,3,1.000,1,2,3,1,0,1,0,0,5
13349,DAL,2022,JaQuori McLaughlin,24,4,0,11,0,2,.000,0,1,.000,0,1,.000,.000,0,0,,0,0,0,2,0,0,0,1,0
13350,DAL,2021,Luka Dončić,21,66,66,2262,647,1351,.479,192,548,.350,455,803,.567,.550,344,471,.730,54,473,527,567,64,36,281,152,1830
13351,DAL,2021,Tim Hardaway Jr.,28,70,31,1985,407,911,.447,207,529,.391,200,382,.524,.560,142,174,.816,20,209,229,126,31,11,64,111,1163
13352,DAL,2021,Dorian Finney-Smith,27,60,60,1921,220,466,.472,119,302,.394,101,164,.616,.600,31,41,.756,98,228,326,102,52,25,48,138,590
13353,DAL,2021,Josh Richardson,27,59,56,1790,264,618,.427,88,267,.330,176,351,.501,.498,99,108,.917,51,144,195,153,61,24,79,130,715
13354,DAL,2021,Jalen Brunson,24,68,12,1697,328,627,.523,81,200,.405,247,427,.578,.588,120,151,.795,27,204,231,239,35,1,80,109,857
13355,DAL,2021,Maxi Kleber,29,50,40,1341,116,275,.422,87,212,.410,29,63,.460,.580,34,37,.919,47,213,260,68,24,35,30,105,353
13356,DAL,2021,Kristaps Porziņģis,25,43,43,1327,325,683,.476,97,258,.376,228,425,.536,.547,118,138,.855,82,299,381,68,20,58,51,115,865
13357,DAL,2021,Dwight Powell,29,58,19,966,120,194,.619,5,21,.238,115,173,.665,.631,97,124,.782,80,154,234,63,36,30,40,135,342
13358,DAL,2021,Trey Burke,28,62,1,911,151,353,.428,58,164,.354,93,189,.492,.510,51,57,.895,10,44,54,81,36,7,33,64,411
13359,DAL,2021,Willie Cauley-Stein,27,53,16,906,115,182,.632,1,11,.091,114,171,.667,.635,49,78,.628,66,170,236,35,21,43,29,129,280
13360,DAL,2021,James Johnson,33,29,1,504,67,145,.462,15,60,.250,52,85,.612,.514,17,29,.586,14,72,86,50,24,23,27,59,166
13361,DAL,2021,Josh Green,20,39,5,445,42,93,.452,4,25,.160,38,68,.559,.473,13,23,.565,28,50,78,28,16,3,17,35,101
13362,DAL,2021,Nicolò Melli,30,23,4,325,31,82,.378,16,48,.333,15,34,.441,.476,13,18,.722,17,48,65,19,5,2,5,30,91
13363,DAL,2021,Wes Iwundu,26,23,3,288,17,52,.327,3,23,.130,14,29,.483,.356,12,14,.857,6,38,44,10,9,3,6,26,49
13364,DAL,2021,Boban Marjanović,32,33,3,271,62,122,.508,1,8,.125,61,114,.535,.512,31,38,.816,47,81,128,10,2,6,12,29,156
13365,DAL,2021,JJ Redick,36,13,0,147,19,53,.358,15,38,.395,4,15,.267,.500,4,5,.800,1,11,12,11,2,1,11,13,57
13366,DAL,2021,Nate Hinton,21,21,0,93,15,42,.357,4,19,.211,11,23,.478,.405,7,10,.700,1,8,9,8,7,2,5,8,41
13367,DAL,2021,Tyler Bey,22,18,0,71,7,22,.318,1,4,.250,6,18,.333,.341,3,5,.600,8,11,19,3,0,1,3,6,18
13368,DAL,2021,Tyrell Terry,20,11,0,56,5,16,.313,0,7,.000,5,9,.556,.313,1,3,.333,0,6,6,6,5,0,2,2,11
13369,DAL,2020,Dorian Finney-Smith,26,71,68,2120,243,522,.466,114,303,.376,129,219,.589,.575,78,108,.722,145,260,405,114,45,39,69,178,678
13370,DAL,2020,Tim Hardaway Jr.,27,71,58,2091,384,884,.434,204,513,.398,180,371,.485,.550,149,182,.819,25,207,232,137,41,5,69,125,1121
13371,DAL,2020,Luka Dončić,20,61,61,2047,581,1255,.463,171,541,.316,410,714,.574,.531,426,562,.758,78,495,573,538,62,14,260,153,1759
13372,DAL,2020,Maxi Kleber,28,74,21,1890,237,514,.461,119,319,.373,118,195,.605,.577,79,93,.849,112,276,388,88,25,83,58,176,672
13373,DAL,2020,Kristaps Porziņģis,24,57,57,1814,398,932,.427,142,403,.352,256,529,.484,.503,226,283,.799,100,440,540,102,41,115,92,185,1164
13374,DAL,2020,Seth Curry,29,64,25,1576,284,574,.495,145,321,.452,139,253,.549,.621,80,97,.825,27,118,145,124,38,9,62,113,793
13375,DAL,2020,Delon Wright,27,73,5,1570,190,411,.462,47,127,.370,143,284,.504,.519,77,100,.770,70,210,280,244,85,22,73,93,504
13376,DAL,2020,Dwight Powell,28,40,37,1061,146,229,.638,10,39,.256,136,190,.716,.659,74,111,.667,75,152,227,59,34,22,36,102,376
13377,DAL,2020,Justin Jackson,24,65,3,1045,135,341,.396,48,163,.294,87,178,.489,.466,42,50,.840,27,127,154,52,15,10,14,69,360
13378,DAL,2020,Jalen Brunson,23,57,16,1022,181,388,.466,43,120,.358,138,268,.515,.522,61,75,.813,22,112,134,188,22,4,66,74,466
13379,DAL,2020,J.J. Barea,35,29,6,450,85,207,.411,32,85,.376,53,122,.434,.488,20,22,.909,10,43,53,112,5,2,38,27,222
13380,DAL,2020,Boban Marjanović,31,44,5,422,121,211,.573,4,17,.235,117,194,.603,.583,43,57,.754,66,131,197,20,8,10,30,56,289
13381,DAL,2020,Courtney Lee,34,24,9,345,40,82,.488,21,47,.447,19,35,.543,.616,6,7,.857,7,25,32,12,18,6,11,33,107
13382,DAL,2020,Trey Burke,27,8,1,191,35,82,.427,16,37,.432,19,45,.422,.524,10,11,.909,1,14,15,30,9,1,9,12,96
13383,DAL,2020,Ryan Broekhoff,29,17,1,180,22,59,.373,20,51,.392,2,8,.250,.542,7,8,.875,5,38,43,11,5,4,6,15,71
13384,DAL,2020,Willie Cauley-Stein,26,13,2,157,31,45,.689,0,1,.000,31,44,.705,.689,5,9,.556,13,47,60,10,4,11,5,19,67
13385,DAL,2020,Michael Kidd-Gilchrist,26,13,0,121,4,13,.308,0,3,.000,4,10,.400,.308,4,5,.800,5,27,32,4,2,3,9,19,12
13386,DAL,2020,Antonius Cleveland,25,11,0,46,4,14,.286,0,3,.000,4,11,.364,.286,3,5,.600,2,5,7,1,1,3,2,8,11
13387,DAL,2020,Josh Reaves,22,4,0,28,3,9,.333,0,2,.000,3,7,.429,.333,2,2,1.000,1,2,3,3,0,0,0,5,8
13388,DAL,2019,Luka Dončić,19,72,72,2318,506,1186,.427,168,514,.327,338,672,.503,.497,346,485,.713,86,477,563,429,77,25,247,137,1526
13389,DAL,2019,Dorian Finney-Smith,25,81,26,1985,228,528,.432,79,254,.311,149,274,.544,.507,73,103,.709,138,251,389,95,69,36,74,186,608
13390,DAL,2019,Dwight Powell,27,77,22,1662,290,486,.597,39,127,.307,251,359,.699,.637,196,254,.772,140,271,411,112,44,50,67,201,815
13391,DAL,2019,Jalen Brunson,22,73,38,1591,264,565,.467,63,181,.348,201,384,.523,.523,87,120,.725,25,144,169,230,37,4,88,127,678
13392,DAL,2019,Harrison Barnes,26,49,49,1584,290,717,.404,121,311,.389,169,406,.416,.489,165,198,.833,36,171,207,62,33,11,68,79,866
13393,DAL,2019,DeAndre Jordan,30,50,50,1554,208,323,.644,0,0,,208,323,.644,.644,135,198,.682,161,525,686,99,33,53,111,125,551
13394,DAL,2019,Maxi Kleber,27,71,18,1502,175,386,.453,77,218,.353,98,168,.583,.553,58,74,.784,90,239,329,70,36,78,54,143,485
13395,DAL,2019,Wesley Matthews,32,44,44,1312,194,469,.414,100,263,.380,94,206,.456,.520,87,110,.791,20,82,102,100,33,12,58,102,575
13396,DAL,2019,Devin Harris,35,68,2,1071,132,347,.380,62,200,.310,70,147,.476,.470,102,134,.761,12,100,112,122,35,16,56,133,428
13397,DAL,2019,Dennis Smith Jr.,21,32,32,908,157,357,.440,43,125,.344,114,232,.491,.500,57,82,.695,18,79,97,138,40,11,100,82,414
13398,DAL,2019,Dirk Nowitzki,40,51,20,795,135,376,.359,64,205,.312,71,171,.415,.444,39,50,.780,5,153,158,35,9,18,18,76,373
13399,DAL,2019,J.J. Barea,34,38,0,752,161,385,.418,38,128,.297,123,257,.479,.468,55,78,.705,13,82,95,211,22,1,72,50,415
13400,DAL,2019,Tim Hardaway Jr.,26,19,17,558,108,267,.404,45,140,.321,63,127,.496,.489,33,43,.767,7,54,61,37,12,2,24,35,294
13401,DAL,2019,Justin Jackson,23,29,11,531,92,190,.484,32,86,.372,60,104,.577,.568,21,29,.724,19,47,66,28,9,1,7,32,237
13402,DAL,2019,Ryan Broekhoff,28,42,0,453,57,126,.452,38,93,.409,19,33,.576,.603,15,19,.789,8,55,63,22,6,4,16,35,167
13403,DAL,2019,Trey Burke,26,25,1,436,88,190,.463,26,73,.356,62,117,.530,.532,41,49,.837,13,24,37,65,12,2,20,25,243
13404,DAL,2019,Salah Mejri,32,36,4,399,55,112,.491,11,34,.324,44,78,.564,.540,20,32,.625,36,95,131,35,10,26,21,55,141
13405,DAL,2019,Courtney Lee,33,22,4,268,32,82,.390,11,39,.282,21,43,.488,.457,5,7,.714,3,24,27,21,13,1,9,19,80
13406,DAL,2019,Daryl Macon,23,8,0,90,10,27,.370,5,11,.455,5,16,.313,.463,4,7,.571,2,10,12,7,1,0,6,8,29
13407,DAL,2019,Kostas Antetokounmpo,21,2,0,11,0,3,.000,0,0,,0,3,.000,.000,2,4,.500,0,1,1,0,2,0,1,0,2
13408,DAL,2019,Ray Spalding,21,1,0,1,0,0,,0,0,,0,0,,,0,0,,0,0,0,0,0,0,0,0,0
13409,DAL,2018,Harrison Barnes,25,77,77,2634,537,1208,.445,119,333,.357,418,875,.478,.494,259,313,.827,77,391,468,152,49,14,118,94,1452
13410,DAL,2018,Yogi Ferrell,24,82,21,2282,311,730,.426,134,359,.373,177,371,.477,.518,82,103,.796,26,223,249,201,64,9,78,153,838
13411,DAL,2018,Wesley Matthews,31,63,63,2131,283,697,.406,153,402,.381,130,295,.441,.516,83,101,.822,28,170,198,172,76,16,83,140,802
13412,DAL,2018,Dennis Smith Jr.,20,69,69,2049,404,1024,.395,106,339,.313,298,685,.435,.446,134,193,.694,50,210,260,358,71,18,194,152,1048
13413,DAL,2018,Dirk Nowitzki,39,77,77,1900,346,758,.456,138,337,.409,208,421,.494,.547,97,108,.898,22,416,438,120,43,45,51,146,927
13414,DAL,2018,Dwight Powell,26,79,24,1672,255,430,.593,28,84,.333,227,346,.656,.626,133,185,.719,135,309,444,91,67,32,59,186,671
13415,DAL,2018,J.J. Barea,33,69,11,1603,303,690,.439,115,313,.367,188,377,.499,.522,80,102,.784,15,186,201,434,35,3,143,83,801
13416,DAL,2018,Maxi Kleber,26,72,35,1206,151,309,.489,40,128,.313,111,181,.613,.553,44,59,.746,71,163,234,51,26,47,30,114,386
13417,DAL,2018,Devin Harris,34,44,1,807,118,284,.415,44,125,.352,74,159,.465,.493,93,112,.830,9,76,85,85,33,8,49,103,373
13418,DAL,2018,Salah Mejri,31,61,1,729,88,137,.642,0,3,.000,88,134,.657,.642,38,66,.576,85,161,246,35,22,67,39,121,214
13419,DAL,2018,Doug McDermott,26,26,3,596,86,180,.478,39,79,.494,47,101,.465,.586,24,28,.857,7,59,66,29,9,4,22,49,235
13420,DAL,2018,Kyle Collinsworth,26,32,2,480,38,99,.384,4,17,.235,34,82,.415,.404,21,40,.525,32,75,107,56,17,9,24,44,101
13421,DAL,2018,Nerlens Noel,23,30,6,472,55,105,.524,0,1,.000,55,104,.529,.524,21,28,.750,48,120,168,20,31,22,26,59,131
13422,DAL,2018,Dorian Finney-Smith,24,21,13,448,46,121,.380,20,67,.299,26,54,.481,.463,11,15,.733,22,53,75,26,10,4,21,43,123
13423,DAL,2018,Aaron Harrison,23,9,3,233,19,69,.275,9,43,.209,10,26,.385,.341,13,17,.765,4,20,24,11,9,2,3,27,60
13424,DAL,2018,Johnathan Motley,22,11,4,176,40,75,.533,1,6,.167,39,69,.565,.540,15,28,.536,14,35,49,7,3,2,9,18,96
13425,DAL,2018,Jalen Jones,24,12,0,162,25,64,.391,9,25,.360,16,39,.410,.461,10,17,.588,13,22,35,4,5,1,7,20,69
13426,DAL,2018,Antonius Cleveland,23,13,0,81,4,14,.286,0,1,.000,4,13,.308,.286,2,4,.500,2,8,10,2,6,4,2,11,10
13427,DAL,2018,Gian Clavell,24,7,0,64,6,18,.333,6,15,.400,0,3,.000,.500,2,2,1.000,1,6,7,3,2,0,2,8,20
13428,DAL,2018,Jeff Withey,27,10,0,39,6,16,.375,2,10,.200,4,6,.667,.438,1,2,.500,1,9,10,0,0,3,2,3,15
13429,DAL,2018,Jameel Warney,24,3,0,27,7,12,.583,0,0,,7,12,.583,.583,3,5,.600,4,5,9,0,0,0,1,2,17
13430,DAL,2018,Scotty Hopson,28,1,0,8,0,1,.000,0,0,,0,1,.000,.000,1,2,.500,0,0,0,1,0,0,1,0,1
13431,DAL,2018,Josh McRoberts,30,2,0,6,0,1,.000,0,1,.000,0,0,,.000,0,0,,0,0,0,0,0,0,0,2,0
13432,DAL,2017,Harrison Barnes,24,79,79,2803,599,1280,.468,78,222,.351,521,1058,.492,.498,242,281,.861,93,301,394,116,65,15,102,128,1518
13433,DAL,2017,Wesley Matthews,30,73,73,2495,333,847,.393,174,479,.363,159,368,.432,.496,146,179,.816,18,241,259,210,77,15,102,161,986
13434,DAL,2017,Seth Curry,26,70,42,2029,338,703,.481,137,322,.425,201,381,.528,.578,85,100,.850,25,154,179,189,79,7,92,126,898
13435,DAL,2017,Dorian Finney-Smith,23,81,35,1642,124,333,.372,56,191,.293,68,142,.479,.456,46,61,.754,55,167,222,67,52,25,45,125,350
13436,DAL,2017,Dirk Nowitzki,38,54,54,1424,296,678,.437,79,209,.378,217,469,.463,.495,98,112,.875,23,330,353,82,30,38,51,113,769
13437,DAL,2017,Dwight Powell,25,77,3,1333,194,377,.515,21,74,.284,173,303,.571,.542,107,141,.759,93,213,306,49,61,39,34,135,516
13438,DAL,2017,Deron Williams,32,40,40,1171,195,453,.430,63,181,.348,132,272,.485,.500,69,84,.821,13,89,102,274,25,2,98,96,522
13439,DAL,2017,Devin Harris,33,65,0,1087,136,341,.399,58,177,.328,78,164,.476,.484,107,129,.829,11,116,127,136,43,7,57,101,437
13440,DAL,2017,Yogi Ferrell,23,36,29,1046,142,345,.412,60,149,.403,82,196,.418,.499,64,73,.877,16,83,99,155,40,7,56,79,408
13441,DAL,2017,Salah Mejri,30,73,11,905,88,137,.642,1,3,.333,87,134,.649,.646,36,61,.590,97,211,308,14,32,61,40,152,213
13442,DAL,2017,J.J. Barea,32,35,6,771,142,343,.414,53,148,.358,89,195,.456,.491,44,51,.863,9,75,84,193,14,1,63,30,381
13443,DAL,2017,Justin Anderson,23,51,2,710,111,277,.401,37,122,.303,74,155,.477,.468,70,88,.795,39,110,149,32,28,16,40,64,329
13444,DAL,2017,Andrew Bogut,32,26,21,582,38,81,.469,0,1,.000,38,80,.475,.469,3,11,.273,56,162,218,49,13,25,43,84,79
13445,DAL,2017,Nicolás Brussino,23,54,2,521,52,141,.369,29,95,.305,23,46,.500,.472,17,22,.773,26,69,95,47,17,8,26,43,150
13446,DAL,2017,Nerlens Noel,22,22,12,483,77,134,.575,0,0,,77,134,.575,.575,34,48,.708,47,103,150,20,22,24,22,55,188
13447,DAL,2017,Jonathan Gibson,29,17,0,231,35,95,.368,15,45,.333,20,50,.400,.447,21,29,.724,1,21,22,26,8,0,21,21,106
13448,DAL,2017,A.J. Hammons,24,22,0,163,17,42,.405,5,10,.500,12,32,.375,.464,9,20,.450,8,28,36,4,1,13,10,21,48
13449,DAL,2017,Jarrod Uthoff,23,9,0,115,16,38,.421,3,9,.333,13,29,.448,.461,5,7,.714,8,14,22,9,2,4,3,8,40
13450,DAL,2017,Pierre Jackson,25,8,1,84,13,39,.333,3,11,.273,10,28,.357,.372,6,7,.857,1,8,9,19,2,0,3,5,35
13451,DAL,2017,Quinn Cook,23,5,0,77,11,25,.440,5,14,.357,6,11,.545,.540,0,2,.000,0,3,3,12,1,0,8,6,27
13452,DAL,2017,Quincy Acy,26,6,0,48,5,17,.294,1,7,.143,4,10,.400,.324,2,3,.667,2,6,8,0,0,0,2,9,13
13453,DAL,2017,Manny Harris,27,4,0,25,3,15,.200,0,2,.000,3,13,.231,.200,2,4,.500,3,6,9,2,0,0,2,1,8
13454,DAL,2017,DeAndre Liggins,28,1,0,25,3,6,.500,0,1,.000,3,5,.600,.500,2,3,.667,3,4,7,0,2,0,0,3,8
13455,DAL,2017,Ben Bentil,21,3,0,10,0,3,.000,0,1,.000,0,2,.000,.000,0,0,,0,2,2,0,0,0,1,1,0
13456,DAL,2016,Wesley Matthews,29,78,78,2644,331,854,.388,189,525,.360,142,329,.432,.498,126,146,.863,27,211,238,151,78,17,78,179,977
13457,DAL,2016,Dirk Nowitzki,37,75,75,2364,498,1112,.448,126,342,.368,372,770,.483,.504,250,280,.893,52,437,489,132,52,52,84,161,1372
13458,DAL,2016,Raymond Felton,31,80,31,2192,277,682,.406,60,213,.282,217,469,.463,.450,149,176,.847,36,222,258,284,68,15,121,141,763
13459,DAL,2016,Deron Williams,31,65,63,2106,321,775,.414,97,282,.344,224,493,.454,.477,179,206,.869,19,171,190,378,61,14,150,155,918
13460,DAL,2016,Zaza Pachulia,31,76,69,2004,219,470,.466,0,3,.000,219,467,.469,.466,212,276,.768,249,469,718,128,64,22,119,181,650
13461,DAL,2016,Chandler Parsons,27,61,51,1799,320,651,.492,104,251,.414,216,400,.540,.571,93,136,.684,29,256,285,169,46,21,95,114,837
13462,DAL,2016,J.J. Barea,31,74,16,1667,317,711,.446,100,260,.385,217,451,.481,.516,74,96,.771,26,126,152,302,26,2,113,110,808
13463,DAL,2016,Devin Harris,32,64,0,1280,167,374,.447,52,158,.329,115,216,.532,.516,101,140,.721,18,120,138,118,60,13,66,124,487
13464,DAL,2016,Dwight Powell,24,69,2,992,146,296,.493,2,16,.125,144,280,.514,.497,105,142,.739,84,189,273,44,36,24,40,118,399
13465,DAL,2016,Charlie Villanueva,31,62,4,665,125,327,.382,47,172,.273,78,155,.503,.454,22,24,.917,24,128,152,24,18,15,31,71,319
13466,DAL,2016,Justin Anderson,22,55,9,647,71,175,.406,22,83,.265,49,92,.533,.469,44,55,.800,18,114,132,29,19,25,24,45,208
13467,DAL,2016,David Lee,32,25,1,433,91,143,.636,0,0,,91,143,.636,.636,31,42,.738,60,115,175,30,10,15,28,63,213
13468,DAL,2016,Salah Mejri,29,34,6,397,49,78,.628,0,1,.000,49,77,.636,.628,27,46,.587,41,82,123,10,8,36,23,54,125
13469,DAL,2016,JaVale McGee,28,34,2,370,77,134,.575,0,1,.000,77,133,.579,.575,18,36,.500,53,80,133,3,5,26,21,49,172
13470,DAL,2016,Jeremy Evans,28,30,2,251,26,48,.542,4,16,.250,22,32,.688,.583,15,21,.714,11,43,54,2,6,9,7,19,71
13471,DAL,2016,John Jenkins,24,21,1,193,29,70,.414,3,19,.158,26,51,.510,.436,8,9,.889,4,18,22,9,3,0,11,11,69
13472,DAL,2015,Monta Ellis,29,80,80,2699,602,1354,.445,81,284,.285,521,1070,.487,.475,228,303,.752,34,156,190,329,148,25,198,197,1513
13473,DAL,2015,Tyson Chandler,32,75,75,2286,293,440,.666,0,0,,293,440,.666,.666,185,257,.720,294,570,864,84,42,91,105,169,771
13474,DAL,2015,Dirk Nowitzki,36,77,77,2282,487,1062,.459,104,274,.380,383,788,.486,.508,255,289,.882,44,413,457,143,39,33,82,160,1333
13475,DAL,2015,Chandler Parsons,26,66,66,2186,383,829,.462,132,347,.380,251,482,.521,.542,139,193,.720,64,259,323,161,69,19,96,140,1037
13476,DAL,2015,Devin Harris,31,76,3,1685,219,524,.418,95,266,.357,124,258,.481,.509,132,162,.815,13,122,135,237,78,14,85,147,665
13477,DAL,2015,Al-Farouq Aminu,24,74,3,1366,147,357,.412,34,124,.274,113,233,.485,.459,84,118,.712,114,228,342,59,70,62,55,137,412
13478,DAL,2015,J.J. Barea,30,77,10,1362,225,536,.420,54,167,.323,171,369,.463,.470,76,94,.809,23,111,134,263,33,1,70,104,580
13479,DAL,2015,Rajon Rondo,28,46,46,1319,194,445,.436,19,54,.352,175,391,.448,.457,19,42,.452,48,160,208,301,54,4,135,111,426
13480,DAL,2015,Richard Jefferson,34,74,18,1244,144,324,.444,66,155,.426,78,169,.462,.546,78,114,.684,25,158,183,61,32,11,52,115,432
13481,DAL,2015,Charlie Villanueva,30,64,1,678,150,362,.414,83,221,.376,67,141,.475,.529,20,35,.571,30,119,149,19,15,22,28,64,403
13482,DAL,2015,Jameer Nelson,32,23,23,584,61,163,.374,38,103,.369,23,60,.383,.491,7,8,.875,14,49,63,95,15,2,39,53,167
13483,DAL,2015,Brandan Wright,27,27,0,505,101,135,.748,0,0,,101,135,.748,.748,36,48,.750,51,59,110,10,17,42,13,44,238
13484,DAL,2015,Amar'e Stoudemire,32,23,1,380,104,179,.581,0,1,.000,104,178,.584,.581,40,59,.678,27,57,84,8,9,4,15,50,248
13485,DAL,2015,Greg Smith,24,42,2,363,30,49,.612,0,0,,30,49,.612,.612,20,39,.513,26,53,79,9,7,11,11,53,80
13486,DAL,2015,Raymond Felton,30,29,3,281,43,106,.406,10,34,.294,33,72,.458,.453,12,15,.800,2,24,26,41,11,4,18,17,108
13487,DAL,2015,Jae Crowder,24,25,0,265,33,76,.434,13,38,.342,20,38,.526,.520,10,11,.909,12,17,29,12,15,5,10,26,89
13488,DAL,2015,Dwight Powell,23,24,0,227,27,62,.435,3,11,.273,24,51,.471,.460,24,31,.774,18,31,49,9,7,6,9,39,81
13489,DAL,2015,Bernard James,29,16,2,158,12,27,.444,0,0,,12,27,.444,.444,20,23,.870,18,21,39,4,2,15,6,17,44
13490,DAL,2015,Ricky Ledo,22,5,0,11,0,6,.000,0,3,.000,0,3,.000,.000,1,2,.500,1,1,2,1,0,0,2,1,1
13491,DAL,2014,Monta Ellis,28,82,82,3023,576,1278,.451,69,209,.330,507,1069,.474,.478,339,430,.788,38,257,295,471,141,23,264,197,1560
13492,DAL,2014,Dirk Nowitzki,35,80,80,2628,633,1273,.497,131,329,.398,502,944,.532,.549,338,376,.899,40,458,498,216,73,45,117,165,1735
13493,DAL,2014,José Calderón,32,81,81,2468,341,748,.456,191,425,.449,150,323,.464,.584,52,63,.825,29,163,192,377,69,11,103,136,925
13494,DAL,2014,Shawn Marion,35,76,76,2409,341,708,.482,58,162,.358,283,546,.518,.523,51,65,.785,132,365,497,124,90,37,95,125,791
13495,DAL,2014,Vince Carter,37,81,0,1973,330,811,.407,146,371,.394,184,440,.418,.497,161,196,.821,67,217,284,212,61,35,108,209,967
13496,DAL,2014,Samuel Dalembert,32,80,68,1614,214,377,.568,0,1,.000,214,376,.569,.568,101,137,.737,200,341,541,38,41,94,90,210,529
13497,DAL,2014,Jae Crowder,23,78,8,1254,130,296,.439,50,151,.331,80,145,.552,.524,46,61,.754,46,148,194,60,59,21,41,100,356
13498,DAL,2014,DeJuan Blair,24,78,13,1214,210,393,.534,0,2,.000,210,391,.537,.534,77,121,.636,139,229,368,70,60,21,77,192,497
13499,DAL,2014,Brandan Wright,26,58,0,1077,224,331,.677,0,0,,224,331,.677,.677,77,106,.726,102,142,244,31,32,55,35,94,525
13500,DAL,2014,Devin Harris,30,40,0,818,96,254,.378,31,101,.307,65,153,.425,.439,92,115,.800,8,77,85,178,28,2,59,72,315
13501,DAL,2014,Shane Larkin,21,48,0,489,52,137,.380,12,38,.316,40,99,.404,.423,16,25,.640,11,31,42,71,26,1,39,46,132
13502,DAL,2014,Wayne Ellington,26,45,1,393,55,126,.437,25,59,.424,30,67,.448,.536,10,11,.909,8,35,43,19,16,2,11,33,145
13503,DAL,2014,Gal Mekel,25,31,1,292,30,86,.349,5,20,.250,25,66,.379,.378,8,12,.667,5,22,27,63,4,1,31,31,73
13504,DAL,2014,Bernard James,28,30,0,146,11,23,.478,0,1,.000,11,22,.500,.478,6,11,.545,15,27,42,3,3,8,10,24,28
13505,DAL,2014,Ricky Ledo,21,11,0,33,6,17,.353,3,8,.375,3,9,.333,.441,4,4,1.000,0,2,2,2,1,0,2,2,19
13506,DAL,2013,O.J. Mayo,25,82,82,2913,461,1026,.449,142,349,.407,319,677,.471,.519,191,233,.820,36,255,291,361,93,23,210,195,1255
13507,DAL,2013,Darren Collison,25,81,47,2372,341,724,.471,48,136,.353,293,588,.498,.504,242,275,.880,31,188,219,415,100,8,173,139,972
13508,DAL,2013,Vince Carter,36,81,3,2093,372,855,.435,162,399,.406,210,456,.461,.530,182,223,.816,58,276,334,194,74,44,106,226,1088
13509,DAL,2013,Shawn Marion,34,67,67,2010,355,690,.514,23,73,.315,332,617,.538,.531,79,101,.782,146,379,525,163,75,47,103,111,812
13510,DAL,2013,Dirk Nowitzki,34,53,47,1661,343,728,.471,65,157,.414,278,571,.487,.516,166,193,.860,37,326,363,132,38,37,70,93,917
13511,DAL,2013,Elton Brand,33,72,18,1527,226,478,.473,0,1,.000,226,477,.474,.473,66,93,.710,130,300,430,70,50,90,57,192,518
13512,DAL,2013,Chris Kaman,30,66,52,1363,313,617,.507,0,1,.000,313,616,.508,.507,67,85,.788,97,275,372,51,29,52,103,141,693
13513,DAL,2013,Jae Crowder,22,78,16,1353,141,367,.384,63,192,.328,78,175,.446,.470,47,73,.644,35,152,187,94,63,17,49,128,392
13514,DAL,2013,Brandan Wright,25,64,16,1149,241,404,.597,0,3,.000,241,401,.601,.597,59,96,.615,85,175,260,38,26,76,34,78,541
13515,DAL,2013,Mike James,37,45,23,862,101,271,.373,48,125,.384,53,146,.363,.461,23,29,.793,9,63,72,139,26,3,55,95,273
13516,DAL,2013,Dahntay Jones,32,50,15,635,50,140,.357,8,37,.216,42,103,.408,.386,66,82,.805,13,57,70,28,10,5,22,73,174
13517,DAL,2013,Rodrigue Beaubois,24,45,0,549,65,176,.369,21,72,.292,44,104,.423,.429,30,38,.789,9,48,57,84,19,4,33,54,181
13518,DAL,2013,Bernard James,27,46,11,457,53,103,.515,0,2,.000,53,101,.525,.515,25,41,.610,52,79,131,6,12,38,18,64,131
13519,DAL,2013,Dominique Jones,24,29,3,338,40,109,.367,1,9,.111,39,100,.390,.372,35,53,.660,18,27,45,83,14,2,38,29,116
13520,DAL,2013,Troy Murphy,32,14,1,256,22,61,.361,11,35,.314,11,26,.423,.451,10,11,.909,7,42,49,7,10,6,7,29,65
13521,DAL,2013,Derek Fisher,38,9,9,229,23,65,.354,10,23,.435,13,42,.310,.431,21,23,.913,0,15,15,31,5,2,18,24,77
13522,DAL,2013,Anthony Morrow,27,17,0,82,17,34,.500,1,5,.200,16,29,.552,.515,4,4,1.000,1,3,4,4,1,0,4,10,39
13523,DAL,2013,Chris Douglas-Roberts,26,6,0,63,5,14,.357,0,4,.000,5,10,.500,.357,7,10,.700,0,5,5,4,2,0,1,4,17
13524,DAL,2013,Jared Cunningham,21,8,0,26,6,14,.429,2,3,.667,4,11,.364,.500,2,2,1.000,1,2,3,1,1,0,2,3,16
13525,DAL,2013,Eddy Curry,30,2,0,25,4,8,.500,0,0,,4,8,.500,.500,1,4,.250,2,2,4,0,0,0,3,7,9
13526,DAL,2013,Josh Akognon,26,3,0,9,2,4,.500,1,2,.500,1,2,.500,.625,0,0,,0,1,1,1,0,0,0,3,5
13527,DAL,2013,Justin Dentmon,27,2,0,4,0,2,.000,0,0,,0,2,.000,.000,0,0,,0,0,0,0,0,0,0,0,0
13528,DAL,2013,Chris Wright,23,3,0,4,1,2,.500,0,0,,1,2,.500,.500,0,0,,0,0,0,0,0,0,1,0,2
13529,DAL,2012,Dirk Nowitzki,33,62,62,2079,473,1034,.457,78,212,.368,395,822,.481,.495,318,355,.896,46,372,418,136,42,30,117,129,1342
13530,DAL,2012,Jason Terry,34,63,1,2000,357,830,.430,138,365,.378,219,465,.471,.513,98,111,.883,16,133,149,226,73,11,127,69,950
13531,DAL,2012,Shawn Marion,33,63,63,1919,288,646,.446,20,68,.294,268,578,.464,.461,74,93,.796,145,320,465,132,67,36,98,87,670
13532,DAL,2012,Vince Carter,35,61,40,1542,223,542,.411,74,205,.361,149,337,.442,.480,95,115,.826,32,173,205,139,56,25,84,134,615
13533,DAL,2012,Jason Kidd,38,48,48,1379,99,273,.363,79,223,.354,20,50,.400,.507,22,28,.786,15,183,198,264,82,10,91,83,299
13534,DAL,2012,Rodrigue Beaubois,23,53,12,1151,188,445,.422,38,132,.288,150,313,.479,.465,58,69,.841,19,132,151,152,56,28,70,98,472
13535,DAL,2012,Brendan Haywood,32,54,54,1146,118,228,.518,0,0,,118,228,.518,.518,45,96,.469,139,185,324,19,24,54,46,121,281
13536,DAL,2012,Ian Mahinmi,25,61,12,1139,130,238,.546,0,1,.000,130,237,.549,.546,94,147,.639,108,181,289,12,38,31,50,176,354
13537,DAL,2012,Delonte West,28,44,33,1060,166,360,.461,27,76,.355,139,284,.489,.499,62,70,.886,13,88,101,139,58,11,76,67,421
13538,DAL,2012,Lamar Odom,32,50,4,1027,123,349,.352,28,111,.252,95,238,.399,.393,58,98,.592,36,172,208,83,20,18,52,97,332
13539,DAL,2012,Brandan Wright,24,49,0,791,144,233,.618,0,1,.000,144,232,.621,.618,52,82,.634,62,112,174,13,22,63,21,61,340
13540,DAL,2012,Brian Cardinal,34,44,0,277,14,55,.255,10,49,.204,4,6,.667,.345,5,6,.833,4,30,34,16,8,2,8,38,43
13541,DAL,2012,Dominique Jones,23,33,1,268,29,73,.397,1,8,.125,28,65,.431,.404,29,37,.784,9,35,44,42,10,5,28,28,88
13542,DAL,2012,Yi Jianlian,24,30,0,203,31,82,.378,3,10,.300,28,72,.389,.396,14,21,.667,12,37,49,5,7,8,14,23,79
13543,DAL,2012,Sean Williams,25,8,0,65,12,16,.750,0,0,,12,16,.750,.750,5,6,.833,9,4,13,2,1,5,7,14,29
13544,DAL,2012,Kelenna Azubuike,28,3,0,18,3,8,.375,1,3,.333,2,5,.400,.438,0,0,,0,0,0,0,1,0,4,1,7
13545,DAL,2011,Jason Kidd,37,80,80,2653,215,596,.361,133,391,.340,82,205,.400,.472,67,77,.870,35,316,351,655,134,29,179,119,630
13546,DAL,2011,Jason Terry,33,82,10,2564,492,1091,.451,127,351,.362,365,740,.493,.509,182,214,.850,24,129,153,334,93,13,167,140,1293
13547,DAL,2011,Dirk Nowitzki,32,73,73,2504,610,1179,.517,66,168,.393,544,1011,.538,.545,395,443,.892,50,463,513,190,38,47,137,172,1681
13548,DAL,2011,Shawn Marion,32,80,27,2253,434,834,.520,5,33,.152,429,801,.536,.523,126,164,.768,168,383,551,110,68,50,130,144,999
13549,DAL,2011,Tyson Chandler,28,74,74,2059,266,407,.654,0,0,,266,407,.654,.654,216,295,.732,206,486,692,32,36,80,88,240,748
13550,DAL,2011,J.J. Barea,26,81,2,1669,285,649,.439,66,189,.349,219,460,.476,.490,133,157,.847,29,130,159,317,30,1,136,136,769
13551,DAL,2011,Brendan Haywood,31,72,8,1331,128,223,.574,0,1,.000,128,222,.577,.574,64,177,.362,129,247,376,19,16,74,51,146,320
13552,DAL,2011,DeShawn Stevenson,29,72,54,1158,128,330,.388,94,249,.378,34,81,.420,.530,33,43,.767,20,86,106,77,21,5,44,71,383
13553,DAL,2011,Caron Butler,30,29,29,867,170,378,.450,28,65,.431,142,313,.454,.487,68,88,.773,22,96,118,46,28,8,49,59,436
13554,DAL,2011,Brian Cardinal,33,56,4,618,43,100,.430,42,87,.483,1,13,.077,.640,17,18,.944,10,49,59,40,24,7,17,82,145
13555,DAL,2011,Peja Stojaković,33,25,13,506,79,184,.429,42,105,.400,37,79,.468,.543,15,16,.938,14,52,66,22,11,2,11,22,215
13556,DAL,2011,Rodrigue Beaubois,22,28,26,496,94,223,.422,25,83,.301,69,140,.493,.478,23,30,.767,7,45,52,64,20,8,47,76,236
13557,DAL,2011,Ian Mahinmi,24,56,0,488,55,98,.561,0,2,.000,55,96,.573,.561,63,82,.768,43,77,120,8,14,15,25,105,173
13558,DAL,2011,Sasha Pavlović,27,10,6,163,15,35,.429,7,16,.438,8,19,.421,.529,4,5,.800,0,12,12,7,5,3,5,15,41
13559,DAL,2011,Corey Brewer,24,13,2,148,25,51,.490,4,13,.308,21,38,.553,.529,15,21,.714,12,11,23,12,11,2,10,25,69
13560,DAL,2011,Dominique Jones,22,18,0,135,14,45,.311,0,4,.000,14,41,.341,.311,14,17,.824,6,19,25,19,5,3,10,7,42
13561,DAL,2011,Alexis Ajinça,22,10,2,75,12,32,.375,3,7,.429,9,25,.360,.422,2,3,.667,5,12,17,2,3,5,1,13,29
13562,DAL,2011,Steve Novak,27,7,0,18,4,8,.500,3,4,.750,1,4,.250,.688,0,0,,0,5,5,0,0,0,0,3,11
13563,DAL,2010,Dirk Nowitzki,31,81,80,3039,720,1496,.481,51,121,.421,669,1375,.487,.498,536,586,.915,80,540,620,218,70,79,149,208,2027
13564,DAL,2010,Jason Kidd,36,80,80,2881,284,671,.423,176,414,.425,108,257,.420,.554,80,99,.808,48,397,445,724,145,35,195,142,824
13565,DAL,2010,Jason Terry,32,77,12,2540,456,1041,.438,136,373,.365,320,668,.479,.503,232,268,.866,19,121,140,292,94,17,109,142,1280
13566,DAL,2010,Shawn Marion,31,75,75,2385,395,778,.508,3,19,.158,392,759,.516,.510,105,139,.755,158,319,477,107,69,61,99,141,898
13567,DAL,2010,J.J. Barea,25,78,18,1546,232,527,.440,56,157,.357,176,370,.476,.493,76,90,.844,17,129,146,258,35,6,102,119,596
13568,DAL,2010,Erick Dampier,34,55,47,1280,133,213,.624,1,3,.333,132,210,.629,.627,61,101,.604,128,272,400,31,15,77,61,153,328
13569,DAL,2010,Drew Gooden,28,46,11,1030,157,336,.467,1,6,.167,156,330,.473,.469,93,115,.809,123,193,316,26,26,50,56,129,408
13570,DAL,2010,Caron Butler,29,27,27,930,157,357,.440,17,50,.340,140,307,.456,.464,79,104,.760,36,109,145,49,48,9,47,67,410
13571,DAL,2010,Josh Howard,29,31,9,827,137,342,.401,20,75,.267,117,267,.438,.430,94,119,.790,26,86,112,44,23,9,43,78,388
13572,DAL,2010,Brendan Haywood,30,28,19,741,88,156,.564,0,1,.000,88,155,.568,.564,50,87,.575,78,130,208,25,8,57,32,64,226
13573,DAL,2010,Rodrigue Beaubois,21,56,16,700,155,299,.518,45,110,.409,110,189,.582,.594,42,52,.808,12,66,78,74,29,12,54,84,397
13574,DAL,2010,Eduardo Nájera,33,33,3,481,42,93,.452,16,47,.340,26,46,.565,.538,8,12,.667,22,55,77,14,17,12,13,61,108
13575,DAL,2010,Kris Humphries,24,25,0,315,53,115,.461,0,0,,53,115,.461,.461,25,44,.568,38,57,95,7,7,11,13,43,131
13576,DAL,2010,Quinton Ross,28,27,7,301,23,56,.411,3,13,.231,20,43,.465,.438,5,8,.625,11,16,27,7,7,4,3,34,54
13577,DAL,2010,Tim Thomas,32,18,1,285,49,106,.462,16,43,.372,33,63,.524,.538,21,24,.875,13,28,41,14,10,2,14,31,135
13578,DAL,2010,DeShawn Stevenson,28,24,5,267,17,60,.283,8,25,.320,9,35,.257,.350,7,10,.700,4,22,26,12,5,1,6,23,49
13579,DAL,2010,James Singleton,28,25,0,211,24,64,.375,5,22,.227,19,42,.452,.414,6,6,1.000,17,38,55,9,11,7,12,31,59
13580,DAL,2010,Matt Carroll,29,25,0,121,18,50,.360,4,19,.211,14,31,.452,.400,6,6,1.000,4,8,12,6,5,0,7,13,46
13581,DAL,2009,Dirk Nowitzki,30,81,81,3050,774,1616,.479,61,170,.359,713,1446,.493,.498,485,545,.890,88,593,681,197,61,63,157,176,2094
13582,DAL,2009,Jason Kidd,35,81,81,2886,257,618,.416,131,323,.406,126,295,.427,.522,86,105,.819,85,415,500,702,160,39,185,168,731
13583,DAL,2009,Jason Terry,31,74,11,2491,541,1168,.463,167,456,.366,374,712,.525,.535,198,225,.880,39,138,177,251,97,20,119,141,1447
13584,DAL,2009,Erick Dampier,33,80,80,1836,182,280,.650,0,0,,182,280,.650,.650,90,141,.638,216,349,565,77,24,95,74,191,454
13585,DAL,2009,Josh Howard,28,52,51,1663,353,783,.451,58,168,.345,295,615,.480,.488,172,220,.782,59,204,263,83,55,30,89,135,936
13586,DAL,2009,J.J. Barea,24,79,15,1600,246,557,.442,55,154,.357,191,403,.474,.491,70,93,.753,36,141,177,269,37,5,105,121,617
13587,DAL,2009,Brandon Bass,23,81,0,1574,252,508,.496,0,6,.000,252,502,.502,.496,182,210,.867,129,238,367,43,27,55,86,140,686
13588,DAL,2009,Antoine Wright,24,65,53,1552,179,431,.415,45,149,.302,134,282,.475,.468,71,95,.747,31,105,136,77,46,27,54,172,474
13589,DAL,2009,James Singleton,27,62,6,884,117,221,.529,13,40,.325,104,181,.575,.559,67,78,.859,89,161,250,17,26,28,36,110,314
13590,DAL,2009,Devean George,31,43,17,708,54,142,.380,22,76,.289,32,66,.485,.458,17,22,.773,25,53,78,15,23,11,17,57,147
13591,DAL,2009,DeSagana Diop,27,34,0,452,22,58,.379,0,0,,22,58,.379,.379,12,29,.414,45,73,118,13,12,25,11,55,56
13592,DAL,2009,Gerald Green,23,38,12,376,79,180,.439,14,46,.304,65,134,.485,.478,27,32,.844,14,40,54,15,10,5,33,51,199
13593,DAL,2009,Ryan Hollins,24,27,2,260,31,59,.525,0,0,,31,59,.525,.525,17,33,.515,27,34,61,3,4,15,14,44,79
13594,DAL,2009,Shawne Williams,22,15,0,170,16,56,.286,1,17,.059,15,39,.385,.295,9,11,.818,19,27,46,2,2,9,5,19,42
13595,DAL,2009,Jerry Stackhouse,34,10,1,162,16,60,.267,3,19,.158,13,41,.317,.292,7,7,1.000,5,12,17,12,4,1,9,6,42
13596,DAL,2009,Matt Carroll,28,21,0,141,9,33,.273,1,8,.125,8,25,.320,.288,6,6,1.000,2,12,14,3,3,1,7,14,25
13597,DAL,2008,Dirk Nowitzki,29,77,77,2769,630,1314,.479,79,220,.359,551,1094,.504,.510,478,544,.879,95,564,659,266,51,71,160,198,1817
13598,DAL,2008,Josh Howard,27,76,76,2757,567,1247,.455,67,210,.319,500,1037,.482,.482,312,384,.813,120,412,532,164,59,32,114,202,1513
13599,DAL,2008,Jason Terry,30,82,34,2579,471,1008,.467,136,363,.375,335,645,.519,.535,191,223,.857,30,178,208,264,88,18,92,170,1269
13600,DAL,2008,Erick Dampier,32,72,64,1755,178,277,.643,0,0,,178,277,.643,.643,84,146,.575,207,332,539,63,24,106,80,226,440
13601,DAL,2008,Brandon Bass,22,79,1,1557,246,493,.499,0,4,.000,246,489,.503,.499,162,197,.822,120,227,347,58,22,48,82,150,654
13602,DAL,2008,Jerry Stackhouse,33,58,13,1412,213,526,.405,60,184,.326,153,342,.447,.462,132,148,.892,33,100,133,145,28,10,86,82,618
13603,DAL,2008,Devin Harris,24,39,39,1184,187,387,.483,25,70,.357,162,317,.511,.516,161,196,.821,17,74,91,206,56,2,93,127,560
13604,DAL,2008,Jason Kidd,34,29,29,1011,104,244,.426,35,76,.461,69,168,.411,.498,44,54,.815,36,152,188,276,62,11,81,75,287
13605,DAL,2008,Eddie Jones,36,47,33,922,66,180,.367,34,116,.293,32,64,.500,.461,10,14,.714,18,114,132,69,26,8,29,72,176
13606,DAL,2008,DeSagana Diop,26,52,18,894,67,115,.583,0,0,,67,115,.583,.583,24,40,.600,111,159,270,26,20,63,42,100,158
13607,DAL,2008,Devean George,30,53,4,821,74,207,.357,22,68,.324,52,139,.374,.411,24,34,.706,28,109,137,35,19,13,24,90,194
13608,DAL,2008,Trenton Hassell,28,37,6,463,37,80,.463,1,4,.250,36,76,.474,.469,1,2,.500,11,33,44,26,9,1,14,55,76
13609,DAL,2008,J.J. Barea,23,44,9,460,71,170,.418,21,54,.389,50,116,.431,.479,28,35,.800,4,43,47,58,14,1,35,48,191
13610,DAL,2008,Juwan Howard,34,50,0,353,23,64,.359,0,0,,23,64,.359,.359,11,14,.786,21,60,81,17,5,2,17,62,57
13611,DAL,2008,Malik Allen,29,25,4,333,33,66,.500,0,0,,33,66,.500,.500,11,12,.917,24,44,68,15,4,10,13,60,77
13612,DAL,2008,Antoine Wright,23,15,0,176,21,42,.500,5,9,.556,16,33,.485,.560,5,9,.556,5,17,22,13,2,4,11,22,52
13613,DAL,2008,Tyronn Lue,30,17,0,172,27,57,.474,9,17,.529,18,40,.450,.553,1,4,.250,0,13,13,15,0,1,5,28,64
13614,DAL,2008,Maurice Ager,23,12,3,77,5,27,.185,0,8,.000,5,19,.263,.185,5,6,.833,1,3,4,4,0,1,3,11,15
13615,DAL,2008,Jamaal Magloire,29,7,0,27,3,6,.500,0,0,,3,6,.500,.500,6,13,.462,1,7,8,0,1,0,7,8,12
13616,DAL,2008,Nick Fazekas,22,4,0,9,2,5,.400,0,0,,2,5,.400,.400,0,0,,1,2,3,0,0,0,0,0,4
13617,DAL,2007,Jason Terry,29,81,80,2846,514,1063,.484,162,370,.438,352,693,.508,.560,160,199,.804,41,190,231,422,81,17,152,170,1350
13618,DAL,2007,Dirk Nowitzki,28,78,78,2820,673,1341,.502,72,173,.416,601,1168,.515,.529,498,551,.904,122,571,693,263,52,62,167,171,1916
13619,DAL,2007,Josh Howard,26,70,69,2455,493,1075,.459,92,239,.385,401,836,.480,.501,243,294,.827,130,345,475,127,82,56,123,180,1321
13620,DAL,2007,Devin Harris,23,80,61,2081,292,593,.492,14,50,.280,278,543,.512,.504,215,261,.824,45,151,196,296,96,21,146,242,813
13621,DAL,2007,Erick Dampier,31,76,73,1915,209,334,.626,0,0,,209,334,.626,.626,119,191,.623,217,349,566,44,24,82,107,239,537
13622,DAL,2007,Jerry Stackhouse,32,67,8,1615,280,654,.428,62,162,.383,218,492,.443,.476,182,215,.847,39,106,145,187,51,10,117,78,804
13623,DAL,2007,DeSagana Diop,25,81,9,1480,71,151,.470,0,1,.000,71,150,.473,.470,48,86,.558,166,272,438,30,40,113,63,244,190
13624,DAL,2007,Greg Buckner,30,76,11,1372,123,299,.411,32,103,.311,91,196,.464,.465,27,34,.794,35,123,158,70,47,7,40,152,305
13625,DAL,2007,Devean George,29,60,17,1283,146,370,.395,53,150,.353,93,220,.423,.466,36,48,.750,57,156,213,33,46,23,51,143,381
13626,DAL,2007,Austin Croshere,31,61,2,727,78,222,.351,26,91,.286,52,131,.397,.410,45,52,.865,33,153,186,44,14,6,33,68,227
13627,DAL,2007,Anthony Johnson,32,40,0,562,60,146,.411,11,29,.379,49,117,.419,.449,21,29,.724,13,35,48,78,16,1,31,68,152
13628,DAL,2007,Maurice Ager,22,32,1,214,22,70,.314,5,15,.333,17,55,.309,.350,20,33,.606,1,20,21,7,4,3,15,27,69
13629,DAL,2007,J.J. Barea,22,33,1,191,28,78,.359,6,21,.286,22,57,.386,.397,16,24,.667,7,18,25,24,1,1,14,19,78
13630,DAL,2007,D.J. Mbenga,26,21,0,79,5,16,.313,0,0,,5,16,.313,.313,7,8,.875,3,8,11,6,3,5,5,17,17
13631,DAL,2007,Pops Mensah-Bonsu,23,12,0,71,11,17,.647,0,0,,11,17,.647,.647,7,18,.389,9,12,21,0,1,0,9,8,29
13632,DAL,2007,Kevin Willis,44,5,0,43,5,13,.385,0,0,,5,13,.385,.385,2,2,1.000,2,6,8,1,2,1,2,11,12
13633,DAL,2006,Dirk Nowitzki,27,81,81,3089,751,1564,.480,110,271,.406,641,1293,.496,.515,539,598,.901,115,613,728,226,58,83,156,164,2151
13634,DAL,2006,Jason Terry,28,80,80,2798,516,1099,.470,171,416,.411,345,683,.505,.547,168,210,.800,31,127,158,306,100,27,135,196,1371
13635,DAL,2006,Erick Dampier,30,82,36,1934,171,347,.493,0,0,,171,347,.493,.493,127,215,.591,273,367,640,51,27,106,115,263,469
13636,DAL,2006,Josh Howard,25,59,58,1915,350,743,.471,27,63,.429,323,680,.475,.489,196,267,.734,123,248,371,111,68,26,79,167,923
13637,DAL,2006,Marquis Daniels,25,62,29,1766,246,512,.480,4,19,.211,242,493,.491,.484,138,183,.754,81,143,224,172,67,13,100,143,634
13638,DAL,2006,Jerry Stackhouse,31,55,11,1525,242,603,.401,36,130,.277,206,473,.436,.431,195,221,.882,32,121,153,160,37,10,121,96,715
13639,DAL,2006,DeSagana Diop,24,81,45,1510,75,154,.487,1,2,.500,74,152,.487,.490,39,72,.542,145,229,374,23,44,146,36,253,190
13640,DAL,2006,Devin Harris,22,56,4,1275,190,405,.469,5,21,.238,185,384,.482,.475,169,236,.716,26,99,125,177,53,16,84,121,554
13641,DAL,2006,Adrian Griffin,31,52,45,1245,98,204,.480,0,2,.000,98,202,.485,.480,41,53,.774,75,152,227,89,51,9,39,113,237
13642,DAL,2006,Keith Van Horn,30,53,0,1090,164,387,.424,50,136,.368,114,251,.454,.488,94,113,.832,54,138,192,37,31,11,71,121,472
13643,DAL,2006,Darrell Armstrong,37,62,2,622,43,128,.336,11,48,.229,32,80,.400,.379,33,42,.786,18,63,81,86,27,3,58,71,130
13644,DAL,2006,Josh Powell,23,37,2,429,37,81,.457,0,0,,37,81,.457,.457,36,45,.800,28,53,81,9,7,4,22,52,110
13645,DAL,2006,Rawle Marshall,23,23,9,241,24,60,.400,1,3,.333,23,57,.404,.408,22,29,.759,8,23,31,10,8,7,15,17,71
13646,DAL,2006,D.J. Mbenga,25,43,1,237,32,60,.533,0,1,.000,32,59,.542,.533,10,20,.500,19,37,56,2,6,25,16,47,74
13647,DAL,2006,Doug Christie,35,7,7,185,9,26,.346,0,1,.000,9,25,.360,.346,8,12,.667,2,11,13,14,9,1,6,10,26
13648,DAL,2006,Pavel Podkolzin,21,1,0,18,0,2,.000,0,0,,0,2,.000,.000,3,6,.500,0,7,7,0,0,1,2,0,3
13649,DAL,2005,Dirk Nowitzki,26,78,78,3020,663,1445,.459,91,228,.399,572,1217,.470,.490,615,708,.869,96,661,757,240,97,119,176,219,2032
13650,DAL,2005,Josh Howard,24,76,76,2446,377,793,.475,34,115,.296,343,678,.506,.497,170,232,.733,169,315,484,109,116,49,122,211,958
13651,DAL,2005,Jason Terry,27,80,57,2401,372,743,.501,103,245,.420,269,498,.540,.570,146,173,.844,38,150,188,429,109,15,147,177,993
13652,DAL,2005,Michael Finley,31,64,64,2358,387,907,.427,116,285,.407,271,622,.436,.491,113,136,.831,45,217,262,169,48,18,60,123,1003
13653,DAL,2005,Jerry Stackhouse,30,56,7,1617,274,662,.414,32,120,.267,242,542,.446,.438,253,298,.849,38,145,183,127,53,10,106,104,833
13654,DAL,2005,Erick Dampier,29,59,56,1609,202,367,.550,0,3,.000,202,364,.555,.550,138,228,.605,183,318,501,51,15,80,102,205,542
13655,DAL,2005,Marquis Daniels,24,60,17,1412,220,504,.437,7,35,.200,213,469,.454,.443,98,133,.737,87,129,216,128,83,14,86,124,545
13656,DAL,2005,Alan Henderson,32,78,10,1203,116,220,.527,0,2,.000,116,218,.532,.527,41,76,.539,164,184,348,21,29,37,49,149,273
13657,DAL,2005,Devin Harris,21,76,19,1173,157,366,.429,44,131,.336,113,235,.481,.489,78,103,.757,28,74,102,169,77,19,82,139,436
13658,DAL,2005,Shawn Bradley,32,77,14,885,84,186,.452,0,0,,84,186,.452,.452,43,63,.683,70,144,214,15,25,63,33,153,211
13659,DAL,2005,Keith Van Horn,29,29,3,684,129,279,.462,24,64,.375,105,215,.488,.505,72,92,.783,34,95,129,34,15,10,34,88,354
13660,DAL,2005,Darrell Armstrong,36,52,7,576,36,118,.305,11,41,.268,25,77,.325,.352,39,47,.830,19,48,67,113,30,6,39,62,122
13661,DAL,2005,Calvin Booth,28,34,1,262,34,79,.430,0,1,.000,34,78,.436,.430,14,16,.875,16,42,58,4,11,16,8,55,82
13662,DAL,2005,D.J. Mbenga,24,15,1,58,6,14,.429,0,0,,6,14,.429,.429,3,4,.750,3,5,8,0,0,5,5,13,15
13663,DAL,2005,Dan Dickau,26,4,0,16,1,8,.125,1,3,.333,0,5,.000,.188,2,3,.667,0,1,1,1,0,0,1,1,5
13664,DAL,2005,Pavel Podkolzin,20,5,0,10,0,0,,0,0,,0,0,,,1,2,.500,0,2,2,0,0,0,2,4,1
13665,DAL,2004,Dirk Nowitzki,25,77,77,2915,605,1310,.462,99,290,.341,506,1020,.496,.500,371,423,.877,90,580,670,207,92,104,135,216,1680
13666,DAL,2004,Antoine Walker,27,82,82,2840,483,1129,.428,82,305,.269,401,824,.487,.464,103,186,.554,198,486,684,369,65,65,202,212,1151
13667,DAL,2004,Michael Finley,30,72,72,2778,514,1159,.443,150,370,.405,364,789,.461,.508,164,193,.850,78,247,325,212,84,39,83,118,1342
13668,DAL,2004,Steve Nash,29,78,78,2612,397,845,.470,104,257,.405,293,588,.498,.531,230,251,.916,59,173,232,687,67,8,209,139,1128
13669,DAL,2004,Antawn Jamison,27,82,2,2376,488,913,.535,16,40,.400,472,873,.541,.543,220,294,.748,233,287,520,70,83,30,81,174,1212
13670,DAL,2004,Josh Howard,23,67,29,1589,229,532,.430,20,66,.303,209,466,.448,.449,97,138,.703,149,219,368,97,69,54,67,168,575
13671,DAL,2004,Marquis Daniels,23,56,15,1039,203,411,.494,11,36,.306,192,375,.512,.507,60,78,.769,66,80,146,116,53,12,44,51,477
13672,DAL,2004,Shawn Bradley,31,66,5,773,89,188,.473,0,1,.000,89,187,.476,.473,41,49,.837,72,101,173,20,33,74,17,130,219
13673,DAL,2004,Travis Best,31,61,1,762,64,172,.372,3,20,.150,61,152,.401,.381,40,46,.870,17,51,68,112,31,4,33,66,171
13674,DAL,2004,Eduardo Nájera,27,58,7,720,72,162,.444,2,4,.500,70,158,.443,.451,30,46,.652,67,89,156,25,35,19,29,90,176
13675,DAL,2004,Danny Fortson,27,56,20,625,71,139,.511,0,0,,71,139,.511,.511,75,92,.815,114,136,250,9,12,11,37,148,217
13676,DAL,2004,Tony Delk,30,33,11,509,70,184,.380,20,66,.303,50,118,.424,.435,37,44,.841,16,43,59,28,27,7,17,46,197
13677,DAL,2004,Scott Williams,35,27,11,260,37,85,.435,0,1,.000,37,84,.440,.435,7,14,.500,15,45,60,11,5,9,10,50,81
13678,DAL,2004,Mamadou N'Diaye,28,3,0,7,0,1,.000,0,0,,0,1,.000,.000,0,0,,0,1,1,0,0,1,1,1,0
13679,DAL,2003,Dirk Nowitzki,24,80,80,3117,690,1489,.463,148,390,.379,542,1099,.493,.513,483,548,.881,81,710,791,239,111,82,152,206,2011
13680,DAL,2003,Steve Nash,28,82,82,2711,518,1114,.465,111,269,.413,407,845,.482,.515,308,339,.909,63,171,234,598,85,6,192,134,1455
13681,DAL,2003,Michael Finley,29,69,69,2642,507,1193,.425,119,322,.370,388,871,.445,.475,198,230,.861,107,295,402,205,76,21,114,105,1331
13682,DAL,2003,Nick Van Exel,31,73,1,2026,342,831,.412,118,312,.378,224,519,.432,.483,110,144,.764,35,173,208,312,42,4,123,86,912
13683,DAL,2003,Shawn Bradley,30,81,39,1731,201,375,.536,0,1,.000,201,374,.537,.536,141,175,.806,151,325,476,54,65,170,67,242,543
13684,DAL,2003,Raef LaFrentz,26,69,43,1611,266,514,.518,47,116,.405,219,398,.550,.563,60,88,.682,125,205,330,54,35,91,46,264,639
13685,DAL,2003,Adrian Griffin,28,74,48,1373,146,337,.433,6,24,.250,140,313,.447,.442,27,32,.844,88,176,264,105,77,6,47,157,325
13686,DAL,2003,Raja Bell,26,75,32,1173,93,211,.441,21,51,.412,72,160,.450,.491,23,34,.676,47,98,145,57,52,8,43,134,230
13687,DAL,2003,Walt Williams,32,66,1,1161,134,341,.393,64,171,.374,70,170,.412,.487,31,50,.620,53,154,207,59,42,26,35,141,363
13688,DAL,2003,Eduardo Nájera,26,48,12,1103,129,231,.558,0,1,.000,129,230,.561,.558,62,91,.681,90,133,223,47,40,22,23,129,320
13689,DAL,2003,Avery Johnson,37,48,0,430,63,150,.420,0,2,.000,63,148,.426,.420,30,39,.769,10,21,31,64,15,1,29,26,156
13690,DAL,2003,Popeye Jones,32,26,0,222,24,62,.387,0,0,,24,62,.387,.387,5,11,.455,29,30,59,8,5,1,15,31,53
13691,DAL,2003,Tariq Abdul-Wahad,28,14,0,204,27,58,.466,0,1,.000,27,57,.474,.466,3,6,.500,14,26,40,21,6,3,7,26,57
13692,DAL,2003,Evan Eschmeyer,27,17,3,135,7,19,.368,0,0,,7,19,.368,.368,3,4,.750,10,19,29,6,10,7,6,35,17
13693,DAL,2003,Antoine Rigaudeau,31,11,0,91,8,35,.229,1,5,.200,7,30,.233,.243,0,0,,4,4,8,6,3,0,6,11,17
13694,DAL,2003,Adam Harrington,22,13,0,37,4,17,.235,1,3,.333,3,14,.214,.265,2,2,1.000,0,2,2,2,1,1,2,2,11
13695,DAL,2003,Mark Strickland,32,4,0,13,2,5,.400,0,0,,2,5,.400,.400,0,0,,5,2,7,0,0,0,1,1,4
13696,DAL,2002,Dirk Nowitzki,23,76,76,2891,600,1258,.477,139,350,.397,461,908,.508,.532,440,516,.853,120,635,755,186,83,77,145,222,1779
13697,DAL,2002,Steve Nash,27,82,82,2837,525,1088,.483,156,343,.455,369,745,.495,.554,260,293,.887,50,204,254,634,53,4,229,164,1466
13698,DAL,2002,Michael Finley,28,69,69,2754,569,1228,.463,76,224,.339,493,1004,.491,.494,210,251,.837,90,270,360,230,65,25,117,144,1424
13699,DAL,2002,Juwan Howard,28,53,44,1659,270,585,.462,0,1,.000,270,584,.462,.462,144,191,.754,138,252,390,93,28,30,78,170,684
13700,DAL,2002,Adrian Griffin,27,58,34,1383,179,359,.499,16,54,.296,163,305,.534,.521,41,49,.837,68,161,229,106,75,12,42,142,415
13701,DAL,2002,Eduardo Nájera,25,62,11,1357,150,300,.500,0,2,.000,150,298,.503,.500,100,148,.676,149,193,342,38,56,30,40,156,400
13702,DAL,2002,Tim Hardaway,35,54,2,1276,179,494,.362,95,279,.341,84,215,.391,.459,65,78,.833,13,84,97,201,40,8,73,84,518
13703,DAL,2002,Greg Buckner,25,44,16,885,104,198,.525,5,16,.313,99,182,.544,.538,40,58,.690,67,106,173,48,31,19,27,124,253
13704,DAL,2002,Raef LaFrentz,25,27,25,787,114,261,.437,29,95,.305,85,166,.512,.492,35,46,.761,59,141,200,29,24,60,34,108,292
13705,DAL,2002,Shawn Bradley,29,53,16,757,78,163,.479,0,1,.000,78,162,.481,.479,59,64,.922,53,123,176,20,28,64,25,128,215
13706,DAL,2002,Nick Van Exel,30,27,2,757,129,314,.411,34,98,.347,95,216,.440,.465,65,77,.844,9,76,85,113,14,4,40,35,357
13707,DAL,2002,Johnny Newman,38,47,17,724,67,148,.453,22,57,.386,45,91,.495,.527,42,58,.724,9,40,49,14,29,4,21,88,198
13708,DAL,2002,Wang Zhizhi,24,55,0,600,109,248,.440,48,116,.414,61,132,.462,.536,42,57,.737,19,92,111,22,11,18,25,84,308
13709,DAL,2002,Danny Manning,35,41,10,552,71,149,.477,1,7,.143,70,142,.493,.480,22,33,.667,25,83,108,30,21,21,25,80,165
13710,DAL,2002,Evan Eschmeyer,26,31,6,299,21,50,.420,0,0,,21,50,.420,.420,20,33,.606,35,63,98,9,10,9,16,60,62
13711,DAL,2002,Donnell Harvey,21,18,0,162,14,26,.538,0,0,,14,26,.538,.538,10,22,.455,12,34,46,5,4,5,8,27,38
13712,DAL,2002,Avery Johnson,36,17,0,152,21,49,.429,0,0,,21,49,.429,.429,12,17,.706,0,5,5,28,5,1,9,17,54
13713,DAL,2002,Tariq Abdul-Wahad,27,4,0,24,0,2,.000,0,0,,0,2,.000,.000,0,1,.000,2,4,6,2,2,1,3,5,0
13714,DAL,2002,Darrick Martin,30,3,0,22,0,10,.000,0,2,.000,0,8,.000,.000,1,2,.500,0,1,1,3,2,0,1,4,1
13715,DAL,2002,Charlie Bell,22,2,0,2,0,0,,0,0,,0,0,,,0,0,,0,1,1,0,0,0,0,0,0
13716,DAL,2001,Michael Finley,27,82,82,3443,711,1552,.458,91,263,.346,620,1289,.481,.487,252,325,.775,109,316,425,360,118,32,190,174,1765
13717,DAL,2001,Dirk Nowitzki,22,82,82,3125,591,1247,.474,151,390,.387,440,857,.513,.534,451,538,.838,119,635,754,173,79,101,156,245,1784
13718,DAL,2001,Howard Eisley,28,82,40,2426,265,675,.393,107,269,.398,158,406,.389,.472,104,126,.825,23,174,197,295,99,12,102,218,741
13719,DAL,2001,Steve Nash,26,70,70,2387,386,792,.487,89,219,.406,297,573,.518,.544,231,258,.895,46,177,223,509,72,5,205,158,1092
13720,DAL,2001,Shawn Bradley,28,82,35,2001,219,447,.490,1,6,.167,218,441,.494,.491,140,178,.787,160,448,608,38,36,228,88,256,579
13721,DAL,2001,Hubert Davis,30,51,7,1261,139,314,.443,58,133,.436,81,181,.448,.535,35,41,.854,18,91,109,61,29,1,56,92,371
13722,DAL,2001,Juwan Howard,27,27,27,993,191,391,.488,0,3,.000,191,388,.492,.488,99,127,.780,50,143,193,70,29,16,73,106,481
13723,DAL,2001,Christian Laettner,31,53,35,930,165,323,.511,1,3,.333,164,320,.513,.512,67,82,.817,75,137,212,67,40,27,70,159,398
13724,DAL,2001,Greg Buckner,24,37,9,820,84,192,.438,2,7,.286,82,185,.443,.443,59,81,.728,60,97,157,49,33,9,27,118,229
13725,DAL,2001,Courtney Alexander,23,38,6,472,62,178,.348,3,10,.300,59,168,.351,.357,33,45,.733,20,43,63,21,16,3,21,76,160
13726,DAL,2001,Eduardo Nájera,24,40,4,431,58,111,.523,1,3,.333,57,108,.528,.527,14,33,.424,41,54,95,27,13,8,17,48,131
13727,DAL,2001,Loy Vaught,32,37,1,392,55,121,.455,0,0,,55,121,.455,.455,4,6,.667,35,88,123,16,15,5,18,61,114
13728,DAL,2001,Gary Trent,26,33,4,319,57,130,.438,0,1,.000,57,129,.442,.438,19,36,.528,39,53,92,10,13,8,22,52,133
13729,DAL,2001,Calvin Booth,24,15,7,293,46,84,.548,0,0,,46,84,.548,.548,20,33,.606,24,48,72,19,12,30,17,55,112
13730,DAL,2001,Vernon Maxwell,35,19,0,285,31,98,.316,13,47,.277,18,51,.353,.383,6,10,.600,1,28,29,20,9,3,17,31,81
13731,DAL,2001,Mark Bryant,35,18,1,101,8,20,.400,0,0,,8,20,.400,.400,3,5,.600,4,17,21,3,1,2,5,29,19
13732,DAL,2001,Donnell Harvey,20,18,0,65,8,14,.571,0,0,,8,14,.571,.571,6,16,.375,6,14,20,2,3,1,7,15,22
13733,DAL,2001,Wang Zhizhi,23,5,0,38,8,19,.421,0,2,.000,8,17,.471,.421,8,10,.800,1,6,7,0,0,0,1,8,24
13734,DAL,2001,Bill Curley,28,5,0,15,1,4,.250,0,1,.000,1,3,.333,.250,1,4,.250,0,0,0,0,1,1,2,4,3
13735,DAL,2001,Obinna Ekezie,25,4,0,8,0,4,.000,0,0,,0,4,.000,.000,0,0,,0,2,2,0,0,0,0,2,0
13736,DAL,2000,Michael Finley,26,82,82,3464,748,1636,.457,99,247,.401,649,1389,.467,.487,260,317,.820,122,396,518,438,109,32,196,171,1855
13737,DAL,2000,Dirk Nowitzki,21,82,81,2938,515,1118,.461,116,306,.379,399,812,.491,.513,289,348,.830,102,430,532,203,63,68,141,256,1435
13738,DAL,2000,Cedric Ceballos,30,69,25,2064,447,1002,.446,44,134,.328,403,868,.464,.468,209,248,.843,172,290,462,90,56,24,125,165,1147
13739,DAL,2000,Erick Strickland,26,68,67,2025,316,730,.433,73,186,.392,243,544,.447,.483,162,195,.831,69,254,323,211,105,13,102,190,867
13740,DAL,2000,Shawn Bradley,27,77,54,1901,266,555,.479,1,5,.200,265,550,.482,.480,114,149,.765,160,337,497,60,71,190,74,260,647
13741,DAL,2000,Hubert Davis,29,79,15,1817,217,464,.468,82,167,.491,135,297,.455,.556,67,77,.870,17,117,134,141,24,3,70,109,583
13742,DAL,2000,Steve Nash,25,56,27,1532,173,363,.477,60,149,.403,113,214,.528,.559,75,85,.882,34,87,121,272,37,3,102,122,481
13743,DAL,2000,Sean Rooks,30,71,13,1001,122,283,.431,0,0,,122,283,.431,.431,65,89,.730,82,166,248,68,29,52,70,169,309
13744,DAL,2000,Greg Buckner,23,48,1,923,111,233,.476,10,26,.385,101,207,.488,.498,43,63,.683,56,118,174,55,38,20,36,148,275
13745,DAL,2000,Robert Pack,30,29,22,665,96,230,.417,4,11,.364,92,219,.420,.426,63,78,.808,7,35,42,168,31,3,76,44,259
13746,DAL,2000,Damon Jones,23,42,0,416,55,154,.357,30,91,.330,25,63,.397,.455,25,39,.641,12,27,39,57,12,1,25,21,165
13747,DAL,2000,Dennis Rodman,38,12,12,389,12,31,.387,0,1,.000,12,30,.400,.387,10,14,.714,48,123,171,14,2,1,19,41,34
13748,DAL,2000,Gary Trent,25,11,11,301,70,142,.493,0,2,.000,70,140,.500,.493,11,21,.524,20,32,52,22,8,3,25,28,151
13749,DAL,2000,Rick Hughes,26,21,0,224,35,72,.486,0,1,.000,35,71,.493,.486,12,26,.462,24,25,49,9,3,1,14,30,82
13750,DAL,2000,Bruno Šundov,19,14,0,61,12,31,.387,0,0,,12,31,.387,.387,2,2,1.000,5,7,12,2,2,2,4,16,26
13751,DAL,2000,Rodrick Rhodes,26,1,0,8,0,3,.000,0,0,,0,3,.000,.000,0,0,,1,0,1,0,2,0,2,0,0
13752,DAL,2000,Randell Jackson,24,1,0,1,0,0,,0,0,,0,0,,,0,0,,0,0,0,0,0,0,0,0,0
13753,DAL,1999,Michael Finley,25,50,50,2051,389,876,.444,45,136,.331,344,740,.465,.470,186,226,.823,69,194,263,218,66,15,107,96,1009
13754,DAL,1999,Hubert Davis,28,50,21,1378,174,397,.438,65,144,.451,109,253,.431,.520,44,50,.880,3,83,86,89,21,3,57,76,457
13755,DAL,1999,Gary Trent,24,45,23,1362,287,602,.477,0,5,.000,287,597,.481,.477,145,235,.617,127,224,351,77,29,23,66,122,719
13756,DAL,1999,Shawn Bradley,26,49,33,1294,167,348,.480,0,4,.000,167,344,.485,.480,86,115,.748,130,262,392,40,35,159,56,153,420
13757,DAL,1999,Steve Nash,24,40,40,1269,114,314,.363,49,131,.374,65,183,.355,.441,38,46,.826,32,82,114,219,37,2,83,98,315
13758,DAL,1999,Dirk Nowitzki,20,47,24,958,136,336,.405,14,68,.206,122,268,.455,.426,99,128,.773,41,121,162,47,29,27,73,105,385
13759,DAL,1999,A.C. Green,35,50,35,924,108,256,.422,0,8,.000,108,248,.435,.422,30,52,.577,82,146,228,25,28,8,19,69,246
13760,DAL,1999,Samaki Walker,22,39,2,568,88,190,.463,0,1,.000,88,189,.466,.463,53,98,.541,46,97,143,6,9,16,37,87,229
13761,DAL,1999,Erick Strickland,25,33,2,567,89,221,.403,18,59,.305,71,162,.438,.443,53,65,.815,12,71,83,64,40,2,36,44,249
13762,DAL,1999,Chris Anstey,24,41,4,470,50,139,.360,0,7,.000,50,132,.379,.360,34,48,.708,35,62,97,27,18,13,26,98,134
13763,DAL,1999,Robert Pack,29,25,0,468,75,174,.431,0,4,.000,75,170,.441,.431,72,88,.818,9,27,36,81,20,1,49,41,222
13764,DAL,1999,Hot Rod Williams,36,25,11,403,11,33,.333,0,0,,11,33,.333,.333,7,10,.700,36,47,83,15,13,18,13,49,29
13765,DAL,1999,Cedric Ceballos,29,13,5,352,59,140,.421,11,28,.393,48,112,.429,.461,34,49,.694,23,62,85,12,7,5,28,23,163
13766,DAL,1999,Bruno Šundov,18,3,0,11,2,7,.286,0,0,,2,7,.286,.286,0,0,,0,0,0,1,0,0,1,4,4
13767,DAL,1998,Michael Finley,24,82,82,3394,675,1505,.449,87,244,.357,588,1261,.466,.477,326,416,.784,150,288,438,405,132,30,219,163,1763
13768,DAL,1998,A.C. Green,34,82,68,2649,242,534,.453,0,4,.000,242,530,.457,.453,116,162,.716,219,449,668,123,78,27,68,157,600
13769,DAL,1998,Hubert Davis,27,81,30,2378,350,767,.456,101,230,.439,249,537,.464,.522,97,116,.836,34,135,169,157,43,5,88,117,898
13770,DAL,1998,Khalid Reeves,25,82,54,1950,248,593,.418,56,152,.368,192,441,.435,.465,165,213,.775,54,131,185,230,80,10,130,195,717
13771,DAL,1998,Shawn Bradley,25,64,46,1822,300,711,.422,1,3,.333,299,708,.422,.423,130,180,.722,164,354,518,60,51,214,96,214,731
13772,DAL,1998,Dennis Scott,29,52,42,1797,258,666,.387,94,273,.344,164,393,.417,.458,97,118,.822,39,158,197,129,43,32,92,121,707
13773,DAL,1998,Erick Strickland,24,67,19,1505,199,558,.357,48,163,.294,151,395,.382,.400,65,84,.774,35,126,161,167,56,8,106,140,511
13774,DAL,1998,Samaki Walker,21,41,19,1027,156,321,.486,0,1,.000,156,320,.488,.486,53,97,.546,96,206,302,24,30,40,61,127,365
13775,DAL,1998,Chris Anstey,23,41,8,680,92,231,.398,3,16,.188,89,215,.414,.405,53,74,.716,53,104,157,35,31,27,41,95,240
13776,DAL,1998,Martin Müürsepp,23,41,7,603,83,191,.435,16,38,.421,67,153,.438,.476,51,67,.761,46,68,114,30,29,14,29,96,233
13777,DAL,1998,Eric Riley,27,39,14,544,56,135,.415,0,1,.000,56,134,.418,.415,27,36,.750,43,90,133,22,15,46,37,80,139
13778,DAL,1998,Bubba Wells,23,39,2,395,48,116,.414,1,6,.167,47,110,.427,.418,31,43,.721,22,46,68,34,15,4,31,40,128
13779,DAL,1998,Cedric Ceballos,28,12,9,364,75,157,.478,6,20,.300,69,137,.504,.497,47,61,.770,24,48,72,25,11,8,33,29,203
13780,DAL,1998,Robert Pack,28,12,10,292,33,98,.337,3,6,.500,30,92,.326,.352,25,36,.694,8,26,34,42,20,1,38,17,94
13781,DAL,1998,Shawn Respert,25,10,0,215,36,84,.429,6,26,.231,30,58,.517,.464,4,7,.571,7,20,27,17,5,0,15,17,82
13782,DAL,1998,Kevin Ollie,25,16,0,214,14,42,.333,0,0,,14,42,.333,.333,18,25,.720,6,15,21,32,6,0,16,16,46
13783,DAL,1998,Kurt Thomas,25,5,0,73,17,45,.378,0,0,,17,45,.378,.378,3,3,1.000,8,16,24,3,1,0,10,19,37
13784,DAL,1998,Adrian Caldwell,31,1,0,3,0,0,,0,0,,0,0,,,0,0,,0,0,0,0,0,0,0,0,0
13785,DAL,1997,Derek Harper,35,75,29,2210,299,674,.444,60,176,.341,239,498,.480,.488,95,128,.742,30,107,137,321,92,12,132,144,753
13786,DAL,1997,Michael Finley,23,56,36,1994,334,774,.432,87,225,.387,247,549,.450,.488,142,176,.807,54,198,252,156,50,20,120,96,897
13787,DAL,1997,A.C. Green,33,56,54,1944,173,356,.486,1,17,.059,172,339,.507,.487,97,149,.651,189,329,518,52,52,15,54,111,444
13788,DAL,1997,Jim Jackson,26,46,46,1676,260,588,.442,46,139,.331,214,449,.477,.481,148,188,.787,81,146,227,156,57,15,107,113,714
13789,DAL,1997,George McCloud,29,41,26,1207,204,482,.423,78,205,.380,126,277,.455,.504,77,92,.837,29,114,143,92,52,8,52,106,563
13790,DAL,1997,Chris Gatling,29,44,1,1191,309,580,.533,1,6,.167,308,574,.537,.534,221,313,.706,126,222,348,25,35,31,114,125,840
13791,DAL,1997,Shawn Bradley,24,33,32,1060,207,449,.461,0,3,.000,207,446,.464,.461,68,106,.642,103,183,286,32,17,88,70,115,482
13792,DAL,1997,Eric Montross,25,47,46,984,86,187,.460,0,0,,86,187,.460,.460,10,34,.294,66,170,236,32,9,34,51,150,182
13793,DAL,1997,Jamal Mashburn,24,37,21,975,140,376,.372,42,131,.321,98,245,.400,.428,72,111,.649,28,87,115,93,35,5,57,69,394
13794,DAL,1997,Oliver Miller,26,42,0,836,76,154,.494,0,1,.000,76,153,.497,.494,28,53,.528,82,151,233,58,34,50,70,133,180
13795,DAL,1997,Jason Kidd,23,22,22,791,75,203,.369,21,65,.323,54,138,.391,.421,46,69,.667,30,60,90,200,45,8,66,42,217
13796,DAL,1997,Erick Strickland,23,28,15,759,102,256,.398,28,92,.304,74,164,.451,.453,65,80,.813,21,69,90,68,27,5,66,75,297
13797,DAL,1997,Samaki Walker,20,43,12,602,83,187,.444,0,1,.000,83,186,.446,.444,48,74,.649,47,100,147,17,15,22,39,71,214
13798,DAL,1997,Robert Pack,27,20,11,597,79,219,.361,9,38,.237,70,181,.387,.381,62,73,.849,13,47,60,127,35,3,67,56,229
13799,DAL,1997,Sasha Danilović,26,13,9,438,73,174,.420,22,60,.367,51,114,.447,.483,48,57,.842,8,26,34,25,15,1,22,37,216
13800,DAL,1997,Sam Cassell,27,16,13,398,70,165,.424,15,49,.306,55,116,.474,.470,42,50,.840,14,36,50,57,17,6,41,48,197
13801,DAL,1997,Greg Dreiling,34,40,3,389,34,74,.459,1,1,1.000,33,73,.452,.466,11,27,.407,19,57,76,11,8,7,9,65,80
13802,DAL,1997,Khalid Reeves,24,13,12,384,43,111,.387,7,35,.200,36,76,.474,.419,9,12,.750,12,19,31,56,11,2,26,40,102
13803,DAL,1997,Martin Müürsepp,22,32,0,321,49,117,.419,3,20,.150,46,97,.474,.432,38,56,.679,33,29,62,17,12,10,15,55,139
13804,DAL,1997,Loren Meyer,24,19,16,259,34,78,.436,1,2,.500,33,76,.434,.442,9,12,.750,14,35,49,7,6,3,27,52,78
13805,DAL,1997,Tony Dumas,24,18,0,227,27,77,.351,3,24,.125,24,53,.453,.370,15,23,.652,3,11,14,22,10,1,15,36,72
13806,DAL,1997,Jamie Watson,24,10,6,211,20,47,.426,3,9,.333,17,38,.447,.457,2,4,.500,14,15,29,23,11,2,15,18,45
13807,DAL,1997,Ed O'Bannon,24,19,0,175,17,72,.236,1,10,.100,16,62,.258,.243,11,12,.917,9,27,36,11,5,2,6,19,46
13808,DAL,1997,Stacey King,30,6,0,70,6,15,.400,0,0,,6,15,.400,.400,0,4,.000,10,8,18,0,2,0,5,11,12
13809,DAL,1997,Stevin Smith,25,8,0,60,6,18,.333,1,6,.167,5,12,.417,.361,1,1,1.000,2,8,10,4,1,0,4,9,14
13810,DAL,1997,Fred Roberts,36,12,0,40,6,15,.400,0,0,,6,15,.400,.400,10,14,.714,2,8,10,0,0,1,5,2,22
13811,DAL,1997,Jason Sasser,23,2,0,7,1,4,.250,0,1,.000,1,3,.333,.250,0,0,,1,0,1,1,1,0,0,0,2
13812,DAL,1996,Jason Kidd,22,81,81,3034,493,1293,.381,133,396,.336,360,897,.401,.433,229,331,.692,203,350,553,783,175,26,328,155,1348
13813,DAL,1996,George McCloud,28,79,63,2846,530,1281,.414,257,678,.379,273,603,.453,.514,180,224,.804,116,263,379,212,113,38,166,212,1497
13814,DAL,1996,Jim Jackson,25,82,82,2820,569,1308,.435,121,333,.363,448,975,.459,.481,345,418,.825,173,237,410,235,47,22,191,165,1604
13815,DAL,1996,Popeye Jones,25,68,68,2322,327,733,.446,14,39,.359,313,694,.451,.456,102,133,.767,260,477,737,132,54,27,109,262,770
13816,DAL,1996,Lorenzo Williams,26,65,61,1806,87,214,.407,0,1,.000,87,213,.408,.407,24,70,.343,234,287,521,85,48,122,78,226,198
13817,DAL,1996,Tony Dumas,23,67,12,1284,274,655,.418,74,207,.357,200,448,.446,.475,154,257,.599,58,57,115,99,42,13,77,128,776
13818,DAL,1996,Loren Meyer,23,72,21,1266,145,330,.439,3,11,.273,142,319,.445,.444,70,102,.686,114,205,319,57,20,32,67,224,363
13819,DAL,1996,Lucious Harris,25,61,1,1016,183,397,.461,47,125,.376,136,272,.500,.520,68,87,.782,41,81,122,79,35,3,46,56,481
13820,DAL,1996,Cherokee Parks,23,64,3,869,101,247,.409,7,26,.269,94,221,.425,.423,41,62,.661,66,150,216,29,25,32,31,100,250
13821,DAL,1996,Scott Brooks,30,69,0,716,134,293,.457,25,62,.403,109,231,.472,.500,59,69,.855,11,30,41,100,42,3,43,53,352
13822,DAL,1996,Jamal Mashburn,23,18,18,669,145,383,.379,35,102,.343,110,281,.391,.424,97,133,.729,37,60,97,50,14,3,55,39,422
13823,DAL,1996,David Wood,31,37,0,642,67,154,.435,19,59,.322,48,95,.505,.497,29,40,.725,42,91,133,27,16,9,19,118,182
13824,DAL,1996,Terry Davis,28,28,0,501,55,108,.509,0,0,,55,108,.509,.509,27,47,.574,43,74,117,21,10,4,25,66,137
13825,DAL,1996,Donald Hodge,26,13,0,113,9,24,.375,0,0,,9,24,.375,.375,0,0,,9,13,22,4,1,8,2,26,18
13826,DAL,1996,Reggie Slater,25,3,0,26,5,11,.455,0,0,,5,11,.455,.455,1,2,.500,1,4,5,0,0,0,3,6,11
13827,DAL,1995,Jamal Mashburn,22,80,80,2980,683,1566,.436,113,344,.328,570,1222,.466,.472,447,605,.739,116,215,331,298,82,8,235,190,1926
13828,DAL,1995,Jason Kidd,21,79,79,2668,330,857,.385,70,257,.272,260,600,.433,.426,192,275,.698,152,278,430,607,151,24,250,146,922
13829,DAL,1995,Popeye Jones,24,80,80,2385,372,839,.443,1,12,.083,371,827,.449,.444,80,124,.645,329,515,844,163,35,27,124,267,825
13830,DAL,1995,Lorenzo Williams,25,82,81,2383,145,304,.477,0,0,,145,304,.477,.477,38,101,.376,291,399,690,124,52,148,105,306,328
13831,DAL,1995,Jim Jackson,24,51,51,1982,484,1026,.472,35,110,.318,449,916,.490,.489,306,380,.805,120,140,260,191,28,12,160,92,1309
13832,DAL,1995,Lucious Harris,24,79,31,1695,280,610,.459,55,142,.387,225,468,.481,.504,136,170,.800,85,135,220,132,58,14,77,105,751
13833,DAL,1995,Roy Tarpley,30,55,1,1354,292,610,.479,5,18,.278,287,592,.485,.483,102,122,.836,142,307,449,58,45,55,109,155,691
13834,DAL,1995,Doug Smith,25,63,0,826,131,314,.417,1,12,.083,130,302,.430,.419,57,75,.760,43,101,144,44,29,26,37,132,320
13835,DAL,1995,George McCloud,27,42,3,802,144,328,.439,34,89,.382,110,239,.460,.491,80,96,.833,82,65,147,53,23,9,40,71,402
13836,DAL,1995,Donald Hodge,25,54,0,633,83,204,.407,4,14,.286,79,190,.416,.417,39,51,.765,40,82,122,41,10,14,39,107,209
13837,DAL,1995,Scott Brooks,29,31,0,622,91,210,.433,17,52,.327,74,158,.468,.474,46,58,.793,13,40,53,94,26,3,33,42,245
13838,DAL,1995,Tony Dumas,22,58,0,613,96,250,.384,22,73,.301,74,177,.418,.428,50,77,.649,32,30,62,57,13,4,50,78,264
13839,DAL,1995,Terry Davis,27,46,2,580,49,113,.434,0,2,.000,49,111,.441,.434,42,66,.636,63,93,156,10,6,3,30,76,140
13840,DAL,1995,Morlon Wiley,28,38,2,407,47,111,.423,29,75,.387,18,36,.500,.554,7,10,.700,6,33,39,69,21,1,19,44,130
13841,DAL,1994,Jim Jackson,23,82,82,3066,637,1432,.445,17,60,.283,620,1372,.452,.451,285,347,.821,169,219,388,374,87,25,334,161,1576
13842,DAL,1994,Jamal Mashburn,21,79,73,2896,561,1382,.406,85,299,.284,476,1083,.440,.437,306,438,.699,107,246,353,266,89,14,245,205,1513
13843,DAL,1994,Fat Lever,33,81,54,1947,227,557,.408,26,74,.351,201,483,.416,.431,75,98,.765,83,200,283,213,159,15,88,155,555
13844,DAL,1994,Popeye Jones,23,81,47,1773,195,407,.479,0,1,.000,195,406,.480,.479,78,107,.729,299,306,605,99,61,31,94,246,468
13845,DAL,1994,Doug Smith,24,79,42,1684,295,678,.435,2,9,.222,293,669,.438,.437,106,127,.835,114,235,349,119,82,38,93,287,698
13846,DAL,1994,Tim Legler,27,79,0,1322,231,528,.438,52,139,.374,179,389,.460,.487,142,169,.840,36,92,128,120,52,13,60,133,656
13847,DAL,1994,Sean Rooks,24,47,28,1255,193,393,.491,0,1,.000,193,392,.492,.491,150,210,.714,84,175,259,49,21,44,80,109,536
13848,DAL,1994,Lucious Harris,23,77,0,1165,162,385,.421,7,33,.212,155,352,.440,.430,87,119,.731,45,112,157,106,49,10,78,117,418
13849,DAL,1994,Derek Harper,32,28,28,893,130,342,.380,37,105,.352,93,237,.392,.434,28,50,.560,10,45,55,98,45,4,54,46,325
13850,DAL,1994,Tony Campbell,31,41,3,835,164,384,.427,6,25,.240,158,359,.440,.435,64,83,.771,48,78,126,51,30,14,55,75,398
13851,DAL,1994,Greg Dreiling,31,54,19,685,52,104,.500,1,1,1.000,51,103,.495,.505,27,38,.711,47,123,170,31,16,24,43,159,132
13852,DAL,1994,Lorenzo Williams,24,34,11,678,48,103,.466,0,0,,48,103,.466,.466,12,28,.429,92,117,209,23,15,41,21,87,108
13853,DAL,1994,Donald Hodge,24,50,0,428,46,101,.455,0,0,,46,101,.455,.455,44,52,.846,46,49,95,32,15,13,30,66,136
13854,DAL,1994,Darren Morningstar,24,22,15,363,38,81,.469,0,0,,38,81,.469,.469,18,30,.600,31,49,80,15,14,2,19,69,94
13855,DAL,1994,Randy White,26,18,3,320,45,112,.402,6,20,.300,39,92,.424,.429,19,33,.576,30,53,83,11,10,10,18,46,115
13856,DAL,1994,Terry Davis,26,15,5,286,24,59,.407,0,0,,24,59,.407,.407,8,12,.667,30,44,74,6,9,1,5,27,56
13857,DAL,1994,Morlon Wiley,27,12,0,124,6,21,.286,2,6,.333,4,15,.267,.333,0,0,,0,6,6,16,13,0,11,17,14
13858,DAL,1994,Chucky Brown,25,1,0,10,1,1,1.000,0,0,,1,1,1.000,1.000,1,1,1.000,0,1,1,0,0,0,0,2,3
13859,DAL,1993,Terry Davis,25,75,74,2462,393,863,.455,2,8,.250,391,855,.457,.457,167,281,.594,259,442,701,68,36,28,160,199,955
13860,DAL,1993,Derek Harper,31,62,60,2108,393,939,.419,101,257,.393,292,682,.428,.472,239,316,.756,42,81,123,334,80,16,136,145,1126
13861,DAL,1993,Sean Rooks,23,72,68,2087,368,747,.493,0,2,.000,368,745,.494,.493,234,389,.602,196,340,536,95,38,81,160,204,970
13862,DAL,1993,Mike Iuzzolino,25,70,23,1769,221,478,.462,54,144,.375,167,334,.500,.519,114,149,.765,31,109,140,328,49,6,129,101,610
13863,DAL,1993,Walter Bond,23,74,38,1578,227,565,.402,7,42,.167,220,523,.421,.408,129,167,.772,52,144,196,122,75,18,112,223,590
13864,DAL,1993,Doug Smith,23,61,42,1524,289,666,.434,0,4,.000,289,662,.437,.434,56,74,.757,96,232,328,104,48,52,115,280,634
13865,DAL,1993,Randy White,25,64,20,1433,235,540,.435,10,42,.238,225,498,.452,.444,138,184,.750,154,216,370,49,63,45,108,226,618
13866,DAL,1993,Brian Howard,25,68,22,1295,183,414,.442,1,7,.143,182,407,.447,.443,72,94,.766,66,146,212,67,55,34,68,217,439
13867,DAL,1993,Donald Hodge,23,79,8,1267,161,400,.403,0,0,,161,400,.403,.403,71,104,.683,93,201,294,75,33,37,90,204,393
13868,DAL,1993,Jim Jackson,22,28,28,938,184,466,.395,21,73,.288,163,393,.415,.417,68,92,.739,42,80,122,131,40,11,115,80,457
13869,DAL,1993,Dexter Cambridge,23,53,13,885,151,312,.484,0,4,.000,151,308,.490,.484,68,99,.687,88,79,167,58,24,6,63,128,370
13870,DAL,1993,Morlon Wiley,26,33,13,641,70,173,.405,39,103,.379,31,70,.443,.517,12,18,.667,20,36,56,100,39,1,51,78,191
13871,DAL,1993,Tim Legler,26,30,0,630,104,238,.437,22,65,.338,82,173,.474,.483,57,71,.803,25,33,58,46,24,6,28,63,287
13872,DAL,1993,Tracy Moore,27,39,1,510,103,249,.414,23,67,.343,80,182,.440,.460,53,61,.869,23,29,52,47,21,4,32,54,282
13873,DAL,1993,Steve Bardo,24,23,0,175,19,62,.306,1,6,.167,18,56,.321,.315,12,17,.706,10,27,37,29,8,3,17,28,51
13874,DAL,1993,Radisav Ćurčić,27,20,0,166,16,41,.390,0,0,,16,41,.390,.390,26,36,.722,17,32,49,12,7,2,8,30,58
13875,DAL,1993,Lamont Strothers,24,9,0,138,20,61,.328,2,13,.154,18,48,.375,.344,8,10,.800,8,6,14,13,8,0,15,13,50
13876,DAL,1993,Walter Palmer,24,20,0,124,27,57,.474,0,0,,27,57,.474,.474,6,9,.667,12,32,44,5,1,5,10,29,60
13877,DAL,1992,Rolando Blackman,32,75,74,2527,535,1161,.461,65,169,.385,470,992,.474,.489,239,266,.898,78,161,239,204,50,22,153,134,1374
13878,DAL,1992,Derek Harper,30,65,64,2252,448,1011,.443,58,186,.312,390,825,.473,.472,198,261,.759,49,121,170,373,101,17,154,150,1152
13879,DAL,1992,Terry Davis,24,68,67,2149,256,531,.482,0,5,.000,256,526,.487,.482,181,285,.635,228,444,672,57,26,29,117,202,693
13880,DAL,1992,Rodney McCray,30,75,48,2106,271,622,.436,25,85,.294,246,537,.458,.456,110,153,.719,149,319,468,219,48,30,115,180,677
13881,DAL,1992,Herb Williams,33,75,26,2040,367,851,.431,1,6,.167,366,845,.433,.432,124,171,.725,106,348,454,94,35,98,114,189,859
13882,DAL,1992,Doug Smith,22,76,32,1707,291,702,.415,0,11,.000,291,691,.421,.415,89,121,.736,129,262,391,129,62,34,97,259,671
13883,DAL,1992,Mike Iuzzolino,24,52,21,1280,160,355,.451,59,136,.434,101,219,.461,.534,107,128,.836,27,71,98,194,33,1,92,79,486
13884,DAL,1992,Donald Hodge,22,51,27,1058,163,328,.497,0,0,,163,328,.497,.497,100,150,.667,118,157,275,39,25,23,75,128,426
13885,DAL,1992,Randy White,24,65,12,1021,145,382,.380,4,27,.148,141,355,.397,.385,124,162,.765,96,140,236,31,31,22,68,157,418
13886,DAL,1992,James Donaldson,34,44,32,994,107,227,.471,0,0,,107,227,.471,.471,59,84,.702,97,173,270,31,8,44,41,86,273
13887,DAL,1992,Fat Lever,31,31,5,884,135,349,.387,17,52,.327,118,297,.397,.411,60,80,.750,56,105,161,107,46,12,36,73,347
13888,DAL,1992,Tracy Moore,26,42,2,782,130,325,.400,30,84,.357,100,241,.415,.446,65,78,.833,31,51,82,48,32,4,44,97,355
13889,DAL,1992,Brad Davis,36,33,0,429,38,86,.442,5,18,.278,33,68,.485,.471,11,15,.733,4,29,33,66,11,3,27,57,92
13890,DAL,1992,Brian Howard,24,27,0,318,54,104,.519,1,2,.500,53,102,.520,.524,22,31,.710,17,34,51,14,11,8,15,55,131
13891,DAL,1992,Brian Quinnett,25,15,0,136,15,51,.294,3,15,.200,12,36,.333,.324,8,12,.667,7,20,27,5,9,2,8,11,41
13892,DAL,1992,Tom Garrick,25,6,0,63,4,17,.235,0,1,.000,4,16,.250,.235,2,2,1.000,2,4,6,17,8,0,4,7,10
13893,DAL,1992,João Vianna,25,1,0,9,1,2,.500,0,0,,1,2,.500,.500,0,0,,0,0,0,2,0,0,1,3,2
13894,DAL,1991,Rolando Blackman,31,80,80,2965,634,1316,.482,40,114,.351,594,1202,.494,.497,282,326,.865,63,193,256,301,69,19,159,153,1590
13895,DAL,1991,Derek Harper,29,77,77,2879,572,1226,.467,89,246,.362,483,980,.493,.503,286,391,.731,59,174,233,548,147,14,177,222,1519
13896,DAL,1991,James Donaldson,33,82,82,2800,327,615,.532,0,0,,327,615,.532,.532,165,229,.721,201,526,727,69,34,93,146,181,819
13897,DAL,1991,Rodney McCray,29,74,68,2561,336,679,.495,13,39,.333,323,640,.505,.504,159,198,.803,153,407,560,259,70,51,129,203,844
13898,DAL,1991,Randy White,23,79,29,1901,265,665,.398,6,37,.162,259,628,.412,.403,159,225,.707,173,331,504,63,81,44,131,308,695
13899,DAL,1991,Herb Williams,32,60,36,1832,332,655,.507,0,4,.000,332,651,.510,.507,83,130,.638,86,271,357,95,30,88,113,197,747
13900,DAL,1991,Alex English,37,79,26,1748,322,734,.439,0,1,.000,322,733,.439,.439,119,140,.850,108,146,254,105,40,25,101,141,763
13901,DAL,1991,Brad Davis,35,80,6,1426,159,373,.426,22,85,.259,137,288,.476,.456,91,118,.771,13,105,118,230,45,17,77,212,431
13902,DAL,1991,Kelvin Upshaw,28,48,1,514,104,231,.450,7,29,.241,97,202,.480,.465,55,64,.859,20,35,55,86,28,5,39,77,270
13903,DAL,1991,John Shasky,26,57,0,510,51,116,.440,0,0,,51,116,.440,.440,48,79,.608,58,76,134,11,14,20,27,75,150
13904,DAL,1991,Steve Alford,26,34,0,236,59,117,.504,7,23,.304,52,94,.553,.534,26,31,.839,10,14,24,22,8,1,16,11,151
13905,DAL,1991,Roy Tarpley,26,5,5,171,43,79,.544,0,1,.000,43,78,.551,.544,16,18,.889,16,39,55,12,6,9,13,20,102
13906,DAL,1991,Jim Grandholm,30,26,0,168,30,58,.517,9,17,.529,21,41,.512,.595,10,21,.476,20,30,50,8,2,8,11,33,79
13907,DAL,1991,Fat Lever,30,4,0,86,9,23,.391,0,3,.000,9,20,.450,.391,11,14,.786,3,12,15,12,6,3,10,5,29
13908,DAL,1991,Howard Wright,23,3,0,8,2,3,.667,0,1,.000,2,2,1.000,.667,2,2,1.000,1,1,2,0,1,0,0,2,6
13909,DAL,1990,Derek Harper,28,82,82,3007,567,1161,.488,89,240,.371,478,921,.519,.527,250,315,.794,54,190,244,609,187,26,207,224,1473
13910,DAL,1990,Rolando Blackman,30,80,80,2934,626,1256,.498,13,43,.302,613,1213,.505,.504,287,340,.844,88,192,280,289,77,21,174,128,1552
13911,DAL,1990,Sam Perkins,28,76,70,2668,435,883,.493,6,28,.214,429,855,.502,.496,330,424,.778,209,363,572,175,88,64,148,225,1206
13912,DAL,1990,James Donaldson,32,73,73,2265,258,479,.539,0,0,,258,479,.539,.539,149,213,.700,155,475,630,57,22,47,119,129,665
13913,DAL,1990,Herb Williams,31,81,19,2199,295,665,.444,2,9,.222,293,656,.447,.445,108,159,.679,76,315,391,119,51,106,106,243,700
13914,DAL,1990,Roy Tarpley,25,45,35,1648,314,696,.451,0,6,.000,314,690,.455,.451,130,172,.756,189,400,589,67,79,70,117,160,758
13915,DAL,1990,Adrian Dantley,34,45,45,1300,231,484,.477,0,2,.000,231,482,.479,.477,200,254,.787,78,94,172,80,20,7,75,99,662
13916,DAL,1990,Brad Davis,34,73,2,1292,179,365,.490,35,104,.337,144,261,.552,.538,77,100,.770,12,81,93,242,47,9,86,151,470
13917,DAL,1990,Bill Wennington,26,60,2,814,105,234,.449,0,4,.000,105,230,.457,.449,60,75,.800,64,134,198,41,20,21,50,144,270
13918,DAL,1990,Randy White,22,55,2,707,93,252,.369,1,14,.071,92,238,.387,.371,50,89,.562,78,95,173,21,24,6,47,124,237
13919,DAL,1990,Anthony Jones,27,66,0,650,72,194,.371,4,13,.308,68,181,.376,.381,47,69,.681,33,49,82,29,32,16,42,77,195
13920,DAL,1990,Steve Alford,25,41,0,302,63,138,.457,7,22,.318,56,116,.483,.482,35,37,.946,2,23,25,39,15,3,16,22,168
13921,DAL,1990,Bob McCann,25,10,0,62,7,21,.333,0,0,,7,21,.333,.333,12,14,.857,4,8,12,6,2,2,6,7,26
13922,DAL,1990,Kelvin Upshaw,27,3,0,4,1,3,.333,0,1,.000,1,2,.500,.333,0,0,,0,0,0,0,0,0,0,0,2
13923,DAL,1990,Mark Wade,24,1,0,3,0,0,,0,0,,0,0,,,0,0,,0,0,0,2,0,0,0,0,0
13924,DAL,1989,Derek Harper,27,81,81,2968,538,1127,.477,99,278,.356,439,849,.517,.521,229,284,.806,46,182,228,570,172,41,205,219,1404
13925,DAL,1989,Rolando Blackman,29,78,78,2946,594,1249,.476,30,85,.353,564,1164,.485,.488,316,370,.854,70,203,273,288,65,20,165,137,1534
13926,DAL,1989,Sam Perkins,27,78,77,2860,445,959,.464,7,38,.184,438,921,.476,.468,274,329,.833,235,453,688,127,76,92,141,224,1171
13927,DAL,1989,James Donaldson,31,53,53,1746,193,337,.573,0,0,,193,337,.573,.573,95,124,.766,158,412,570,38,24,81,83,111,481
13928,DAL,1989,Mark Aguirre,29,44,44,1529,373,829,.450,29,99,.293,344,730,.471,.467,178,244,.730,90,145,235,189,29,29,140,128,953
13929,DAL,1989,Brad Davis,33,78,4,1395,183,379,.483,32,102,.314,151,277,.545,.525,99,123,.805,14,94,108,242,48,18,92,151,497
13930,DAL,1989,Adrian Dantley,33,31,25,1081,212,459,.462,0,1,.000,212,458,.463,.462,204,263,.776,64,89,153,78,20,7,82,87,628
13931,DAL,1989,Bill Wennington,25,65,9,1074,119,275,.433,1,9,.111,118,266,.444,.435,61,82,.744,82,204,286,46,16,35,54,211,300
13932,DAL,1989,Terry Tyler,32,70,11,1057,169,360,.469,1,9,.111,168,351,.479,.471,47,62,.758,74,135,209,40,24,39,51,90,386
13933,DAL,1989,Herb Williams,30,30,20,903,78,197,.396,0,2,.000,78,195,.400,.396,43,68,.632,48,149,197,36,15,54,41,80,199
13934,DAL,1989,Detlef Schrempf,26,37,1,845,112,263,.426,2,16,.125,110,247,.445,.430,127,161,.789,56,110,166,86,24,9,56,118,353
13935,DAL,1989,Roy Tarpley,24,19,6,591,131,242,.541,0,1,.000,131,241,.544,.541,66,96,.688,77,141,218,17,28,30,45,70,328
13936,DAL,1989,Morlon Wiley,22,51,1,408,46,114,.404,6,24,.250,40,90,.444,.430,13,16,.813,13,34,47,76,25,6,34,61,111
13937,DAL,1989,Uwe Blab,26,37,0,208,24,52,.462,0,0,,24,52,.462,.462,20,25,.800,11,33,44,12,3,13,14,36,68
13938,DAL,1989,Anthony Jones,26,25,0,131,24,64,.375,4,15,.267,20,49,.408,.406,12,14,.857,10,10,20,13,9,2,4,13,64
13939,DAL,1989,Steve Alford,24,9,0,38,3,11,.273,0,2,.000,3,9,.333,.273,1,2,.500,0,3,3,9,1,0,1,3,7
13940,DAL,1988,Derek Harper,26,82,82,3032,536,1167,.459,60,192,.313,476,975,.488,.485,261,344,.759,71,175,246,634,168,35,190,164,1393
13941,DAL,1988,Mark Aguirre,28,77,77,2610,746,1571,.475,52,172,.302,694,1399,.496,.491,388,504,.770,182,252,434,278,70,57,203,223,1932
13942,DAL,1988,Rolando Blackman,28,71,69,2580,497,1050,.473,0,5,.000,497,1045,.476,.473,331,379,.873,82,164,246,262,64,18,144,112,1325
13943,DAL,1988,James Donaldson,30,81,81,2523,212,380,.558,0,0,,212,380,.558,.558,147,189,.778,247,508,755,66,40,104,113,175,571
13944,DAL,1988,Sam Perkins,26,75,75,2499,394,876,.450,5,30,.167,389,846,.460,.453,273,332,.822,201,400,601,118,74,54,119,227,1066
13945,DAL,1988,Roy Tarpley,23,81,9,2307,444,888,.500,0,5,.000,444,883,.503,.500,205,277,.740,360,599,959,86,103,86,172,313,1093
13946,DAL,1988,Detlef Schrempf,25,82,4,1587,246,539,.456,5,32,.156,241,507,.475,.461,201,266,.756,102,177,279,159,42,32,108,189,698
13947,DAL,1988,Brad Davis,32,75,12,1480,208,415,.501,30,74,.405,178,341,.522,.537,91,108,.843,18,84,102,303,51,18,91,149,537
13948,DAL,1988,Uwe Blab,25,73,1,658,58,132,.439,0,0,,58,132,.439,.439,46,65,.708,52,82,134,35,8,29,49,108,162
13949,DAL,1988,Steve Alford,23,28,0,197,21,55,.382,1,8,.125,20,47,.426,.391,16,17,.941,3,20,23,23,17,3,12,23,59
13950,DAL,1988,Jim Farmer,23,30,0,157,26,69,.377,0,6,.000,26,63,.413,.377,9,10,.900,9,9,18,16,3,1,22,18,61
13951,DAL,1988,Bill Wennington,24,30,0,125,25,49,.510,1,2,.500,24,47,.511,.520,12,19,.632,14,25,39,4,5,9,9,33,63
13952,DAL,1987,James Donaldson,29,82,82,3028,311,531,.586,0,0,,311,531,.586,.586,267,329,.812,295,678,973,63,51,136,104,191,889
13953,DAL,1987,Rolando Blackman,27,80,80,2758,626,1264,.495,5,15,.333,621,1249,.497,.497,419,474,.884,96,182,278,266,64,21,174,142,1676
13954,DAL,1987,Sam Perkins,25,80,80,2687,461,957,.482,19,54,.352,442,903,.489,.492,245,296,.828,197,419,616,146,109,77,132,269,1186
13955,DAL,1987,Mark Aguirre,27,80,80,2663,787,1590,.495,53,150,.353,734,1440,.510,.512,429,557,.770,181,246,427,254,84,30,217,243,2056
13956,DAL,1987,Derek Harper,25,77,76,2556,497,993,.501,76,212,.358,421,781,.539,.539,160,234,.684,51,148,199,609,167,25,138,195,1230
13957,DAL,1987,Detlef Schrempf,24,81,5,1711,265,561,.472,33,69,.478,232,492,.472,.502,193,260,.742,87,216,303,161,50,16,110,224,756
13958,DAL,1987,Brad Davis,31,82,6,1582,199,436,.456,32,106,.302,167,330,.506,.493,147,171,.860,27,87,114,373,63,10,114,159,577
13959,DAL,1987,Roy Tarpley,22,75,1,1405,233,499,.467,1,3,.333,232,496,.468,.468,94,139,.676,180,353,533,52,56,79,101,232,561
13960,DAL,1987,Al Wood,28,54,0,657,121,310,.390,7,25,.280,114,285,.400,.402,109,139,.784,39,55,94,34,19,11,34,83,358
13961,DAL,1987,Bill Wennington,23,58,0,560,56,132,.424,0,2,.000,56,130,.431,.424,45,60,.750,53,76,129,24,13,10,39,95,157
13962,DAL,1987,Uwe Blab,24,30,0,160,20,51,.392,0,0,,20,51,.392,.392,13,28,.464,11,25,36,13,4,9,15,33,53
13963,DAL,1987,Dennis Nutt,23,25,0,91,16,40,.400,5,17,.294,11,23,.478,.463,20,22,.909,1,7,8,16,7,0,10,6,57
13964,DAL,1987,Myron Jackson,22,8,0,22,2,9,.222,0,0,,2,9,.222,.222,7,8,.875,1,2,3,6,1,0,5,1,11
13965,DAL,1986,Rolando Blackman,26,82,81,2787,677,1318,.514,4,29,.138,673,1289,.522,.515,404,483,.836,88,203,291,271,79,25,189,138,1762
13966,DAL,1986,Sam Perkins,24,80,79,2626,458,910,.503,11,33,.333,447,877,.510,.509,307,377,.814,195,490,685,153,75,94,145,212,1234
13967,DAL,1986,Mark Aguirre,26,74,73,2501,668,1327,.503,16,56,.286,652,1271,.513,.509,318,451,.705,177,268,445,339,62,14,252,229,1670
13968,DAL,1986,James Donaldson,28,69,64,2241,213,375,.568,0,0,,213,375,.568,.568,147,184,.799,143,521,664,84,23,110,85,156,573
13969,DAL,1986,Derek Harper,24,79,39,2150,390,730,.534,12,51,.235,378,679,.557,.542,171,229,.747,75,151,226,416,153,23,144,166,963
13970,DAL,1986,Jay Vincent,26,80,3,1994,442,919,.481,0,3,.000,442,916,.483,.481,222,274,.810,107,261,368,180,66,21,145,193,1106
13971,DAL,1986,Brad Davis,30,82,43,1971,267,502,.532,32,89,.360,235,413,.569,.564,198,228,.868,26,120,146,467,57,15,110,174,764
13972,DAL,1986,Dale Ellis,25,72,1,1086,193,470,.411,63,173,.364,130,297,.438,.478,59,82,.720,86,82,168,37,40,9,38,78,508
13973,DAL,1986,Detlef Schrempf,23,64,12,969,142,315,.451,3,7,.429,139,308,.451,.456,110,152,.724,70,128,198,88,23,10,84,166,397
13974,DAL,1986,Bill Wennington,22,56,3,562,72,153,.471,0,4,.000,72,149,.483,.471,45,62,.726,32,100,132,21,11,22,21,83,189
13975,DAL,1986,Uwe Blab,23,48,0,409,44,94,.468,0,0,,44,94,.468,.468,36,67,.537,25,66,91,17,3,12,28,65,124
13976,DAL,1986,Kurt Nimphius,27,13,4,280,37,72,.514,0,1,.000,37,71,.521,.514,17,29,.586,23,37,60,14,3,12,13,38,91
13977,DAL,1986,Wallace Bryant,26,9,8,154,11,30,.367,0,0,,11,30,.367,.367,6,11,.545,9,24,33,11,3,2,7,26,28
13978,DAL,1986,Harold Keeling,22,20,0,75,17,39,.436,0,0,,17,39,.436,.436,10,14,.714,3,3,6,10,7,0,7,9,44
13979,DAL,1985,Rolando Blackman,25,81,80,2834,625,1230,.508,6,20,.300,619,1210,.512,.511,342,413,.828,107,193,300,289,61,16,162,96,1598
13980,DAL,1985,Mark Aguirre,25,80,79,2699,794,1569,.506,27,85,.318,767,1484,.517,.515,440,580,.759,188,289,477,249,60,24,253,250,2055
13981,DAL,1985,Jay Vincent,25,79,47,2543,545,1138,.479,0,4,.000,545,1134,.481,.479,351,420,.836,185,519,704,169,48,22,170,226,1441
13982,DAL,1985,Brad Davis,29,82,82,2539,310,614,.505,47,115,.409,263,499,.527,.543,158,178,.888,39,154,193,581,91,10,123,219,825
13983,DAL,1985,Sam Perkins,23,82,42,2317,347,736,.471,9,36,.250,338,700,.483,.478,200,244,.820,189,416,605,135,63,63,102,236,903
13984,DAL,1985,Derek Harper,23,82,1,2218,329,633,.520,21,61,.344,308,572,.538,.536,111,154,.721,47,152,199,360,144,37,123,194,790
13985,DAL,1985,Kurt Nimphius,26,82,40,2010,196,434,.452,0,6,.000,196,428,.458,.452,108,140,.771,136,272,408,183,30,126,95,262,500
13986,DAL,1985,Dale Ellis,24,72,4,1314,274,603,.454,42,109,.385,232,494,.470,.489,77,104,.740,100,138,238,56,46,7,58,131,667
13987,DAL,1985,Wallace Bryant,25,56,35,860,67,148,.453,0,0,,67,148,.453,.453,30,44,.682,74,167,241,84,21,24,46,110,164
13988,DAL,1985,Charlie Sitton,22,43,0,304,39,94,.415,0,2,.000,39,92,.424,.415,13,25,.520,24,36,60,26,7,6,19,50,91
13989,DAL,1985,Tom Sluby,22,31,0,151,30,58,.517,0,2,.000,30,56,.536,.517,13,21,.619,5,7,12,16,3,0,11,18,73
13990,DAL,1985,Howard Carter,23,11,0,66,4,23,.174,0,3,.000,4,20,.200,.174,1,1,1.000,1,2,3,4,1,0,8,4,9
13991,DAL,1984,Rolando Blackman,24,81,81,3025,721,1320,.546,1,11,.091,720,1309,.550,.547,372,458,.812,124,249,373,288,56,37,169,127,1815
13992,DAL,1984,Mark Aguirre,24,79,79,2900,925,1765,.524,15,56,.268,910,1709,.532,.528,465,621,.749,161,308,469,358,80,22,285,246,2330
13993,DAL,1984,Brad Davis,28,81,81,2665,345,651,.530,7,38,.184,338,613,.551,.535,199,238,.836,41,146,187,561,94,13,166,218,896
13994,DAL,1984,Pat Cummings,27,80,80,2492,452,915,.494,0,2,.000,452,913,.495,.494,141,190,.742,151,507,658,158,64,23,146,282,1045
13995,DAL,1984,Kurt Nimphius,25,82,46,2284,272,523,.520,1,4,.250,271,519,.522,.521,101,162,.623,182,331,513,176,41,144,98,283,646
13996,DAL,1984,Derek Harper,22,82,1,1712,200,451,.443,3,26,.115,197,425,.464,.447,66,98,.673,53,119,172,239,95,21,111,143,469
13997,DAL,1984,Bill Garnett,23,80,34,1529,141,299,.472,0,2,.000,141,297,.475,.472,129,176,.733,123,208,331,128,44,66,68,217,411
13998,DAL,1984,Jay Vincent,24,61,5,1421,252,579,.435,0,1,.000,252,578,.436,.435,168,215,.781,81,166,247,114,30,10,113,159,672
13999,DAL,1984,Dale Ellis,23,67,2,1059,225,493,.456,12,29,.414,213,464,.459,.469,87,121,.719,106,144,250,56,41,9,78,118,549
14000,DAL,1984,Elston Turner,24,47,1,536,54,150,.360,1,9,.111,53,141,.376,.363,28,34,.824,42,51,93,59,26,0,29,40,137
14001,DAL,1984,Mark West,23,34,0,202,15,42,.357,0,0,,15,42,.357,.357,7,22,.318,19,27,46,13,1,15,12,55,37
14002,DAL,1984,Roger Phegley,27,10,0,76,9,31,.290,1,4,.250,8,27,.296,.306,2,2,1.000,2,7,9,9,1,0,5,10,21
14003,DAL,1984,Jim Spanarkel,26,7,0,54,7,16,.438,1,2,.500,6,14,.429,.469,9,13,.692,5,2,7,5,6,0,4,8,24
14004,DAL,1983,Mark Aguirre,23,81,75,2784,767,1589,.483,16,76,.211,751,1513,.496,.488,429,589,.728,191,317,508,332,80,26,261,247,1979
14005,DAL,1983,Jay Vincent,23,81,73,2726,622,1272,.489,0,3,.000,622,1269,.490,.489,269,343,.784,217,375,592,212,70,45,188,295,1513
14006,DAL,1983,Rolando Blackman,23,75,62,2349,513,1042,.492,3,15,.200,510,1027,.497,.494,297,381,.780,108,185,293,185,37,29,118,116,1326
14007,DAL,1983,Brad Davis,27,79,78,2323,359,628,.572,11,43,.256,348,585,.595,.580,186,220,.845,34,164,198,565,80,11,143,176,915
14008,DAL,1983,Pat Cummings,26,81,71,2317,433,878,.493,0,1,.000,433,877,.494,.493,148,196,.755,225,443,668,144,57,35,162,296,1014
14009,DAL,1983,Kelvin Ransey,24,76,4,1607,343,746,.460,2,16,.125,341,730,.467,.461,152,199,.764,44,103,147,280,58,4,129,109,840
14010,DAL,1983,Kurt Nimphius,24,81,12,1515,174,355,.490,1,1,1.000,173,354,.489,.492,77,140,.550,157,247,404,115,24,111,66,287,426
14011,DAL,1983,Bill Garnett,22,75,13,1411,170,319,.533,0,3,.000,170,316,.538,.533,129,174,.741,141,265,406,103,48,70,81,245,469
14012,DAL,1983,Elston Turner,23,59,16,879,96,238,.403,2,3,.667,94,235,.400,.408,20,30,.667,68,84,152,88,47,0,59,75,214
14013,DAL,1983,Jim Spanarkel,25,48,4,722,91,197,.462,2,10,.200,89,187,.476,.467,88,113,.779,27,57,84,78,27,3,55,59,272
14014,DAL,1983,Corny Thompson,22,44,2,520,43,137,.314,0,0,,43,137,.314,.314,36,46,.783,41,79,120,34,12,7,31,92,122
14015,DAL,1983,Allan Bristow,31,37,0,371,44,99,.444,6,13,.462,38,86,.442,.475,10,14,.714,24,35,59,70,6,1,31,46,104
14016,DAL,1983,Scott Lloyd,30,15,0,206,19,50,.380,0,1,.000,19,49,.388,.380,11,17,.647,19,27,46,21,6,6,6,24,49
14017,DAL,1982,Jay Vincent,22,81,62,2626,719,1448,.497,1,4,.250,718,1444,.497,.497,293,409,.716,182,383,565,176,89,22,194,308,1732
14018,DAL,1982,Brad Davis,26,82,82,2614,397,771,.515,14,49,.286,383,722,.530,.524,185,230,.804,35,191,226,509,73,6,159,218,993
14019,DAL,1982,Allan Bristow,30,82,54,2035,218,499,.437,3,18,.167,215,481,.447,.440,134,164,.817,119,220,339,448,65,6,165,222,573
14020,DAL,1982,Elston Turner,22,80,62,1996,282,639,.441,0,4,.000,282,635,.444,.441,97,138,.703,143,158,301,189,75,2,116,182,661
14021,DAL,1982,Rolando Blackman,22,82,16,1979,439,855,.513,1,4,.250,438,851,.515,.514,212,276,.768,97,157,254,105,46,30,113,122,1091
14022,DAL,1982,Wayne Cooper,25,76,38,1818,281,669,.420,1,8,.125,280,661,.424,.421,119,160,.744,200,350,550,115,37,106,88,285,682
14023,DAL,1982,Jim Spanarkel,24,82,1,1755,270,564,.479,8,24,.333,262,540,.485,.486,279,327,.853,99,111,210,206,86,9,111,140,827
14024,DAL,1982,Mark Aguirre,22,51,20,1468,381,820,.465,25,71,.352,356,749,.475,.480,168,247,.680,89,160,249,164,37,22,135,152,955
14025,DAL,1982,Kurt Nimphius,23,63,27,1085,137,297,.461,0,0,,137,297,.461,.461,63,108,.583,92,203,295,61,17,82,56,190,337
14026,DAL,1982,Scott Lloyd,29,74,17,1047,108,285,.379,2,4,.500,106,281,.377,.382,69,91,.758,60,103,163,67,15,7,59,175,287
14027,DAL,1982,Tom LaGarde,26,47,28,909,113,269,.420,0,2,.000,113,267,.423,.420,86,166,.518,63,147,210,49,17,17,82,138,312
14028,DAL,1982,Clarence Kea,22,35,0,248,26,49,.531,0,0,,26,49,.531,.531,29,42,.690,26,35,61,14,4,3,16,55,81
14029,DAL,1982,Ollie Mack,24,13,3,150,19,59,.322,0,2,.000,19,57,.333,.322,6,8,.750,8,10,18,14,5,1,4,6,44
14030,DAL,1981,Tom LaGarde,25,82,82,2670,417,888,.470,0,0,,417,888,.470,.470,288,444,.649,177,488,665,237,35,45,206,293,1122
14031,DAL,1981,Jim Spanarkel,23,82,,2317,404,866,.467,1,10,.100,403,856,.471,.467,375,423,.887,142,155,297,232,117,20,172,230,1184
14032,DAL,1981,Scott Lloyd,28,72,,2186,245,547,.448,0,2,.000,245,545,.450,.448,147,205,.717,161,293,454,159,34,25,145,269,637
14033,DAL,1981,Bill Robinzine,28,70,,1932,378,794,.476,1,6,.167,377,788,.478,.477,213,273,.780,164,356,520,113,71,9,177,256,970
14034,DAL,1981,Geoff Huston,23,56,,1892,385,789,.488,1,4,.250,384,785,.489,.489,128,185,.692,33,66,99,277,45,6,148,113,899
14035,DAL,1981,Brad Davis,25,56,,1686,230,410,.561,3,17,.176,227,393,.578,.565,163,204,.799,29,122,151,385,52,11,123,156,626
14036,DAL,1981,Ollie Mack,23,62,,1666,278,600,.463,0,9,.000,278,591,.470,.463,79,123,.642,92,137,229,162,55,7,70,114,635
14037,DAL,1981,Marty Byrnes,24,72,,1360,216,451,.479,9,20,.450,207,431,.480,.489,120,157,.764,74,103,177,113,29,17,61,126,561
14038,DAL,1981,Abdul Jeelani,26,66,,1108,187,440,.425,0,1,.000,187,439,.426,.425,179,220,.814,83,147,230,65,44,31,87,123,553
14039,DAL,1981,Winford Boynes,23,44,,757,121,313,.387,0,0,,121,313,.387,.387,45,55,.818,24,51,75,37,23,16,69,79,287
14040,DAL,1981,Stan Pietkiewicz,24,36,,431,55,133,.414,19,48,.396,36,85,.424,.485,11,14,.786,13,28,41,75,15,2,17,26,140
14041,DAL,1981,Terry Duerod,24,18,,337,74,161,.460,2,6,.333,72,155,.465,.466,18,27,.667,15,24,39,30,12,4,25,19,168
14042,DAL,1981,Richard Washington,25,11,,307,51,117,.436,0,0,,51,117,.436,.436,17,23,.739,25,59,84,16,5,7,21,37,119
14043,DAL,1981,Joe Hassett,25,17,,280,59,142,.415,10,40,.250,49,102,.480,.451,10,13,.769,11,14,25,18,5,0,11,21,138
14044,DAL,1981,Darrell Allums,22,22,,276,23,67,.343,0,1,.000,23,66,.348,.343,13,22,.591,19,46,65,25,5,8,23,51,59
14045,DAL,1981,Clarence Kea,21,16,,199,37,81,.457,0,1,.000,37,80,.463,.457,43,62,.694,28,39,67,5,6,1,16,44,117
14046,DAL,1981,Jerome Whitehead,24,7,,118,16,38,.421,0,0,,16,38,.421,.421,5,11,.455,8,20,28,2,4,1,11,16,37
14047,DAL,1981,Chad Kinch,22,12,,106,14,45,.311,0,0,,14,45,.311,.311,10,13,.769,0,9,9,10,2,1,8,9,38
14048,DAL,1981,Austin Carr,32,8,,77,7,28,.250,0,0,,7,28,.250,.250,2,4,.500,4,5,9,9,1,0,9,10,16
14049,DAL,1981,Ralph Drollinger,26,6,,67,7,14,.500,0,0,,7,14,.500,.500,1,4,.250,5,14,19,14,1,2,13,16,15
14050,DAL,1981,Monti Davis,22,1,,8,0,4,.000,0,0,,0,4,.000,.000,1,5,.200,2,1,3,0,0,1,0,0,1
14051,MIN,2024,Anthony Edwards,22,79,78,2770,718,1558,.461,190,532,.357,528,1026,.515,.522,423,506,.836,52,378,430,405,101,42,241,141,2049
14052,MIN,2024,Rudy Gobert,31,76,76,2593,406,614,.661,0,3,.000,406,611,.664,.661,249,390,.638,285,697,982,102,52,162,118,238,1061
14053,MIN,2024,Mike Conley,36,76,76,2193,294,644,.457,179,405,.442,115,239,.481,.595,102,112,.911,37,181,218,449,88,17,102,128,869
14054,MIN,2024,Jaden McDaniels,23,72,71,2105,307,628,.489,86,255,.337,221,373,.592,.557,57,79,.722,56,168,224,101,63,42,87,219,757
14055,MIN,2024,Karl-Anthony Towns,28,62,62,2026,479,951,.504,136,327,.416,343,624,.550,.575,255,292,.873,94,421,515,189,43,41,177,204,1349
14056,MIN,2024,Naz Reid,24,81,14,1964,406,851,.477,169,408,.414,237,443,.535,.576,109,148,.736,73,350,423,106,63,73,111,172,1090
14057,MIN,2024,Nickeil Alexander-Walker,25,82,20,1921,236,538,.439,131,335,.391,105,203,.517,.560,52,65,.800,35,132,167,204,64,42,76,143,655
14058,MIN,2024,Kyle Anderson,30,79,10,1782,199,433,.460,11,48,.229,188,385,.488,.472,97,137,.708,60,213,273,331,71,47,91,128,506
14059,MIN,2024,Jordan McLaughlin,27,56,0,626,70,145,.483,42,89,.472,28,56,.500,.628,13,18,.722,18,54,72,110,35,7,19,31,195
14060,MIN,2024,Shake Milton,27,38,0,491,64,160,.400,14,53,.264,50,107,.467,.444,36,44,.818,7,44,51,50,16,5,28,44,178
14061,MIN,2024,Troy Brown Jr.,24,37,3,410,52,118,.441,31,84,.369,21,34,.618,.572,19,22,.864,14,58,72,35,8,2,18,26,154
14062,MIN,2024,Monte Morris,28,27,0,408,50,120,.417,25,59,.424,25,61,.410,.521,12,17,.706,5,40,45,61,18,8,5,13,137
14063,MIN,2024,T.J. Warren,30,11,0,125,18,41,.439,2,13,.154,16,28,.571,.463,3,4,.750,5,17,22,9,4,1,4,11,41
14064,MIN,2024,Luka Garza,25,25,0,122,36,75,.480,9,32,.281,27,43,.628,.540,18,25,.720,19,12,31,4,4,1,6,24,99
14065,MIN,2024,Josh Minott,21,32,0,91,17,36,.472,4,10,.400,13,26,.500,.528,12,14,.857,4,13,17,8,5,5,2,10,50
14066,MIN,2024,Wendell Moore Jr.,22,25,0,75,9,18,.500,0,6,.000,9,12,.750,.500,0,0,,0,12,12,6,5,1,4,5,18
14067,MIN,2024,Leonard Miller,20,17,0,52,13,20,.650,2,5,.400,11,15,.733,.700,1,2,.500,5,15,20,8,2,1,1,5,29
14068,MIN,2024,Daishen Nix,21,15,0,50,9,24,.375,6,17,.353,3,7,.429,.500,3,6,.500,1,2,3,6,5,0,5,2,27
14069,MIN,2024,Justin Jackson,28,2,0,1,0,0,,0,0,,0,0,,,0,0,,0,0,0,0,0,0,0,0,0
14070,MIN,2023,Anthony Edwards,21,79,79,2842,707,1541,.459,213,578,.369,494,963,.513,.528,319,422,.756,47,411,458,350,125,58,259,186,1946
14071,MIN,2023,Jaden McDaniels,22,79,79,2416,370,716,.517,107,269,.398,263,447,.588,.591,106,144,.736,92,215,307,148,74,76,112,272,953
14072,MIN,2023,Rudy Gobert,30,70,70,2148,360,546,.659,0,3,.000,360,543,.663,.659,219,340,.644,231,583,814,87,56,95,122,210,939
14073,MIN,2023,Kyle Anderson,29,69,46,1957,252,495,.509,43,105,.410,209,390,.536,.553,100,136,.735,66,302,368,335,78,63,103,146,647
14074,MIN,2023,D'Angelo Russell,26,54,54,1778,338,727,.465,148,379,.391,190,348,.546,.567,143,167,.856,28,137,165,334,60,21,147,117,967
14075,MIN,2023,Jaylen Nowell,23,65,2,1252,280,625,.448,67,232,.289,213,393,.542,.502,77,99,.778,36,134,170,132,42,5,65,101,704
14076,MIN,2023,Naz Reid,23,68,11,1251,310,577,.537,75,217,.346,235,360,.653,.602,86,127,.677,73,260,333,77,42,53,92,176,781
14077,MIN,2023,Taurean Prince,28,54,4,1192,177,379,.467,74,194,.381,103,185,.557,.565,65,77,.844,15,117,132,84,28,15,69,123,493
14078,MIN,2023,Austin Rivers,30,52,10,1016,91,209,.435,43,123,.350,48,86,.558,.538,30,39,.769,5,78,83,75,28,4,23,80,255
14079,MIN,2023,Karl-Anthony Towns,27,29,29,957,212,428,.495,60,164,.366,152,264,.576,.565,118,135,.874,48,188,236,140,20,17,86,111,602
14080,MIN,2023,Mike Conley,35,24,24,753,108,235,.460,58,138,.420,50,97,.515,.583,63,73,.863,16,59,75,120,29,4,29,45,337
14081,MIN,2023,Jordan McLaughlin,26,43,0,678,61,145,.421,24,78,.308,37,67,.552,.503,15,18,.833,15,47,62,148,32,4,33,28,161
14082,MIN,2023,Nickeil Alexander-Walker,24,23,0,356,48,125,.384,26,72,.361,22,53,.415,.488,13,21,.619,7,35,42,32,8,7,10,30,135
14083,MIN,2023,Nathan Knight,25,38,0,291,46,81,.568,8,22,.364,38,59,.644,.617,39,57,.684,22,34,56,13,10,6,21,41,139
14084,MIN,2023,Bryn Forbes,29,25,0,268,30,83,.361,14,46,.304,16,37,.432,.446,15,15,1.000,4,11,15,17,7,2,12,22,89
14085,MIN,2023,Luka Garza,24,28,0,243,63,116,.543,14,39,.359,49,77,.636,.603,41,52,.788,33,30,63,18,3,2,14,43,181
14086,MIN,2023,Matt Ryan,25,22,0,181,25,59,.424,19,49,.388,6,10,.600,.585,6,7,.857,2,10,12,12,3,1,4,13,75
14087,MIN,2023,Wendell Moore Jr.,21,29,2,153,18,43,.419,2,17,.118,16,26,.615,.442,4,5,.800,4,14,18,18,8,5,8,13,42
14088,MIN,2023,Josh Minott,20,15,0,96,18,36,.500,2,6,.333,16,30,.533,.528,8,8,1.000,5,20,25,5,4,6,3,10,46
14089,MIN,2023,A.J. Lawson,22,1,0,2,1,1,1.000,0,0,,1,1,1.000,1.000,0,0,,0,1,1,0,0,0,0,1,2
14090,MIN,2022,Karl-Anthony Towns,26,74,74,2476,642,1214,.529,150,366,.410,492,848,.580,.591,384,467,.822,194,533,727,269,72,83,226,267,1818
14091,MIN,2022,Anthony Edwards,20,72,72,2466,549,1245,.441,215,602,.357,334,643,.519,.527,220,280,.786,62,281,343,275,105,46,190,164,1533
14092,MIN,2022,D'Angelo Russell,25,65,65,2077,401,975,.411,176,518,.340,225,457,.492,.502,198,240,.825,25,191,216,460,62,22,165,130,1176
14093,MIN,2022,Malik Beasley,25,79,18,1976,332,850,.391,240,637,.377,92,213,.432,.532,49,60,.817,26,201,227,116,43,12,43,88,953
14094,MIN,2022,Jarred Vanderbilt,22,74,67,1880,212,361,.587,2,14,.143,210,347,.605,.590,86,131,.656,215,409,624,94,99,46,73,181,512
14095,MIN,2022,Jaden McDaniels,21,70,31,1803,255,554,.460,80,252,.317,175,302,.579,.532,57,71,.803,76,217,293,79,52,54,75,224,647
14096,MIN,2022,Patrick Beverley,33,58,54,1476,177,436,.406,83,242,.343,94,194,.485,.501,96,133,.722,62,178,240,268,67,52,73,174,533
14097,MIN,2022,Naz Reid,22,77,6,1215,233,476,.489,57,166,.343,176,310,.568,.549,114,149,.765,102,199,301,71,40,71,82,172,637
14098,MIN,2022,Taurean Prince,27,69,8,1177,177,390,.454,86,229,.376,91,161,.565,.564,62,82,.756,26,148,174,68,47,23,53,116,502
14099,MIN,2022,Jaylen Nowell,22,62,1,975,196,413,.475,63,160,.394,133,253,.526,.551,72,92,.783,22,101,123,130,27,10,36,73,527
14100,MIN,2022,Jordan McLaughlin,25,62,3,902,88,200,.440,27,85,.318,61,115,.530,.508,30,40,.750,22,72,94,180,57,10,38,54,233
14101,MIN,2022,Josh Okogie,23,49,6,516,42,104,.404,14,47,.298,28,57,.491,.471,35,51,.686,29,41,70,25,26,12,23,53,133
14102,MIN,2022,Nathan Knight,24,37,2,267,45,88,.511,4,13,.308,41,75,.547,.534,44,60,.733,32,53,85,22,7,8,18,42,138
14103,MIN,2022,Leandro Bolmaro,21,35,2,241,17,54,.315,5,18,.278,12,36,.333,.361,11,13,.846,16,27,43,21,6,0,13,26,50
14104,MIN,2022,Jake Layman,27,34,1,231,30,73,.411,8,35,.229,22,38,.579,.466,13,18,.722,6,30,36,9,7,5,10,12,81
14105,MIN,2022,Greg Monroe,31,4,0,81,13,22,.591,0,0,,13,22,.591,.591,3,7,.429,6,18,24,16,4,6,7,9,29
14106,MIN,2022,McKinley Wright IV,23,5,0,19,2,3,.667,1,2,.500,1,1,1.000,.833,0,0,,0,0,0,3,0,0,1,1,5
14107,MIN,2022,Chris Silva,25,1,0,3,0,0,,0,0,,0,0,,,0,0,,0,1,1,0,0,0,0,0,0
14108,MIN,2021,Anthony Edwards,19,72,55,2314,505,1211,.417,171,520,.329,334,691,.483,.488,211,272,.776,59,277,336,211,82,36,160,129,1392
14109,MIN,2021,Ricky Rubio,30,68,51,1772,193,498,.388,66,214,.308,127,284,.447,.454,130,150,.867,28,195,223,433,98,4,111,139,582
14110,MIN,2021,Karl-Anthony Towns,25,50,50,1689,425,875,.486,122,315,.387,303,560,.541,.555,267,311,.859,133,396,529,225,39,57,160,186,1239
14111,MIN,2021,Jaden McDaniels,20,63,27,1511,164,367,.447,72,198,.364,92,169,.544,.545,27,45,.600,52,180,232,71,35,60,47,172,427
14112,MIN,2021,Naz Reid,21,70,15,1347,304,581,.523,61,174,.351,243,407,.597,.576,115,166,.693,82,240,322,72,34,76,69,179,784
14113,MIN,2021,Malik Beasley,24,37,36,1214,264,600,.440,128,321,.399,136,279,.487,.547,68,80,.850,28,134,162,88,30,7,60,62,724
14114,MIN,2021,Josh Okogie,22,59,37,1197,102,254,.402,29,108,.269,73,146,.500,.459,83,108,.769,63,93,156,63,54,28,43,123,316
14115,MIN,2021,D'Angelo Russell,24,42,26,1196,281,652,.431,120,310,.387,161,342,.471,.523,114,149,.765,16,95,111,244,45,18,112,68,796
14116,MIN,2021,Jarred Vanderbilt,21,64,30,1139,143,236,.606,1,5,.200,142,231,.615,.608,57,102,.559,118,250,368,76,64,46,53,123,344
14117,MIN,2021,Jordan McLaughlin,24,51,2,938,100,242,.413,33,92,.359,67,150,.447,.481,23,30,.767,21,87,108,193,51,6,51,44,256
14118,MIN,2021,Juancho Hernangómez,25,52,6,900,130,299,.435,55,168,.327,75,131,.573,.527,60,97,.619,45,160,205,35,19,7,27,52,375
14119,MIN,2021,Jaylen Nowell,21,42,0,759,142,335,.424,50,150,.333,92,185,.497,.499,45,55,.818,19,76,95,62,22,12,28,72,379
14120,MIN,2021,Jake Layman,26,45,11,627,91,184,.495,23,78,.295,68,106,.642,.557,26,37,.703,13,54,67,28,29,19,26,44,231
14121,MIN,2021,Jarrett Culver,21,34,7,499,69,168,.411,13,53,.245,56,115,.487,.449,29,48,.604,34,70,104,24,17,9,28,58,180
14122,MIN,2021,Ed Davis,31,23,7,299,19,44,.432,0,0,,19,44,.432,.432,10,12,.833,46,69,115,21,13,13,7,56,48
14123,MIN,2021,Ashton Hagans,21,2,0,4,0,0,,0,0,,0,0,,,0,0,,0,0,0,0,0,0,1,0,0
14124,MIN,2020,Josh Okogie,21,62,28,1547,170,398,.427,41,154,.266,129,244,.529,.479,152,191,.796,87,181,268,99,68,26,87,139,533
14125,MIN,2020,Jarrett Culver,20,63,35,1506,230,569,.404,66,221,.299,164,348,.471,.462,54,117,.462,70,142,212,110,57,38,81,125,580
14126,MIN,2020,Andrew Wiggins,24,42,42,1455,351,790,.444,91,275,.331,260,515,.505,.502,149,207,.720,48,171,219,155,29,36,107,101,942
14127,MIN,2020,Robert Covington,29,48,47,1411,216,496,.435,108,312,.346,108,184,.587,.544,75,94,.798,36,251,287,56,80,45,73,148,615
14128,MIN,2020,Karl-Anthony Towns,24,35,35,1187,316,622,.508,114,277,.412,202,345,.586,.600,180,226,.796,95,283,378,153,33,42,110,117,926
14129,MIN,2020,Jeff Teague,31,34,13,945,145,324,.448,33,87,.379,112,237,.473,.498,125,144,.868,15,73,88,208,25,13,76,70,448
14130,MIN,2020,Shabazz Napier,28,36,22,856,114,283,.403,47,159,.296,67,124,.540,.486,72,88,.818,17,93,110,187,40,7,76,62,347
14131,MIN,2020,Gorgui Dieng,30,46,17,778,124,277,.448,46,120,.383,78,157,.497,.531,47,59,.797,73,183,256,58,37,42,44,89,341
14132,MIN,2020,Treveon Graham,26,33,20,663,62,175,.354,20,83,.241,42,92,.457,.411,27,37,.730,29,71,100,30,17,2,19,66,171
14133,MIN,2020,Keita Bates-Diop,24,37,0,646,87,206,.422,31,94,.330,56,112,.500,.498,46,65,.708,21,89,110,30,17,20,14,36,251
14134,MIN,2020,Jordan McLaughlin,23,30,2,590,87,178,.489,29,76,.382,58,102,.569,.570,26,39,.667,7,42,49,125,34,4,31,31,229
14135,MIN,2020,Jake Layman,25,23,2,505,81,179,.453,24,72,.333,57,107,.533,.520,24,32,.750,17,40,57,15,17,10,24,47,210
14136,MIN,2020,Kelan Martin,24,31,4,495,71,181,.392,25,96,.260,46,85,.541,.461,30,31,.968,12,84,96,23,7,9,20,51,197
14137,MIN,2020,Naz Reid,20,30,11,495,100,243,.412,32,97,.330,68,146,.466,.477,37,53,.698,34,90,124,35,19,22,22,83,269
14138,MIN,2020,Malik Beasley,23,14,14,463,110,233,.472,49,115,.426,61,118,.517,.577,21,28,.750,9,62,71,27,9,2,21,27,290
14139,MIN,2020,Juancho Hernangómez,24,14,14,411,62,137,.453,29,69,.420,33,68,.485,.558,28,46,.609,19,83,102,18,14,4,14,35,181
14140,MIN,2020,D'Angelo Russell,23,12,12,392,87,211,.412,38,110,.345,49,101,.485,.502,48,55,.873,3,52,55,79,17,4,46,22,260
14141,MIN,2020,Noah Vonleh,24,29,1,347,47,86,.547,2,14,.143,45,72,.625,.558,23,28,.821,34,82,116,26,11,6,19,36,119
14142,MIN,2020,James Johnson,32,14,1,338,64,128,.500,17,46,.370,47,82,.573,.566,23,34,.676,17,49,66,53,19,19,33,46,168
14143,MIN,2020,Jordan Bell,25,27,0,235,32,60,.533,2,9,.222,30,51,.588,.550,17,29,.586,28,50,78,14,2,10,18,17,83
14144,MIN,2020,Jaylen Nowell,20,15,0,151,19,53,.358,3,26,.115,16,27,.593,.387,16,17,.941,3,10,13,19,3,1,3,11,57
14145,MIN,2020,Allen Crabbe,27,9,0,131,11,34,.324,6,26,.231,5,8,.625,.412,1,2,.500,1,11,12,5,0,0,5,11,29
14146,MIN,2020,Jarred Vanderbilt,20,2,0,5,0,1,.000,0,1,.000,0,0,,.000,2,2,1.000,0,1,1,0,0,0,0,0,2
14147,MIN,2020,Jacob Evans,22,2,0,4,0,1,.000,0,1,.000,0,0,,.000,0,0,,0,0,0,0,0,0,0,0,0
14148,MIN,2019,Karl-Anthony Towns,23,77,77,2545,681,1314,.518,142,355,.400,539,959,.562,.572,376,450,.836,263,691,954,259,67,125,240,292,1880
14149,MIN,2019,Andrew Wiggins,23,73,73,2543,498,1209,.412,118,348,.339,380,861,.441,.461,207,296,.699,83,269,352,184,70,48,138,153,1321
14150,MIN,2019,Josh Okogie,20,74,52,1757,196,508,.386,60,215,.279,136,293,.464,.445,118,162,.728,41,177,218,91,88,33,63,166,570
14151,MIN,2019,Taj Gibson,33,70,57,1686,304,537,.566,11,34,.324,293,503,.583,.576,134,177,.757,172,286,458,84,53,39,73,186,753
14152,MIN,2019,Dario Šarić,24,68,28,1627,256,564,.454,97,253,.383,159,311,.511,.540,105,120,.875,105,266,371,101,41,6,72,143,714
14153,MIN,2019,Tyus Jones,22,68,23,1560,185,446,.415,40,126,.317,145,320,.453,.460,58,69,.841,23,111,134,327,81,5,47,78,468
14154,MIN,2019,Derrick Rose,30,51,13,1392,363,753,.482,54,146,.370,309,607,.509,.518,137,160,.856,33,107,140,220,31,12,82,57,917
14155,MIN,2019,Jeff Teague,30,42,41,1264,176,416,.423,35,105,.333,141,311,.453,.465,123,153,.804,16,90,106,343,43,18,97,90,510
14156,MIN,2019,Anthony Tolliver,33,65,0,1079,99,259,.382,81,215,.377,18,44,.409,.539,47,60,.783,15,162,177,46,17,21,36,91,326
14157,MIN,2019,Gorgui Dieng,29,76,2,1031,189,377,.501,19,56,.339,170,321,.530,.527,88,106,.830,81,230,311,72,48,41,57,134,485
14158,MIN,2019,Robert Covington,28,22,22,763,106,245,.433,55,148,.372,51,97,.526,.545,51,66,.773,21,105,126,32,50,24,25,81,318
14159,MIN,2019,Jerryd Bayless,30,34,6,657,82,230,.357,29,98,.296,53,132,.402,.420,16,28,.571,11,51,62,119,18,2,32,56,209
14160,MIN,2019,Keita Bates-Diop,23,30,3,503,60,142,.423,13,52,.250,47,90,.522,.468,18,28,.643,16,67,83,17,18,14,14,29,151
14161,MIN,2019,Luol Deng,33,22,2,392,59,118,.500,14,44,.318,45,74,.608,.559,25,35,.714,20,53,73,18,15,8,14,24,157
14162,MIN,2019,Jimmy Butler,29,10,10,361,74,157,.471,17,45,.378,57,112,.509,.525,48,61,.787,16,36,52,43,24,10,14,18,213
14163,MIN,2019,Cameron Reynolds,23,19,0,259,33,78,.423,21,51,.412,12,27,.444,.558,8,9,.889,4,27,31,13,6,2,5,26,95
14164,MIN,2019,C.J. Williams,28,15,0,128,17,35,.486,5,16,.313,12,19,.632,.557,0,1,.000,1,7,8,12,6,0,5,16,39
14165,MIN,2019,Jared Terrell,23,14,0,111,12,39,.308,4,17,.235,8,22,.364,.359,3,6,.500,1,5,6,12,3,2,10,16,31
14166,MIN,2019,Isaiah Canaan,27,7,1,95,11,29,.379,7,19,.368,4,10,.400,.500,4,4,1.000,0,5,5,19,2,1,4,4,33
14167,MIN,2019,James Nunnally,28,13,0,64,9,21,.429,5,13,.385,4,8,.500,.548,4,4,1.000,0,4,4,5,1,0,1,4,27
14168,MIN,2019,Mitch Creek,26,1,0,12,3,6,.500,0,1,.000,3,5,.600,.500,0,0,,1,1,2,1,1,0,1,0,6
14169,MIN,2018,Andrew Wiggins,22,82,82,2979,569,1300,.438,112,338,.331,457,962,.475,.481,202,314,.643,82,276,358,160,91,51,138,163,1452
14170,MIN,2018,Karl-Anthony Towns,22,82,82,2918,639,1172,.545,120,285,.421,519,887,.585,.596,345,402,.858,238,774,1012,199,64,115,159,285,1743
14171,MIN,2018,Taj Gibson,32,82,82,2726,425,737,.577,7,35,.200,418,702,.595,.581,142,185,.768,194,390,584,99,62,59,89,218,999
14172,MIN,2018,Jeff Teague,29,70,70,2311,354,794,.446,84,228,.368,270,566,.477,.499,202,239,.845,24,185,209,492,102,23,177,171,994
14173,MIN,2018,Jimmy Butler,28,59,59,2164,437,921,.474,70,200,.350,367,721,.509,.512,363,425,.854,79,235,314,288,116,24,108,78,1307
14174,MIN,2018,Jamal Crawford,37,80,0,1653,308,742,.415,104,314,.331,204,428,.477,.485,102,113,.903,21,78,99,185,40,9,95,85,822
14175,MIN,2018,Tyus Jones,21,82,11,1467,150,328,.457,45,129,.349,105,199,.528,.526,71,81,.877,16,116,132,232,95,6,59,110,416
14176,MIN,2018,Nemanja Bjelica,29,67,21,1371,171,371,.461,76,183,.415,95,188,.505,.563,36,45,.800,53,221,274,86,50,16,52,141,454
14177,MIN,2018,Gorgui Dieng,28,79,0,1333,186,388,.479,19,61,.311,167,327,.511,.504,79,102,.775,106,254,360,71,45,39,59,147,470
14178,MIN,2018,Shabazz Muhammad,25,32,2,301,47,121,.388,4,19,.211,43,102,.422,.405,22,31,.710,15,30,45,7,5,2,5,23,120
14179,MIN,2018,Marcus Georges-Hunt,23,42,0,224,21,48,.438,4,15,.267,17,33,.515,.479,13,21,.619,7,9,16,7,6,0,3,32,59
14180,MIN,2018,Aaron Brooks,33,32,1,189,28,69,.406,11,31,.355,17,38,.447,.486,8,11,.727,7,10,17,20,6,0,11,28,75
14181,MIN,2018,Derrick Rose,29,9,0,112,23,54,.426,1,6,.167,22,48,.458,.435,5,5,1.000,3,3,6,11,4,0,7,2,52
14182,MIN,2018,Cole Aldrich,29,21,0,49,5,15,.333,0,0,,5,15,.333,.333,2,6,.333,3,12,15,3,2,1,1,11,12
14183,MIN,2018,Anthony Brown,25,1,0,4,1,1,1.000,1,1,1.000,0,0,,1.500,0,0,,0,0,0,1,0,0,0,0,3
14184,MIN,2018,Justin Patton,20,1,0,4,1,2,.500,0,0,,1,2,.500,.500,0,0,,0,0,0,0,1,0,0,1,2
14185,MIN,2017,Andrew Wiggins,21,82,82,3048,709,1570,.452,103,289,.356,606,1281,.473,.484,412,542,.760,102,226,328,189,82,30,187,183,1933
14186,MIN,2017,Karl-Anthony Towns,21,82,82,3030,802,1480,.542,101,275,.367,701,1205,.582,.576,356,428,.832,296,711,1007,220,56,103,212,241,2061
14187,MIN,2017,Gorgui Dieng,27,82,82,2653,332,661,.502,16,43,.372,316,618,.511,.514,136,167,.814,188,459,647,158,88,95,107,254,816
14188,MIN,2017,Ricky Rubio,26,75,75,2469,261,650,.402,60,196,.306,201,454,.443,.448,254,285,.891,68,237,305,682,128,10,195,202,836
14189,MIN,2017,Zach LaVine,21,47,47,1749,326,710,.459,120,310,.387,206,400,.515,.544,117,140,.836,19,141,160,139,41,10,85,104,889
14190,MIN,2017,Shabazz Muhammad,24,78,1,1516,288,598,.482,49,145,.338,239,453,.528,.523,147,190,.774,84,136,220,35,22,6,56,86,772
14191,MIN,2017,Kris Dunn,22,78,7,1333,118,313,.377,21,73,.288,97,240,.404,.411,36,59,.610,24,142,166,188,78,36,89,178,293
14192,MIN,2017,Nemanja Bjelica,28,65,1,1190,151,356,.424,56,177,.316,95,179,.531,.503,45,61,.738,57,187,244,79,40,20,59,154,403
14193,MIN,2017,Brandon Rush,31,47,33,1030,70,187,.374,44,114,.386,26,73,.356,.492,13,18,.722,16,83,99,45,22,23,28,42,197
14194,MIN,2017,Tyus Jones,20,60,0,774,75,181,.414,26,73,.356,49,108,.454,.486,33,43,.767,10,57,67,156,48,5,38,50,209
14195,MIN,2017,Cole Aldrich,28,62,0,531,45,86,.523,0,0,,45,86,.523,.523,15,22,.682,51,107,158,25,25,23,17,85,105
14196,MIN,2017,Omri Casspi,28,13,0,222,19,38,.500,2,10,.200,17,28,.607,.526,5,8,.625,6,14,20,11,13,2,10,24,45
14197,MIN,2017,Adreian Payne,25,18,0,135,23,54,.426,3,15,.200,20,39,.513,.454,14,19,.737,9,24,33,7,8,7,8,32,63
14198,MIN,2017,Lance Stephenson,26,6,0,67,10,21,.476,0,2,.000,10,19,.526,.476,1,2,.500,0,10,10,5,0,0,4,2,21
14199,MIN,2017,Jordan Hill,29,7,0,47,5,13,.385,0,0,,5,13,.385,.385,2,2,1.000,8,6,14,0,1,0,4,9,12
14200,MIN,2017,John Lucas III,34,5,0,11,1,4,.250,0,1,.000,1,3,.333,.250,0,0,,0,0,0,1,2,0,0,0,2
14201,MIN,2016,Andrew Wiggins,20,81,81,2845,594,1294,.459,57,190,.300,537,1104,.486,.481,430,565,.761,105,186,291,164,78,46,182,165,1675
14202,MIN,2016,Karl-Anthony Towns,20,82,82,2627,625,1153,.542,30,88,.341,595,1065,.559,.555,223,275,.811,229,629,858,161,58,138,183,245,1503
14203,MIN,2016,Ricky Rubio,25,76,76,2323,219,586,.374,62,190,.326,157,396,.396,.427,266,314,.847,40,286,326,658,162,10,193,201,766
14204,MIN,2016,Zach LaVine,20,82,33,2294,433,959,.452,123,316,.389,310,643,.482,.516,161,203,.793,27,201,228,251,69,17,155,193,1150
14205,MIN,2016,Gorgui Dieng,26,82,39,2220,308,579,.532,6,20,.300,302,559,.540,.537,205,248,.827,157,428,585,143,94,96,140,219,827
14206,MIN,2016,Shabazz Muhammad,23,82,0,1682,317,681,.465,44,152,.289,273,529,.516,.498,185,242,.764,100,167,267,52,24,7,70,94,863
14207,MIN,2016,Tayshaun Prince,35,77,44,1462,102,229,.445,4,23,.174,98,206,.476,.454,13,19,.684,32,115,147,73,36,13,27,62,221
14208,MIN,2016,Nemanja Bjelica,27,60,0,1075,110,235,.468,48,125,.384,62,110,.564,.570,40,55,.727,49,161,210,83,26,21,47,154,308
14209,MIN,2016,Kevin Martin,32,39,12,834,126,334,.377,38,103,.369,88,231,.381,.434,125,142,.880,10,71,81,46,17,1,41,68,415
14210,MIN,2016,Tyus Jones,19,37,0,573,56,156,.359,16,53,.302,40,103,.388,.410,28,39,.718,7,40,47,108,31,3,33,33,156
14211,MIN,2016,Kevin Garnett,39,38,38,556,54,115,.470,0,1,.000,54,114,.474,.470,14,21,.667,15,135,150,62,28,10,16,70,122
14212,MIN,2016,Adreian Payne,24,52,2,486,53,145,.366,9,32,.281,44,113,.389,.397,17,26,.654,20,91,111,29,16,11,36,77,132
14213,MIN,2016,Andre Miller,39,26,0,280,36,58,.621,1,4,.250,35,54,.648,.629,15,19,.789,6,18,24,58,9,0,25,32,88
14214,MIN,2016,Damjan Rudež,29,33,0,277,25,62,.403,17,50,.340,8,12,.667,.540,8,8,1.000,5,15,20,11,3,1,13,33,75
14215,MIN,2016,Greg Smith,25,18,0,192,18,32,.563,0,0,,18,32,.563,.563,7,17,.412,12,30,42,6,4,1,7,28,43
14216,MIN,2016,Nikola Peković,30,12,3,156,19,50,.380,0,0,,19,50,.380,.380,16,20,.800,7,14,21,11,1,0,9,22,54
14217,MIN,2015,Andrew Wiggins,19,82,82,2969,497,1137,.437,39,126,.310,458,1011,.453,.454,354,466,.760,134,240,374,170,86,50,177,190,1387
14218,MIN,2015,Gorgui Dieng,25,73,49,2193,259,512,.506,1,6,.167,258,506,.510,.507,191,244,.783,223,386,609,146,71,126,126,188,710
14219,MIN,2015,Zach LaVine,19,77,40,1902,286,677,.422,57,167,.341,229,510,.449,.465,149,177,.842,27,187,214,276,54,10,193,158,778
14220,MIN,2015,Thaddeus Young,26,48,48,1605,289,641,.451,19,65,.292,270,576,.469,.466,88,129,.682,75,170,245,135,86,17,75,115,685
14221,MIN,2015,Kevin Martin,31,39,36,1302,267,625,.427,75,191,.393,192,434,.442,.487,170,193,.881,19,123,142,89,33,1,76,76,779
14222,MIN,2015,Chase Budinger,26,67,4,1286,169,390,.433,52,143,.364,117,247,.474,.500,67,81,.827,33,165,198,64,44,10,49,72,457
14223,MIN,2015,Mo Williams,32,41,19,1149,180,447,.403,59,170,.347,121,277,.437,.469,80,94,.851,13,85,98,261,30,8,102,103,499
14224,MIN,2015,Anthony Bennett,21,57,3,894,125,297,.421,7,23,.304,118,274,.431,.433,41,64,.641,52,164,216,48,27,16,36,87,298
14225,MIN,2015,Shabazz Muhammad,22,38,13,866,194,397,.489,20,51,.392,174,346,.503,.514,104,145,.717,63,91,154,44,18,7,35,49,512
14226,MIN,2015,Nikola Peković,29,31,29,815,139,328,.424,0,0,,139,328,.424,.424,108,129,.837,89,145,234,27,19,12,42,59,386
14227,MIN,2015,Robbie Hummel,25,45,4,742,79,172,.459,16,51,.314,63,121,.521,.506,24,29,.828,31,103,134,27,16,9,18,86,198
14228,MIN,2015,Adreian Payne,23,29,22,720,89,213,.418,1,8,.125,88,205,.429,.420,29,44,.659,47,111,158,30,18,9,44,84,208
14229,MIN,2015,Ricky Rubio,24,22,22,692,78,219,.356,13,51,.255,65,168,.387,.386,57,71,.803,19,106,125,193,38,1,64,59,226
14230,MIN,2015,Corey Brewer,28,24,16,680,94,225,.418,8,41,.195,86,184,.467,.436,55,78,.705,32,62,94,78,54,4,50,62,251
14231,MIN,2015,Lorenzo Brown,24,29,7,549,52,122,.426,6,28,.214,46,94,.489,.451,12,19,.632,14,56,70,90,28,6,30,49,122
14232,MIN,2015,Justin Hamilton,24,17,9,423,58,113,.513,4,12,.333,54,101,.535,.531,33,40,.825,33,53,86,24,19,25,18,37,153
14233,MIN,2015,Gary Neal,30,11,1,262,45,105,.429,11,31,.355,34,74,.459,.481,29,33,.879,0,35,35,20,7,0,10,18,130
14234,MIN,2015,Jeff Adrien,28,17,0,215,19,44,.432,0,0,,19,44,.432,.432,22,38,.579,23,54,77,15,4,9,9,30,60
14235,MIN,2015,Troy Daniels,23,19,0,154,19,59,.322,13,39,.333,6,20,.300,.432,2,2,1.000,6,13,19,13,3,0,8,14,53
14236,MIN,2015,Glenn Robinson III,21,25,0,108,8,24,.333,1,6,.167,7,18,.389,.354,12,16,.750,4,10,14,3,3,0,3,5,29
14237,MIN,2015,Kevin Garnett,38,5,5,98,18,31,.581,0,1,.000,18,30,.600,.581,2,4,.500,2,24,26,8,5,4,1,13,38
14238,MIN,2015,Sean Kilpatrick,25,4,0,72,7,20,.350,4,13,.308,3,7,.429,.450,4,4,1.000,1,5,6,4,3,0,2,3,22
14239,MIN,2015,Arinze Onuaku,27,6,1,68,12,14,.857,0,0,,12,14,.857,.857,3,8,.375,7,14,21,4,1,3,2,6,27
14240,MIN,2015,Miroslav Raduljica,27,5,0,23,3,8,.375,0,0,,3,8,.375,.375,2,2,1.000,2,3,5,0,1,0,2,8,8
14241,MIN,2015,Ronny Turiaf,32,2,0,19,0,0,,0,0,,0,0,,,0,0,,0,1,1,2,0,0,0,0,0
14242,MIN,2014,Kevin Love,25,77,77,2797,650,1421,.457,190,505,.376,460,916,.502,.524,520,633,.821,224,739,963,341,59,35,196,136,2010
14243,MIN,2014,Ricky Rubio,23,82,82,2638,255,670,.381,44,133,.331,211,537,.393,.413,227,283,.802,61,281,342,704,191,11,221,218,781
14244,MIN,2014,Corey Brewer,27,81,81,2609,388,807,.481,59,211,.280,329,596,.552,.517,163,227,.718,63,144,207,135,151,30,105,210,998
14245,MIN,2014,Kevin Martin,30,68,68,2177,440,1023,.430,115,297,.387,325,726,.448,.486,303,340,.891,34,169,203,121,66,6,106,123,1298
14246,MIN,2014,Nikola Peković,28,54,54,1663,379,701,.541,0,0,,379,701,.541,.541,186,249,.747,206,262,468,50,30,23,84,129,944
14247,MIN,2014,Dante Cunningham,26,81,7,1635,236,509,.464,0,5,.000,236,504,.468,.464,38,67,.567,112,218,330,83,62,58,42,146,510
14248,MIN,2014,J.J. Barea,29,79,1,1471,254,656,.387,73,231,.316,181,425,.426,.443,79,100,.790,16,138,154,303,26,0,125,129,660
14249,MIN,2014,Gorgui Dieng,24,60,15,818,113,227,.498,1,1,1.000,112,226,.496,.500,59,93,.634,103,197,300,39,30,50,54,108,286
14250,MIN,2014,Luc Mbah a Moute,27,55,2,807,72,161,.447,3,14,.214,69,147,.469,.457,37,54,.685,47,72,119,21,21,9,36,50,184
14251,MIN,2014,Chase Budinger,25,41,8,751,100,254,.394,42,120,.350,58,134,.433,.476,32,39,.821,19,84,103,31,19,2,24,58,274
14252,MIN,2014,Alexey Shved,25,63,0,664,76,237,.321,30,102,.294,46,135,.341,.384,68,90,.756,21,60,81,68,26,16,48,36,250
14253,MIN,2014,Robbie Hummel,24,53,5,655,67,177,.379,32,89,.360,35,88,.398,.469,15,16,.938,35,97,132,23,16,2,10,57,181
14254,MIN,2014,Ronny Turiaf,31,31,10,606,64,107,.598,0,0,,64,107,.598,.598,21,50,.420,55,119,174,24,8,50,24,65,149
14255,MIN,2014,Shabazz Muhammad,21,37,0,290,57,124,.460,3,11,.273,54,113,.478,.472,26,40,.650,24,29,53,6,8,1,16,24,143
14256,MIN,2014,Derrick Williams,22,11,0,162,19,54,.352,2,15,.133,17,39,.436,.370,14,16,.875,3,23,26,1,4,4,6,9,54
14257,MIN,2014,A.J. Price,27,28,0,99,19,46,.413,6,22,.273,13,24,.542,.478,0,2,.000,1,9,10,13,1,0,7,5,44
14258,MIN,2014,Othyus Jeffers,28,2,0,13,0,1,.000,0,1,.000,0,0,,.000,2,2,1.000,0,3,3,0,0,0,1,1,2
14259,MIN,2013,Luke Ridnour,31,82,82,2474,367,811,.453,66,212,.311,301,599,.503,.493,139,164,.848,41,165,206,311,82,15,130,187,939
14260,MIN,2013,Andrei Kirilenko,31,64,64,2034,284,560,.507,35,120,.292,249,440,.566,.538,188,250,.752,102,260,362,177,96,62,119,82,791
14261,MIN,2013,Dante Cunningham,25,80,9,2010,314,671,.468,0,6,.000,314,665,.472,.468,67,103,.650,142,266,408,67,84,38,56,153,695
14262,MIN,2013,Nikola Peković,27,62,62,1959,385,741,.520,0,0,,385,741,.520,.520,241,324,.744,230,315,545,53,43,50,101,143,1011
14263,MIN,2013,Derrick Williams,21,78,56,1916,338,786,.430,65,196,.332,273,590,.463,.471,192,272,.706,96,334,430,46,44,37,101,127,933
14264,MIN,2013,Alexey Shved,24,77,16,1840,236,635,.372,85,288,.295,151,347,.435,.439,108,150,.720,41,134,175,286,54,27,147,117,665
14265,MIN,2013,J.J. Barea,28,74,2,1713,316,758,.417,97,280,.346,219,478,.458,.481,105,134,.784,34,173,207,294,32,0,145,131,834
14266,MIN,2013,Ricky Rubio,22,57,47,1691,185,514,.360,27,92,.293,158,422,.374,.386,211,264,.799,44,185,229,418,137,5,172,143,608
14267,MIN,2013,Greg Stiemsma,27,76,19,1209,127,278,.457,0,0,,127,278,.457,.457,53,69,.768,61,200,261,30,44,90,59,184,307
14268,MIN,2013,Mickaël Gelabale,29,36,13,644,72,139,.518,16,52,.308,56,87,.644,.576,21,24,.875,32,67,99,26,16,4,16,47,181
14269,MIN,2013,Kevin Love,24,18,18,618,105,298,.352,20,92,.217,85,206,.413,.386,100,142,.704,64,188,252,42,13,9,39,34,330
14270,MIN,2013,Chase Budinger,24,23,1,508,79,191,.414,26,81,.321,53,110,.482,.482,32,42,.762,15,56,71,25,14,7,23,29,216
14271,MIN,2013,Malcolm Lee,22,16,12,289,29,76,.382,8,24,.333,21,52,.404,.434,12,20,.600,15,24,39,20,12,6,10,30,78
14272,MIN,2013,Chris Johnson,27,30,0,284,48,75,.640,0,0,,48,75,.640,.640,21,34,.618,20,40,60,8,7,28,13,49,117
14273,MIN,2013,Josh Howard,32,11,4,207,31,77,.403,5,16,.313,26,61,.426,.435,7,12,.583,9,27,36,4,10,3,10,18,74
14274,MIN,2013,Lou Amundson,30,20,0,161,14,38,.368,0,0,,14,38,.368,.368,4,20,.200,23,24,47,3,7,6,11,26,32
14275,MIN,2013,Brandon Roy,28,5,5,122,11,35,.314,0,9,.000,11,26,.423,.314,7,10,.700,3,11,14,23,3,0,7,5,29
14276,MIN,2013,Lazar Hayward,26,4,0,31,2,10,.200,0,4,.000,2,6,.333,.200,6,6,1.000,0,4,4,3,2,0,0,3,10
14277,MIN,2013,Will Conroy,30,4,0,20,0,9,.000,0,3,.000,0,6,.000,.000,1,2,.500,1,0,1,0,0,0,0,1,1
14278,MIN,2012,Kevin Love,23,55,55,2145,474,1059,.448,105,282,.372,369,777,.475,.497,379,460,.824,226,508,734,111,47,28,128,152,1432
14279,MIN,2012,Luke Ridnour,30,53,53,1750,242,550,.440,49,152,.322,193,398,.485,.485,106,119,.891,19,122,141,252,56,16,96,136,639
14280,MIN,2012,Wesley Johnson,24,65,64,1469,158,397,.398,53,169,.314,105,228,.461,.465,24,34,.706,24,153,177,59,35,48,60,115,393
14281,MIN,2012,Derrick Williams,20,66,15,1418,205,498,.412,37,138,.268,168,360,.467,.449,136,195,.697,77,234,311,38,30,31,77,95,583
14282,MIN,2012,Ricky Rubio,21,41,31,1404,139,389,.357,32,94,.340,107,295,.363,.398,126,157,.803,21,150,171,336,91,8,131,97,436
14283,MIN,2012,Nikola Peković,26,47,35,1264,256,454,.564,0,0,,256,454,.564,.564,139,187,.743,181,165,346,31,29,31,87,98,651
14284,MIN,2012,Martell Webster,25,47,26,1140,115,272,.423,37,109,.339,78,163,.479,.491,57,72,.792,42,126,168,40,31,17,46,86,324
14285,MIN,2012,Michael Beasley,23,47,7,1087,221,497,.445,38,101,.376,183,396,.462,.483,61,95,.642,39,168,207,45,18,19,80,83,541
14286,MIN,2012,J.J. Barea,27,41,11,1032,167,418,.400,53,143,.371,114,275,.415,.463,76,98,.776,14,100,114,232,21,0,103,61,463
14287,MIN,2012,Wayne Ellington,24,51,4,973,122,302,.404,35,108,.324,87,194,.448,.462,32,40,.800,14,85,99,33,26,10,26,56,311
14288,MIN,2012,Anthony Tolliver,26,51,0,882,71,182,.390,25,101,.248,46,81,.568,.459,41,55,.745,50,103,153,22,18,19,35,86,208
14289,MIN,2012,Anthony Randolph,22,34,5,517,94,200,.470,0,1,.000,94,199,.472,.470,64,84,.762,42,81,123,19,13,35,40,56,252
14290,MIN,2012,Darko Miličić,26,29,23,472,59,130,.454,0,0,,59,130,.454,.454,16,37,.432,35,62,97,17,9,25,32,59,134
14291,MIN,2012,Malcolm Lee,21,19,0,243,23,59,.390,2,10,.200,21,49,.429,.407,14,17,.824,9,17,26,31,8,4,17,22,62
14292,MIN,2012,Brad Miller,35,15,1,146,9,27,.333,7,15,.467,2,12,.167,.463,10,12,.833,4,15,19,24,4,2,12,10,35
14293,MIN,2011,Kevin Love,22,73,73,2611,482,1026,.470,88,211,.417,394,815,.483,.513,424,499,.850,330,782,1112,184,45,28,155,148,1476
14294,MIN,2011,Michael Beasley,22,73,73,2361,561,1246,.450,60,164,.366,501,1082,.463,.474,219,291,.753,118,291,409,158,54,52,195,222,1401
14295,MIN,2011,Luke Ridnour,29,71,66,2159,319,681,.468,81,184,.440,238,497,.479,.528,121,137,.883,37,162,199,384,89,10,158,146,840
14296,MIN,2011,Wesley Johnson,23,79,63,2069,271,682,.397,103,289,.356,168,393,.427,.473,64,92,.696,51,189,240,148,58,54,95,163,709
14297,MIN,2011,Darko Miličić,25,69,69,1686,271,578,.469,0,0,,271,578,.469,.469,64,115,.557,133,227,360,104,54,140,151,229,606
14298,MIN,2011,Corey Brewer,24,56,22,1362,168,437,.384,26,99,.263,142,338,.420,.414,121,171,.708,45,107,152,77,89,14,77,134,483
14299,MIN,2011,Anthony Tolliver,25,65,4,1362,141,313,.450,47,115,.409,94,198,.475,.526,105,131,.802,92,203,295,82,28,28,49,145,434
14300,MIN,2011,Wayne Ellington,23,62,8,1181,160,397,.403,48,121,.397,112,276,.406,.463,42,53,.792,26,82,108,72,28,3,53,85,410
14301,MIN,2011,Martell Webster,24,46,1,1094,152,340,.447,55,132,.417,97,208,.466,.528,94,122,.770,36,111,147,53,28,9,58,101,453
14302,MIN,2011,Jonny Flynn,21,53,8,983,108,296,.365,31,100,.310,77,196,.393,.417,32,42,.762,12,65,77,182,34,3,113,58,279
14303,MIN,2011,Nikola Peković,25,65,11,887,136,263,.517,0,0,,136,263,.517,.517,87,114,.763,90,103,193,27,18,35,91,181,359
14304,MIN,2011,Sebastian Telfair,25,37,8,711,97,241,.402,28,78,.359,69,163,.423,.461,44,60,.733,17,37,54,111,25,3,64,64,266
14305,MIN,2011,Anthony Randolph,21,23,3,463,109,219,.498,0,0,,109,219,.498,.498,52,74,.703,32,88,120,26,18,16,43,47,270
14306,MIN,2011,Lazar Hayward,24,42,0,419,55,154,.357,17,60,.283,38,94,.404,.412,33,42,.786,23,47,70,28,12,7,19,44,160
14307,MIN,2011,Kosta Koufos,21,39,1,336,47,108,.435,0,2,.000,47,106,.443,.435,12,24,.500,42,55,97,7,8,20,25,50,106
14308,MIN,2011,Sundiata Gaines,24,8,0,65,7,22,.318,2,6,.333,5,16,.313,.364,5,10,.500,1,5,6,6,3,0,6,4,21
14309,MIN,2011,Maurice Ager,26,4,0,29,6,11,.545,3,4,.750,3,7,.429,.682,0,0,,0,2,2,1,1,0,4,4,15
14310,MIN,2010,Corey Brewer,23,82,82,2482,409,949,.431,82,237,.346,327,712,.459,.474,166,256,.648,70,209,279,193,117,29,164,224,1066
14311,MIN,2010,Al Jefferson,25,76,76,2463,560,1125,.498,0,4,.000,560,1121,.500,.498,181,266,.680,180,523,703,137,63,98,136,205,1301
14312,MIN,2010,Jonny Flynn,20,81,81,2339,397,952,.417,77,215,.358,320,737,.434,.457,223,270,.826,24,167,191,356,82,2,233,98,1094
14313,MIN,2010,Ryan Gomes,27,76,64,2210,327,732,.447,74,199,.372,253,533,.475,.497,104,126,.825,76,272,348,124,62,16,95,155,832
14314,MIN,2010,Ramon Sessions,23,82,1,1732,253,555,.456,1,15,.067,252,540,.467,.457,167,233,.717,58,156,214,258,55,5,137,137,674
14315,MIN,2010,Kevin Love,21,60,22,1714,291,646,.450,35,106,.330,256,540,.474,.478,225,276,.815,227,431,658,136,43,23,117,136,842
14316,MIN,2010,Damien Wilkins,30,80,31,1585,165,381,.433,18,61,.295,147,320,.459,.457,103,129,.798,72,177,249,135,66,25,76,144,451
14317,MIN,2010,Wayne Ellington,22,76,1,1384,190,448,.424,64,162,.395,126,286,.441,.496,61,70,.871,33,126,159,74,20,5,74,72,505
14318,MIN,2010,Ryan Hollins,25,73,27,1223,169,303,.558,0,1,.000,169,302,.560,.558,109,158,.690,79,128,207,51,19,38,95,199,447
14319,MIN,2010,Sasha Pavlović,26,71,0,877,109,300,.363,35,118,.297,74,182,.407,.422,10,26,.385,12,105,117,58,23,6,53,84,263
14320,MIN,2010,Darko Miličić,24,24,18,614,92,187,.492,0,1,.000,92,186,.495,.492,15,28,.536,42,91,133,43,18,33,33,75,199
14321,MIN,2010,Oleksiy Pecherov,24,44,5,447,77,188,.410,14,52,.269,63,136,.463,.447,29,32,.906,32,92,124,11,9,14,32,55,197
14322,MIN,2010,Nathan Jawai,23,39,2,412,49,111,.441,0,1,.000,49,110,.445,.441,26,38,.684,49,55,104,24,10,9,27,58,124
14323,MIN,2010,Brian Cardinal,32,29,0,267,14,36,.389,3,9,.333,11,27,.407,.431,17,18,.944,7,22,29,24,9,3,7,56,48
14324,MIN,2010,Alando Tucker,25,4,0,25,4,9,.444,0,0,,4,9,.444,.444,0,0,,1,2,3,1,0,0,1,1,8
14325,MIN,2010,Jason Hart,31,1,0,5,0,1,.000,0,0,,0,1,.000,.000,0,0,,0,0,0,1,1,0,0,0,0
14326,MIN,2009,Ryan Gomes,26,82,76,2614,420,974,.431,106,285,.372,314,689,.456,.486,146,181,.807,106,286,392,135,63,22,128,183,1092
14327,MIN,2009,Randy Foye,25,70,61,2494,399,981,.407,111,308,.360,288,673,.428,.463,230,272,.846,34,180,214,303,72,26,150,201,1139
14328,MIN,2009,Mike Miller,28,73,47,2356,264,548,.482,85,225,.378,179,323,.554,.559,109,149,.732,73,410,483,326,30,31,145,139,722
14329,MIN,2009,Sebastian Telfair,23,75,43,2095,267,697,.383,73,211,.346,194,486,.399,.435,131,160,.819,32,95,127,343,73,12,146,184,738
14330,MIN,2009,Kevin Love,20,81,37,2048,316,688,.459,2,19,.105,314,669,.469,.461,265,336,.789,274,460,734,84,35,50,118,205,899
14331,MIN,2009,Al Jefferson,24,50,50,1836,485,975,.497,0,4,.000,485,971,.499,.497,186,252,.738,172,376,548,79,39,83,92,141,1156
14332,MIN,2009,Craig Smith,25,74,31,1460,289,514,.562,0,1,.000,289,513,.563,.562,168,248,.677,98,186,284,79,31,19,105,184,746
14333,MIN,2009,Rodney Carney,24,67,6,1199,176,423,.416,79,226,.350,97,197,.492,.509,50,66,.758,36,90,126,26,45,29,43,94,481
14334,MIN,2009,Brian Cardinal,31,64,4,909,65,169,.385,30,92,.326,35,77,.455,.473,30,35,.857,39,103,142,76,37,13,48,135,190
14335,MIN,2009,Kevin Ollie,36,50,21,850,61,150,.407,0,1,.000,61,149,.409,.407,80,96,.833,13,62,75,117,19,4,34,79,202
14336,MIN,2009,Rashad McCants,24,34,2,636,105,292,.360,38,119,.319,67,173,.387,.425,60,81,.741,11,52,63,32,27,6,45,63,308
14337,MIN,2009,Jason Collins,30,31,22,422,22,70,.314,0,0,,22,70,.314,.314,13,28,.464,28,42,70,11,9,13,12,73,57
14338,MIN,2009,Corey Brewer,22,15,8,307,37,90,.411,5,12,.417,32,78,.410,.439,14,19,.737,18,31,49,25,15,3,13,37,93
14339,MIN,2009,Bobby Brown,24,21,1,256,47,113,.416,14,36,.389,33,77,.429,.478,8,9,.889,6,10,16,30,6,2,16,21,116
14340,MIN,2009,Shelden Williams,25,15,0,207,30,68,.441,0,0,,30,68,.441,.441,14,21,.667,24,51,75,4,10,8,8,28,74
14341,MIN,2009,Mark Madsen,33,19,1,116,3,14,.214,0,0,,3,14,.214,.214,0,4,.000,10,8,18,4,1,1,3,18,6
14342,MIN,2009,Calvin Booth,32,1,0,1,0,0,,0,0,,0,0,,,0,0,,1,0,1,0,0,0,0,0,0
14343,MIN,2008,Al Jefferson,23,82,82,2919,721,1441,.500,0,5,.000,721,1436,.502,.500,284,394,.721,308,603,911,117,74,119,167,222,1726
14344,MIN,2008,Ryan Gomes,25,82,74,2434,392,857,.457,59,179,.330,333,678,.491,.492,190,229,.830,133,342,475,145,65,10,96,154,1033
14345,MIN,2008,Marko Jarić,29,75,56,2189,227,528,.430,46,127,.362,181,401,.451,.473,121,163,.742,38,184,222,311,97,32,128,180,621
14346,MIN,2008,Rashad McCants,23,75,24,2020,428,944,.453,142,349,.407,286,595,.481,.529,116,155,.748,50,156,206,162,66,18,172,234,1114
14347,MIN,2008,Sebastian Telfair,22,60,51,1933,223,556,.401,32,114,.281,191,442,.432,.430,78,105,.743,16,119,135,355,59,11,111,171,556
14348,MIN,2008,Corey Brewer,21,79,35,1803,182,486,.374,7,36,.194,175,450,.389,.382,88,110,.800,82,210,292,111,76,25,89,188,459
14349,MIN,2008,Craig Smith,24,77,11,1547,297,528,.563,0,9,.000,297,519,.572,.563,133,200,.665,123,230,353,60,36,17,89,217,727
14350,MIN,2008,Randy Foye,24,39,31,1259,198,462,.429,61,148,.412,137,314,.436,.495,53,65,.815,13,115,128,164,36,3,79,102,510
14351,MIN,2008,Antoine Walker,31,46,1,892,136,375,.363,61,188,.324,75,187,.401,.444,35,66,.530,56,112,168,45,33,8,46,80,368
14352,MIN,2008,Kirk Snyder,24,27,18,680,83,161,.516,3,14,.214,80,147,.544,.525,58,77,.753,25,89,114,56,19,14,48,49,227
14353,MIN,2008,Chris Richard,23,52,3,556,41,87,.471,0,0,,41,87,.471,.471,16,27,.593,52,83,135,18,10,12,24,83,98
14354,MIN,2008,Greg Buckner,31,31,4,520,45,117,.385,15,50,.300,30,67,.448,.449,19,22,.864,10,55,65,39,21,2,29,63,124
14355,MIN,2008,Gerald Green,22,29,0,358,49,148,.331,15,39,.385,34,109,.312,.382,34,41,.829,11,51,62,29,8,4,32,43,147
14356,MIN,2008,Michael Doleac,30,24,8,257,28,63,.444,0,0,,28,63,.444,.444,1,2,.500,16,33,49,7,10,10,12,44,57
14357,MIN,2008,Theo Ratliff,34,10,6,214,23,45,.511,0,1,.000,23,44,.523,.511,17,25,.680,13,26,39,7,3,19,12,30,63
14358,MIN,2008,Mark Madsen,32,20,6,151,3,19,.158,0,0,,3,19,.158,.158,3,12,.250,18,20,38,4,3,2,9,25,9
14359,MIN,2007,Ricky Davis,27,81,81,3021,506,1089,.465,123,310,.397,383,779,.492,.521,239,285,.839,54,261,315,385,80,23,210,189,1374
14360,MIN,2007,Kevin Garnett,30,76,76,2995,638,1341,.476,12,56,.214,626,1285,.487,.480,416,498,.835,183,792,975,313,89,126,205,184,1704
14361,MIN,2007,Mark Blount,31,82,81,2544,427,839,.509,9,31,.290,418,808,.517,.514,147,195,.754,136,369,505,67,43,58,159,239,1010
14362,MIN,2007,Trenton Hassell,27,76,68,2223,217,443,.490,6,25,.240,211,418,.505,.497,72,92,.783,83,160,243,203,22,26,80,144,512
14363,MIN,2007,Mike James,31,82,65,2069,297,703,.422,80,215,.372,217,488,.445,.479,154,184,.837,25,138,163,297,55,7,129,171,828
14364,MIN,2007,Randy Foye,23,82,12,1879,300,691,.434,68,185,.368,232,506,.458,.483,164,192,.854,49,169,218,232,53,21,152,184,832
14365,MIN,2007,Marko Jarić,28,70,13,1555,136,325,.418,32,85,.376,104,240,.433,.468,67,88,.761,54,130,184,145,75,16,88,172,371
14366,MIN,2007,Craig Smith,23,82,5,1537,246,463,.531,0,6,.000,246,457,.538,.531,116,186,.624,149,267,416,49,51,18,74,223,608
14367,MIN,2007,Troy Hudson,30,34,6,554,74,195,.379,28,80,.350,46,115,.400,.451,26,32,.813,8,40,48,73,14,2,40,23,202
14368,MIN,2007,Rashad McCants,22,37,0,554,62,177,.350,20,75,.267,42,102,.412,.407,40,58,.690,14,33,47,38,26,7,40,71,184
14369,MIN,2007,Mark Madsen,31,56,0,473,23,43,.535,0,0,,23,43,.535,.535,15,29,.517,35,52,87,10,10,10,21,100,61
14370,MIN,2007,Justin Reed,25,41,3,318,40,107,.374,0,0,,40,107,.374,.374,26,30,.867,15,31,46,17,5,3,22,44,106
14371,MIN,2007,Bracey Wright,22,19,0,190,24,60,.400,6,20,.300,18,40,.450,.450,13,18,.722,7,14,21,15,9,1,6,6,67
14372,MIN,2007,Eddie Griffin,24,13,0,92,7,27,.259,0,1,.000,7,26,.269,.259,4,5,.800,7,18,25,4,0,7,6,8,18
14373,MIN,2006,Kevin Garnett,29,76,76,2957,626,1191,.526,8,30,.267,618,1161,.532,.529,396,489,.810,214,752,966,308,104,107,180,206,1656
14374,MIN,2006,Trenton Hassell,26,77,67,2514,286,616,.464,7,23,.304,279,593,.470,.470,131,176,.744,82,134,216,203,43,29,124,201,710
14375,MIN,2006,Marko Jarić,27,75,49,2102,226,566,.399,40,133,.301,186,433,.430,.435,95,138,.688,60,173,233,293,108,21,127,189,587
14376,MIN,2006,Wally Szczerbiak,28,40,40,1555,292,590,.495,58,143,.406,234,447,.523,.544,163,182,.896,36,154,190,112,21,15,86,90,805
14377,MIN,2006,Ricky Davis,26,36,36,1460,255,595,.429,33,117,.282,222,478,.464,.456,146,181,.807,25,139,164,173,42,8,98,99,689
14378,MIN,2006,Rashad McCants,21,79,12,1362,241,535,.450,67,180,.372,174,355,.490,.513,78,106,.736,29,114,143,63,44,22,86,176,627
14379,MIN,2006,Eddie Griffin,23,70,27,1359,130,370,.351,16,82,.195,114,288,.396,.373,44,74,.595,107,282,389,40,13,148,43,125,320
14380,MIN,2006,Marcus Banks,24,40,28,1228,186,388,.479,16,44,.364,170,344,.494,.500,91,117,.778,19,97,116,188,47,11,96,124,479
14381,MIN,2006,Mark Blount,30,42,30,1157,179,354,.506,0,0,,179,354,.506,.506,71,95,.747,60,143,203,33,25,40,74,147,429
14382,MIN,2006,Troy Hudson,29,36,0,800,127,333,.381,40,101,.396,87,232,.375,.441,48,52,.923,8,36,44,106,12,4,40,55,342
14383,MIN,2006,Michael Olowokandi,30,32,24,752,87,195,.446,0,0,,87,195,.446,.446,19,39,.487,45,134,179,17,19,27,41,100,193
14384,MIN,2006,Justin Reed,24,40,6,706,94,221,.425,0,1,.000,94,220,.427,.425,62,80,.775,40,55,95,34,18,11,37,118,250
14385,MIN,2006,Mark Madsen,30,62,7,676,27,66,.409,0,7,.000,27,59,.458,.409,20,47,.426,50,91,141,11,23,17,26,114,74
14386,MIN,2006,Anthony Carter,30,45,8,589,53,137,.387,4,15,.267,49,122,.402,.401,40,55,.727,9,53,62,101,24,9,40,71,150
14387,MIN,2006,Ronald Dupree,25,36,0,265,33,63,.524,0,1,.000,33,62,.532,.524,14,41,.341,21,28,49,14,12,0,14,44,80
14388,MIN,2006,Richie Frahm,28,25,0,225,24,65,.369,15,48,.313,9,17,.529,.485,3,5,.600,3,20,23,15,3,2,4,22,66
14389,MIN,2006,Bracey Wright,21,7,0,135,21,51,.412,6,17,.353,15,34,.441,.471,14,16,.875,3,15,18,5,1,0,8,8,62
14390,MIN,2006,Nikoloz Tskitishvili,22,5,0,13,1,4,.250,0,0,,1,4,.250,.250,1,2,.500,0,2,2,0,0,0,2,0,3
14391,MIN,2005,Kevin Garnett,28,82,82,3121,683,1360,.502,6,25,.240,677,1335,.507,.504,445,549,.811,247,861,1108,466,121,112,222,207,1817
14392,MIN,2005,Wally Szczerbiak,27,81,37,2558,465,919,.506,63,169,.373,402,750,.536,.540,260,304,.855,82,221,303,191,40,16,132,178,1253
14393,MIN,2005,Latrell Sprewell,34,80,79,2450,398,961,.414,69,211,.327,329,750,.439,.450,156,188,.830,65,189,254,179,53,21,127,124,1021
14394,MIN,2005,Trenton Hassell,25,82,51,2068,225,475,.474,1,11,.091,224,464,.483,.475,90,114,.789,80,139,219,128,30,30,64,200,541
14395,MIN,2005,Troy Hudson,28,79,32,1729,266,664,.401,89,258,.345,177,406,.436,.468,70,90,.778,19,86,105,283,27,6,113,121,691
14396,MIN,2005,Sam Cassell,35,59,38,1522,319,687,.464,27,103,.262,292,584,.500,.484,134,155,.865,25,132,157,301,36,14,109,160,799
14397,MIN,2005,Eddie Griffin,22,70,0,1492,202,522,.387,67,204,.328,135,318,.425,.451,56,78,.718,128,325,453,53,23,118,55,120,527
14398,MIN,2005,Fred Hoiberg,32,76,0,1272,139,284,.489,70,145,.483,69,139,.496,.613,89,102,.873,32,149,181,85,50,15,20,105,437
14399,MIN,2005,Michael Olowokandi,29,62,34,1215,161,353,.456,0,0,,161,353,.456,.456,46,69,.667,106,218,324,29,15,56,68,193,368
14400,MIN,2005,Anthony Carter,29,66,12,742,72,177,.407,2,17,.118,70,160,.438,.412,35,51,.686,12,57,69,161,35,18,62,88,181
14401,MIN,2005,Mark Madsen,29,41,14,601,34,66,.515,0,0,,34,66,.515,.515,20,40,.500,63,65,128,18,7,14,24,103,88
14402,MIN,2005,John Thomas,29,44,8,521,42,86,.488,0,0,,42,86,.488,.488,27,46,.587,39,58,97,17,15,13,18,82,111
14403,MIN,2005,Ervin Johnson,37,46,23,410,28,54,.519,1,1,1.000,27,53,.509,.528,16,25,.640,43,70,113,6,7,13,18,86,73
14404,MIN,2005,Ndudi Ebi,20,2,0,54,11,21,.524,0,1,.000,11,20,.550,.524,5,9,.556,6,10,16,1,1,1,3,7,27
14405,MIN,2004,Kevin Garnett,27,82,82,3231,804,1611,.499,11,43,.256,793,1568,.506,.502,368,465,.791,245,894,1139,409,120,178,212,202,1987
14406,MIN,2004,Latrell Sprewell,33,82,82,3100,518,1266,.409,99,299,.331,419,967,.433,.448,240,295,.814,56,254,310,286,88,21,158,101,1375
14407,MIN,2004,Sam Cassell,34,81,81,2838,620,1270,.488,74,186,.398,546,1084,.504,.517,289,331,.873,44,227,271,592,102,18,220,247,1603
14408,MIN,2004,Trenton Hassell,24,81,74,2264,177,381,.465,4,13,.308,173,368,.470,.470,48,61,.787,68,189,257,133,36,54,46,200,406
14409,MIN,2004,Fred Hoiberg,31,79,3,1804,178,383,.465,76,172,.442,102,211,.483,.564,98,116,.845,21,247,268,109,66,10,44,136,530
14410,MIN,2004,Mark Madsen,28,72,12,1246,101,204,.495,0,6,.000,101,198,.510,.495,57,118,.483,134,138,272,28,33,18,47,175,259
14411,MIN,2004,Gary Trent,29,68,2,1025,155,328,.473,0,6,.000,155,322,.481,.473,69,91,.758,83,133,216,49,12,17,54,129,379
14412,MIN,2004,Ervin Johnson,36,66,47,965,55,103,.534,0,1,.000,55,102,.539,.534,17,28,.607,61,171,232,24,27,43,30,156,127
14413,MIN,2004,Michael Olowokandi,28,43,25,925,121,285,.425,0,0,,121,285,.425,.425,36,61,.590,78,167,245,24,16,68,54,137,278
14414,MIN,2004,Wally Szczerbiak,26,28,0,622,106,236,.449,20,46,.435,86,190,.453,.492,53,64,.828,24,64,88,33,12,1,28,42,285
14415,MIN,2004,Oliver Miller,33,48,1,506,53,100,.530,0,1,.000,53,99,.535,.530,15,23,.652,46,84,130,36,19,26,33,91,121
14416,MIN,2004,Troy Hudson,27,29,1,503,80,207,.386,31,77,.403,49,130,.377,.461,27,33,.818,4,31,35,70,7,0,34,32,218
14417,MIN,2004,Keith McLeod,24,33,0,391,27,82,.329,1,10,.100,26,72,.361,.335,33,43,.767,5,29,34,59,16,1,29,39,88
14418,MIN,2004,Darrick Martin,32,16,0,172,20,67,.299,6,26,.231,14,41,.341,.343,9,9,1.000,2,5,7,23,2,1,7,23,55
14419,MIN,2004,Anthony Goldwire,32,5,0,66,5,14,.357,2,6,.333,3,8,.375,.429,1,1,1.000,1,5,6,10,3,0,2,5,13
14420,MIN,2004,Quincy Lewis,26,14,0,65,7,20,.350,2,5,.400,5,15,.333,.400,0,0,,1,6,7,2,2,2,3,10,16
14421,MIN,2004,Ndudi Ebi,19,17,0,32,6,14,.429,0,0,,6,14,.429,.429,1,4,.250,2,1,3,3,0,4,3,6,13
14422,MIN,2003,Kevin Garnett,26,82,82,3321,743,1481,.502,20,71,.282,723,1410,.513,.508,377,502,.751,244,858,1102,495,113,129,229,199,1883
14423,MIN,2003,Troy Hudson,26,79,74,2600,409,956,.428,97,266,.365,312,690,.452,.479,208,231,.900,42,141,183,452,60,7,182,160,1123
14424,MIN,2003,Rasho Nesterović,26,77,77,2337,400,762,.525,0,2,.000,400,760,.526,.525,61,95,.642,146,358,504,114,39,116,99,256,861
14425,MIN,2003,Anthony Peeler,33,82,39,2245,252,609,.414,87,212,.410,165,397,.416,.485,39,50,.780,40,201,241,244,72,13,82,161,630
14426,MIN,2003,Kendall Gill,34,82,34,2068,286,677,.422,19,59,.322,267,618,.432,.436,123,161,.764,51,197,248,156,78,15,108,176,714
14427,MIN,2003,Wally Szczerbiak,25,52,42,1836,351,729,.481,61,145,.421,290,584,.497,.523,150,173,.867,53,188,241,136,44,22,87,123,913
14428,MIN,2003,Gary Trent,28,80,22,1222,208,389,.535,0,2,.000,208,387,.537,.535,60,101,.594,106,185,291,77,32,23,59,142,476
14429,MIN,2003,Joe Smith,27,54,21,1117,151,328,.460,0,2,.000,151,326,.463,.460,102,131,.779,111,159,270,38,14,55,43,171,404
14430,MIN,2003,Marc Jackson,28,77,0,1041,153,349,.438,1,1,1.000,152,348,.437,.440,114,149,.765,86,139,225,37,24,30,59,137,421
14431,MIN,2003,Rod Strickland,36,47,8,956,120,278,.432,1,11,.091,119,267,.446,.433,79,107,.738,20,75,95,215,46,6,76,55,320
14432,MIN,2003,Loren Woods,24,38,11,353,29,76,.382,1,3,.333,28,73,.384,.388,21,27,.778,27,68,95,19,10,13,23,37,80
14433,MIN,2003,Mike Wilks,23,31,0,324,21,67,.313,4,18,.222,17,49,.347,.343,16,18,.889,11,19,30,50,11,3,12,31,62
14434,MIN,2003,Igor Rakočević,24,42,0,244,22,58,.379,5,12,.417,17,46,.370,.422,29,36,.806,4,13,17,33,4,0,23,25,78
14435,MIN,2003,Reggie Slater,32,26,0,141,27,50,.540,0,0,,27,50,.540,.540,27,45,.600,18,13,31,4,6,1,9,31,81
14436,MIN,2002,Kevin Garnett,25,81,81,3175,659,1401,.470,37,116,.319,622,1285,.484,.484,359,448,.801,243,738,981,422,96,126,229,184,1714
14437,MIN,2002,Wally Szczerbiak,24,82,82,3117,609,1200,.508,87,191,.455,522,1009,.517,.544,226,272,.831,120,271,391,257,66,21,181,188,1531
14438,MIN,2002,Chauncey Billups,25,82,54,2355,348,823,.423,124,315,.394,224,508,.441,.498,207,234,.885,35,191,226,450,66,17,138,169,1027
14439,MIN,2002,Rasho Nesterović,25,82,82,2218,324,657,.493,0,1,.000,324,656,.494,.493,39,71,.549,200,334,534,75,45,109,94,262,687
14440,MIN,2002,Anthony Peeler,32,82,0,2060,288,684,.421,111,283,.392,177,401,.441,.502,50,58,.862,37,169,206,177,61,11,76,137,737
14441,MIN,2002,Joe Smith,26,72,63,1922,297,581,.511,2,3,.667,295,578,.510,.513,171,206,.830,152,301,453,82,39,59,86,250,767
14442,MIN,2002,Gary Trent,27,64,10,1140,193,381,.507,0,2,.000,193,379,.509,.507,92,144,.639,104,166,270,60,21,27,58,160,478
14443,MIN,2002,Terrell Brandon,31,32,28,962,155,365,.425,4,23,.174,151,342,.442,.430,83,84,.988,17,76,93,264,52,6,43,49,397
14444,MIN,2002,Sam Mitchell,38,74,10,726,98,227,.432,10,35,.286,88,192,.458,.454,38,49,.776,18,64,82,45,12,4,26,79,244
14445,MIN,2002,Felipe López,27,67,0,581,59,156,.378,14,33,.424,45,123,.366,.423,37,55,.673,29,51,80,39,18,1,36,73,169
14446,MIN,2002,Loren Woods,23,60,0,516,33,96,.344,0,2,.000,33,94,.351,.344,44,60,.733,46,76,122,22,17,34,36,60,110
14447,MIN,2002,Marc Jackson,27,22,0,326,38,99,.384,0,1,.000,38,98,.388,.384,26,32,.813,31,54,85,7,6,3,18,44,102
14448,MIN,2002,William Avery,22,28,0,258,26,90,.289,6,35,.171,20,55,.364,.322,13,19,.684,4,20,24,36,7,0,19,17,71
14449,MIN,2002,Robert Pack,32,16,0,252,25,68,.368,1,4,.250,24,64,.375,.375,11,15,.733,7,16,23,49,13,0,20,32,62
14450,MIN,2002,Dean Garrett,35,29,0,152,14,40,.350,0,0,,14,40,.350,.350,0,3,.000,13,34,47,4,5,9,7,26,28
14451,MIN,2002,Maurice Evans,23,10,0,45,9,19,.474,0,3,.000,9,16,.563,.474,3,4,.750,3,1,4,4,0,0,2,9,21
14452,MIN,2001,Kevin Garnett,24,81,81,3202,704,1475,.477,19,66,.288,685,1409,.486,.484,357,467,.764,219,702,921,401,111,145,230,204,1784
14453,MIN,2001,Wally Szczerbiak,23,82,82,2856,469,920,.510,26,77,.338,443,843,.526,.524,181,208,.870,133,314,447,260,59,33,138,226,1145
14454,MIN,2001,Terrell Brandon,30,78,78,2821,511,1134,.451,33,91,.363,478,1043,.458,.465,195,224,.871,60,238,298,583,161,21,155,138,1250
14455,MIN,2001,Anthony Peeler,31,75,41,2126,308,732,.421,100,256,.391,208,476,.437,.489,75,87,.862,44,148,192,192,91,18,105,166,791
14456,MIN,2001,LaPhonso Ellis,30,82,5,1948,298,642,.464,7,22,.318,291,620,.469,.470,169,214,.790,199,295,494,93,67,74,108,290,772
14457,MIN,2001,Chauncey Billups,24,77,33,1790,248,587,.422,73,194,.376,175,393,.445,.485,144,171,.842,32,126,158,260,51,11,111,178,713
14458,MIN,2001,Rasho Nesterović,24,73,39,1233,147,319,.461,0,1,.000,147,318,.462,.461,34,65,.523,99,187,286,45,25,63,55,189,328
14459,MIN,2001,Sam Mitchell,37,82,4,983,118,289,.408,9,43,.209,109,246,.443,.424,40,55,.727,28,95,123,57,26,10,36,117,285
14460,MIN,2001,Dean Garrett,34,70,21,831,75,156,.481,0,0,,75,156,.481,.481,27,39,.692,65,152,217,24,26,49,25,93,177
14461,MIN,2001,Reggie Slater,30,55,16,686,90,175,.514,0,0,,90,175,.514,.514,74,110,.673,78,108,186,26,18,9,43,126,254
14462,MIN,2001,William Avery,21,55,0,463,55,144,.382,16,59,.271,39,85,.459,.438,28,36,.778,5,24,29,75,13,4,45,48,154
14463,MIN,2001,Felipe López,26,23,10,457,69,152,.454,13,23,.565,56,129,.434,.497,19,33,.576,25,49,74,34,21,12,27,46,170
14464,MIN,2001,Todd Day,31,31,0,345,44,118,.373,26,69,.377,18,49,.367,.483,18,23,.783,10,27,37,28,10,7,24,52,132
14465,MIN,2001,Sam Jacobson,25,14,0,59,9,18,.500,0,0,,9,18,.500,.500,2,3,.667,3,3,6,4,3,0,0,19,20
14466,MIN,2001,Tom Hammonds,33,7,0,30,3,10,.300,0,0,,3,10,.300,.300,1,2,.500,2,2,4,1,0,0,3,8,7
14467,MIN,2000,Kevin Garnett,23,81,81,3243,759,1526,.497,30,81,.370,729,1445,.504,.507,309,404,.765,223,733,956,401,120,126,268,205,1857
14468,MIN,2000,Terrell Brandon,29,71,71,2587,486,1042,.466,53,132,.402,433,910,.476,.492,187,208,.899,44,194,238,629,134,30,184,158,1212
14469,MIN,2000,Malik Sealy,29,82,61,2392,371,780,.476,10,35,.286,361,745,.485,.482,177,218,.812,119,233,352,197,76,19,110,197,929
14470,MIN,2000,Wally Szczerbiak,22,73,53,2171,342,669,.511,28,78,.359,314,591,.531,.532,133,161,.826,89,183,272,201,58,23,83,175,845
14471,MIN,2000,Anthony Peeler,30,82,22,2073,316,725,.436,85,255,.333,231,470,.491,.494,87,109,.798,58,174,232,195,62,10,85,171,804
14472,MIN,2000,Joe Smith,24,78,9,1975,289,623,.464,1,1,1.000,288,622,.463,.465,195,258,.756,186,298,484,88,45,85,119,302,774
14473,MIN,2000,Rasho Nesterović,23,82,55,1723,206,433,.476,0,2,.000,206,431,.478,.476,59,103,.573,135,244,379,93,21,85,71,262,471
14474,MIN,2000,Sam Mitchell,36,66,24,1227,168,376,.447,10,23,.435,158,353,.448,.460,81,92,.880,28,110,138,111,27,14,44,116,427
14475,MIN,2000,Bobby Jackson,26,73,10,1034,140,346,.405,13,46,.283,127,300,.423,.423,76,98,.776,50,103,153,172,48,7,58,114,369
14476,MIN,2000,Dean Garrett,33,56,23,604,48,108,.444,0,0,,48,108,.444,.444,18,26,.692,41,99,140,19,8,40,21,94,114
14477,MIN,2000,William Avery,20,59,1,484,56,181,.309,18,63,.286,38,118,.322,.359,24,36,.667,8,32,40,88,14,2,42,60,154
14478,MIN,2000,Tom Hammonds,32,56,0,372,42,97,.433,0,0,,42,97,.433,.433,33,56,.589,34,67,101,10,8,3,21,55,117
14479,MIN,2000,Andrae Patterson,24,5,0,20,3,4,.750,0,0,,3,4,.750,.750,0,0,,1,1,2,1,1,0,1,4,6
14480,MIN,1999,Kevin Garnett,22,47,47,1780,414,900,.460,4,14,.286,410,886,.463,.462,145,206,.704,166,323,489,202,78,83,135,152,977
14481,MIN,1999,Joe Smith,23,43,42,1418,223,522,.427,0,3,.000,223,519,.430,.427,142,188,.755,154,200,354,68,32,66,66,147,588
14482,MIN,1999,Sam Mitchell,35,50,20,1344,213,522,.408,9,38,.237,204,484,.421,.417,126,165,.764,55,127,182,98,35,16,34,111,561
14483,MIN,1999,Dean Garrett,32,49,37,1054,116,231,.502,0,0,,116,231,.502,.502,38,51,.745,99,158,257,28,30,45,29,113,270
14484,MIN,1999,Bobby Jackson,25,50,12,941,141,348,.405,10,27,.370,131,321,.408,.420,61,79,.772,43,92,135,167,39,3,75,75,353
14485,MIN,1999,Anthony Peeler,29,28,28,810,103,272,.379,34,114,.298,69,158,.437,.441,30,41,.732,30,54,84,78,35,6,38,60,270
14486,MIN,1999,Malik Sealy,28,31,7,731,95,231,.411,6,23,.261,89,208,.428,.424,55,61,.902,23,69,92,36,30,5,33,68,251
14487,MIN,1999,Tom Hammonds,31,49,0,716,82,179,.458,0,0,,82,179,.458,.458,48,75,.640,54,82,136,20,8,7,32,88,212
14488,MIN,1999,Terrell Brandon,28,21,20,712,127,299,.425,5,19,.263,122,280,.436,.433,39,47,.830,16,65,81,205,39,7,38,57,298
14489,MIN,1999,Stephon Marbury,21,18,18,661,124,304,.408,8,39,.205,116,265,.438,.421,63,87,.724,17,45,62,167,29,5,55,44,319
14490,MIN,1999,Dennis Scott,30,21,9,532,70,157,.446,29,68,.426,41,89,.461,.538,22,27,.815,5,33,38,32,12,2,14,32,191
14491,MIN,1999,Bill Curley,26,35,7,372,29,72,.403,1,5,.200,28,67,.418,.410,19,22,.864,20,31,51,14,17,9,10,83,78
14492,MIN,1999,Reggie Jordan,31,27,1,296,15,54,.278,0,0,,15,54,.278,.278,21,38,.553,27,32,59,41,12,5,14,38,51
14493,MIN,1999,Andrae Patterson,23,35,0,284,43,97,.443,0,5,.000,43,92,.467,.443,28,36,.778,30,35,65,15,19,7,22,62,114
14494,MIN,1999,James Robinson,28,17,0,226,28,87,.322,13,44,.295,15,43,.349,.397,8,14,.571,8,27,35,38,8,5,28,31,77
14495,MIN,1999,Chris Carr,24,11,2,81,9,26,.346,3,9,.333,6,17,.353,.404,2,4,.500,0,12,12,7,1,1,4,9,23
14496,MIN,1999,Rasho Nesterović,22,2,0,30,3,12,.250,0,0,,3,12,.250,.250,2,2,1.000,3,5,8,1,0,0,1,5,8
14497,MIN,1999,Brian Evans,25,5,0,24,2,10,.200,0,2,.000,2,8,.250,.200,0,0,,2,0,2,1,2,0,0,1,4
14498,MIN,1999,Paul Grant,25,4,0,8,1,4,.250,0,0,,1,4,.250,.250,0,0,,1,0,1,0,0,0,1,4,2
14499,MIN,1999,Trevor Winter,25,1,0,5,0,0,,0,0,,0,0,,,0,0,,1,2,3,0,0,0,0,5,0
14500,MIN,1998,Kevin Garnett,21,82,82,3222,635,1293,.491,3,16,.188,632,1277,.495,.492,245,332,.738,222,564,786,348,139,150,192,224,1518
14501,MIN,1998,Stephon Marbury,20,82,81,3112,513,1237,.415,95,304,.313,418,933,.448,.453,329,450,.731,58,172,230,704,104,7,256,222,1450
14502,MIN,1998,Sam Mitchell,34,81,33,2239,371,800,.464,15,43,.349,356,757,.470,.473,243,292,.832,118,267,385,107,64,22,66,200,1000
14503,MIN,1998,Terry Porter,34,82,8,1786,259,577,.449,92,233,.395,167,344,.485,.529,167,195,.856,37,131,168,271,63,16,104,103,777
14504,MIN,1998,Cherokee Parks,25,79,43,1703,224,449,.499,0,1,.000,224,448,.500,.499,110,169,.651,140,297,437,53,36,86,66,237,558
14505,MIN,1998,Tom Gugliotta,28,41,41,1582,319,635,.502,2,17,.118,317,618,.513,.504,183,223,.821,106,250,356,167,61,22,109,102,823
14506,MIN,1998,Stanley Roberts,27,74,44,1328,191,386,.495,0,0,,191,386,.495,.495,75,156,.481,109,254,363,27,24,72,70,226,457
14507,MIN,1998,Chris Carr,23,51,40,1165,190,452,.420,40,127,.315,150,325,.462,.465,84,99,.848,43,112,155,85,17,11,69,129,504
14508,MIN,1998,Tom Hammonds,30,57,2,1140,127,246,.516,0,1,.000,127,245,.518,.516,92,132,.697,100,171,271,36,15,17,48,127,346
14509,MIN,1998,Anthony Peeler,28,30,24,991,155,348,.445,48,106,.453,107,242,.442,.514,32,41,.780,31,72,103,114,52,6,45,81,390
14510,MIN,1998,Doug West,30,38,10,688,64,171,.374,0,2,.000,64,169,.379,.374,29,40,.725,23,59,82,45,11,5,21,97,157
14511,MIN,1998,Reggie Jordan,30,57,1,487,54,113,.478,0,1,.000,54,112,.482,.478,41,72,.569,57,40,97,50,35,9,30,63,149
14512,MIN,1998,Micheal Williams,31,25,0,161,16,48,.333,0,4,.000,16,44,.364,.333,32,33,.970,2,12,14,32,9,2,16,24,64
14513,MIN,1998,DeJuan Wheat,24,34,0,150,20,50,.400,8,17,.471,12,33,.364,.480,9,15,.600,3,8,11,25,6,1,9,12,57
14514,MIN,1998,Bill Curley,25,11,1,146,16,33,.485,0,1,.000,16,32,.500,.485,2,3,.667,11,17,28,4,3,1,3,28,34
14515,MIN,1998,Clifford Rozier,25,6,0,30,3,6,.500,0,0,,3,6,.500,.500,0,1,.000,3,3,6,0,0,0,4,7,6
14516,MIN,1997,Tom Gugliotta,27,81,81,3131,592,1339,.442,24,93,.258,568,1246,.456,.451,464,566,.820,187,515,702,335,130,89,293,237,1672
14517,MIN,1997,Kevin Garnett,20,77,77,2995,549,1100,.499,6,21,.286,543,1079,.503,.502,205,272,.754,190,428,618,236,105,163,175,199,1309
14518,MIN,1997,Stephon Marbury,19,67,64,2324,355,871,.408,102,288,.354,253,583,.434,.466,245,337,.727,54,130,184,522,67,19,210,159,1057
14519,MIN,1997,Sam Mitchell,33,82,5,2044,269,603,.446,4,25,.160,265,578,.458,.449,224,295,.759,112,214,326,79,51,20,93,232,766
14520,MIN,1997,Doug West,29,68,66,1920,226,484,.467,15,45,.333,211,439,.481,.482,64,94,.681,37,111,148,113,61,24,66,218,531
14521,MIN,1997,Dean Garrett,30,68,47,1665,223,389,.573,0,0,,223,389,.573,.573,96,138,.696,149,346,495,38,40,95,34,158,542
14522,MIN,1997,Terry Porter,33,82,20,1568,187,449,.416,67,200,.335,120,249,.482,.491,127,166,.765,31,145,176,295,54,11,128,104,568
14523,MIN,1997,James Robinson,26,69,5,1309,196,482,.407,102,267,.382,94,215,.437,.512,78,114,.684,24,88,112,126,30,8,69,125,572
14524,MIN,1997,Cherokee Parks,24,76,0,961,103,202,.510,0,1,.000,103,201,.512,.510,46,76,.605,83,112,195,34,41,48,32,150,252
14525,MIN,1997,Chris Carr,22,55,10,830,125,271,.461,31,88,.352,94,183,.514,.518,56,73,.767,31,82,113,48,24,10,37,93,337
14526,MIN,1997,Stojko Vranković,33,53,35,766,78,139,.561,0,0,,78,139,.561,.561,25,37,.676,57,111,168,14,10,67,52,121,181
14527,MIN,1997,Shane Heal,26,43,0,236,26,97,.268,20,65,.308,6,32,.188,.371,3,5,.600,2,16,18,33,3,3,17,20,75
14528,MIN,1997,Reggie Jordan,29,10,0,31,8,10,.800,0,0,,8,10,.800,.800,4,7,.571,0,4,4,1,2,0,2,2,20
14529,MIN,1996,Tom Gugliotta,26,78,78,2835,473,1004,.471,26,86,.302,447,918,.487,.484,289,374,.773,176,514,690,238,139,96,234,265,1261
14530,MIN,1996,Isaiah Rider,24,75,68,2594,560,1206,.464,102,275,.371,458,931,.492,.507,248,296,.838,99,210,309,213,48,23,201,204,1470
14531,MIN,1996,Kevin Garnett,19,80,43,2293,361,735,.491,8,28,.286,353,707,.499,.497,105,149,.705,175,326,501,145,86,131,110,189,835
14532,MIN,1996,Sam Mitchell,32,78,42,2145,303,618,.490,1,18,.056,302,600,.503,.491,237,291,.814,107,232,339,74,49,26,87,220,844
14533,MIN,1996,Terry Porter,32,82,40,2072,269,608,.442,71,226,.314,198,382,.518,.501,164,209,.785,36,176,212,452,89,15,173,154,773
14534,MIN,1996,Doug West,28,73,16,1639,175,393,.445,1,13,.077,174,380,.458,.447,114,144,.792,48,113,161,119,30,17,81,228,465
14535,MIN,1996,Christian Laettner,26,44,44,1518,283,582,.486,9,31,.290,274,551,.497,.494,217,266,.816,98,204,302,129,40,43,112,157,792
14536,MIN,1996,Sean Rooks,26,49,7,902,112,227,.493,1,6,.167,111,221,.502,.496,106,159,.667,60,144,204,38,19,28,49,106,331
14537,MIN,1996,Darrick Martin,24,35,16,747,88,231,.381,15,47,.319,73,184,.397,.413,63,74,.851,3,41,44,156,26,2,70,76,254
14538,MIN,1996,Spud Webb,32,26,21,645,82,208,.394,29,72,.403,53,136,.390,.464,51,58,.879,7,33,40,154,25,5,59,41,244
14539,MIN,1996,Mark Davis,22,57,0,571,55,149,.369,4,13,.308,51,136,.375,.383,74,116,.638,56,69,125,47,40,22,68,92,188
14540,MIN,1996,Andrew Lang,29,20,18,550,72,171,.421,1,2,.500,71,169,.420,.424,30,38,.789,42,79,121,3,7,41,30,63,175
14541,MIN,1996,Marques Bragg,25,53,0,369,54,120,.450,0,0,,54,120,.450,.450,23,41,.561,38,41,79,8,17,8,26,71,131
14542,MIN,1996,Jerome Allen,23,41,0,362,36,105,.343,10,33,.303,26,72,.361,.390,26,36,.722,5,20,25,49,21,5,34,42,108
14543,MIN,1996,Eric Riley,25,25,10,310,35,74,.473,0,1,.000,35,73,.479,.473,22,28,.786,32,44,76,5,8,16,17,42,92
14544,MIN,1996,Micheal Williams,29,9,7,189,13,40,.325,1,3,.333,12,37,.324,.338,28,33,.848,3,20,23,31,5,3,23,37,55
14545,MIN,1996,Charles Smith,28,8,0,39,3,10,.300,0,3,.000,3,7,.429,.300,0,2,.000,0,5,5,6,1,0,5,7,6
14546,MIN,1995,Christian Laettner,25,81,80,2770,450,920,.489,13,40,.325,437,880,.497,.496,409,500,.818,164,449,613,234,101,87,225,302,1322
14547,MIN,1995,Isaiah Rider,23,75,67,2645,558,1249,.447,139,396,.351,419,853,.491,.502,277,339,.817,90,159,249,245,69,23,232,194,1532
14548,MIN,1995,Sean Rooks,25,80,70,2405,289,615,.470,0,5,.000,289,610,.474,.470,290,381,.761,165,321,486,97,29,71,142,208,868
14549,MIN,1995,Doug West,27,71,65,2328,351,762,.461,11,61,.180,340,701,.485,.468,206,246,.837,60,167,227,185,65,24,126,250,919
14550,MIN,1995,Winston Garland,30,73,58,1931,170,410,.415,19,75,.253,151,335,.451,.438,89,112,.795,48,120,168,318,71,13,105,184,448
14551,MIN,1995,Chris Smith,24,64,17,1073,116,264,.439,47,108,.435,69,156,.442,.528,41,63,.651,14,59,73,146,32,22,50,119,320
14552,MIN,1995,Donyell Marshall,21,40,8,1036,158,423,.374,32,106,.302,126,317,.397,.411,83,122,.680,64,132,196,57,25,50,58,63,431
14553,MIN,1995,Tom Gugliotta,25,31,17,1018,162,357,.454,28,88,.318,134,269,.498,.493,93,122,.762,49,173,222,139,61,28,81,86,445
14554,MIN,1995,Pat Durham,27,59,2,852,117,237,.494,5,26,.192,112,211,.531,.504,63,96,.656,37,57,94,53,36,32,45,114,302
14555,MIN,1995,Greg Foster,26,61,0,845,109,232,.470,7,23,.304,102,209,.488,.485,56,80,.700,67,138,205,23,13,20,54,129,281
14556,MIN,1995,Darrick Martin,23,34,9,803,95,233,.408,7,38,.184,88,195,.451,.423,57,65,.877,14,50,64,133,34,0,62,88,254
14557,MIN,1995,Stacey King,28,50,10,792,99,212,.467,0,1,.000,99,211,.469,.467,68,102,.667,54,111,165,26,24,20,64,126,266
14558,MIN,1995,Howard Eisley,22,34,4,496,37,105,.352,8,32,.250,29,73,.397,.390,31,40,.775,10,32,42,77,18,5,42,78,113
14559,MIN,1995,Charles Shackleford,28,21,2,239,39,65,.600,0,0,,39,65,.600,.600,16,20,.800,16,51,67,8,8,6,8,47,94
14560,MIN,1995,Mike Brown,31,27,0,213,10,40,.250,0,1,.000,10,39,.256,.250,15,27,.556,9,36,45,10,7,0,16,35,35
14561,MIN,1995,Andrés Guibert,26,17,0,167,16,47,.340,0,4,.000,16,43,.372,.340,13,19,.684,16,29,45,10,8,1,12,29,45
14562,MIN,1995,Askia Jones,23,11,0,139,15,44,.341,2,12,.167,13,32,.406,.364,13,16,.813,6,5,11,16,6,0,9,19,45
14563,MIN,1995,Micheal Williams,28,1,1,28,1,4,.250,0,0,,1,4,.250,.250,4,5,.800,0,1,1,3,2,0,3,3,6
14564,MIN,1994,Christian Laettner,24,70,67,2428,396,883,.448,6,25,.240,390,858,.455,.452,375,479,.783,160,442,602,307,87,86,259,264,1173
14565,MIN,1994,Isaiah Rider,22,79,60,2415,522,1115,.468,54,150,.360,468,965,.485,.492,215,265,.811,118,197,315,202,54,28,218,194,1313
14566,MIN,1994,Micheal Williams,27,71,66,2206,314,687,.457,10,45,.222,304,642,.474,.464,333,397,.839,67,154,221,512,118,24,203,193,971
14567,MIN,1994,Doug West,26,72,61,2182,434,891,.487,1,8,.125,433,883,.490,.488,187,231,.810,61,170,231,172,65,24,137,236,1056
14568,MIN,1994,Chuck Person,29,77,37,2029,356,843,.422,100,272,.368,256,571,.448,.482,82,108,.759,55,198,253,185,45,12,121,164,894
14569,MIN,1994,Mike Brown,30,82,40,1921,111,260,.427,0,2,.000,111,258,.430,.427,77,118,.653,119,328,447,72,51,29,75,218,299
14570,MIN,1994,Chris Smith,23,80,16,1617,184,423,.435,10,39,.256,174,384,.453,.447,95,141,.674,15,107,122,285,38,18,101,131,473
14571,MIN,1994,Thurl Bailey,32,79,3,1297,232,455,.510,0,2,.000,232,453,.512,.510,119,149,.799,66,149,215,54,20,58,58,93,583
14572,MIN,1994,Luc Longley,25,49,29,989,134,289,.464,0,1,.000,134,288,.465,.464,56,80,.700,87,208,295,46,35,58,79,131,324
14573,MIN,1994,Tellis Frank,28,67,11,959,67,160,.419,0,2,.000,67,158,.424,.419,54,76,.711,83,137,220,57,35,35,49,163,188
14574,MIN,1994,Marlon Maxey,24,55,2,626,89,167,.533,0,2,.000,89,165,.539,.533,70,98,.714,75,124,199,10,16,33,40,113,248
14575,MIN,1994,Stacey King,27,18,15,516,78,170,.459,0,0,,78,170,.459,.459,57,83,.687,40,69,109,19,13,30,40,57,213
14576,MIN,1994,Brian Davis,23,68,3,374,40,126,.317,1,3,.333,39,123,.317,.321,50,68,.735,21,34,55,22,16,4,19,34,131
14577,MIN,1994,Stanley Jackson,23,17,0,92,17,33,.515,1,5,.200,16,28,.571,.530,3,3,1.000,12,15,27,16,5,0,10,13,38
14578,MIN,1994,Corey Williams,23,4,0,46,5,13,.385,0,1,.000,5,12,.417,.385,1,1,1.000,1,5,6,6,2,0,2,6,11
14579,MIN,1994,Andrés Guibert,25,5,0,33,6,20,.300,0,0,,6,20,.300,.300,3,6,.500,10,6,16,2,0,1,6,6,15
14580,MIN,1993,Doug West,25,80,80,3104,646,1249,.517,2,23,.087,644,1226,.525,.518,249,296,.841,89,158,247,235,85,21,165,279,1543
14581,MIN,1993,Chuck Person,28,78,75,2985,541,1248,.433,118,332,.355,423,916,.462,.481,109,168,.649,98,335,433,343,67,30,219,198,1309
14582,MIN,1993,Christian Laettner,23,81,81,2823,503,1061,.474,4,40,.100,499,1021,.489,.476,462,553,.835,171,537,708,223,105,83,275,290,1472
14583,MIN,1993,Micheal Williams,26,76,76,2661,353,791,.446,26,107,.243,327,684,.478,.463,419,462,.907,84,189,273,661,165,23,227,268,1151
14584,MIN,1993,Bob McCann,28,79,7,1536,200,410,.488,0,2,.000,200,408,.490,.488,95,152,.625,92,190,282,68,51,58,79,202,495
14585,MIN,1993,Felton Spencer,25,71,48,1296,105,226,.465,0,0,,105,226,.465,.465,83,127,.654,134,190,324,17,23,66,70,243,293
14586,MIN,1993,Thurl Bailey,31,70,3,1276,203,446,.455,0,0,,203,446,.455,.455,119,142,.838,53,162,215,61,20,47,60,88,525
14587,MIN,1993,Chris Smith,22,80,6,1266,125,289,.433,2,14,.143,123,275,.447,.436,95,120,.792,32,64,96,196,48,16,68,96,347
14588,MIN,1993,Luc Longley,24,55,25,1045,133,292,.455,0,0,,133,292,.455,.455,53,74,.716,71,169,240,51,47,77,88,169,319
14589,MIN,1993,Lance Blanks,26,61,2,642,65,150,.433,11,43,.256,54,107,.505,.470,20,32,.625,18,50,68,72,16,5,31,61,161
14590,MIN,1993,Brad Sellers,30,54,4,533,49,130,.377,0,1,.000,49,129,.380,.377,37,39,.949,27,56,83,46,6,11,27,40,135
14591,MIN,1993,Marlon Maxey,23,43,3,520,93,169,.550,0,1,.000,93,168,.554,.550,45,70,.643,66,98,164,12,11,18,38,75,231
14592,MIN,1993,Gundars Vētra,25,13,0,89,19,40,.475,3,3,1.000,16,37,.432,.513,4,6,.667,4,4,8,6,2,0,2,12,45
14593,MIN,1993,Gerald Glass,25,4,0,71,8,27,.296,0,2,.000,8,25,.320,.296,4,6,.667,1,2,3,9,3,0,5,6,20
14594,MIN,1993,Mark Randall,25,2,0,8,0,1,.000,0,1,.000,0,0,,.000,0,0,,0,0,0,1,0,0,1,1,0
14595,MIN,1992,Pooh Richardson,25,82,82,2922,587,1261,.466,53,155,.342,534,1106,.483,.487,123,178,.691,91,210,301,685,119,25,204,152,1350
14596,MIN,1992,Doug West,24,80,72,2540,463,894,.518,4,23,.174,459,871,.527,.520,186,231,.805,107,150,257,281,66,26,120,239,1116
14597,MIN,1992,Tony Campbell,29,78,41,2441,527,1137,.464,13,37,.351,514,1100,.467,.469,240,299,.803,141,145,286,229,84,31,165,206,1307
14598,MIN,1992,Sam Mitchell,28,82,63,2151,307,725,.423,2,11,.182,305,714,.427,.425,209,266,.786,158,315,473,94,53,39,97,230,825
14599,MIN,1992,Gerald Glass,24,75,41,1822,383,871,.440,16,54,.296,367,817,.449,.449,77,125,.616,107,153,260,175,66,30,103,171,859
14600,MIN,1992,Thurl Bailey,30,71,18,1777,329,735,.448,0,1,.000,329,734,.448,.448,171,215,.795,99,308,407,59,30,102,87,129,829
14601,MIN,1992,Felton Spencer,24,61,54,1481,141,331,.426,0,0,,141,331,.426,.426,123,178,.691,167,268,435,53,27,79,70,241,405
14602,MIN,1992,Randy Breuer,31,67,25,1176,161,344,.468,0,1,.000,161,343,.469,.468,41,77,.532,98,183,281,89,27,99,41,117,363
14603,MIN,1992,Scott Brooks,26,82,0,1082,167,374,.447,32,90,.356,135,284,.475,.489,51,63,.810,27,72,99,205,66,7,51,82,417
14604,MIN,1992,Luc Longley,23,66,3,991,114,249,.458,0,0,,114,249,.458,.458,53,80,.663,67,190,257,53,35,64,83,157,281
14605,MIN,1992,Tod Murphy,28,47,3,429,39,80,.488,1,2,.500,38,78,.487,.494,19,34,.559,36,74,110,11,9,8,18,40,98
14606,MIN,1992,Mark Randall,24,39,0,374,58,127,.457,3,14,.214,55,113,.487,.469,26,35,.743,35,27,62,26,12,3,19,31,145
14607,MIN,1992,Tyrone Corbin,29,11,8,344,57,142,.401,0,1,.000,57,141,.404,.401,44,53,.830,24,45,69,33,12,6,26,31,158
14608,MIN,1992,Tellis Frank,26,10,0,140,18,33,.545,0,0,,18,33,.545,.545,10,15,.667,8,18,26,8,5,4,5,24,46
14609,MIN,1992,Tom Garrick,25,15,0,112,11,33,.333,1,2,.500,10,31,.323,.348,6,8,.750,2,7,9,18,7,3,10,14,29
14610,MIN,1992,Myron Brown,22,4,0,23,4,6,.667,1,3,.333,3,3,1.000,.750,0,0,,0,3,3,6,1,0,4,2,9
14611,MIN,1991,Tyrone Corbin,28,82,82,3196,587,1311,.448,2,10,.200,585,1301,.450,.449,296,371,.798,185,404,589,347,162,53,209,257,1472
14612,MIN,1991,Pooh Richardson,24,82,82,3154,635,1350,.470,42,128,.328,593,1222,.485,.486,89,165,.539,82,204,286,734,131,13,174,114,1401
14613,MIN,1991,Sam Mitchell,27,82,60,3121,445,1010,.441,0,9,.000,445,1001,.445,.441,307,396,.775,188,332,520,133,66,57,104,338,1197
14614,MIN,1991,Tony Campbell,28,77,71,2893,652,1502,.434,16,61,.262,636,1441,.441,.439,358,446,.803,161,185,346,214,121,48,190,204,1678
14615,MIN,1991,Felton Spencer,23,81,46,2099,195,381,.512,0,1,.000,195,380,.513,.512,182,252,.722,272,369,641,25,48,121,77,337,572
14616,MIN,1991,Randy Breuer,30,73,44,1505,197,435,.453,0,0,,197,435,.453,.453,35,79,.443,114,231,345,73,35,80,69,132,429
14617,MIN,1991,Tod Murphy,27,52,19,1063,90,227,.396,1,17,.059,89,210,.424,.399,70,105,.667,92,163,255,60,25,20,32,101,251
14618,MIN,1991,Scott Brooks,25,80,0,980,159,370,.430,45,135,.333,114,235,.485,.491,61,72,.847,28,44,72,204,53,5,51,122,424
14619,MIN,1991,Doug West,23,75,1,824,118,246,.480,0,1,.000,118,245,.482,.480,58,84,.690,56,80,136,48,35,23,41,115,294
14620,MIN,1991,Gerald Glass,23,51,3,606,149,340,.438,2,17,.118,147,323,.455,.441,52,76,.684,54,48,102,42,28,9,41,76,352
14621,MIN,1991,Richard Coffey,25,52,1,320,28,75,.373,0,1,.000,28,74,.378,.373,12,22,.545,42,37,79,3,6,4,5,45,68
14622,MIN,1991,Bob Thornton,28,12,1,110,4,13,.308,0,0,,4,13,.308,.308,8,10,.800,1,14,15,1,0,3,9,18,16
14623,MIN,1991,Dan Godfread,23,10,0,20,5,12,.417,0,1,.000,5,11,.455,.417,3,4,.750,0,2,2,0,1,4,0,5,13
14624,MIN,1991,Jim Thomas,30,3,0,14,1,4,.250,0,0,,1,4,.250,.250,0,0,,0,0,0,1,1,0,1,0,2
14625,MIN,1990,Tony Campbell,27,82,81,3164,723,1581,.457,9,54,.167,714,1527,.468,.460,448,569,.787,209,242,451,213,111,31,251,260,1903
14626,MIN,1990,Tyrone Corbin,27,82,80,3011,521,1083,.481,0,11,.000,521,1072,.486,.481,161,209,.770,219,385,604,216,175,41,143,288,1203
14627,MIN,1990,Pooh Richardson,23,82,48,2581,426,925,.461,23,83,.277,403,842,.479,.473,63,107,.589,55,162,217,554,133,25,141,143,938
14628,MIN,1990,Tod Murphy,26,82,59,2493,260,552,.471,16,43,.372,244,509,.479,.486,144,203,.709,207,357,564,106,76,60,61,229,680
14629,MIN,1990,Sam Mitchell,26,80,30,2414,372,834,.446,0,9,.000,372,825,.451,.446,268,349,.768,180,282,462,89,66,54,96,301,1012
14630,MIN,1990,Sidney Lowe,30,80,38,1744,73,229,.319,2,9,.222,71,220,.323,.323,39,54,.722,41,122,163,337,73,4,63,114,187
14631,MIN,1990,Randy Breuer,29,51,47,1325,212,510,.416,0,1,.000,212,509,.417,.416,94,142,.662,111,179,290,84,33,75,68,133,518
14632,MIN,1990,Scott Roth,26,71,3,1061,159,420,.379,18,52,.346,141,368,.383,.400,150,201,.746,34,78,112,115,51,6,85,144,486
14633,MIN,1990,Donald Royal,23,66,0,746,117,255,.459,0,1,.000,117,254,.461,.459,153,197,.777,69,68,137,43,32,8,81,107,387
14634,MIN,1990,Brad Lohaus,25,28,24,590,94,202,.465,1,16,.063,93,186,.500,.468,21,26,.808,21,89,110,62,14,22,45,66,210
14635,MIN,1990,Doug West,22,52,0,378,53,135,.393,3,11,.273,50,124,.403,.404,26,32,.813,24,46,70,18,10,6,31,61,135
14636,MIN,1990,Gary Leonard,22,22,0,127,13,31,.419,0,1,.000,13,30,.433,.419,6,14,.429,10,17,27,1,3,9,8,26,32
14637,MIN,1990,Brad Sellers,27,14,0,113,19,56,.339,0,2,.000,19,54,.352,.339,9,12,.750,8,11,19,1,6,3,12,11,47
14638,MIN,1990,Adrian Branch,26,11,0,91,25,61,.410,1,1,1.000,24,60,.400,.418,14,22,.636,8,12,20,4,6,0,8,14,65
14639,MIN,1990,Steve Johnson,32,4,0,17,0,2,.000,0,0,,0,2,.000,.000,0,0,,0,3,3,1,0,0,6,4,0
14640,NOP,2024,Herbert Jones,25,76,76,2321,293,588,.498,114,273,.418,179,315,.568,.595,137,158,.867,74,198,272,199,105,62,93,224,837
14641,NOP,2024,Zion Williamson,23,70,70,2207,624,1094,.570,6,18,.333,618,1076,.574,.573,347,494,.702,122,284,406,352,77,47,193,159,1601
14642,NOP,2024,CJ McCollum,32,66,66,2159,484,1055,.459,239,557,.429,245,498,.492,.572,115,139,.827,39,247,286,305,62,41,110,126,1322
14643,NOP,2024,Brandon Ingram,26,64,64,2103,500,1017,.492,86,242,.355,414,775,.534,.534,246,307,.801,43,281,324,363,50,40,163,145,1332
14644,NOP,2024,Jonas Valančiūnas,31,82,82,1925,402,719,.559,37,120,.308,365,599,.609,.585,161,205,.785,186,535,721,173,32,68,111,218,1002
14645,NOP,2024,Trey Murphy III,23,57,23,1690,275,621,.443,169,445,.380,106,176,.602,.579,123,151,.815,42,238,280,124,51,28,34,70,842
14646,NOP,2024,Dyson Daniels,20,61,16,1358,139,311,.447,42,135,.311,97,176,.551,.514,34,53,.642,62,174,236,164,85,25,59,101,354
14647,NOP,2024,Naji Marshall,26,66,1,1257,170,367,.463,58,150,.387,112,217,.516,.542,68,86,.791,53,187,240,128,49,12,65,91,466
14648,NOP,2024,Larry Nance Jr.,31,61,0,1216,138,241,.573,27,65,.415,111,176,.631,.629,47,61,.770,94,213,307,113,61,19,49,98,350
14649,NOP,2024,Jordan Hawkins,21,67,10,1160,174,456,.382,109,298,.366,65,158,.411,.501,67,80,.838,29,119,148,70,19,7,40,72,524
14650,NOP,2024,Jose Alvarado,25,56,0,1028,142,345,.412,78,207,.377,64,138,.464,.525,35,52,.673,25,103,128,117,59,15,40,89,397
14651,NOP,2024,Matt Ryan,26,28,1,390,49,113,.434,41,91,.451,8,22,.364,.615,13,14,.929,6,34,40,18,6,1,19,32,152
14652,NOP,2024,Jeremiah Robinson-Earl,23,39,1,334,45,95,.474,13,39,.333,32,56,.571,.542,12,16,.750,23,53,76,21,10,4,16,24,115
14653,NOP,2024,Cody Zeller,31,43,0,320,26,62,.419,1,3,.333,25,59,.424,.427,23,38,.605,48,64,112,39,9,5,16,45,76
14654,NOP,2024,Kira Lewis Jr.,22,15,0,144,16,52,.308,2,20,.100,14,32,.438,.327,10,11,.909,4,10,14,18,5,1,8,8,44
14655,NOP,2024,Dereon Seabron,23,6,0,55,4,13,.308,1,2,.500,3,11,.273,.346,5,6,.833,1,6,7,5,2,1,0,4,14
14656,NOP,2024,E.J. Liddell,23,8,0,23,1,6,.167,0,5,.000,1,1,1.000,.167,2,2,1.000,0,5,5,1,2,2,2,2,4
14657,NOP,2024,Kaiser Gates,27,1,0,7,0,4,.000,0,2,.000,0,2,.000,.000,0,0,,0,1,1,0,0,0,0,0,0
14658,NOP,2024,Jalen Crutcher,24,1,0,3,0,1,.000,0,0,,0,1,.000,.000,0,0,,0,0,0,0,0,0,0,0,0
14659,NOP,2024,Izaiah Brockington,24,1,0,3,2,5,.400,0,1,.000,2,4,.500,.400,0,0,,1,1,2,0,0,0,0,0,4
14660,NOP,2023,CJ McCollum,31,75,75,2649,587,1344,.437,211,543,.389,376,801,.469,.515,183,238,.769,55,273,328,429,70,38,183,153,1568
14661,NOP,2023,Trey Murphy III,22,79,65,2448,387,800,.484,202,497,.406,185,303,.611,.610,172,190,.905,59,222,281,112,89,43,61,155,1148
14662,NOP,2023,Jonas Valančiūnas,30,79,79,1968,446,816,.547,38,109,.349,408,707,.577,.570,185,224,.826,225,579,804,140,20,52,159,245,1115
14663,NOP,2023,Herbert Jones,24,66,66,1951,235,501,.469,56,167,.335,179,334,.536,.525,123,161,.764,97,172,269,162,103,42,88,208,649
14664,NOP,2023,Naji Marshall,25,77,21,1792,247,571,.433,66,218,.303,181,353,.513,.490,138,175,.789,48,231,279,189,54,14,97,113,698
14665,NOP,2023,Brandon Ingram,25,45,45,1538,404,835,.484,64,164,.390,340,671,.507,.522,240,272,.882,23,223,246,262,32,19,148,116,1112
14666,NOP,2023,Larry Nance Jr.,30,65,1,1381,186,305,.610,14,42,.333,172,263,.654,.633,55,79,.696,106,248,354,119,56,37,42,133,441
14667,NOP,2023,Jose Alvarado,24,61,10,1310,201,489,.411,83,247,.336,118,242,.488,.496,65,80,.813,28,113,141,186,67,10,81,125,550
14668,NOP,2023,Dyson Daniels,19,59,11,1042,87,208,.418,27,86,.314,60,122,.492,.483,26,40,.650,36,152,188,134,43,11,57,99,227
14669,NOP,2023,Zion Williamson,22,29,29,956,285,469,.608,7,19,.368,278,450,.618,.615,177,248,.714,58,144,202,133,32,16,99,65,754
14670,NOP,2023,Devonte' Graham,27,53,0,811,85,231,.368,66,190,.347,19,41,.463,.511,44,59,.746,12,60,72,116,30,10,27,48,280
14671,NOP,2023,Jaxson Hayes,22,47,2,610,86,156,.551,3,29,.103,83,127,.654,.561,58,83,.699,39,93,132,34,20,19,31,67,233
14672,NOP,2023,Josh Richardson,29,23,4,533,62,148,.419,33,86,.384,29,62,.468,.530,16,21,.762,11,45,56,37,29,9,23,47,173
14673,NOP,2023,Willy Hernangómez,28,38,2,458,89,169,.527,3,11,.273,86,158,.544,.536,81,104,.779,58,122,180,33,17,13,39,64,262
14674,NOP,2023,Kira Lewis Jr.,21,25,0,235,40,88,.455,15,34,.441,25,54,.463,.540,19,22,.864,5,28,33,23,10,2,10,24,114
14675,NOP,2023,Garrett Temple,36,25,0,162,18,45,.400,11,26,.423,7,19,.368,.522,3,4,.750,5,12,17,13,9,2,4,15,50
14676,NOP,2023,Dereon Seabron,22,5,0,12,2,5,.400,0,0,,2,5,.400,.400,0,0,,1,0,1,0,0,0,0,1,4
14677,NOP,2022,Herbert Jones,23,78,69,2335,274,576,.476,57,169,.337,217,407,.533,.525,137,163,.840,98,198,296,167,130,60,100,238,742
14678,NOP,2022,Jonas Valančiūnas,29,74,74,2240,510,938,.544,57,158,.361,453,780,.581,.574,237,289,.820,226,617,843,190,41,60,179,247,1314
14679,NOP,2022,Devonte' Graham,26,76,63,2162,296,815,.363,192,563,.341,104,252,.413,.481,118,140,.843,37,140,177,316,71,12,105,95,902
14680,NOP,2022,Brandon Ingram,24,55,55,1869,453,983,.461,74,226,.327,379,757,.501,.498,266,322,.826,35,285,320,307,34,26,151,119,1246
14681,NOP,2022,Jaxson Hayes,21,70,28,1398,245,398,.616,20,57,.351,225,341,.660,.641,144,188,.766,115,200,315,43,33,55,54,155,654
14682,NOP,2022,Josh Hart,26,41,40,1374,195,386,.505,42,130,.323,153,256,.598,.560,116,154,.753,53,265,318,168,45,11,81,118,548
14683,NOP,2022,Nickeil Alexander-Walker,23,50,19,1317,237,632,.375,95,305,.311,142,327,.434,.450,70,97,.722,36,128,164,139,41,19,85,88,639
14684,NOP,2022,Garrett Temple,35,59,16,1098,111,295,.376,59,185,.319,52,110,.473,.476,28,41,.683,29,114,143,74,43,23,42,81,309
14685,NOP,2022,CJ McCollum,30,26,26,878,246,499,.493,71,180,.394,175,319,.549,.564,68,102,.667,19,97,116,152,34,1,57,44,631
14686,NOP,2022,Trey Murphy III,21,62,1,864,109,277,.394,71,186,.382,38,91,.418,.522,45,51,.882,47,100,147,38,23,7,16,60,334
14687,NOP,2022,Willy Hernangómez,27,50,8,839,170,327,.520,4,12,.333,166,315,.527,.526,109,141,.773,143,195,338,63,21,19,51,97,453
14688,NOP,2022,Jose Alvarado,23,54,1,834,131,294,.446,32,110,.291,99,184,.538,.500,36,53,.679,25,75,100,152,71,7,40,73,330
14689,NOP,2022,Naji Marshall,24,55,4,735,109,269,.405,21,105,.200,88,164,.537,.444,74,93,.796,38,104,142,62,33,8,46,69,313
14690,NOP,2022,Tomáš Satoranský,30,32,3,481,32,107,.299,5,31,.161,27,76,.355,.322,19,25,.760,18,46,64,76,14,1,23,33,88
14691,NOP,2022,Gary Clark,27,38,1,378,33,88,.375,28,70,.400,5,18,.278,.534,7,10,.700,23,67,90,18,13,7,10,20,101
14692,NOP,2022,Kira Lewis Jr.,20,24,0,341,59,146,.404,13,58,.224,46,88,.523,.449,10,12,.833,9,30,39,49,11,1,26,17,141
14693,NOP,2022,Tony Snell,30,15,2,277,33,74,.446,21,53,.396,12,21,.571,.588,1,1,1.000,5,26,31,8,8,2,8,26,88
14694,NOP,2022,Larry Nance Jr.,29,9,0,182,27,49,.551,4,8,.500,23,41,.561,.592,8,8,1.000,14,25,39,8,5,7,10,17,66
14695,NOP,2022,Tyrone Wallace,27,6,0,75,7,20,.350,2,8,.250,5,12,.417,.400,1,5,.200,0,8,8,1,3,1,2,7,17
14696,NOP,2022,Jared Harper,24,5,0,43,14,26,.538,5,12,.417,9,14,.643,.635,4,4,1.000,2,0,2,14,4,1,2,5,37
14697,NOP,2022,Alize Johnson,25,4,0,28,3,10,.300,0,0,,3,10,.300,.300,3,4,.750,7,6,13,1,2,0,1,3,9
14698,NOP,2022,Didi Louzada,22,2,0,7,0,3,.000,0,3,.000,0,0,,.000,0,0,,2,0,2,1,0,0,0,0,0
14699,NOP,2021,Eric Bledsoe,31,71,70,2111,307,730,.421,121,355,.341,186,375,.496,.503,134,195,.687,29,215,244,268,55,24,114,112,869
14700,NOP,2021,Brandon Ingram,23,61,61,2093,513,1101,.466,143,375,.381,370,726,.510,.531,281,320,.878,34,265,299,296,42,36,154,124,1450
14701,NOP,2021,Zion Williamson,20,61,61,2026,634,1037,.611,10,34,.294,624,1003,.622,.616,369,529,.698,167,274,441,226,57,39,167,135,1647
14702,NOP,2021,Lonzo Ball,23,55,55,1747,290,700,.414,172,455,.378,118,245,.482,.537,50,64,.781,33,230,263,316,82,31,123,103,802
14703,NOP,2021,Steven Adams,27,58,58,1605,189,308,.614,0,3,.000,189,305,.620,.614,60,135,.444,213,301,514,111,54,38,78,113,438
14704,NOP,2021,Josh Hart,25,47,4,1349,151,344,.439,63,193,.326,88,151,.583,.531,69,89,.775,53,324,377,109,38,12,49,111,434
14705,NOP,2021,Nickeil Alexander-Walker,22,46,13,1007,192,458,.419,76,219,.347,116,239,.485,.502,48,66,.727,13,131,144,102,47,22,69,88,508
14706,NOP,2021,Jaxson Hayes,20,60,3,964,175,280,.625,6,14,.429,169,266,.635,.636,93,120,.775,92,165,257,35,25,38,39,101,449
14707,NOP,2021,Kira Lewis Jr.,19,54,0,904,130,337,.386,40,120,.333,90,217,.415,.445,43,51,.843,12,59,71,124,38,10,34,88,343
14708,NOP,2021,Willy Hernangómez,26,47,12,846,151,268,.563,1,10,.100,150,258,.581,.565,62,93,.667,117,217,334,50,22,23,34,68,365
14709,NOP,2021,Naji Marshall,23,32,10,700,82,209,.392,29,83,.349,53,126,.421,.462,53,75,.707,15,133,148,88,26,10,38,58,246
14710,NOP,2021,JJ Redick,36,31,0,576,87,214,.407,51,140,.364,36,74,.486,.526,45,47,.957,3,49,52,40,9,2,25,37,270
14711,NOP,2021,James Johnson,33,22,11,539,79,182,.434,16,60,.267,63,122,.516,.478,28,47,.596,18,73,91,48,18,19,28,61,202
14712,NOP,2021,Wes Iwundu,26,18,1,251,17,50,.340,2,18,.111,15,32,.469,.360,14,17,.824,9,37,46,8,6,1,13,23,50
14713,NOP,2021,Nicolò Melli,30,22,0,241,15,59,.254,7,37,.189,8,22,.364,.314,6,7,.857,12,45,57,25,9,1,7,28,43
14714,NOP,2021,Wenyen Gabriel,23,21,0,241,24,60,.400,13,32,.406,11,28,.393,.508,11,17,.647,20,34,54,11,9,8,15,32,72
14715,NOP,2021,Sindarius Thornwell,26,14,1,73,7,21,.333,3,9,.333,4,12,.333,.405,0,2,.000,1,4,5,4,5,1,4,3,17
14716,NOP,2021,Didi Louzada,21,3,0,56,3,13,.231,2,8,.250,1,5,.200,.308,0,0,,1,2,3,3,2,0,3,5,8
14717,NOP,2021,James Nunnally,30,9,0,48,5,13,.385,4,12,.333,1,1,1.000,.538,1,2,.500,2,7,9,3,0,0,2,1,15
14718,NOP,2021,Isaiah Thomas,31,3,0,48,9,27,.333,3,12,.250,6,15,.400,.389,2,2,1.000,1,3,4,5,1,0,6,3,23
14719,NOP,2021,Will Magnay,22,1,0,3,0,1,.000,0,1,.000,0,0,,.000,0,0,,0,0,0,0,0,0,1,1,0
14720,NOP,2020,Jrue Holiday,29,61,61,2117,458,1006,.455,122,346,.353,336,660,.509,.516,129,182,.709,77,216,293,408,99,48,184,145,1167
14721,NOP,2020,Brandon Ingram,22,62,62,2104,507,1096,.463,150,384,.391,357,712,.501,.531,313,368,.851,51,329,380,259,61,38,189,179,1477
14722,NOP,2020,Lonzo Ball,22,63,54,2025,277,687,.403,148,395,.375,129,292,.442,.511,43,76,.566,71,312,383,438,88,38,193,128,745
14723,NOP,2020,Josh Hart,24,65,16,1755,225,532,.423,121,354,.342,104,178,.584,.537,85,115,.739,61,364,425,108,63,23,75,160,656
14724,NOP,2020,JJ Redick,35,60,36,1581,286,631,.453,180,397,.453,106,234,.453,.596,165,185,.892,10,141,151,119,20,10,75,96,917
14725,NOP,2020,Derrick Favors,28,51,49,1243,209,339,.617,1,7,.143,208,332,.627,.618,40,71,.563,163,338,501,81,30,46,55,107,459
14726,NOP,2020,Jaxson Hayes,19,64,14,1080,174,259,.672,1,4,.250,173,255,.678,.674,123,190,.647,97,162,259,56,26,55,53,161,472
14727,NOP,2020,Nicolò Melli,29,60,8,1042,136,323,.421,69,206,.335,67,117,.573,.528,54,73,.740,38,142,180,82,34,23,46,124,395
14728,NOP,2020,E'Twaun Moore,30,56,6,1020,186,437,.426,63,167,.377,123,270,.456,.498,31,45,.689,31,100,131,78,32,11,40,80,466
14729,NOP,2020,Kenrich Williams,25,39,18,832,51,147,.347,25,97,.258,26,50,.520,.432,9,26,.346,51,135,186,57,27,21,22,88,136
14730,NOP,2020,Frank Jackson,21,59,2,797,134,331,.405,47,144,.326,87,187,.465,.476,56,75,.747,22,61,83,61,17,4,49,77,371
14731,NOP,2020,Zion Williamson,19,24,24,668,210,360,.583,6,14,.429,204,346,.590,.592,114,178,.640,64,86,150,50,16,9,59,42,540
14732,NOP,2020,Nickeil Alexander-Walker,21,47,1,591,98,266,.368,46,133,.346,52,133,.391,.455,25,37,.676,9,75,84,89,17,8,54,57,267
14733,NOP,2020,Jahlil Okafor,24,30,9,467,101,162,.623,1,3,.333,100,159,.629,.627,40,62,.645,48,79,127,37,7,22,38,67,243
14734,NOP,2020,Zylan Cheatham,24,4,0,51,6,9,.667,0,1,.000,6,8,.750,.667,0,0,,3,6,9,3,1,1,4,10,12
14735,NOP,2020,Sindarius Thornwell,25,2,0,35,6,11,.545,2,4,.500,4,7,.571,.636,2,4,.500,0,4,4,4,1,1,2,2,16
14736,NOP,2020,Josh Gray,26,2,0,23,1,2,.500,0,0,,1,2,.500,.500,0,0,,1,1,2,2,0,0,5,1,2
14737,NOP,2019,Jrue Holiday,28,67,67,2402,547,1159,.472,118,363,.325,429,796,.539,.523,208,271,.768,75,259,334,518,109,54,210,148,1420
14738,NOP,2019,Julius Randle,24,73,49,2232,571,1089,.524,67,195,.344,504,894,.564,.555,356,487,.731,162,472,634,229,52,45,208,246,1565
14739,NOP,2019,Anthony Davis,25,56,56,1850,530,1026,.517,48,145,.331,482,881,.547,.540,344,433,.794,174,498,672,218,88,135,112,132,1452
14740,NOP,2019,Darius Miller,28,69,15,1757,189,484,.390,133,364,.365,56,120,.467,.528,56,71,.789,14,114,128,146,40,23,59,165,567
14741,NOP,2019,E'Twaun Moore,29,53,36,1463,256,532,.481,76,176,.432,180,356,.506,.553,45,59,.763,35,92,127,102,40,8,59,112,633
14742,NOP,2019,Elfrid Payton,24,42,42,1250,179,412,.434,33,105,.314,146,307,.476,.475,55,74,.743,49,171,220,320,44,17,112,81,446
14743,NOP,2019,Frank Jackson,20,61,16,1169,194,447,.434,53,169,.314,141,278,.507,.493,54,73,.740,25,109,134,69,25,2,48,92,495
14744,NOP,2019,Kenrich Williams,24,46,29,1079,107,279,.384,52,156,.333,55,123,.447,.477,13,19,.684,55,164,219,83,45,19,36,95,279
14745,NOP,2019,Ian Clark,27,60,6,973,151,383,.394,66,202,.327,85,181,.470,.480,33,37,.892,13,76,89,94,22,8,58,95,401
14746,NOP,2019,Jahlil Okafor,23,59,24,935,212,362,.586,1,5,.200,211,357,.591,.587,59,89,.663,82,196,278,40,15,40,52,96,484
14747,NOP,2019,Nikola Mirotić,27,32,22,925,182,407,.447,85,231,.368,97,176,.551,.552,85,101,.842,46,218,264,35,21,25,37,86,534
14748,NOP,2019,Tim Frazier,28,47,17,909,88,195,.451,27,77,.351,61,118,.517,.521,32,41,.780,32,105,137,206,25,4,60,93,235
14749,NOP,2019,Cheick Diallo,22,64,1,896,168,271,.620,1,4,.250,167,267,.625,.622,50,67,.746,75,257,332,33,29,33,49,113,387
14750,NOP,2019,Solomon Hill,27,44,15,878,68,178,.382,32,101,.317,36,77,.468,.472,23,32,.719,34,99,133,55,23,10,31,80,191
14751,NOP,2019,Wesley Johnson,31,26,13,377,35,88,.398,19,50,.380,16,38,.421,.506,6,9,.667,10,44,54,16,12,7,12,45,95
14752,NOP,2019,Stanley Johnson,22,18,0,247,38,91,.418,11,34,.324,27,57,.474,.478,9,13,.692,9,33,42,28,12,1,26,22,96
14753,NOP,2019,Christian Wood,23,8,2,189,49,92,.533,6,21,.286,43,71,.606,.565,31,41,.756,13,50,63,6,7,10,14,14,135
14754,NOP,2019,Dairis Bertāns,29,12,0,167,12,47,.255,10,34,.294,2,13,.154,.362,0,0,,2,7,9,10,1,0,2,7,34
14755,NOP,2019,Andrew Harrison,24,6,0,38,3,12,.250,2,10,.200,1,2,.500,.333,1,2,.500,2,3,5,7,0,0,2,7,9
14756,NOP,2019,Jason Smith,32,2,0,20,2,9,.222,2,7,.286,0,2,.000,.333,2,2,1.000,2,2,4,1,0,0,1,3,8
14757,NOP,2018,Jrue Holiday,27,81,81,2927,615,1244,.494,120,356,.337,495,888,.557,.543,187,238,.786,62,303,365,486,123,64,213,201,1537
14758,NOP,2018,Anthony Davis,24,75,75,2727,780,1462,.534,55,162,.340,725,1300,.558,.552,495,598,.828,187,645,832,174,115,193,162,159,2110
14759,NOP,2018,E'Twaun Moore,28,82,80,2586,423,832,.508,128,301,.425,295,531,.556,.585,48,68,.706,57,181,238,187,79,12,102,182,1022
14760,NOP,2018,Darius Miller,27,82,3,1944,216,487,.444,147,358,.411,69,129,.535,.594,58,67,.866,18,146,164,111,28,17,58,160,637
14761,NOP,2018,DeMarcus Cousins,27,48,48,1737,406,864,.470,104,294,.354,302,570,.530,.530,294,394,.746,105,512,617,257,79,76,242,183,1210
14762,NOP,2018,Rajon Rondo,31,65,63,1705,231,494,.468,50,150,.333,181,344,.526,.518,25,46,.543,31,232,263,533,70,10,151,119,537
14763,NOP,2018,Ian Clark,26,74,2,1455,222,495,.448,62,195,.318,160,300,.533,.511,45,59,.763,10,117,127,110,33,10,57,120,551
14764,NOP,2018,Dante Cunningham,30,51,24,1115,99,225,.440,35,108,.324,64,117,.547,.518,20,36,.556,50,143,193,26,27,16,16,75,253
14765,NOP,2018,Jameer Nelson,35,43,0,897,84,205,.410,40,110,.364,44,95,.463,.507,13,17,.765,11,85,96,156,23,3,56,67,221
14766,NOP,2018,Nikola Mirotić,26,30,11,872,163,382,.427,66,197,.335,97,185,.524,.513,47,58,.810,41,205,246,41,29,26,31,63,439
14767,NOP,2018,Cheick Diallo,21,52,0,581,102,176,.580,0,0,,102,176,.580,.580,50,66,.758,47,164,211,19,11,21,28,82,254
14768,NOP,2018,Emeka Okafor,35,26,19,353,48,95,.505,0,0,,48,95,.505,.505,18,22,.818,47,73,120,8,8,25,13,30,114
14769,NOP,2018,Tony Allen,36,22,0,273,44,91,.484,4,12,.333,40,79,.506,.505,11,21,.524,20,27,47,9,11,3,19,49,103
14770,NOP,2018,DeAndre Liggins,29,27,3,244,18,41,.439,8,17,.471,10,24,.417,.537,0,0,,2,24,26,21,10,4,7,20,44
14771,NOP,2018,Solomon Hill,26,12,1,187,11,41,.268,4,21,.190,7,20,.350,.317,3,6,.500,9,27,36,22,7,1,9,22,29
14772,NOP,2018,Ömer Aşık,31,14,0,121,7,16,.438,0,0,,7,16,.438,.438,4,12,.333,7,30,37,2,1,2,5,14,18
14773,NOP,2018,Larry Drew II,27,7,0,55,6,17,.353,3,6,.500,3,11,.273,.441,0,0,,2,0,2,8,0,0,2,4,15
14774,NOP,2018,Jordan Crawford,29,5,0,53,12,27,.444,8,14,.571,4,13,.308,.593,1,1,1.000,2,2,4,13,1,1,5,7,33
14775,NOP,2018,Charles Cooke,23,13,0,38,2,14,.143,1,8,.125,1,6,.167,.179,1,2,.500,0,2,2,1,1,0,1,0,6
14776,NOP,2018,Walt Lemon Jr.,25,5,0,35,7,16,.438,1,1,1.000,6,15,.400,.469,2,3,.667,0,2,2,5,0,1,4,5,17
14777,NOP,2018,Jalen Jones,24,4,0,19,1,4,.250,1,1,1.000,0,3,.000,.375,2,2,1.000,0,3,3,0,0,0,0,2,5
14778,NOP,2018,Mike James,27,4,0,18,2,9,.222,0,1,.000,2,8,.250,.222,0,0,,1,0,1,6,1,0,1,3,4
14779,NOP,2018,Josh Smith,32,3,0,12,1,4,.250,0,0,,1,4,.250,.250,0,0,,3,1,4,0,0,0,0,3,2
14780,NOP,2017,Anthony Davis,23,75,75,2708,770,1526,.505,40,134,.299,730,1392,.524,.518,519,647,.802,172,712,884,157,94,167,181,168,2099
14781,NOP,2017,Solomon Hill,25,80,71,2374,183,478,.383,94,270,.348,89,208,.428,.481,103,128,.805,51,256,307,141,72,32,82,182,563
14782,NOP,2017,Jrue Holiday,26,67,61,2190,405,893,.454,100,281,.356,305,612,.498,.510,119,168,.708,46,218,264,488,100,44,194,133,1029
14783,NOP,2017,E'Twaun Moore,27,73,22,1820,283,619,.457,77,208,.370,206,411,.501,.519,57,74,.770,33,119,152,164,50,32,62,131,700
14784,NOP,2017,Dante Cunningham,29,66,35,1649,174,359,.485,71,181,.392,103,178,.579,.584,16,27,.593,56,221,277,37,39,28,28,100,435
14785,NOP,2017,Tim Frazier,26,65,35,1525,163,404,.403,40,128,.313,123,276,.446,.453,98,129,.760,34,139,173,335,56,6,101,133,464
14786,NOP,2017,Terrence Jones,25,51,12,1264,231,489,.472,19,75,.253,212,414,.512,.492,103,170,.606,65,238,303,59,39,53,48,67,584
14787,NOP,2017,Buddy Hield,24,57,37,1161,185,471,.393,89,241,.369,96,230,.417,.487,29,33,.879,19,147,166,77,18,7,48,81,488
14788,NOP,2017,Langston Galloway,25,55,0,1120,165,441,.374,101,268,.377,64,173,.370,.489,40,52,.769,20,101,121,65,40,5,28,76,471
14789,NOP,2017,Alexis Ajinça,28,39,15,584,89,178,.500,0,4,.000,89,174,.511,.500,29,40,.725,46,131,177,12,20,22,31,77,207
14790,NOP,2017,DeMarcus Cousins,26,17,17,574,142,314,.452,36,96,.375,106,218,.486,.510,94,121,.777,37,174,211,66,25,19,62,75,414
14791,NOP,2017,Ömer Aşık,30,31,19,482,31,65,.477,0,0,,31,65,.477,.477,23,39,.590,48,115,163,15,5,10,14,51,85
14792,NOP,2017,Donatas Motiejūnas,26,34,0,479,57,138,.413,11,47,.234,46,91,.505,.453,25,49,.510,26,75,101,32,18,11,31,55,150
14793,NOP,2017,Tyreke Evans,27,26,0,474,91,227,.401,21,70,.300,70,157,.446,.447,45,58,.776,6,80,86,91,23,4,39,41,248
14794,NOP,2017,Jordan Crawford,28,19,0,442,105,218,.482,37,95,.389,68,123,.553,.567,20,26,.769,4,30,34,57,11,2,25,30,267
14795,NOP,2017,Cheick Diallo,20,17,0,199,36,76,.474,0,0,,36,76,.474,.474,15,21,.714,23,50,73,4,4,7,7,17,87
14796,NOP,2017,Hollis Thompson,25,9,8,191,11,41,.268,6,24,.250,5,17,.294,.341,6,9,.667,4,24,28,9,6,0,2,14,34
14797,NOP,2017,Lance Stephenson,26,6,0,162,26,55,.473,1,10,.100,25,45,.556,.482,5,8,.625,3,15,18,29,2,1,11,18,58
14798,NOP,2017,Anthony Brown,24,9,0,143,14,41,.341,6,24,.250,8,17,.471,.415,0,0,,6,20,26,6,5,1,5,13,34
14799,NOP,2017,Quinn Cook,23,9,0,111,22,41,.537,6,12,.500,16,29,.552,.610,2,3,.667,1,3,4,14,3,0,5,7,52
14800,NOP,2017,Reggie Williams,30,6,0,79,8,23,.348,5,11,.455,3,12,.250,.457,6,7,.857,2,4,6,4,3,0,0,2,27
14801,NOP,2017,Wayne Selden,22,3,3,47,5,8,.625,4,7,.571,1,1,1.000,.875,2,4,.500,0,5,5,1,2,0,3,6,16
14802,NOP,2017,Axel Toupane,24,2,0,41,5,8,.625,1,3,.333,4,5,.800,.688,0,0,,0,1,1,0,1,1,0,5,11
14803,NOP,2017,Jarrett Jack,33,2,0,33,2,3,.667,0,1,.000,2,2,1.000,.667,2,2,1.000,0,0,0,5,2,0,3,4,6
14804,NOP,2017,Archie Goodwin,22,3,0,30,2,5,.400,1,2,.500,1,3,.333,.500,10,10,1.000,0,0,0,1,0,1,0,1,15
14805,NOP,2017,Omri Casspi,28,1,0,24,5,9,.556,2,4,.500,3,5,.600,.667,0,0,,1,1,2,0,0,0,2,3,12
14806,NOP,2016,Anthony Davis,22,61,61,2164,560,1136,.493,35,108,.324,525,1028,.511,.508,326,430,.758,130,497,627,116,78,125,121,148,1481
14807,NOP,2016,Ryan Anderson,27,66,7,2008,397,929,.427,131,358,.366,266,571,.466,.498,199,228,.873,131,265,396,73,38,25,90,109,1124
14808,NOP,2016,Dante Cunningham,28,80,46,1971,186,412,.451,55,174,.316,131,238,.550,.518,57,82,.695,57,179,236,77,42,33,41,173,484
14809,NOP,2016,Jrue Holiday,25,65,23,1831,410,935,.439,87,259,.336,323,676,.478,.485,182,216,.843,27,168,195,391,88,22,167,148,1089
14810,NOP,2016,Alonzo Gee,28,73,38,1632,132,255,.518,17,60,.283,115,195,.590,.551,44,66,.667,60,185,245,72,63,13,55,169,325
14811,NOP,2016,Eric Gordon,27,45,44,1481,231,552,.418,113,294,.384,118,258,.457,.521,111,125,.888,10,89,99,121,43,14,73,98,686
14812,NOP,2016,Toney Douglas,29,61,18,1262,183,445,.411,81,203,.399,102,242,.421,.502,84,99,.848,25,118,143,157,70,5,64,131,531
14813,NOP,2016,Norris Cole,27,45,23,1198,196,484,.405,33,102,.324,163,382,.427,.439,52,65,.800,10,141,151,167,37,5,75,102,477
14814,NOP,2016,Ömer Aşık,29,68,64,1178,104,195,.533,0,0,,104,195,.533,.533,61,112,.545,120,294,414,26,21,23,60,124,269
14815,NOP,2016,Alexis Ajinça,27,59,17,861,150,315,.476,0,1,.000,150,314,.478,.476,52,62,.839,75,194,269,31,19,36,54,134,352
14816,NOP,2016,Luke Babbitt,26,47,13,845,122,289,.422,44,109,.404,78,180,.433,.498,39,50,.780,25,123,148,53,11,7,23,90,327
14817,NOP,2016,Tyreke Evans,26,25,25,765,136,314,.433,33,85,.388,103,229,.450,.486,74,93,.796,20,109,129,164,32,8,73,66,379
14818,NOP,2016,Ish Smith,27,27,3,617,98,228,.430,10,33,.303,88,195,.451,.452,33,43,.767,14,78,92,154,24,6,45,38,239
14819,NOP,2016,Kendrick Perkins,31,37,5,542,40,75,.533,0,0,,40,75,.533,.533,11,25,.440,25,103,128,31,11,11,41,64,91
14820,NOP,2016,Tim Frazier,25,16,1,469,76,169,.450,13,31,.419,63,138,.457,.488,45,59,.763,15,56,71,120,23,1,38,42,210
14821,NOP,2016,Jordan Hamilton,25,11,4,304,49,116,.422,13,45,.289,36,71,.507,.478,14,21,.667,12,50,62,25,8,3,17,24,125
14822,NOP,2016,James Ennis III,25,9,5,282,50,100,.500,24,50,.480,26,50,.520,.620,19,24,.792,17,18,35,18,12,3,17,26,143
14823,NOP,2016,Bryce Dejean-Jones,23,14,11,279,28,69,.406,12,32,.375,16,37,.432,.493,11,21,.524,8,40,48,15,10,2,11,17,79
14824,NOP,2016,Orlando Johnson,26,5,1,54,4,17,.235,1,5,.200,3,12,.250,.265,1,2,.500,1,5,6,2,1,0,3,4,10
14825,NOP,2016,Nate Robinson,31,2,1,23,0,1,.000,0,1,.000,0,0,,.000,0,0,,0,0,0,4,1,0,0,5,0
14826,NOP,2016,Jimmer Fredette,26,4,0,13,1,4,.250,0,1,.000,1,3,.333,.250,0,0,,0,0,0,1,1,0,1,1,2
14827,NOP,2015,Tyreke Evans,25,79,76,2690,521,1165,.447,69,227,.304,452,938,.482,.477,202,291,.694,82,334,416,521,100,37,246,198,1313
14828,NOP,2015,Anthony Davis,21,68,68,2455,642,1199,.535,1,12,.083,641,1187,.540,.536,371,461,.805,173,523,696,149,100,200,95,141,1656
14829,NOP,2015,Eric Gordon,26,61,60,2018,285,694,.411,141,315,.448,144,379,.380,.512,107,133,.805,28,131,159,229,50,14,122,145,818
14830,NOP,2015,Ömer Aşık,28,76,76,1982,213,412,.517,0,0,,213,412,.517,.517,131,225,.582,244,504,748,72,29,54,95,144,557
14831,NOP,2015,Ryan Anderson,26,61,5,1675,291,729,.399,122,359,.340,169,370,.457,.483,129,151,.854,108,187,295,55,33,20,62,113,833
14832,NOP,2015,Dante Cunningham,27,66,27,1652,155,339,.457,1,10,.100,154,329,.468,.459,29,47,.617,70,186,256,50,46,37,35,101,340
14833,NOP,2015,Jrue Holiday,24,40,37,1303,238,534,.446,51,135,.378,187,399,.469,.493,65,76,.855,32,103,135,274,63,23,91,110,592
14834,NOP,2015,Quincy Pondexter,26,45,28,1253,140,312,.449,74,171,.433,66,141,.468,.567,50,66,.758,33,105,138,66,14,19,41,103,404
14835,NOP,2015,Alexis Ajinça,26,68,8,957,181,329,.550,0,0,,181,329,.550,.550,81,99,.818,104,211,315,47,21,51,69,151,443
14836,NOP,2015,Luke Babbitt,25,63,19,830,92,192,.479,59,115,.513,33,77,.429,.633,13,19,.684,12,99,111,24,17,11,26,63,256
14837,NOP,2015,Austin Rivers,22,35,3,772,86,222,.387,14,50,.280,72,172,.419,.419,53,71,.746,12,56,68,87,18,7,30,65,239
14838,NOP,2015,Norris Cole,26,28,2,683,112,252,.444,28,74,.378,84,178,.472,.500,26,35,.743,1,50,51,90,15,7,41,49,278
14839,NOP,2015,Jimmer Fredette,25,50,0,509,63,166,.380,9,48,.188,54,118,.458,.407,43,45,.956,8,32,40,58,15,2,33,43,178
14840,NOP,2015,John Salmons,35,21,0,270,16,48,.333,8,26,.308,8,22,.364,.417,2,4,.500,4,17,21,13,9,4,5,25,42
14841,NOP,2015,Jeff Withey,24,37,0,259,32,64,.500,0,0,,32,64,.500,.500,34,50,.680,23,41,64,11,4,18,12,26,98
14842,NOP,2015,Toney Douglas,28,12,0,177,19,51,.373,5,18,.278,14,33,.424,.422,8,13,.615,2,20,22,24,11,4,10,20,51
14843,NOP,2015,Nate Wolters,23,10,0,105,8,26,.308,0,2,.000,8,24,.333,.308,1,2,.500,6,12,18,11,3,2,10,7,17
14844,NOP,2015,Elliot Williams,25,8,0,77,8,24,.333,3,11,.273,5,13,.385,.396,0,2,.000,0,5,5,8,2,0,0,11,19
14845,NOP,2015,Gal Mekel,26,4,0,43,3,20,.150,0,3,.000,3,17,.176,.150,0,0,,0,1,1,13,2,0,2,1,6
14846,NOP,2015,Darius Miller,24,5,1,43,1,7,.143,0,1,.000,1,6,.167,.143,0,0,,0,1,1,2,1,0,1,8,2
14847,NOP,2015,Russ Smith,23,6,0,29,2,10,.200,1,6,.167,1,4,.250,.250,0,0,,0,3,3,2,0,0,7,6,5
14848,NOP,2014,Anthony Davis,20,67,66,2358,522,1005,.519,2,9,.222,520,996,.522,.520,348,440,.791,207,466,673,105,89,189,109,200,1394
14849,NOP,2014,Eric Gordon,25,64,64,2057,356,817,.436,101,258,.391,255,559,.456,.498,175,223,.785,30,135,165,208,74,12,134,114,988
14850,NOP,2014,Al-Farouq Aminu,23,80,65,2045,234,494,.474,13,48,.271,221,446,.496,.487,91,137,.664,129,367,496,114,82,38,88,147,572
14851,NOP,2014,Tyreke Evans,24,72,22,2028,391,897,.436,21,95,.221,370,802,.461,.448,239,310,.771,76,265,341,363,84,21,175,155,1042
14852,NOP,2014,Brian Roberts,28,72,42,1667,244,581,.420,64,178,.360,180,403,.447,.475,125,133,.940,17,119,136,234,43,7,95,132,677
14853,NOP,2014,Anthony Morrow,28,76,9,1426,238,520,.458,88,195,.451,150,325,.462,.542,72,87,.828,29,111,140,59,38,12,51,102,636
14854,NOP,2014,Austin Rivers,21,69,4,1339,192,474,.405,36,99,.364,156,375,.416,.443,110,173,.636,26,103,129,160,45,9,77,134,530
14855,NOP,2014,Jrue Holiday,23,34,34,1143,203,454,.447,30,77,.390,173,377,.459,.480,51,63,.810,28,114,142,268,56,12,105,92,487
14856,NOP,2014,Greg Stiemsma,28,55,20,1007,70,122,.574,0,1,.000,70,121,.579,.574,19,32,.594,72,154,226,36,35,57,44,169,159
14857,NOP,2014,Alexis Ajinça,25,56,30,951,136,249,.546,0,1,.000,136,248,.548,.546,56,67,.836,94,183,277,40,23,46,63,187,328
14858,NOP,2014,Jason Smith,27,31,27,830,131,282,.465,0,0,,131,282,.465,.465,39,50,.780,51,130,181,29,11,29,28,100,301
14859,NOP,2014,Ryan Anderson,25,22,14,795,155,354,.438,67,164,.409,88,190,.463,.532,59,62,.952,66,76,142,17,10,7,20,47,436
14860,NOP,2014,Darius Miller,23,45,7,723,73,166,.440,25,77,.325,48,89,.539,.515,29,36,.806,9,43,52,43,24,9,22,88,200
14861,NOP,2014,Jeff Withey,23,58,4,684,69,129,.535,0,1,.000,69,128,.539,.535,52,73,.712,49,101,150,26,15,50,20,73,190
14862,NOP,2014,Luke Babbitt,24,27,2,473,60,154,.390,36,95,.379,24,59,.407,.506,14,18,.778,18,70,88,29,7,11,15,52,170
14863,NOP,2014,Lou Amundson,31,18,0,184,16,32,.500,0,0,,16,32,.500,.500,6,24,.250,28,27,55,6,9,11,14,49,38
14864,NOP,2014,Lance Thomas,25,5,0,42,2,9,.222,0,0,,2,9,.222,.222,2,4,.500,2,5,7,3,0,0,2,4,6
14865,NOP,2014,Melvin Ely,35,2,0,27,3,6,.500,0,0,,3,6,.500,.500,0,0,,0,1,1,0,0,1,0,5,6
14866,NOP,2014,James Southerland,23,3,0,27,5,12,.417,3,5,.600,2,7,.286,.542,1,2,.500,0,8,8,0,1,2,1,3,14
14867,NOP,2014,Arinze Onuaku,26,3,0,25,1,4,.250,0,0,,1,4,.250,.250,1,2,.500,2,5,7,3,0,0,1,3,3
14868,NOP,2014,Josh Childress,30,4,0,24,0,0,,0,0,,0,0,,,0,0,,0,3,3,2,1,0,1,1,0
14869,NOH,2013,Greivis Vásquez,26,78,78,2685,438,1012,.433,83,243,.342,355,769,.462,.474,124,154,.805,43,294,337,704,66,6,247,190,1083
14870,NOH,2013,Ryan Anderson,24,81,22,2503,472,1115,.423,213,557,.382,259,558,.464,.519,152,180,.844,191,328,519,97,42,31,97,179,1309
14871,NOH,2013,Robin Lopez,24,82,82,2136,384,719,.534,0,0,,384,719,.534,.534,161,207,.778,226,236,462,64,32,128,110,167,929
14872,NOH,2013,Al-Farouq Aminu,22,76,71,2066,225,474,.475,4,19,.211,221,455,.486,.479,101,137,.737,139,446,585,103,92,51,116,153,555
14873,NOH,2013,Anthony Davis,19,64,60,1846,349,676,.516,0,6,.000,349,670,.521,.516,169,225,.751,165,357,522,63,75,112,89,158,867
14874,NOH,2013,Austin Rivers,20,61,26,1418,145,390,.372,28,86,.326,117,304,.385,.408,59,108,.546,16,93,109,127,26,9,74,122,377
14875,NOH,2013,Brian Roberts,27,78,5,1324,213,511,.417,59,153,.386,154,358,.430,.475,70,77,.909,17,80,97,219,37,3,71,108,555
14876,NOH,2013,Eric Gordon,24,42,40,1264,235,584,.402,56,173,.324,179,411,.436,.450,187,222,.842,10,67,77,137,45,8,117,75,713
14877,NOH,2013,Roger Mason,32,69,13,1219,132,305,.433,66,159,.415,66,146,.452,.541,39,43,.907,11,121,132,74,26,11,51,104,369
14878,NOH,2013,Jason Smith,26,51,0,876,167,341,.490,0,4,.000,167,337,.496,.490,86,102,.843,64,122,186,34,15,45,55,123,420
14879,NOH,2013,Darius Miller,22,52,2,694,44,108,.407,22,56,.393,22,52,.423,.509,8,8,1.000,8,70,78,44,17,12,23,89,118
14880,NOH,2013,Lance Thomas,24,59,9,646,53,106,.500,0,0,,53,106,.500,.500,43,59,.729,44,71,115,17,11,7,14,78,149
14881,NOH,2013,Xavier Henry,21,50,2,625,66,161,.410,4,11,.364,62,150,.413,.422,58,92,.630,21,69,90,13,16,5,31,72,194
14882,NOH,2013,Lou Amundson,30,18,0,209,18,42,.429,0,0,,18,42,.429,.429,8,16,.500,24,34,58,8,9,6,8,27,44
14883,NOH,2013,Dominic McGuire,27,9,0,145,9,21,.429,0,0,,9,21,.429,.429,1,2,.500,7,21,28,9,8,3,5,13,19
14884,NOH,2013,Terrel Harris,25,13,0,108,2,19,.105,0,7,.000,2,12,.167,.105,1,2,.500,0,17,17,7,2,3,13,14,5
14885,NOH,2013,Hakim Warrick,30,1,0,7,1,2,.500,0,0,,1,2,.500,.500,2,2,1.000,0,0,0,0,1,0,0,0,4
14886,NOH,2013,Donald Sloan,25,3,0,6,0,0,,0,0,,0,0,,,0,0,,0,0,0,1,0,0,1,0,0
14887,NOH,2013,Henry Sims,22,2,0,5,2,3,.667,0,0,,2,3,.667,.667,0,0,,2,0,2,0,0,0,1,1,4
14888,NOH,2012,Marco Belinelli,25,66,55,1966,286,686,.417,107,284,.377,179,402,.445,.495,101,129,.783,19,153,172,101,48,5,69,115,780
14889,NOH,2012,Greivis Vásquez,25,66,26,1706,225,523,.430,43,135,.319,182,388,.469,.471,96,117,.821,23,150,173,359,60,8,148,126,589
14890,NOH,2012,Jarrett Jack,28,45,39,1530,266,583,.456,39,112,.348,227,471,.482,.490,129,148,.872,23,153,176,285,31,9,106,93,700
14891,NOH,2012,Al-Farouq Aminu,21,66,21,1477,150,365,.411,13,47,.277,137,318,.431,.429,86,114,.754,95,213,308,66,59,34,91,136,399
14892,NOH,2012,Chris Kaman,29,47,33,1372,266,597,.446,0,0,,266,597,.446,.446,84,107,.785,89,275,364,101,25,77,129,106,616
14893,NOH,2012,Trevor Ariza,26,41,41,1350,168,403,.417,29,87,.333,139,316,.440,.453,79,102,.775,41,174,215,135,69,25,76,73,444
14894,NOH,2012,Gustavo Ayón,26,54,24,1088,140,261,.536,0,1,.000,140,260,.538,.536,39,63,.619,86,179,265,74,53,46,46,118,319
14895,NOH,2012,Carl Landry,28,41,8,999,182,362,.503,0,3,.000,182,359,.507,.503,147,184,.799,78,136,214,38,13,12,64,89,511
14896,NOH,2012,Jason Smith,25,40,29,947,181,348,.520,1,9,.111,180,339,.531,.522,33,47,.702,72,124,196,34,21,41,40,102,396
14897,NOH,2012,Emeka Okafor,29,27,27,781,114,214,.533,0,0,,114,214,.533,.533,38,74,.514,70,143,213,24,16,26,37,73,266
14898,NOH,2012,Xavier Henry,20,45,0,759,90,228,.395,7,17,.412,83,211,.393,.410,52,85,.612,24,82,106,35,26,8,35,59,239
14899,NOH,2012,Lance Thomas,23,42,10,630,57,126,.452,0,1,.000,57,125,.456,.452,52,62,.839,49,77,126,12,10,7,24,78,166
14900,NOH,2012,Eric Gordon,23,9,9,310,63,140,.450,10,40,.250,53,100,.530,.486,49,65,.754,2,23,25,31,13,4,24,20,185
14901,NOH,2012,DaJuan Summers,24,15,6,209,28,65,.431,5,16,.313,23,49,.469,.469,7,9,.778,8,15,23,10,7,0,8,31,68
14902,NOH,2012,Solomon Jones,27,11,1,196,23,53,.434,0,0,,23,53,.434,.434,15,18,.833,21,20,41,7,5,6,13,31,61
14903,NOH,2012,Jerome Dyson,24,9,1,180,19,48,.396,1,8,.125,18,40,.450,.406,28,36,.778,2,17,19,18,11,2,20,19,67
14904,NOH,2012,Carldell Johnson,29,15,0,119,11,35,.314,4,15,.267,7,20,.350,.371,1,3,.333,1,8,9,22,8,0,7,11,27
14905,NOH,2012,Darryl Watkins,27,5,0,98,7,14,.500,0,0,,7,14,.500,.500,9,18,.500,8,19,27,3,5,4,8,14,23
14906,NOH,2012,Chris Johnson,26,7,0,82,9,18,.500,0,0,,9,18,.500,.500,5,7,.714,7,15,22,1,5,1,8,13,23
14907,NOH,2012,Trey Johnson,27,11,0,61,8,14,.571,0,0,,8,14,.571,.571,5,5,1.000,3,9,12,4,1,0,5,10,21
14908,NOH,2012,Donald Sloan,24,3,0,41,5,14,.357,0,2,.000,5,12,.417,.357,2,4,.500,2,1,3,8,2,0,5,2,12
14909,NOH,2012,Jeff Foote,24,4,0,39,2,6,.333,0,0,,2,6,.333,.333,0,0,,1,5,6,0,0,1,2,5,4
14910,NOH,2011,Chris Paul,25,80,80,2880,430,928,.463,71,183,.388,359,745,.482,.502,337,384,.878,38,289,327,782,188,5,177,196,1268
14911,NOH,2011,Trevor Ariza,25,75,75,2600,303,762,.398,82,271,.303,221,491,.450,.451,138,197,.701,61,347,408,162,120,31,118,180,826
14912,NOH,2011,David West,30,70,70,2451,528,1040,.508,2,9,.222,526,1031,.510,.509,264,327,.807,155,374,529,164,67,62,142,202,1322
14913,NOH,2011,Emeka Okafor,28,72,72,2287,300,524,.573,0,1,.000,300,523,.574,.573,145,258,.562,230,454,684,42,40,127,119,230,745
14914,NOH,2011,Marco Belinelli,24,80,69,1957,302,691,.437,134,324,.414,168,367,.458,.534,98,125,.784,17,134,151,92,38,6,77,146,836
14915,NOH,2011,Willie Green,29,77,13,1674,270,609,.443,54,155,.348,216,454,.476,.488,78,100,.780,22,139,161,74,36,13,67,143,672
14916,NOH,2011,Jarrett Jack,27,70,2,1375,212,515,.412,29,84,.345,183,431,.425,.440,142,168,.845,14,117,131,183,40,6,76,77,595
14917,NOH,2011,Jason Smith,24,77,6,1102,136,307,.443,0,2,.000,136,305,.446,.443,59,70,.843,89,152,241,36,26,32,53,150,331
14918,NOH,2011,Marcus Thornton,23,46,0,745,137,334,.410,35,93,.376,102,241,.423,.463,50,66,.758,25,106,131,43,19,4,37,50,359
14919,NOH,2011,Quincy Pondexter,22,66,6,734,73,180,.406,18,50,.360,55,130,.423,.456,24,34,.706,23,65,88,28,17,10,16,63,188
14920,NOH,2011,Carl Landry,27,23,10,602,107,203,.527,0,1,.000,107,202,.530,.527,58,73,.795,38,56,94,13,10,12,27,71,272
14921,NOH,2011,Aaron Gray,26,41,6,531,56,99,.566,0,0,,56,99,.566,.566,17,34,.500,59,112,171,16,11,12,32,96,129
14922,NOH,2011,D.J. Mbenga,30,41,0,330,23,49,.469,0,0,,23,49,.469,.469,13,18,.722,35,51,86,6,6,27,21,52,59
14923,NOH,2011,David Andersen,30,29,0,223,33,74,.446,5,13,.385,28,61,.459,.480,7,15,.467,12,38,50,6,2,6,14,29,78
14924,NOH,2011,Jerryd Bayless,22,11,0,149,17,49,.347,3,14,.214,14,35,.400,.378,13,17,.765,2,13,15,28,2,1,17,16,50
14925,NOH,2011,Peja Stojaković,33,6,0,89,14,33,.424,11,25,.440,3,8,.375,.591,6,7,.857,0,6,6,6,2,0,4,2,45
14926,NOH,2011,Sasha Pavlović,27,4,1,50,2,11,.182,0,5,.000,2,6,.333,.182,0,0,,0,6,6,6,0,4,1,4,4
14927,NOH,2011,Pops Mensah-Bonsu,27,7,0,35,1,3,.333,0,0,,1,3,.333,.333,0,0,,3,8,11,2,0,0,2,11,2
14928,NOH,2011,Patrick Ewing,26,7,0,19,0,5,.000,0,2,.000,0,3,.000,.000,3,4,.750,1,1,2,2,0,1,1,1,3
14929,NOH,2010,David West,29,81,81,2949,619,1226,.505,7,27,.259,612,1199,.510,.508,296,342,.865,164,441,605,239,76,60,173,233,1541
14930,NOH,2010,Emeka Okafor,27,82,82,2370,348,656,.530,0,0,,348,656,.530,.530,154,274,.562,251,491,742,55,54,127,111,218,850
14931,NOH,2010,Darren Collison,22,76,37,2109,376,789,.477,46,115,.400,330,674,.490,.506,148,174,.851,41,151,192,432,78,4,202,92,946
14932,NOH,2010,Peja Stojaković,32,62,55,1947,278,688,.404,132,352,.375,146,336,.435,.500,96,107,.897,39,188,227,92,48,5,56,83,784
14933,NOH,2010,Marcus Thornton,22,73,17,1872,398,883,.451,117,313,.374,281,570,.493,.517,144,177,.814,72,139,211,114,58,11,76,127,1057
14934,NOH,2010,James Posey,33,77,2,1731,126,345,.365,81,242,.335,45,103,.437,.483,66,80,.825,32,297,329,117,42,19,51,204,399
14935,NOH,2010,Chris Paul,24,45,45,1712,314,637,.493,52,127,.409,262,510,.514,.534,161,190,.847,20,171,191,480,96,8,112,118,841
14936,NOH,2010,Darius Songaila,31,75,1,1410,241,488,.494,1,6,.167,240,482,.498,.495,60,74,.811,59,173,232,70,62,14,81,206,543
14937,NOH,2010,Morris Peterson,32,46,39,973,116,301,.385,62,171,.363,54,130,.415,.488,33,54,.611,17,109,126,41,25,5,27,81,327
14938,NOH,2010,Devin Brown,31,39,37,967,128,325,.394,54,147,.367,74,178,.416,.477,69,86,.802,27,82,109,58,30,5,57,62,379
14939,NOH,2010,Julian Wright,22,68,14,871,116,232,.500,2,6,.333,114,226,.504,.504,25,41,.610,58,86,144,41,29,18,44,45,259
14940,NOH,2010,Bobby Brown,25,22,0,328,60,152,.395,17,66,.258,43,86,.500,.451,8,8,1.000,1,17,18,46,9,1,24,28,145
14941,NOH,2010,Aaron Gray,25,24,0,261,34,61,.557,0,0,,34,61,.557,.557,18,21,.857,40,50,90,20,9,11,17,44,86
14942,NOH,2010,Hilton Armstrong,25,18,0,239,19,50,.380,0,0,,19,50,.380,.380,13,28,.464,17,44,61,16,8,8,13,44,51
14943,NOH,2010,Sean Marks,34,14,0,75,4,8,.500,0,0,,4,8,.500,.500,2,5,.400,14,9,23,2,0,3,2,17,10
14944,NOH,2010,Jason Hart,31,4,0,17,1,1,1.000,0,0,,1,1,1.000,1.000,0,0,,0,2,2,5,1,1,3,4,2
14945,NOH,2009,Chris Paul,23,78,78,3002,631,1255,.503,64,176,.364,567,1079,.525,.528,455,524,.868,69,363,432,861,216,10,231,212,1781
14946,NOH,2009,David West,28,76,76,2982,610,1292,.472,6,25,.240,604,1267,.477,.474,367,415,.884,160,486,646,173,49,68,163,207,1593
14947,NOH,2009,Rasual Butler,29,82,74,2614,348,803,.433,140,359,.390,208,444,.468,.521,86,110,.782,49,222,271,75,51,61,59,159,922
14948,NOH,2009,James Posey,32,75,0,2140,216,524,.412,116,314,.369,100,210,.476,.523,120,146,.822,38,324,362,82,58,21,79,216,668
14949,NOH,2009,Peja Stojaković,31,61,59,2089,287,719,.399,145,384,.378,142,335,.424,.500,93,104,.894,44,220,264,75,52,3,51,101,812
14950,NOH,2009,Tyson Chandler,26,45,45,1445,160,283,.565,0,0,,160,283,.565,.565,77,133,.579,163,230,393,22,15,56,70,144,397
14951,NOH,2009,Hilton Armstrong,24,70,29,1092,138,246,.561,0,2,.000,138,244,.566,.561,62,98,.633,81,114,195,29,26,45,80,181,338
14952,NOH,2009,Devin Brown,30,63,5,869,111,313,.355,28,97,.289,83,216,.384,.399,78,100,.780,31,88,119,54,32,5,54,81,328
14953,NOH,2009,Sean Marks,33,60,5,838,80,165,.485,2,10,.200,78,155,.503,.491,30,44,.682,62,125,187,14,7,33,35,121,192
14954,NOH,2009,Julian Wright,21,54,19,772,109,234,.466,2,21,.095,107,213,.502,.470,17,30,.567,46,106,152,43,35,19,43,49,237
14955,NOH,2009,Antonio Daniels,33,61,4,733,81,191,.424,17,49,.347,64,142,.451,.469,55,67,.821,5,50,55,130,19,1,49,41,234
14956,NOH,2009,Morris Peterson,31,43,9,515,73,183,.399,33,85,.388,40,98,.408,.489,12,19,.632,13,71,84,16,15,2,15,51,191
14957,NOH,2009,Melvin Ely,30,31,4,373,37,95,.389,0,0,,37,95,.389,.389,23,36,.639,30,34,64,18,2,9,23,58,97
14958,NOH,2009,Ryan Bowen,33,21,3,219,22,38,.579,0,0,,22,38,.579,.579,3,5,.600,10,14,24,9,14,5,5,37,47
14959,NOH,2009,Mike James,33,8,0,74,8,25,.320,3,4,.750,5,21,.238,.380,1,2,.500,1,6,7,8,2,0,3,7,20
14960,NOH,2008,Chris Paul,22,80,80,3006,630,1291,.488,92,249,.369,538,1042,.516,.524,332,390,.851,62,259,321,925,217,4,201,185,1684
14961,NOH,2008,David West,27,76,76,2870,629,1305,.482,6,25,.240,623,1280,.487,.484,300,353,.850,180,495,675,177,62,99,165,208,1564
14962,NOH,2008,Tyson Chandler,25,79,79,2783,377,605,.623,0,1,.000,377,604,.624,.623,175,295,.593,322,606,928,81,45,84,136,243,929
14963,NOH,2008,Peja Stojaković,30,77,77,2711,451,1026,.440,231,524,.441,220,502,.438,.552,130,140,.929,64,267,331,96,57,10,61,127,1263
14964,NOH,2008,Morris Peterson,30,76,76,1796,215,516,.417,113,287,.394,102,229,.445,.526,65,85,.765,36,170,206,67,47,7,41,125,608
14965,NOH,2008,Jannero Pargo,28,80,5,1497,254,652,.390,65,186,.349,189,466,.406,.439,71,81,.877,26,104,130,192,50,5,93,123,644
14966,NOH,2008,Bobby Jackson,34,46,0,891,116,296,.392,53,144,.368,63,152,.414,.481,40,49,.816,23,87,110,76,32,3,31,59,325
14967,NOH,2008,Rasual Butler,28,51,8,875,91,260,.350,44,133,.331,47,127,.370,.435,26,31,.839,16,84,100,36,15,21,10,66,252
14968,NOH,2008,Hilton Armstrong,23,65,3,732,67,148,.453,0,0,,67,148,.453,.453,44,70,.629,65,98,163,23,15,34,59,130,178
14969,NOH,2008,Ryan Bowen,32,53,4,660,49,100,.490,0,1,.000,49,99,.495,.490,16,29,.552,55,45,100,25,32,11,15,77,114
14970,NOH,2008,Julian Wright,20,57,1,640,90,169,.533,10,24,.417,80,145,.552,.562,33,52,.635,33,84,117,40,29,12,34,43,223
14971,NOH,2008,Melvin Ely,29,52,1,621,85,180,.472,0,0,,85,180,.472,.472,32,58,.552,28,117,145,22,7,18,42,79,202
14972,NOH,2008,Bonzi Wells,31,22,0,438,77,157,.490,4,12,.333,73,145,.503,.503,35,53,.660,21,50,71,17,24,8,27,44,193
14973,NOH,2008,Mike James,32,21,0,183,22,64,.344,7,23,.304,15,41,.366,.398,6,6,1.000,3,14,17,6,4,0,7,12,57
14974,NOH,2008,Marcus Vinicius,23,13,0,69,9,20,.450,5,12,.417,4,8,.500,.575,5,11,.455,1,7,8,2,1,1,3,4,28
14975,NOH,2008,Chris Andersen,29,5,0,34,2,7,.286,0,0,,2,7,.286,.286,2,4,.500,2,7,9,0,0,4,1,6,6
14976,NOK,2007,Desmond Mason,29,75,75,2575,407,900,.452,0,0,,407,900,.452,.452,214,323,.663,124,221,345,115,52,22,192,174,1028
14977,NOK,2007,Tyson Chandler,24,73,73,2525,292,468,.624,0,1,.000,292,467,.625,.624,106,201,.527,320,584,904,66,37,129,126,244,690
14978,NOK,2007,Chris Paul,21,64,64,2353,381,871,.437,50,143,.350,331,728,.455,.466,292,357,.818,54,226,280,569,118,3,161,154,1104
14979,NOK,2007,Rasual Butler,27,81,38,2223,314,788,.398,134,363,.369,180,425,.424,.484,56,87,.644,42,214,256,63,40,54,67,148,818
14980,NOK,2007,David West,26,52,52,1900,377,792,.476,8,25,.320,369,767,.481,.481,187,227,.824,126,298,424,114,42,38,98,143,949
14981,NOK,2007,Jannero Pargo,27,82,7,1710,283,692,.409,81,209,.388,202,483,.418,.467,104,122,.852,20,160,180,203,53,4,122,121,751
14982,NOK,2007,Devin Brown,28,58,49,1662,233,555,.420,81,227,.357,152,328,.463,.493,123,155,.794,55,196,251,149,44,9,91,139,670
14983,NOK,2007,Bobby Jackson,33,56,2,1330,204,518,.394,54,165,.327,150,353,.425,.446,130,168,.774,42,136,178,141,50,6,78,98,592
14984,NOK,2007,Marc Jackson,32,56,25,1025,159,388,.410,0,1,.000,159,387,.411,.410,90,103,.874,62,130,192,58,21,7,65,89,408
14985,NOK,2007,Linton Johnson,26,54,0,720,93,190,.489,10,30,.333,83,160,.519,.516,30,37,.811,52,111,163,18,33,18,27,101,226
14986,NOK,2007,Hilton Armstrong,22,56,5,634,68,125,.544,0,0,,68,125,.544,.544,40,67,.597,58,91,149,10,12,26,35,79,176
14987,NOK,2007,Cedric Simmons,21,43,4,534,55,132,.417,0,0,,55,132,.417,.417,16,33,.485,44,63,107,12,8,23,22,75,126
14988,NOK,2007,Peja Stojaković,29,13,13,425,83,196,.423,34,84,.405,49,112,.438,.510,31,38,.816,11,43,54,11,8,4,19,29,231
14989,NOK,2007,Brandon Bass,21,21,3,162,15,44,.341,0,1,.000,15,43,.349,.341,12,16,.750,13,30,43,3,2,3,10,16,42
14990,NOK,2007,Marcus Vinicius,22,13,0,103,7,15,.467,3,7,.429,4,8,.500,.567,5,7,.714,2,9,11,5,2,1,6,10,22
14991,NOK,2006,Chris Paul,20,78,78,2808,407,947,.430,50,177,.282,357,770,.464,.456,394,465,.847,61,339,400,611,175,6,183,218,1258
14992,NOK,2006,David West,25,74,74,2526,530,1036,.512,3,11,.273,527,1025,.514,.513,199,236,.843,168,380,548,92,61,64,105,214,1262
14993,NOK,2006,P.J. Brown,36,75,73,2380,269,583,.461,0,0,,269,583,.461,.461,139,168,.827,182,365,547,90,46,50,90,216,677
14994,NOK,2006,Desmond Mason,28,70,55,2102,275,690,.399,1,6,.167,274,684,.401,.399,206,302,.682,64,234,298,66,42,17,113,136,757
14995,NOK,2006,Speedy Claxton,27,71,3,2019,304,736,.413,17,63,.270,287,673,.426,.425,246,320,.769,39,154,193,339,108,6,154,177,871
14996,NOK,2006,Rasual Butler,26,79,20,1875,257,633,.406,92,242,.380,165,391,.422,.479,79,114,.693,51,181,232,40,33,45,65,142,685
14997,NOK,2006,Kirk Snyder,22,68,45,1310,205,453,.453,46,129,.357,159,324,.491,.503,86,117,.735,55,106,161,102,29,23,70,106,542
14998,NOK,2006,J.R. Smith,20,55,25,989,144,366,.393,52,140,.371,92,226,.407,.464,83,101,.822,19,91,110,58,37,4,54,90,423
14999,NOK,2006,Aaron Williams,34,34,2,692,81,157,.516,0,0,,81,157,.516,.516,35,52,.673,59,107,166,16,13,18,25,110,197
15000,NOK,2006,Marc Jackson,31,27,10,594,108,221,.489,1,2,.500,107,219,.489,.491,28,34,.824,56,72,128,22,8,2,37,56,245
15001,NOK,2006,Chris Andersen,27,32,2,570,56,98,.571,0,0,,56,98,.571,.571,49,103,.476,61,94,155,6,8,41,26,84,161
15002,NOK,2006,Linton Johnson,25,27,7,489,56,139,.403,13,36,.361,43,103,.417,.450,17,23,.739,40,75,115,12,10,12,24,54,142
15003,NOK,2006,Jackson Vroman,24,41,2,406,26,66,.394,0,0,,26,66,.394,.394,21,44,.477,33,53,86,11,12,11,21,78,73
15004,NOK,2006,Boštjan Nachbar,25,25,13,405,42,124,.339,17,57,.298,25,67,.373,.407,25,36,.694,4,45,49,22,13,5,20,52,126
15005,NOK,2006,Brandon Bass,20,29,1,268,28,70,.400,0,0,,28,70,.400,.400,12,19,.632,18,50,68,3,3,7,11,18,68
15006,NOK,2006,Moochie Norris,32,16,0,183,20,47,.426,4,9,.444,16,38,.421,.468,16,25,.640,3,17,20,21,6,0,17,18,60
15007,NOK,2006,Arvydas Macijauskas,26,19,0,135,14,41,.341,3,12,.250,11,29,.379,.378,13,15,.867,3,7,10,5,7,0,8,10,44
15008,NOK,2006,Marcus Fizer,27,3,0,39,9,17,.529,1,1,1.000,8,16,.500,.559,1,2,.500,1,6,7,1,0,0,2,5,20
15009,NOK,2006,Maciej Lampe,20,2,0,16,0,4,.000,0,0,,0,4,.000,.000,0,0,,1,3,4,2,0,0,1,2,0
15010,NOH,2005,P.J. Brown,35,82,78,2817,338,758,.446,0,0,,338,758,.446,.446,210,243,.864,266,471,737,178,74,50,101,233,886
15011,NOH,2005,Dan Dickau,26,67,46,2074,305,748,.408,84,242,.347,221,506,.437,.464,188,225,.836,34,145,179,346,76,4,144,200,882
15012,NOH,2005,Lee Nailon,29,68,51,2017,415,869,.478,0,2,.000,415,867,.479,.478,133,165,.806,128,170,298,109,36,16,110,190,963
15013,NOH,2005,J.R. Smith,19,76,56,1859,295,748,.394,81,281,.288,214,467,.458,.449,111,161,.689,39,113,152,142,55,11,109,135,782
15014,NOH,2005,Chris Andersen,26,67,2,1430,191,358,.534,0,3,.000,191,355,.538,.534,131,190,.689,137,273,410,71,14,100,64,144,513
15015,NOH,2005,Boštjan Nachbar,24,55,4,1137,146,368,.397,65,175,.371,81,193,.420,.485,88,105,.838,20,132,152,65,28,16,68,153,445
15016,NOH,2005,Casey Jacobsen,23,44,1,1030,100,251,.398,32,88,.364,68,163,.417,.462,103,130,.792,18,82,100,76,22,7,44,48,335
15017,NOH,2005,David Wesley,34,26,26,934,133,342,.389,28,80,.350,105,262,.401,.430,67,76,.882,12,73,85,109,35,1,54,65,361
15018,NOH,2005,George Lynch,34,44,27,933,68,189,.360,11,37,.297,57,152,.375,.389,17,23,.739,55,119,174,88,32,12,57,83,164
15019,NOH,2005,Rodney Rogers,33,30,26,882,109,289,.377,25,92,.272,84,197,.426,.420,32,42,.762,28,114,142,60,19,12,66,103,275
15020,NOH,2005,Jamaal Magloire,26,23,22,703,98,227,.432,0,0,,98,227,.432,.432,74,123,.602,79,126,205,29,8,23,59,74,270
15021,NOH,2005,Jackson Vroman,23,36,17,648,76,183,.415,0,3,.000,76,180,.422,.415,44,68,.647,59,103,162,33,22,17,57,94,196
15022,NOH,2005,Baron Davis,25,18,13,593,111,303,.366,44,137,.321,67,166,.404,.439,74,96,.771,16,51,67,129,31,4,38,52,340
15023,NOH,2005,David West,24,30,8,552,75,172,.436,2,5,.400,73,167,.437,.442,34,50,.680,40,89,129,23,12,16,37,62,186
15024,NOH,2005,Junior Harrington,24,29,7,550,64,178,.360,6,19,.316,58,159,.365,.376,29,35,.829,13,50,63,62,25,5,41,72,163
15025,NOH,2005,Matt Freije,23,23,11,441,37,127,.291,14,54,.259,23,73,.315,.346,5,8,.625,16,45,61,20,13,2,17,40,93
15026,NOH,2005,Darrell Armstrong,36,14,9,412,53,159,.333,17,70,.243,36,89,.404,.387,19,21,.905,16,32,48,65,15,2,28,30,142
15027,NOH,2005,Speedy Claxton,26,16,3,365,41,110,.373,1,9,.111,40,101,.396,.377,25,41,.610,5,26,31,88,22,2,27,30,108
15028,NOH,2005,Maciej Lampe,19,21,0,261,32,83,.386,0,1,.000,32,82,.390,.386,7,10,.700,15,42,57,10,4,5,7,31,71
15029,NOH,2005,Alex Garcia,24,8,3,146,18,52,.346,5,18,.278,13,34,.382,.394,3,4,.750,7,8,15,18,4,1,8,15,44
15030,NOH,2005,Corsley Edwards,25,10,0,110,10,31,.323,0,0,,10,31,.323,.323,7,12,.583,12,13,25,3,3,4,2,19,27
15031,NOH,2005,Lonny Baxter,26,4,0,36,3,11,.273,0,0,,3,11,.273,.273,0,2,.000,4,4,8,0,0,0,4,10,6
15032,NOH,2004,Jamaal Magloire,25,82,82,2777,383,809,.473,0,1,.000,383,808,.474,.473,353,470,.751,268,579,847,86,43,101,201,278,1119
15033,NOH,2004,P.J. Brown,34,80,80,2753,339,712,.476,0,1,.000,339,711,.477,.476,158,185,.854,237,453,690,155,78,73,101,203,836
15034,NOH,2004,Baron Davis,24,67,66,2686,554,1402,.395,187,582,.321,367,820,.448,.462,237,352,.673,66,221,287,501,158,27,215,178,1532
15035,NOH,2004,Darrell Armstrong,35,79,22,2247,291,736,.395,135,429,.315,156,307,.508,.487,123,144,.854,63,163,226,311,133,16,155,148,840
15036,NOH,2004,David Wesley,33,61,60,2001,311,800,.389,92,285,.323,219,515,.425,.446,137,182,.753,28,106,134,175,71,14,100,147,851
15037,NOH,2004,George Lynch,33,78,51,1701,149,375,.397,43,139,.309,106,236,.449,.455,34,51,.667,96,216,312,117,48,18,64,159,375
15038,NOH,2004,Stacey Augmon,35,69,24,1416,143,347,.412,1,7,.143,142,340,.418,.414,110,139,.791,52,122,174,85,55,15,76,114,397
15039,NOH,2004,Robert Traylor,26,71,0,942,145,287,.505,2,5,.400,143,282,.507,.509,70,128,.547,106,156,262,43,39,37,62,161,362
15040,NOH,2004,David West,23,71,1,930,108,228,.474,0,2,.000,108,226,.478,.474,57,80,.713,117,180,297,60,27,28,48,117,273
15041,NOH,2004,Steve Smith,34,71,4,929,119,293,.406,43,107,.402,76,186,.409,.480,77,83,.928,27,54,81,56,15,6,42,91,358
15042,NOH,2004,Jamal Mashburn,31,19,18,730,156,398,.392,19,67,.284,137,331,.414,.416,65,80,.813,19,98,117,47,14,5,37,42,396
15043,NOH,2004,Sean Rooks,34,35,0,325,34,94,.362,0,0,,34,94,.362,.362,12,15,.800,10,40,50,11,9,5,15,48,80
15044,NOH,2004,Shammond Williams,28,16,2,238,28,81,.346,5,26,.192,23,55,.418,.377,11,13,.846,0,17,17,52,14,1,21,22,72
15045,NOH,2004,Bryce Drew,29,15,0,78,4,18,.222,1,7,.143,3,11,.273,.250,3,3,1.000,0,6,6,13,4,0,8,1,12
15046,NOH,2004,Maurice Carter,27,6,0,60,6,21,.286,3,8,.375,3,13,.231,.357,5,8,.625,2,6,8,2,0,0,3,5,20
15047,NOH,2004,Tierre Brown,24,3,0,17,2,4,.500,0,0,,2,4,.500,.500,2,4,.500,0,1,1,2,0,0,7,1,6
15048,NOH,2003,Jamal Mashburn,30,82,81,3321,670,1586,.422,119,306,.389,551,1280,.430,.460,313,369,.848,66,432,498,462,83,17,230,196,1772
15049,NOH,2003,David Wesley,32,73,73,2710,449,1037,.433,134,316,.424,315,721,.437,.498,185,237,.781,38,137,175,251,109,9,132,173,1217
15050,NOH,2003,P.J. Brown,33,78,78,2609,319,601,.531,0,3,.000,319,598,.533,.531,194,232,.836,243,458,701,147,67,80,98,203,832
15051,NOH,2003,Jamaal Magloire,24,82,82,2443,305,635,.480,0,3,.000,305,632,.483,.480,231,322,.717,260,464,724,88,49,111,158,276,841
15052,NOH,2003,Baron Davis,23,50,47,1889,332,798,.416,99,283,.350,233,515,.452,.478,93,131,.710,56,130,186,320,91,22,140,148,856
15053,NOH,2003,George Lynch,32,81,32,1497,147,359,.409,28,79,.354,119,280,.425,.448,41,74,.554,139,214,353,104,66,19,52,136,363
15054,NOH,2003,Courtney Alexander,25,66,7,1360,193,505,.382,19,57,.333,174,448,.388,.401,118,146,.808,39,79,118,79,31,6,68,125,523
15055,NOH,2003,Stacey Augmon,34,70,3,862,79,192,.411,0,7,.000,79,185,.427,.411,54,72,.750,26,93,119,69,27,9,40,80,212
15056,NOH,2003,Robert Traylor,25,69,0,851,105,237,.443,1,3,.333,104,234,.444,.445,57,88,.648,108,154,262,50,45,37,53,153,268
15057,NOH,2003,Elden Campbell,34,41,1,685,101,247,.409,0,1,.000,101,246,.411,.409,93,115,.809,34,108,142,42,24,31,42,102,295
15058,NOH,2003,Jérôme Moïso,24,51,1,644,89,171,.520,0,0,,89,171,.520,.520,27,41,.659,59,119,178,22,19,44,46,87,205
15059,NOH,2003,Kenny Anderson,32,23,1,446,61,150,.407,1,2,.500,60,148,.405,.410,16,22,.727,14,31,45,77,18,4,42,43,139
15060,NOH,2003,Robert Pack,33,28,4,440,52,129,.403,0,5,.000,52,124,.419,.403,41,55,.745,11,40,51,81,25,0,40,35,145
15061,NOH,2003,Bryce Drew,28,13,0,79,8,27,.296,3,7,.429,5,20,.250,.352,0,0,,4,9,13,11,2,0,3,2,19
15062,NOH,2003,Kirk Haston,23,12,0,57,2,17,.118,0,3,.000,2,14,.143,.118,2,4,.500,0,7,7,3,0,5,7,10,6
15063,NOH,2003,Randy Livingston,27,2,0,12,2,4,.500,0,0,,2,4,.500,.500,2,2,1.000,0,0,0,1,0,0,0,0,6
15064,GSW,2024,Stephen Curry,35,74,74,2421,650,1445,.450,357,876,.408,293,569,.515,.573,299,324,.923,37,293,330,379,54,28,210,117,1956
15065,GSW,2024,Klay Thompson,33,77,63,2284,490,1133,.432,268,692,.387,222,441,.503,.551,127,137,.927,35,219,254,176,50,35,117,127,1375
15066,GSW,2024,Brandin Podziemski,20,74,28,1968,271,597,.454,90,234,.385,181,363,.499,.529,50,79,.633,118,309,427,273,61,14,88,122,682
15067,GSW,2024,Jonathan Kuminga,21,74,46,1949,456,862,.529,53,165,.321,403,697,.578,.560,223,299,.746,92,263,355,163,55,36,122,169,1188
15068,GSW,2024,Andrew Wiggins,28,71,59,1920,353,780,.453,91,254,.358,262,526,.498,.511,142,189,.751,108,213,321,119,42,41,87,147,939
15069,GSW,2024,Chris Paul,38,58,18,1531,206,467,.441,78,210,.371,128,257,.498,.525,43,52,.827,18,207,225,393,70,6,76,108,533
15070,GSW,2024,Draymond Green,33,55,52,1490,185,372,.497,51,129,.395,134,243,.551,.566,54,74,.730,76,322,398,332,55,47,135,166,475
15071,GSW,2024,Kevon Looney,27,74,36,1195,139,233,.597,0,1,.000,139,232,.599,.597,56,83,.675,143,276,419,133,28,29,50,155,334
15072,GSW,2024,Moses Moody,21,66,9,1156,194,420,.462,72,200,.360,122,220,.555,.548,73,93,.785,65,131,196,57,42,24,44,90,533
15073,GSW,2024,Trayce Jackson-Davis,23,68,16,1130,233,332,.702,0,1,.000,233,331,.704,.702,74,132,.561,135,206,341,82,29,76,49,108,540
15074,GSW,2024,Dario Šarić,29,64,9,1098,181,388,.466,74,197,.376,107,191,.560,.562,79,93,.849,73,210,283,144,31,10,78,112,515
15075,GSW,2024,Gary Payton II,31,44,0,680,103,183,.563,20,55,.364,83,128,.648,.617,14,23,.609,46,67,113,48,39,18,27,77,240
15076,GSW,2024,Lester Quiñones,23,37,0,394,56,141,.397,32,88,.364,24,53,.453,.511,20,29,.690,21,51,72,36,6,2,17,44,164
15077,GSW,2024,Cory Joseph,32,26,0,296,23,64,.359,13,42,.310,10,22,.455,.461,4,7,.571,6,24,30,42,4,3,12,25,63
15078,GSW,2024,Gui Santos,21,23,0,192,28,55,.509,10,27,.370,18,28,.643,.600,16,17,.941,17,32,49,14,4,2,7,23,82
15079,GSW,2024,Jerome Robinson,26,22,0,81,11,33,.333,2,17,.118,9,16,.563,.364,7,11,.636,1,5,6,5,1,3,2,5,31
15080,GSW,2024,Pat Spencer,27,6,0,26,2,4,.500,0,2,.000,2,2,1.000,.500,0,0,,2,2,4,5,0,0,1,1,4
15081,GSW,2024,Usman Garuba,21,6,0,18,1,6,.167,0,1,.000,1,5,.200,.167,1,2,.500,3,4,7,1,1,3,2,2,3
15082,GSW,2023,Jordan Poole,23,82,43,2458,550,1278,.430,214,637,.336,336,641,.524,.514,361,415,.870,32,193,225,369,63,21,252,214,1675
15083,GSW,2023,Draymond Green,32,73,73,2297,250,474,.527,40,131,.305,210,343,.612,.570,77,108,.713,66,459,525,500,74,60,204,229,617
15084,GSW,2023,Klay Thompson,32,69,69,2279,546,1252,.436,301,731,.412,245,521,.470,.556,116,132,.879,39,247,286,163,49,29,123,130,1509
15085,GSW,2023,Kevon Looney,26,82,70,1958,242,384,.630,0,1,.000,242,383,.632,.630,94,155,.606,274,486,760,207,52,50,45,225,578
15086,GSW,2023,Stephen Curry,34,56,56,1941,559,1133,.493,273,639,.427,286,494,.579,.614,257,281,.915,39,302,341,352,52,20,179,117,1648
15087,GSW,2023,Donte DiVincenzo,26,72,36,1894,235,540,.435,150,378,.397,85,162,.525,.574,58,71,.817,80,245,325,252,97,10,112,133,678
15088,GSW,2023,Jonathan Kuminga,20,67,16,1394,261,497,.525,54,146,.370,207,351,.590,.579,90,138,.652,70,161,231,125,41,31,95,157,666
15089,GSW,2023,Anthony Lamb,25,62,4,1195,148,314,.471,73,199,.367,75,115,.652,.588,46,60,.767,56,159,215,96,28,20,54,134,415
15090,GSW,2023,Andrew Wiggins,27,37,37,1190,250,529,.473,89,225,.396,161,304,.530,.557,44,72,.611,61,125,186,85,45,28,48,107,633
15091,GSW,2023,Moses Moody,20,63,3,817,108,227,.476,49,135,.363,59,92,.641,.584,37,53,.698,28,77,105,51,18,7,34,54,302
15092,GSW,2023,Ty Jerome,25,45,2,816,118,242,.488,35,90,.389,83,152,.546,.560,38,41,.927,7,71,78,135,23,5,30,64,309
15093,GSW,2023,JaMychal Green,32,57,1,797,136,252,.540,42,111,.378,94,141,.667,.623,52,67,.776,72,133,205,51,25,23,52,105,366
15094,GSW,2023,James Wiseman,21,21,0,262,59,94,.628,1,2,.500,58,92,.630,.633,26,38,.684,18,55,73,14,3,7,14,39,145
15095,GSW,2023,Patrick Baldwin Jr.,20,31,0,226,43,109,.394,32,84,.381,11,25,.440,.541,4,6,.667,1,39,40,11,6,4,11,14,122
15096,GSW,2023,Andre Iguodala,39,8,0,113,7,15,.467,1,9,.111,6,6,1.000,.500,2,3,.667,3,14,17,19,4,3,9,11,17
15097,GSW,2023,Gary Payton II,30,7,0,112,17,28,.607,4,9,.444,13,19,.684,.679,2,3,.667,14,16,30,8,6,4,4,14,40
15098,GSW,2023,Ryan Rollins,20,12,0,62,7,20,.350,3,9,.333,4,11,.364,.425,6,6,1.000,3,9,12,6,1,1,16,10,23
15099,GSW,2023,Lester Quiñones,22,4,0,18,2,5,.400,2,4,.500,0,1,.000,.600,4,6,.667,1,2,3,2,1,0,5,0,10
15100,GSW,2022,Andrew Wiggins,26,73,73,2330,475,1019,.466,157,399,.393,318,620,.513,.543,149,235,.634,85,240,325,161,76,51,111,158,1256
15101,GSW,2022,Jordan Poole,22,76,51,2283,474,1058,.448,211,580,.364,263,478,.550,.548,246,266,.925,34,226,260,304,60,23,187,206,1405
15102,GSW,2022,Stephen Curry,33,64,64,2211,535,1224,.437,285,750,.380,250,474,.527,.554,275,298,.923,34,301,335,404,85,23,206,130,1630
15103,GSW,2022,Kevon Looney,25,82,80,1732,208,364,.571,0,1,.000,208,363,.573,.571,75,125,.600,208,388,596,165,50,52,67,215,491
15104,GSW,2022,Otto Porter Jr.,28,63,15,1396,193,416,.464,80,216,.370,113,200,.565,.560,49,61,.803,86,276,362,94,68,29,37,83,515
15105,GSW,2022,Draymond Green,31,46,44,1329,135,257,.525,16,54,.296,119,203,.586,.556,60,91,.659,45,291,336,320,61,50,139,136,346
15106,GSW,2022,Damion Lee,29,63,5,1256,169,383,.441,63,187,.337,106,196,.541,.523,66,75,.880,27,176,203,63,39,6,38,95,467
15107,GSW,2022,Gary Payton II,29,71,16,1248,212,344,.616,43,120,.358,169,224,.754,.679,35,58,.603,72,175,247,64,96,22,40,131,502
15108,GSW,2022,Jonathan Kuminga,19,70,12,1185,236,460,.513,50,149,.336,186,311,.598,.567,130,190,.684,54,180,234,64,31,22,74,146,652
15109,GSW,2022,Nemanja Bjelica,33,71,0,1143,160,342,.468,54,149,.362,106,193,.549,.547,59,81,.728,62,232,294,159,41,26,87,128,433
15110,GSW,2022,Juan Toscano-Anderson,28,73,6,994,115,235,.489,28,87,.322,87,148,.588,.549,40,70,.571,28,148,176,127,48,17,68,115,298
15111,GSW,2022,Klay Thompson,31,32,32,941,246,573,.429,114,296,.385,132,277,.477,.529,46,51,.902,15,110,125,88,16,17,43,54,652
15112,GSW,2022,Moses Moody,19,52,11,607,80,183,.437,40,110,.364,40,73,.548,.546,28,36,.778,17,63,80,23,7,10,13,43,228
15113,GSW,2022,Andre Iguodala,38,31,0,603,46,121,.380,17,74,.230,29,47,.617,.450,15,20,.750,21,79,100,114,27,22,28,34,124
15114,GSW,2022,Chris Chiozza,26,34,1,372,24,81,.296,17,53,.321,7,28,.250,.401,2,3,.667,9,27,36,65,13,0,32,32,67
15115,GSW,2022,Quinndary Weatherspoon,25,11,0,73,12,21,.571,1,5,.200,11,16,.688,.595,5,5,1.000,2,12,14,5,1,1,3,15,30
15116,GSW,2022,Jeff Dowtin,24,4,0,28,3,6,.500,0,1,.000,3,5,.600,.500,0,0,,1,6,7,3,0,1,1,2,6
15117,GSW,2021,Andrew Wiggins,25,71,71,2364,505,1058,.477,140,368,.380,365,690,.529,.543,170,238,.714,82,265,347,167,67,70,126,159,1320
15118,GSW,2021,Stephen Curry,32,63,63,2152,658,1365,.482,337,801,.421,321,564,.569,.605,362,395,.916,29,316,345,363,77,8,213,119,2015
15119,GSW,2021,Draymond Green,30,63,63,1982,170,380,.447,34,126,.270,136,254,.535,.492,70,88,.795,55,394,449,558,105,52,188,194,444
15120,GSW,2021,Kelly Oubre Jr.,25,55,50,1687,318,724,.439,90,285,.316,228,439,.519,.501,123,177,.695,82,247,329,73,57,42,70,121,849
15121,GSW,2021,Kent Bazemore,31,67,18,1333,176,392,.449,75,184,.408,101,208,.486,.545,54,78,.692,26,203,229,108,69,33,82,158,481
15122,GSW,2021,Kevon Looney,24,61,34,1161,108,197,.548,4,17,.235,104,180,.578,.558,31,48,.646,117,205,322,119,21,22,37,136,251
15123,GSW,2021,Juan Toscano-Anderson,27,53,16,1107,121,209,.579,37,92,.402,84,117,.718,.667,22,31,.710,29,205,234,150,41,26,61,111,301
15124,GSW,2021,Damion Lee,28,57,1,1079,128,274,.467,77,194,.397,51,80,.638,.608,40,44,.909,22,158,180,73,38,8,30,89,373
15125,GSW,2021,Jordan Poole,21,51,7,988,205,474,.432,97,276,.351,108,198,.545,.535,105,119,.882,15,77,92,99,26,9,51,86,612
15126,GSW,2021,James Wiseman,19,39,27,836,191,368,.519,12,38,.316,179,330,.542,.535,54,86,.628,55,171,226,26,11,36,60,121,448
15127,GSW,2021,Mychal Mulder,26,60,6,766,119,265,.449,85,214,.397,34,51,.667,.609,14,22,.636,8,52,60,26,12,12,16,56,337
15128,GSW,2021,Eric Paschall,24,40,2,695,148,298,.497,18,54,.333,130,244,.533,.527,67,94,.713,28,100,128,51,12,7,43,68,381
15129,GSW,2021,Brad Wanamaker,31,39,0,625,61,173,.353,13,61,.213,48,112,.429,.390,50,56,.893,8,58,66,99,26,6,37,55,185
15130,GSW,2021,Nico Mannion,19,30,1,364,39,114,.342,22,60,.367,17,54,.315,.439,23,28,.821,6,40,46,70,16,1,31,29,123
15131,GSW,2021,Alen Smailagić,20,15,1,84,11,27,.407,4,10,.400,7,17,.412,.481,2,6,.333,6,10,16,4,3,5,5,11,28
15132,GSW,2021,Gary Payton II,28,10,0,40,10,13,.769,2,4,.500,8,9,.889,.846,3,4,.750,2,9,11,1,6,1,1,8,25
15133,GSW,2021,Marquese Chriss,23,2,0,27,5,14,.357,1,5,.200,4,9,.444,.393,2,4,.500,3,10,13,2,0,2,2,3,13
15134,GSW,2021,Jordan Bell,26,1,0,15,0,2,.000,0,0,,0,2,.000,.000,1,2,.500,1,4,5,2,0,2,1,2,1
15135,GSW,2020,Eric Paschall,23,60,26,1654,318,640,.497,37,129,.287,281,511,.550,.526,164,212,.774,82,193,275,127,32,13,94,125,837
15136,GSW,2020,Glenn Robinson III,26,48,48,1516,244,507,.481,68,170,.400,176,337,.522,.548,63,74,.851,66,160,226,85,45,14,50,82,619
15137,GSW,2020,Damion Lee,27,49,36,1423,213,511,.417,85,239,.356,128,272,.471,.500,110,126,.873,32,207,239,133,50,6,67,116,621
15138,GSW,2020,Alec Burks,28,48,18,1390,244,601,.406,84,224,.375,160,377,.424,.476,201,224,.897,37,189,226,151,50,17,76,107,773
15139,GSW,2020,Jordan Poole,20,57,14,1274,167,502,.333,74,265,.279,93,237,.392,.406,95,119,.798,9,109,118,134,35,10,74,94,503
15140,GSW,2020,Draymond Green,29,43,43,1222,123,316,.389,36,129,.279,87,187,.465,.446,63,83,.759,23,243,266,266,59,33,98,110,345
15141,GSW,2020,Marquese Chriss,22,59,21,1196,210,385,.545,8,39,.205,202,346,.584,.556,120,156,.769,114,251,365,114,39,62,78,122,548
15142,GSW,2020,D'Angelo Russell,23,33,33,1060,273,635,.430,120,321,.374,153,314,.487,.524,113,144,.785,14,108,122,206,31,9,101,64,779
15143,GSW,2020,Ky Bowman,22,45,12,1015,134,321,.417,33,107,.308,101,214,.472,.469,34,41,.829,24,97,121,131,44,10,70,102,335
15144,GSW,2020,Willie Cauley-Stein,26,41,37,940,144,257,.560,0,0,,144,257,.560,.560,35,57,.614,71,184,255,60,45,50,35,102,323
15145,GSW,2020,Omari Spellman,22,49,3,886,127,295,.431,43,110,.391,84,185,.454,.503,73,92,.793,77,142,219,47,33,24,54,63,370
15146,GSW,2020,Jacob Evans,22,27,1,414,45,133,.338,13,38,.342,32,95,.337,.387,25,29,.862,9,32,41,31,11,12,25,41,128
15147,GSW,2020,Andrew Wiggins,24,12,12,403,86,188,.457,20,59,.339,66,129,.512,.511,41,61,.672,18,37,55,43,16,17,25,26,233
15148,GSW,2020,Juan Toscano-Anderson,26,13,6,272,29,63,.460,8,23,.348,21,40,.525,.524,3,5,.600,9,43,52,26,13,5,16,30,69
15149,GSW,2020,Kevon Looney,23,20,4,262,29,79,.367,1,14,.071,28,65,.431,.373,9,12,.750,28,38,66,20,12,6,12,34,68
15150,GSW,2020,Mychal Mulder,25,7,3,204,26,67,.388,16,52,.308,10,15,.667,.507,9,12,.750,3,20,23,8,2,1,5,20,77
15151,GSW,2020,Dragan Bender,22,9,3,195,31,71,.437,11,34,.324,20,37,.541,.514,8,11,.727,16,37,53,19,4,4,16,26,81
15152,GSW,2020,Alen Smailagić,19,14,0,139,20,40,.500,3,13,.231,17,27,.630,.538,16,19,.842,10,17,27,13,3,4,11,14,59
15153,GSW,2020,Stephen Curry,31,5,5,139,33,82,.402,12,49,.245,21,33,.636,.476,26,26,1.000,4,22,26,33,5,2,16,11,104
15154,GSW,2020,Jeremy Pargo,33,3,0,44,11,22,.500,3,7,.429,8,15,.533,.568,0,1,.000,1,2,3,8,1,0,4,8,25
15155,GSW,2020,Chasson Randle,26,3,0,40,0,4,.000,0,2,.000,0,2,.000,.000,5,6,.833,0,2,2,5,2,0,0,3,5
15156,GSW,2020,Zach Norvell,22,3,0,36,3,11,.273,3,8,.375,0,3,.000,.409,1,1,1.000,0,5,5,3,2,0,3,4,10
15157,GSW,2019,Kevin Durant,30,78,78,2702,721,1383,.521,137,388,.353,584,995,.587,.571,448,506,.885,33,464,497,457,58,84,225,155,2027
15158,GSW,2019,Klay Thompson,28,78,78,2652,655,1402,.467,241,599,.402,414,803,.516,.553,129,158,.816,37,262,299,186,84,47,115,157,1680
15159,GSW,2019,Stephen Curry,30,69,69,2331,632,1340,.472,354,810,.437,278,530,.525,.604,263,287,.916,45,324,369,361,92,25,192,166,1881
15160,GSW,2019,Draymond Green,28,66,66,2065,188,422,.445,47,165,.285,141,257,.549,.501,63,91,.692,60,421,481,454,95,70,169,197,486
15161,GSW,2019,Andre Iguodala,35,68,13,1578,151,302,.500,48,144,.333,103,158,.652,.579,39,67,.582,48,204,252,216,61,51,52,95,389
15162,GSW,2019,Kevon Looney,22,80,24,1481,217,347,.625,1,10,.100,216,337,.641,.627,65,105,.619,194,223,417,123,46,53,51,211,500
15163,GSW,2019,Jonas Jerebko,31,73,6,1218,163,355,.459,69,188,.367,94,167,.563,.556,64,80,.800,72,216,288,96,27,18,43,137,459
15164,GSW,2019,Quinn Cook,25,74,10,1059,204,439,.465,81,200,.405,123,239,.515,.557,20,26,.769,22,135,157,116,20,3,50,92,509
15165,GSW,2019,Alfonzo McKinnie,26,72,5,1003,134,275,.487,42,118,.356,92,157,.586,.564,27,48,.563,81,166,247,31,18,15,30,134,337
15166,GSW,2019,Shaun Livingston,33,64,0,967,109,210,.519,0,2,.000,109,208,.524,.519,40,51,.784,42,75,117,114,31,27,38,74,258
15167,GSW,2019,Jordan Bell,24,68,3,788,99,192,.516,0,2,.000,99,190,.521,.516,25,41,.610,55,129,184,76,20,51,42,80,223
15168,GSW,2019,DeMarcus Cousins,28,30,30,771,178,371,.480,26,95,.274,152,276,.551,.515,106,144,.736,43,204,247,107,40,44,72,109,488
15169,GSW,2019,Damian Jones,23,24,22,410,53,74,.716,0,0,,53,74,.716,.716,24,37,.649,31,44,75,28,12,25,16,63,130
15170,GSW,2019,Damion Lee,26,32,0,375,56,127,.441,27,68,.397,29,59,.492,.547,19,22,.864,8,56,64,13,13,0,11,28,158
15171,GSW,2019,Jacob Evans,21,30,1,204,18,53,.340,4,15,.267,14,38,.368,.377,0,1,.000,6,19,25,23,5,3,11,28,40
15172,GSW,2019,Andrew Bogut,34,11,5,134,18,36,.500,0,0,,18,36,.500,.500,3,3,1.000,12,43,55,11,3,8,8,22,39
15173,GSW,2019,Marcus Derrickson,22,11,0,67,16,33,.485,10,20,.500,6,13,.462,.636,4,5,.800,8,5,13,1,0,1,3,9,46
15174,GSW,2018,Klay Thompson,27,73,73,2506,575,1179,.488,229,521,.440,346,658,.526,.585,82,98,.837,31,246,277,185,55,34,128,117,1461
15175,GSW,2018,Kevin Durant,29,68,68,2325,630,1222,.516,173,413,.419,457,809,.565,.586,359,404,.889,31,433,464,366,50,119,207,133,1792
15176,GSW,2018,Draymond Green,27,70,70,2287,281,619,.454,77,256,.301,204,363,.562,.516,134,173,.775,75,460,535,508,95,91,202,185,773
15177,GSW,2018,Stephen Curry,29,51,51,1631,428,864,.495,212,501,.423,216,363,.595,.618,278,302,.921,36,225,261,310,80,8,153,114,1346
15178,GSW,2018,Andre Iguodala,34,64,7,1622,148,320,.463,33,117,.282,115,203,.567,.514,55,87,.632,50,196,246,210,54,38,67,99,384
15179,GSW,2018,Nick Young,32,80,8,1393,201,488,.412,123,326,.377,78,162,.481,.538,56,65,.862,20,105,125,36,38,7,39,100,581
15180,GSW,2018,Shaun Livingston,32,71,7,1129,172,343,.501,0,5,.000,172,338,.509,.501,50,61,.820,32,99,131,140,35,21,58,117,394
15181,GSW,2018,David West,37,73,0,999,216,378,.571,3,8,.375,213,370,.576,.575,60,79,.759,64,174,238,138,47,75,80,120,495
15182,GSW,2018,Zaza Pachulia,33,69,57,972,149,264,.564,0,1,.000,149,263,.567,.564,75,93,.806,89,232,321,109,38,17,72,122,373
15183,GSW,2018,Patrick McCaw,22,57,10,961,92,225,.409,19,80,.238,73,145,.503,.451,26,34,.765,16,66,82,81,43,10,41,67,229
15184,GSW,2018,Kevon Looney,21,66,4,910,112,193,.580,1,5,.200,111,188,.590,.583,42,77,.545,83,132,215,42,34,56,31,106,267
15185,GSW,2018,Jordan Bell,23,57,13,809,116,185,.627,0,4,.000,116,181,.641,.627,30,44,.682,60,147,207,102,35,56,51,92,262
15186,GSW,2018,Omri Casspi,29,53,7,740,120,207,.580,10,22,.455,110,185,.595,.604,50,69,.725,30,170,200,51,18,19,37,71,300
15187,GSW,2018,Quinn Cook,24,33,18,740,122,252,.484,46,104,.442,76,148,.514,.575,22,25,.880,10,72,82,89,12,1,32,59,312
15188,GSW,2018,JaVale McGee,30,65,17,615,136,219,.621,0,6,.000,136,213,.638,.621,38,52,.731,59,110,169,33,21,57,27,91,310
15189,GSW,2018,Damian Jones,22,15,0,89,11,22,.500,0,0,,11,22,.500,.500,3,5,.600,5,9,14,2,1,3,4,14,25
15190,GSW,2018,Chris Boucher,25,1,0,1,0,1,.000,0,1,.000,0,0,,.000,0,0,,0,1,1,0,0,0,0,0,0
15191,GSW,2017,Klay Thompson,26,78,78,2649,644,1376,.468,268,647,.414,376,729,.516,.565,186,218,.853,49,236,285,160,66,40,128,139,1742
15192,GSW,2017,Stephen Curry,28,79,79,2638,675,1443,.468,324,789,.411,351,654,.537,.580,325,362,.898,61,292,353,524,142,17,239,183,1999
15193,GSW,2017,Draymond Green,26,76,76,2471,272,650,.418,81,263,.308,191,387,.494,.481,151,213,.709,98,501,599,533,154,106,184,217,776
15194,GSW,2017,Kevin Durant,28,62,62,2070,551,1026,.537,117,312,.375,434,714,.608,.594,336,384,.875,39,474,513,300,66,99,138,117,1555
15195,GSW,2017,Andre Iguodala,33,76,0,1998,219,415,.528,64,177,.362,155,238,.651,.605,72,102,.706,51,253,304,261,76,39,58,97,574
15196,GSW,2017,Shaun Livingston,31,76,3,1345,173,316,.547,1,3,.333,172,313,.550,.549,42,60,.700,28,123,151,139,38,20,62,120,389
15197,GSW,2017,Zaza Pachulia,32,70,70,1268,164,307,.534,0,2,.000,164,305,.538,.534,98,126,.778,140,270,410,132,59,33,87,166,426
15198,GSW,2017,Ian Clark,25,77,0,1137,211,433,.487,61,163,.374,150,270,.556,.558,44,58,.759,22,99,121,90,39,8,55,77,527
15199,GSW,2017,Patrick McCaw,21,71,20,1074,106,245,.433,41,123,.333,65,122,.533,.516,29,37,.784,21,79,100,77,32,15,36,62,282
15200,GSW,2017,David West,36,68,0,854,135,252,.536,3,8,.375,132,244,.541,.542,43,56,.768,47,156,203,151,42,48,78,105,316
15201,GSW,2017,JaVale McGee,29,77,10,739,208,319,.652,0,3,.000,208,316,.658,.652,56,111,.505,100,144,244,17,19,67,40,109,472
15202,GSW,2017,James Michael McAdoo,24,52,2,457,62,117,.530,2,8,.250,60,109,.550,.538,21,42,.500,34,57,91,18,18,29,19,47,147
15203,GSW,2017,Kevon Looney,20,53,4,447,56,107,.523,2,9,.222,54,98,.551,.533,21,34,.618,44,80,124,29,15,17,17,64,135
15204,GSW,2017,Matt Barnes,36,20,5,410,38,90,.422,18,52,.346,20,38,.526,.522,20,23,.870,15,76,91,45,12,9,24,47,114
15205,GSW,2017,Anderson Varejão,34,14,1,92,5,14,.357,0,0,,5,14,.357,.357,8,11,.727,12,15,27,10,3,3,8,16,18
15206,GSW,2017,Damian Jones,21,10,0,85,8,16,.500,0,0,,8,16,.500,.500,3,10,.300,9,14,23,0,1,4,6,15,19
15207,GSW,2017,Briante Weber,24,7,0,46,5,14,.357,0,3,.000,5,11,.455,.357,2,3,.667,0,4,4,5,3,1,3,4,12
15208,GSW,2016,Draymond Green,25,81,81,2808,401,819,.490,100,258,.388,301,561,.537,.551,229,329,.696,134,635,769,598,119,113,259,240,1131
15209,GSW,2016,Stephen Curry,27,79,79,2700,805,1598,.504,402,886,.454,403,712,.566,.630,363,400,.908,68,362,430,527,169,15,262,161,2375
15210,GSW,2016,Klay Thompson,25,80,80,2666,651,1386,.470,276,650,.425,375,736,.510,.569,193,221,.873,35,271,306,166,60,49,138,152,1771
15211,GSW,2016,Harrison Barnes,23,66,59,2042,295,633,.466,82,214,.383,213,419,.508,.531,102,134,.761,77,248,325,117,41,10,57,136,774
15212,GSW,2016,Andre Iguodala,32,65,1,1732,176,368,.478,54,154,.351,122,214,.570,.552,51,83,.614,52,211,263,219,73,19,79,102,457
15213,GSW,2016,Shaun Livingston,30,78,3,1520,203,379,.536,2,12,.167,201,367,.548,.538,80,93,.860,42,127,169,237,57,27,78,140,488
15214,GSW,2016,Andrew Bogut,31,70,66,1451,175,279,.627,1,1,1.000,174,278,.626,.629,24,50,.480,121,371,492,162,33,114,83,221,375
15215,GSW,2016,Leandro Barbosa,33,68,0,1079,171,370,.462,39,110,.355,132,260,.508,.515,52,62,.839,28,89,117,82,44,10,53,107,433
15216,GSW,2016,Brandon Rush,30,72,25,1055,111,260,.427,65,157,.414,46,103,.447,.552,18,28,.643,21,160,181,57,20,23,33,57,305
15217,GSW,2016,Marreese Speights,28,72,0,832,197,456,.432,24,62,.387,173,394,.439,.458,94,114,.825,77,162,239,61,19,34,66,117,512
15218,GSW,2016,Festus Ezeli,26,46,13,770,125,228,.548,0,0,,125,228,.548,.548,70,132,.530,91,166,257,32,18,50,38,94,320
15219,GSW,2016,Ian Clark,24,66,1,578,89,202,.441,30,84,.357,59,118,.500,.515,28,34,.824,13,55,68,64,17,13,43,58,236
15220,GSW,2016,James Michael McAdoo,23,41,1,262,45,84,.536,1,2,.500,44,82,.537,.542,26,49,.531,30,28,58,17,10,8,16,39,117
15221,GSW,2016,Anderson Varejão,33,22,0,186,21,48,.438,0,0,,21,48,.438,.438,16,29,.552,13,37,50,15,5,5,6,35,58
15222,GSW,2016,Jason Thompson,29,28,1,179,20,42,.476,0,0,,20,42,.476,.476,20,32,.625,10,44,54,19,4,8,7,40,60
15223,GSW,2016,Kevon Looney,19,5,0,21,4,7,.571,1,2,.500,3,5,.600,.643,0,0,,4,6,10,0,0,0,1,2,9
15224,GSW,2015,Stephen Curry,26,80,80,2613,653,1341,.487,286,646,.443,367,695,.528,.594,308,337,.914,56,285,341,619,163,16,249,158,1900
15225,GSW,2015,Draymond Green,24,79,79,2490,339,765,.443,111,329,.337,228,436,.523,.516,132,200,.660,114,533,647,291,123,99,133,253,921
15226,GSW,2015,Klay Thompson,24,77,77,2455,602,1299,.463,239,545,.439,363,754,.481,.555,225,256,.879,27,220,247,222,87,60,149,122,1668
15227,GSW,2015,Harrison Barnes,22,82,82,2318,316,656,.482,87,215,.405,229,441,.519,.548,108,150,.720,117,336,453,116,61,19,71,146,827
15228,GSW,2015,Andre Iguodala,31,77,0,2069,231,496,.466,74,212,.349,157,284,.553,.540,68,114,.596,44,213,257,228,89,25,88,100,604
15229,GSW,2015,Andrew Bogut,30,67,65,1583,200,355,.563,0,0,,200,355,.563,.563,22,42,.524,141,402,543,180,39,113,106,188,422
15230,GSW,2015,Shaun Livingston,29,78,2,1468,198,396,.500,0,2,.000,198,394,.503,.500,65,91,.714,43,140,183,259,49,20,102,110,461
15231,GSW,2015,Marreese Speights,27,76,9,1207,318,646,.492,5,18,.278,313,628,.498,.496,150,178,.843,109,216,325,72,20,34,82,189,791
15232,GSW,2015,Leandro Barbosa,32,66,1,982,183,386,.474,43,112,.384,140,274,.511,.530,58,74,.784,23,68,91,99,41,8,44,87,467
15233,GSW,2015,David Lee,31,49,4,904,160,313,.511,0,2,.000,160,311,.514,.511,68,104,.654,81,176,257,85,31,26,49,83,388
15234,GSW,2015,Justin Holiday,25,59,4,657,91,235,.387,35,109,.321,56,126,.444,.462,37,45,.822,12,61,73,48,40,12,29,54,254
15235,GSW,2015,Festus Ezeli,25,46,7,504,76,139,.547,0,0,,76,139,.547,.547,49,78,.628,60,95,155,9,7,42,32,77,201
15236,GSW,2015,Brandon Rush,29,33,0,271,11,54,.204,3,27,.111,8,27,.296,.231,5,11,.455,4,37,41,12,5,12,11,27,30
15237,GSW,2015,James Michael McAdoo,22,15,0,137,24,44,.545,0,0,,24,44,.545,.545,14,25,.560,15,22,37,2,5,9,6,21,62
15238,GSW,2015,Ognjen Kuzmić,24,16,0,72,8,12,.667,0,0,,8,12,.667,.667,4,4,1.000,7,10,17,6,2,1,5,13,20
15239,GSW,2014,Klay Thompson,23,81,81,2868,559,1259,.444,223,535,.417,336,724,.464,.533,147,185,.795,38,211,249,181,74,37,135,234,1488
15240,GSW,2014,Stephen Curry,25,78,78,2846,652,1383,.471,261,615,.424,391,768,.509,.566,308,348,.885,46,288,334,666,128,14,294,194,1873
15241,GSW,2014,David Lee,30,69,67,2288,513,981,.523,0,1,.000,513,980,.523,.523,231,296,.780,182,461,643,147,48,26,152,206,1257
15242,GSW,2014,Harrison Barnes,21,78,24,2204,271,679,.399,66,190,.347,205,489,.419,.448,130,181,.718,66,245,311,116,65,20,84,158,738
15243,GSW,2014,Andre Iguodala,30,63,63,2040,220,458,.480,62,175,.354,158,283,.558,.548,86,132,.652,53,240,293,263,95,18,100,103,588
15244,GSW,2014,Draymond Green,23,82,12,1797,187,459,.407,55,165,.333,132,294,.449,.467,82,123,.667,86,323,409,152,102,72,91,231,511
15245,GSW,2014,Andrew Bogut,29,67,67,1769,235,375,.627,0,0,,235,375,.627,.627,22,64,.344,182,489,671,112,47,121,97,210,492
15246,GSW,2014,Marreese Speights,26,79,3,982,195,442,.441,8,31,.258,187,411,.455,.450,110,134,.821,101,189,290,32,10,34,66,148,508
15247,GSW,2014,Jermaine O'Neal,35,44,13,883,125,248,.504,0,0,,125,248,.504,.504,99,132,.750,85,157,242,25,14,40,52,102,349
15248,GSW,2014,Jordan Crawford,25,42,0,661,139,333,.417,40,128,.313,99,205,.483,.477,36,43,.837,10,53,63,57,13,2,50,44,354
15249,GSW,2014,Steve Blake,33,28,1,607,45,120,.375,27,79,.342,18,41,.439,.488,5,8,.625,5,51,56,102,20,6,31,36,122
15250,GSW,2014,Kent Bazemore,24,44,0,268,36,97,.371,10,39,.256,26,58,.448,.423,19,36,.528,5,35,40,20,12,6,28,42,101
15251,GSW,2014,Toney Douglas,27,24,0,265,32,86,.372,19,59,.322,13,27,.481,.483,5,8,.625,4,22,26,19,6,2,16,34,88
15252,GSW,2014,Nemanja Nedović,22,24,0,142,8,39,.205,3,18,.167,5,21,.238,.244,7,8,.875,3,12,15,13,0,1,13,13,26
15253,GSW,2014,Hilton Armstrong,29,15,1,97,9,19,.474,0,0,,9,19,.474,.474,7,16,.438,19,28,47,5,4,4,6,11,25
15254,GSW,2014,Ognjen Kuzmić,23,21,0,92,5,13,.385,0,0,,5,13,.385,.385,5,11,.455,10,11,21,2,3,4,10,17,15
15255,GSW,2014,MarShon Brooks,25,7,0,15,5,13,.385,0,2,.000,5,11,.455,.385,3,4,.750,1,4,5,0,1,0,0,0,13
15256,GSW,2014,Dewayne Dedmon,24,4,0,6,0,1,.000,0,0,,0,1,.000,.000,1,2,.500,0,0,0,0,0,0,0,1,1
15257,GSW,2013,Stephen Curry,24,78,78,2983,626,1388,.451,272,600,.453,354,788,.449,.549,262,291,.900,59,255,314,539,126,12,240,198,1786
15258,GSW,2013,Klay Thompson,22,82,82,2936,508,1205,.422,211,526,.401,297,679,.437,.509,132,157,.841,32,274,306,183,86,45,157,237,1359
15259,GSW,2013,David Lee,29,79,79,2907,602,1160,.519,0,4,.000,602,1156,.521,.519,255,320,.797,218,668,886,279,67,22,207,246,1459
15260,GSW,2013,Jarrett Jack,29,79,4,2349,387,857,.452,82,203,.404,305,654,.466,.499,167,198,.843,21,222,243,439,60,11,157,134,1023
15261,GSW,2013,Harrison Barnes,20,81,81,2058,276,628,.439,52,145,.359,224,483,.464,.481,144,190,.758,53,280,333,98,52,14,101,140,748
15262,GSW,2013,Carl Landry,29,81,2,1876,325,602,.540,1,3,.333,324,599,.541,.541,223,273,.817,180,303,483,65,35,31,115,190,874
15263,GSW,2013,Festus Ezeli,23,78,41,1120,74,169,.438,0,0,,74,169,.438,.438,43,81,.531,141,172,313,22,23,74,63,157,191
15264,GSW,2013,Draymond Green,22,79,1,1061,84,257,.327,14,67,.209,70,190,.368,.354,45,55,.818,58,202,260,53,42,25,51,159,227
15265,GSW,2013,Andrew Bogut,28,32,32,786,83,184,.451,1,1,1.000,82,183,.448,.454,19,38,.500,68,177,245,67,20,55,35,85,186
15266,GSW,2013,Richard Jefferson,32,56,1,568,62,136,.456,14,45,.311,48,91,.527,.507,38,53,.717,5,79,84,31,14,7,23,45,176
15267,GSW,2013,Andris Biedriņš,26,53,9,495,10,21,.476,0,0,,10,21,.476,.476,4,13,.308,34,119,153,14,15,42,14,101,24
15268,GSW,2013,Charles Jenkins,23,47,0,291,35,83,.422,1,2,.500,34,81,.420,.428,10,18,.556,5,16,21,28,9,1,19,18,81
15269,GSW,2013,Kent Bazemore,23,61,0,267,43,116,.371,10,34,.294,33,82,.402,.414,27,44,.614,5,17,22,22,17,4,18,27,123
15270,GSW,2013,Jeremy Tyler,21,20,0,63,9,24,.375,0,0,,9,24,.375,.375,4,6,.667,6,11,17,1,1,2,6,10,22
15271,GSW,2013,Brandon Rush,27,2,0,25,6,9,.667,0,2,.000,6,7,.857,.667,2,3,.667,0,1,1,2,0,0,3,5,14
15272,GSW,2013,Malcolm Thomas,24,5,0,21,0,1,.000,0,0,,0,1,.000,.000,3,4,.750,0,5,5,2,0,1,1,1,3
15273,GSW,2012,David Lee,28,57,57,2121,464,922,.503,0,5,.000,464,917,.506,.503,219,280,.782,171,374,545,162,54,22,149,179,1147
15274,GSW,2012,Brandon Rush,26,65,1,1717,235,469,.501,99,219,.452,136,250,.544,.607,65,82,.793,33,218,251,88,35,58,68,64,634
15275,GSW,2012,Dorell Wright,26,61,61,1650,222,526,.422,105,292,.360,117,234,.500,.522,80,98,.816,60,218,278,94,58,26,51,97,629
15276,GSW,2012,Klay Thompson,21,66,29,1608,318,718,.443,111,268,.414,207,450,.460,.520,79,91,.868,24,137,161,133,49,20,103,155,826
15277,GSW,2012,Monta Ellis,26,37,37,1365,305,704,.433,50,156,.321,255,548,.465,.469,151,186,.812,16,111,127,223,56,12,123,84,811
15278,GSW,2012,Nate Robinson,27,51,9,1192,205,484,.424,66,181,.365,139,303,.459,.492,94,113,.832,15,85,100,231,59,2,75,118,570
15279,GSW,2012,Dominic McGuire,26,64,6,1127,94,210,.448,0,4,.000,94,206,.456,.448,39,53,.736,73,173,246,110,44,36,56,104,227
15280,GSW,2012,Charles Jenkins,22,51,28,893,130,291,.447,3,20,.150,127,271,.469,.452,34,39,.872,8,60,68,170,33,6,60,85,297
15281,GSW,2012,Ekpe Udoh,24,38,6,827,82,185,.443,0,0,,82,185,.443,.443,46,64,.719,58,89,147,31,25,65,35,115,210
15282,GSW,2012,Andris Biedriņš,25,47,35,739,39,64,.609,0,0,,39,64,.609,.609,1,9,.111,45,131,176,16,23,45,14,125,79
15283,GSW,2012,Stephen Curry,23,26,23,732,145,296,.490,55,121,.455,90,175,.514,.583,38,47,.809,15,73,88,138,39,8,65,62,383
15284,GSW,2012,Richard Jefferson,31,22,3,580,71,169,.420,33,79,.418,38,90,.422,.518,24,35,.686,8,68,76,33,12,7,18,38,199
15285,GSW,2012,Jeremy Tyler,20,42,23,568,88,209,.421,0,1,.000,88,208,.423,.421,29,52,.558,54,86,140,16,16,20,36,84,205
15286,GSW,2012,Mickell Gladness,25,18,7,224,24,56,.429,0,0,,24,56,.429,.429,6,12,.500,13,34,47,3,3,19,4,24,54
15287,GSW,2012,Kwame Brown,29,9,3,187,21,40,.525,0,0,,21,40,.525,.525,15,34,.441,16,41,57,4,8,0,14,21,57
15288,GSW,2012,Chris Wright,23,24,1,186,23,45,.511,0,0,,23,45,.511,.511,24,31,.774,19,26,45,4,7,13,8,22,70
15289,GSW,2012,Mikki Moore,36,7,0,118,9,20,.450,0,0,,9,20,.450,.450,6,7,.857,7,15,22,5,3,3,7,24,24
15290,GSW,2012,Ish Smith,23,6,1,63,12,30,.400,2,5,.400,10,25,.400,.433,1,2,.500,2,7,9,9,4,0,1,4,27
15291,GSW,2012,Earl Barron,30,2,0,9,2,4,.500,0,0,,2,4,.500,.500,0,0,,1,0,1,0,0,0,0,5,4
15292,GSW,2012,Keith Benson,23,3,0,9,0,1,.000,0,0,,0,1,.000,.000,0,0,,2,1,3,0,0,0,0,0,0
15293,GSW,2011,Monta Ellis,25,80,80,3227,726,1611,.451,137,379,.361,589,1232,.478,.493,340,431,.789,44,237,281,450,168,23,252,203,1929
15294,GSW,2011,Dorell Wright,25,82,82,3147,485,1146,.423,194,516,.376,291,630,.462,.508,180,228,.789,88,343,431,242,124,63,133,171,1344
15295,GSW,2011,David Lee,27,73,73,2634,496,978,.507,1,3,.333,495,975,.508,.508,210,267,.787,217,497,714,233,74,31,170,211,1203
15296,GSW,2011,Stephen Curry,22,74,74,2489,505,1053,.480,151,342,.442,354,711,.498,.551,212,227,.934,52,234,286,432,109,20,226,233,1373
15297,GSW,2011,Reggie Williams,24,80,9,1626,268,572,.469,102,241,.423,166,331,.502,.558,100,134,.746,45,171,216,121,28,3,57,124,738
15298,GSW,2011,Andris Biedriņš,24,59,55,1397,142,266,.534,0,0,,142,266,.534,.534,10,31,.323,145,281,426,60,52,52,57,198,294
15299,GSW,2011,Vladimir Radmanović,30,74,6,1169,137,318,.431,70,173,.405,67,145,.462,.541,30,34,.882,64,148,212,79,44,44,57,157,374
15300,GSW,2011,Ekpe Udoh,23,58,18,1030,97,222,.437,0,0,,97,222,.437,.437,42,64,.656,80,101,181,40,22,86,48,144,236
15301,GSW,2011,Lou Amundson,28,46,7,691,83,183,.454,0,0,,83,183,.454,.454,34,87,.391,81,104,185,17,14,33,24,87,200
15302,GSW,2011,Acie Law,26,40,0,632,78,167,.467,6,30,.200,72,137,.526,.485,41,54,.759,9,43,52,70,28,0,33,51,203
15303,GSW,2011,Rodney Carney,26,25,1,331,45,107,.421,17,37,.459,28,70,.400,.500,18,27,.667,12,35,47,11,11,5,16,33,125
15304,GSW,2011,Al Thornton,27,22,0,314,51,104,.490,0,1,.000,51,103,.495,.490,29,35,.829,10,47,57,11,7,3,20,40,131
15305,GSW,2011,Dan Gadzuric,32,28,4,297,37,88,.420,0,1,.000,37,87,.425,.420,5,14,.357,53,33,86,11,10,18,21,63,79
15306,GSW,2011,Jeremy Lin,22,29,0,285,28,72,.389,1,5,.200,27,67,.403,.396,19,25,.760,12,22,34,42,33,9,18,31,76
15307,GSW,2011,Jeff Adrien,24,23,0,196,23,54,.426,0,0,,23,54,.426,.426,11,19,.579,23,35,58,10,4,5,9,28,57
15308,GSW,2011,Brandan Wright,23,21,1,195,38,63,.603,0,0,,38,63,.603,.603,7,14,.500,14,27,41,5,3,10,10,19,83
15309,GSW,2011,Charlie Bell,31,19,0,171,12,43,.279,6,21,.286,6,22,.273,.349,2,4,.500,6,12,18,13,6,1,6,13,32
15310,GSW,2010,Stephen Curry,21,80,77,2896,528,1143,.462,166,380,.437,362,763,.474,.535,177,200,.885,48,308,356,472,152,19,243,252,1399
15311,GSW,2010,Monta Ellis,24,64,64,2647,631,1406,.449,77,228,.338,554,1178,.470,.476,292,388,.753,47,210,257,340,143,25,244,189,1631
15312,GSW,2010,Corey Maggette,30,70,49,2081,457,886,.516,13,50,.260,444,836,.531,.523,460,551,.835,92,281,373,172,51,4,168,231,1387
15313,GSW,2010,Anthony Morrow,24,69,37,2018,329,703,.468,140,307,.456,189,396,.477,.568,101,114,.886,61,198,259,104,65,16,84,158,899
15314,GSW,2010,C.J. Watson,25,65,15,1788,247,528,.468,45,145,.310,202,383,.527,.510,128,166,.771,28,141,169,180,103,8,69,124,667
15315,GSW,2010,Anthony Tolliver,24,44,29,1423,193,448,.431,50,151,.331,143,297,.481,.487,103,134,.769,84,235,319,87,32,33,46,127,539
15316,GSW,2010,Ronny Turiaf,27,42,20,872,85,146,.582,0,1,.000,85,145,.586,.582,37,78,.474,54,137,191,90,23,54,49,98,207
15317,GSW,2010,Chris Hunter,25,60,9,783,109,217,.502,0,4,.000,109,213,.512,.502,52,69,.754,56,111,167,37,13,35,30,132,270
15318,GSW,2010,Reggie Williams,23,24,10,782,140,283,.495,33,92,.359,107,191,.560,.553,52,62,.839,18,92,110,66,23,6,29,49,365
15319,GSW,2010,Andris Biedriņš,23,33,29,763,81,137,.591,0,0,,81,137,.591,.591,4,25,.160,63,196,259,57,20,44,32,117,166
15320,GSW,2010,Devean George,32,45,4,761,89,206,.432,48,123,.390,41,83,.494,.549,16,23,.696,21,93,114,32,41,10,15,89,242
15321,GSW,2010,Vladimir Radmanović,29,33,20,758,89,231,.385,23,86,.267,66,145,.455,.435,16,21,.762,43,106,149,38,26,6,39,79,217
15322,GSW,2010,Anthony Randolph,20,33,8,749,137,309,.443,1,5,.200,136,304,.447,.445,109,136,.801,73,142,215,42,28,51,49,92,384
15323,GSW,2010,Mikki Moore,34,23,20,406,54,90,.600,0,0,,54,90,.600,.600,7,11,.636,26,43,69,36,5,13,21,60,115
15324,GSW,2010,Stephen Jackson,31,9,9,300,56,133,.421,11,40,.275,45,93,.484,.462,26,37,.703,6,29,35,42,14,6,26,16,149
15325,GSW,2010,Cartier Martin,25,10,2,276,32,88,.364,10,31,.323,22,57,.386,.420,16,21,.762,17,30,47,9,8,0,13,36,90
15326,GSW,2010,Kelenna Azubuike,26,9,7,231,48,88,.545,10,27,.370,38,61,.623,.602,19,28,.679,12,29,41,10,5,9,7,16,125
15327,GSW,2010,Coby Karl,26,4,1,108,11,32,.344,2,11,.182,9,21,.429,.375,4,6,.667,4,12,16,15,3,1,6,14,28
15328,GSW,2010,Acie Law,25,5,0,66,9,14,.643,1,3,.333,8,11,.727,.679,12,15,.800,0,2,2,7,6,0,2,5,31
15329,GSW,2010,Raja Bell,33,1,0,23,4,6,.667,3,3,1.000,1,3,.333,.917,0,0,,0,2,2,3,0,0,0,2,11
15330,GSW,2009,Kelenna Azubuike,25,74,51,2375,392,845,.464,94,210,.448,298,635,.469,.520,185,229,.808,112,258,370,117,57,50,95,183,1063
15331,GSW,2009,Stephen Jackson,30,59,59,2339,413,997,.414,103,305,.338,310,692,.448,.466,294,356,.826,70,233,303,381,88,31,229,153,1223
15332,GSW,2009,Jamal Crawford,28,54,54,2087,346,853,.406,107,317,.338,239,536,.446,.468,265,298,.889,21,155,176,240,48,13,122,79,1064
15333,GSW,2009,C.J. Watson,24,77,18,1883,257,562,.457,48,120,.400,209,442,.473,.500,168,193,.870,39,153,192,206,96,4,92,137,730
15334,GSW,2009,Andris Biedriņš,22,62,58,1863,308,533,.578,0,1,.000,308,532,.579,.578,119,216,.551,223,470,693,121,63,96,110,236,735
15335,GSW,2009,Ronny Turiaf,26,79,26,1696,186,366,.508,0,3,.000,186,363,.512,.508,98,124,.790,88,272,360,166,34,168,70,243,470
15336,GSW,2009,Corey Maggette,29,51,19,1588,292,634,.461,24,95,.253,268,539,.497,.479,342,415,.824,49,233,282,92,44,8,120,192,950
15337,GSW,2009,Anthony Morrow,23,67,17,1515,255,534,.478,86,184,.467,169,350,.483,.558,80,92,.870,78,121,199,80,36,12,52,130,676
15338,GSW,2009,Anthony Randolph,19,63,22,1129,199,431,.462,0,4,.000,199,427,.466,.462,101,141,.716,128,235,363,49,42,74,80,141,499
15339,GSW,2009,Monta Ellis,23,25,25,892,194,430,.451,8,26,.308,186,404,.460,.460,78,94,.830,14,94,108,93,39,8,67,67,474
15340,GSW,2009,Marco Belinelli,22,42,23,882,140,317,.442,52,131,.397,88,186,.473,.524,40,52,.769,10,61,71,88,36,1,59,73,372
15341,GSW,2009,Brandan Wright,21,39,23,688,130,246,.528,0,4,.000,130,242,.537,.528,63,85,.741,62,95,157,21,22,37,23,74,323
15342,GSW,2009,Rob Kurz,23,40,5,442,51,131,.389,15,38,.395,36,93,.387,.447,40,50,.800,33,48,81,20,14,19,16,78,157
15343,GSW,2009,DeMarcus Nelson,23,13,5,171,24,54,.444,0,3,.000,24,51,.471,.444,5,14,.357,6,18,24,13,9,2,15,24,53
15344,GSW,2009,Al Harrington,28,5,5,166,23,70,.329,11,28,.393,12,42,.286,.407,5,10,.500,10,18,28,10,7,0,7,14,62
15345,GSW,2009,Jermareo Davidson,24,14,0,111,17,35,.486,0,0,,17,35,.486,.486,8,17,.471,10,24,34,1,2,3,5,12,42
15346,GSW,2009,Marcus Williams,23,9,0,54,4,17,.235,2,6,.333,2,11,.182,.294,2,6,.333,0,4,4,13,1,1,4,6,12
15347,GSW,2008,Baron Davis,28,82,82,3196,650,1526,.426,173,525,.330,477,1001,.477,.483,318,424,.750,96,289,385,623,191,43,232,247,1791
15348,GSW,2008,Monta Ellis,22,81,72,3071,652,1227,.531,12,52,.231,640,1175,.545,.536,320,417,.767,133,271,404,315,124,27,173,195,1636
15349,GSW,2008,Stephen Jackson,29,73,73,2855,488,1204,.405,182,501,.363,306,703,.435,.481,308,370,.832,67,251,318,300,92,29,197,171,1466
15350,GSW,2008,Al Harrington,27,81,59,2190,401,923,.434,153,408,.375,248,515,.482,.517,147,190,.774,107,332,439,132,74,16,90,266,1102
15351,GSW,2008,Andris Biedriņš,21,76,59,2078,340,543,.626,0,0,,340,543,.626,.626,116,187,.620,256,488,744,75,56,94,85,262,796
15352,GSW,2008,Kelenna Azubuike,24,81,17,1732,261,587,.445,71,195,.364,190,392,.485,.505,99,138,.717,107,217,324,75,45,34,58,159,692
15353,GSW,2008,Matt Barnes,27,73,18,1414,187,442,.423,53,181,.293,134,261,.513,.483,59,79,.747,94,230,324,139,48,36,85,159,486
15354,GSW,2008,Mickaël Piétrus,25,66,16,1316,170,387,.439,66,183,.361,104,204,.510,.525,66,98,.673,67,175,242,49,66,43,48,200,472
15355,GSW,2008,Austin Croshere,32,44,0,457,61,137,.445,22,61,.361,39,76,.513,.526,29,32,.906,33,71,104,30,8,6,22,60,173
15356,GSW,2008,Brandan Wright,20,38,6,376,62,112,.554,0,0,,62,112,.554,.554,27,40,.675,38,61,99,9,6,22,13,36,151
15357,GSW,2008,C.J. Watson,23,32,0,368,43,101,.426,9,26,.346,34,75,.453,.470,23,29,.793,13,19,32,35,15,0,18,19,118
15358,GSW,2008,Marco Belinelli,21,33,0,241,36,93,.387,16,41,.390,20,52,.385,.473,7,9,.778,3,11,14,15,5,0,12,15,95
15359,GSW,2008,D.J. Mbenga,27,16,0,130,9,23,.391,0,0,,9,23,.391,.391,1,2,.500,13,18,31,4,3,10,4,32,19
15360,GSW,2008,Chris Webber,34,9,8,126,15,31,.484,0,0,,15,31,.484,.484,5,12,.417,2,30,32,18,4,6,11,17,35
15361,GSW,2008,Patrick O'Bryant,21,24,0,99,16,29,.552,0,0,,16,29,.552,.552,3,5,.600,10,19,29,4,4,9,7,27,35
15362,GSW,2008,Troy Hudson,31,9,0,93,9,31,.290,4,12,.333,5,19,.263,.355,6,6,1.000,0,7,7,9,3,0,7,4,28
15363,GSW,2008,Kosta Perović,22,7,0,38,3,10,.300,0,0,,3,10,.300,.300,4,6,.667,6,7,13,1,0,2,1,6,10
15364,GSW,2008,Stéphane Lasme,25,1,0,0,0,0,,0,0,,0,0,,,0,0,,0,0,0,0,0,0,0,0,0
15365,GSW,2007,Monta Ellis,21,77,53,2638,480,1010,.475,39,143,.273,441,867,.509,.495,273,358,.763,62,181,243,319,132,21,221,210,1272
15366,GSW,2007,Andris Biedriņš,20,82,63,2382,348,581,.599,0,0,,348,581,.599,.599,87,167,.521,251,511,762,88,67,136,119,304,783
15367,GSW,2007,Baron Davis,27,63,62,2221,452,1030,.439,85,280,.304,367,750,.489,.480,275,369,.745,51,225,276,509,135,29,193,181,1264
15368,GSW,2007,Mickaël Piétrus,24,72,38,1937,286,586,.488,93,240,.388,193,346,.558,.567,136,210,.648,81,246,327,62,48,55,105,220,801
15369,GSW,2007,Matt Barnes,26,76,23,1813,275,628,.438,106,290,.366,169,338,.500,.522,90,123,.732,91,259,350,156,73,41,105,188,746
15370,GSW,2007,Jason Richardson,26,51,49,1675,306,734,.417,110,301,.365,196,433,.453,.492,92,140,.657,71,188,259,172,54,32,82,129,814
15371,GSW,2007,Al Harrington,26,42,42,1355,272,596,.456,73,175,.417,199,421,.473,.518,96,141,.681,80,190,270,98,40,14,78,153,713
15372,GSW,2007,Stephen Jackson,28,38,37,1293,229,514,.446,59,173,.341,170,341,.499,.503,123,153,.804,44,83,127,173,51,14,102,113,640
15373,GSW,2007,Mike Dunleavy,26,39,6,1051,166,370,.449,36,104,.346,130,266,.489,.497,78,101,.772,40,147,187,117,38,12,71,83,446
15374,GSW,2007,Kelenna Azubuike,23,41,9,669,98,220,.445,34,79,.430,64,141,.454,.523,61,78,.782,26,68,94,28,22,10,39,49,291
15375,GSW,2007,Troy Murphy,26,26,17,667,81,180,.450,22,59,.373,59,121,.488,.511,47,66,.712,37,120,157,60,21,17,29,63,231
15376,GSW,2007,Adonal Foyle,31,48,6,475,48,85,.565,0,0,,48,85,.565,.565,11,25,.440,51,75,126,19,11,50,23,61,107
15377,GSW,2007,Keith McLeod,27,26,2,379,41,105,.390,9,23,.391,32,82,.390,.433,47,53,.887,3,18,21,45,17,3,23,21,138
15378,GSW,2007,Šarūnas Jasikevičius,30,26,2,309,37,101,.366,12,44,.273,25,57,.439,.426,27,31,.871,5,16,21,61,13,1,31,22,113
15379,GSW,2007,Josh Powell,24,30,0,289,41,78,.526,0,0,,41,78,.526,.526,22,30,.733,17,52,69,18,5,12,24,43,104
15380,GSW,2007,Anthony Roberson,23,20,1,227,44,104,.423,21,55,.382,23,49,.469,.524,2,3,.667,2,19,21,10,12,0,13,27,111
15381,GSW,2007,Ike Diogu,23,17,0,222,44,83,.530,0,0,,44,83,.530,.530,35,44,.795,21,42,63,5,3,11,18,35,123
15382,GSW,2007,Patrick O'Bryant,20,16,0,119,10,32,.313,0,0,,10,32,.313,.313,11,17,.647,7,14,21,9,6,8,8,26,31
15383,GSW,2007,Renaldo Major,24,1,0,27,2,10,.200,0,0,,2,10,.200,.200,1,2,.500,0,2,2,0,2,0,1,4,5
15384,GSW,2007,Dajuan Wagner,23,1,0,7,1,1,1.000,1,1,1.000,0,0,,1.500,1,2,.500,0,0,0,1,0,0,1,1,4
15385,GSW,2006,Jason Richardson,25,75,75,2877,641,1438,.446,183,477,.384,458,961,.477,.509,276,410,.673,105,333,438,232,97,37,167,206,1741
15386,GSW,2006,Derek Fisher,31,82,36,2589,364,887,.410,117,295,.397,247,592,.417,.476,244,293,.833,36,175,211,352,125,8,156,237,1089
15387,GSW,2006,Mike Dunleavy,25,81,68,2578,331,816,.406,74,260,.285,257,556,.462,.451,196,252,.778,78,321,399,237,60,32,120,199,932
15388,GSW,2006,Troy Murphy,25,74,74,2516,363,838,.433,58,181,.320,305,657,.464,.468,251,319,.787,195,548,743,101,47,26,108,191,1035
15389,GSW,2006,Baron Davis,26,54,48,1971,335,861,.389,102,324,.315,233,537,.434,.448,195,289,.675,45,191,236,480,89,14,159,165,967
15390,GSW,2006,Adonal Foyle,30,77,72,1824,152,300,.507,0,0,,152,300,.507,.507,41,67,.612,143,281,424,33,44,125,80,215,345
15391,GSW,2006,Mickaël Piétrus,23,52,18,1179,169,418,.404,56,176,.318,113,242,.467,.471,87,143,.608,58,105,163,44,33,10,78,132,481
15392,GSW,2006,Ike Diogu,22,69,14,1031,175,334,.524,0,0,,175,334,.524,.524,136,168,.810,95,134,229,29,15,30,78,164,486
15393,GSW,2006,Andris Biedriņš,19,68,2,1000,118,185,.638,0,0,,118,185,.638,.638,22,72,.306,124,159,283,24,23,47,34,190,258
15394,GSW,2006,Monta Ellis,20,49,3,886,132,318,.415,28,82,.341,104,236,.441,.459,42,59,.712,22,83,105,78,32,11,58,69,334
15395,GSW,2006,Žarko Čabarkapa,24,61,0,505,67,174,.385,5,20,.250,62,154,.403,.399,60,84,.714,37,74,111,20,13,7,35,87,199
15396,GSW,2006,Calbert Cheaney,34,42,0,448,42,108,.389,0,8,.000,42,100,.420,.389,8,8,1.000,20,41,61,19,13,2,17,38,92
15397,GSW,2006,Will Bynum,23,15,0,162,21,52,.404,2,9,.222,19,43,.442,.423,10,16,.625,3,9,12,19,7,0,14,10,54
15398,GSW,2006,Chris Taft,20,17,0,144,23,38,.605,0,0,,23,38,.605,.605,1,6,.167,19,17,36,2,2,7,2,25,47
15399,GSW,2006,Aaron Miles,22,19,0,118,6,18,.333,0,0,,6,18,.333,.333,4,4,1.000,0,14,14,24,4,1,11,13,16
15400,GSW,2005,Jason Richardson,24,72,72,2724,610,1368,.446,125,370,.338,485,998,.486,.492,214,309,.693,125,299,424,281,105,32,169,156,1559
15401,GSW,2005,Mike Dunleavy,24,79,79,2570,408,905,.451,107,276,.388,301,629,.479,.510,134,172,.779,97,338,435,203,79,26,132,198,1057
15402,GSW,2005,Troy Murphy,24,70,69,2375,392,947,.414,59,148,.399,333,799,.417,.445,233,319,.730,251,505,756,97,53,33,108,190,1076
15403,GSW,2005,Derek Fisher,30,74,32,2222,297,755,.393,108,291,.371,189,464,.407,.465,175,203,.862,38,180,218,301,76,4,129,176,877
15404,GSW,2005,Adonal Foyle,29,78,50,1700,156,311,.502,0,0,,156,311,.502,.502,40,72,.556,165,264,429,56,26,159,58,201,352
15405,GSW,2005,Speedy Claxton,26,46,44,1501,216,501,.431,10,52,.192,206,449,.459,.441,162,213,.761,32,121,153,286,87,6,92,154,604
15406,GSW,2005,Mickaël Piétrus,22,67,3,1340,214,501,.427,67,195,.344,147,306,.480,.494,141,202,.698,65,124,189,82,46,18,92,139,636
15407,GSW,2005,Clifford Robinson,38,42,29,1090,141,354,.398,42,127,.331,99,227,.436,.458,35,58,.603,31,83,114,74,44,39,41,107,359
15408,GSW,2005,Baron Davis,25,28,19,988,180,449,.401,74,217,.341,106,232,.457,.483,111,147,.755,16,92,108,233,50,10,93,74,545
15409,GSW,2005,Calbert Cheaney,33,55,5,951,113,265,.426,0,3,.000,113,262,.431,.426,24,37,.649,32,92,124,64,17,15,35,95,250
15410,GSW,2005,Eduardo Nájera,28,42,4,610,70,172,.407,6,15,.400,64,157,.408,.424,29,45,.644,53,65,118,37,18,10,32,71,175
15411,GSW,2005,Dale Davis,35,36,3,577,45,109,.413,0,0,,45,109,.413,.413,22,38,.579,61,92,153,23,13,32,20,79,112
15412,GSW,2005,Žarko Čabarkapa,23,37,0,464,82,170,.482,13,36,.361,69,134,.515,.521,52,64,.813,33,66,99,25,10,5,30,59,229
15413,GSW,2005,Andris Biedriņš,18,30,1,384,45,78,.577,0,1,.000,45,77,.584,.577,19,40,.475,47,71,118,12,12,24,12,87,109
15414,GSW,2005,Rodney White,24,16,0,146,23,62,.371,5,16,.313,18,46,.391,.411,6,10,.600,4,11,15,8,2,1,10,13,57
15415,GSW,2005,Ansu Sesay,28,16,0,128,17,42,.405,2,8,.250,15,34,.441,.429,13,24,.542,18,20,38,12,2,3,8,16,49
15416,GSW,2005,Luis Flores,23,15,0,73,13,27,.481,4,9,.444,9,18,.500,.556,2,2,1.000,0,2,2,11,2,0,11,9,32
15417,GSW,2005,Nikoloz Tskitishvili,21,12,0,62,7,23,.304,2,10,.200,5,13,.385,.348,0,0,,1,11,12,6,0,3,5,9,16
15418,GSW,2004,Jason Richardson,23,78,78,2936,563,1284,.438,77,273,.282,486,1011,.481,.468,258,377,.684,124,400,524,226,86,41,196,182,1461
15419,GSW,2004,Clifford Robinson,37,82,82,2846,366,945,.387,112,314,.357,254,631,.403,.447,123,173,.711,54,268,322,271,68,73,173,237,967
15420,GSW,2004,Erick Dampier,28,74,74,2403,348,650,.535,0,2,.000,348,648,.537,.535,217,332,.654,344,543,887,60,33,137,131,227,913
15421,GSW,2004,Mike Dunleavy,23,75,69,2336,323,720,.449,94,254,.370,229,466,.491,.514,137,185,.741,87,355,442,220,68,13,143,169,877
15422,GSW,2004,Calbert Cheaney,32,79,7,2067,278,578,.481,0,10,.000,278,568,.489,.481,47,77,.610,77,183,260,136,60,12,85,184,603
15423,GSW,2004,Brian Cardinal,26,76,11,1634,220,466,.472,55,124,.444,165,342,.482,.531,238,271,.878,100,217,317,103,66,20,84,206,733
15424,GSW,2004,Speedy Claxton,25,60,29,1595,224,524,.427,4,22,.182,220,502,.438,.431,182,224,.813,38,118,156,267,97,9,102,146,634
15425,GSW,2004,Nick Van Exel,32,39,29,1255,187,479,.390,46,150,.307,141,329,.429,.438,70,99,.707,16,88,104,206,20,2,78,57,490
15426,GSW,2004,Mickaël Piétrus,21,53,22,748,96,231,.416,35,105,.333,61,126,.484,.491,52,75,.693,48,71,119,27,32,12,40,100,279
15427,GSW,2004,Avery Johnson,38,46,1,637,80,199,.402,0,3,.000,80,196,.408,.402,52,78,.667,3,30,33,111,26,3,51,34,212
15428,GSW,2004,Troy Murphy,23,28,0,610,107,243,.440,5,17,.294,102,226,.451,.451,60,80,.750,48,125,173,20,12,17,34,58,279
15429,GSW,2004,Adonal Foyle,28,44,8,572,59,130,.454,0,0,,59,130,.454,.454,19,35,.543,54,113,167,17,6,46,21,68,137
15430,GSW,2004,Cherokee Parks,31,12,0,64,4,10,.400,0,0,,4,10,.400,.400,4,6,.667,4,6,10,1,0,3,2,7,12
15431,GSW,2004,Sean Lampley,24,10,0,63,13,20,.650,0,0,,13,20,.650,.650,8,12,.667,2,9,11,2,0,1,3,2,34
15432,GSW,2004,J.R. Bremer,23,5,0,40,4,21,.190,0,8,.000,4,13,.308,.190,0,0,,2,1,3,12,0,0,5,5,8
15433,GSW,2004,Rusty LaRue,30,4,0,22,1,3,.333,1,1,1.000,0,2,.000,.500,1,2,.500,0,3,3,2,2,0,4,2,4
15434,GSW,2004,Dan Langhi,26,4,0,17,2,6,.333,0,0,,2,6,.333,.333,2,2,1.000,0,3,3,0,0,0,2,5,6
15435,GSW,2004,Popeye Jones,33,5,0,10,0,2,.000,0,0,,0,2,.000,.000,0,0,,1,0,1,0,0,0,0,2,0
15436,GSW,2003,Antawn Jamison,26,82,82,3226,691,1471,.470,65,209,.311,626,1262,.496,.492,375,475,.789,195,383,578,156,76,45,177,197,1822
15437,GSW,2003,Gilbert Arenas,21,82,82,2866,509,1180,.431,109,313,.348,400,867,.461,.478,370,468,.791,97,289,386,514,124,17,290,260,1497
15438,GSW,2003,Jason Richardson,22,82,82,2698,476,1161,.410,123,334,.368,353,827,.427,.463,207,271,.764,111,267,378,247,90,23,179,201,1282
15439,GSW,2003,Troy Murphy,22,79,79,2510,338,749,.451,3,14,.214,335,735,.456,.453,244,290,.841,228,578,806,106,65,30,111,246,923
15440,GSW,2003,Erick Dampier,27,82,82,1978,259,522,.496,0,2,.000,259,520,.498,.496,155,222,.698,248,295,543,58,27,154,112,242,673
15441,GSW,2003,Adonal Foyle,27,82,0,1787,185,345,.536,0,1,.000,185,344,.538,.536,70,104,.673,176,314,490,37,40,205,73,214,440
15442,GSW,2003,Earl Boykins,26,68,0,1321,199,464,.429,29,77,.377,170,387,.439,.460,173,200,.865,35,53,88,221,38,4,73,75,600
15443,GSW,2003,Mike Dunleavy,22,82,3,1305,168,417,.403,52,150,.347,116,267,.434,.465,78,100,.780,66,148,214,106,53,19,86,120,466
15444,GSW,2003,Bob Sura,29,55,0,1130,135,328,.412,28,85,.329,107,243,.440,.454,103,148,.696,58,109,167,177,45,2,82,108,401
15445,GSW,2003,Chris Mills,33,21,0,262,39,106,.368,7,25,.280,32,81,.395,.401,16,18,.889,19,31,50,22,7,3,10,29,101
15446,GSW,2003,Jiří Welsch,23,37,0,234,19,75,.253,1,4,.250,18,71,.254,.260,22,29,.759,12,16,28,27,8,2,19,32,61
15447,GSW,2003,Danny Fortson,26,17,0,223,20,54,.370,0,1,.000,20,53,.377,.370,19,29,.655,28,45,73,12,9,0,15,43,59
15448,GSW,2003,Óscar Torres,26,17,0,109,16,36,.444,7,13,.538,9,23,.391,.542,14,20,.700,3,9,12,3,4,2,8,9,53
15449,GSW,2003,Dean Oliver,24,15,0,93,7,29,.241,1,6,.167,6,23,.261,.259,7,8,.875,8,8,16,23,7,0,10,9,22
15450,GSW,2003,A.J. Guyton,24,2,0,9,0,4,.000,0,1,.000,0,3,.000,.000,0,0,,0,0,0,2,1,0,1,0,0
15451,GSW,2003,Guy Rucker,25,3,0,4,0,0,,0,0,,0,0,,,0,0,,0,1,1,1,0,0,0,1,0
15452,GSW,2002,Antawn Jamison,25,82,82,3033,614,1375,.447,68,210,.324,546,1165,.469,.471,323,440,.734,211,345,556,161,70,45,161,187,1619
15453,GSW,2002,Jason Richardson,21,80,75,2629,464,1090,.426,82,246,.333,382,844,.453,.463,141,210,.671,124,216,340,236,106,31,160,195,1151
15454,GSW,2002,Danny Fortson,25,77,76,2216,309,722,.428,1,4,.250,308,718,.429,.429,245,308,.795,290,609,899,127,44,17,160,255,864
15455,GSW,2002,Larry Hughes,23,73,56,2049,343,810,.423,18,93,.194,325,717,.453,.435,191,259,.737,83,162,245,316,113,23,171,150,895
15456,GSW,2002,Bob Sura,28,78,5,1780,250,590,.424,42,133,.316,208,457,.455,.459,236,328,.720,89,167,256,275,88,17,133,160,778
15457,GSW,2002,Erick Dampier,26,73,46,1740,209,480,.435,0,0,,209,480,.435,.435,136,211,.645,167,220,387,87,17,167,156,235,554
15458,GSW,2002,Adonal Foyle,26,79,36,1485,171,385,.444,0,0,,171,385,.444,.444,37,93,.398,150,234,384,41,36,168,76,179,379
15459,GSW,2002,Troy Murphy,21,82,4,1448,178,423,.421,3,9,.333,175,414,.423,.424,121,156,.776,99,223,322,70,36,21,84,217,480
15460,GSW,2002,Chris Mills,32,66,0,1237,178,427,.417,48,127,.378,130,300,.433,.473,85,107,.794,51,139,190,72,31,13,56,120,489
15461,GSW,2002,Gilbert Arenas,20,47,30,1155,174,384,.453,39,113,.345,135,271,.498,.504,124,160,.775,41,91,132,174,69,11,97,115,511
15462,GSW,2002,Mookie Blaylock,34,35,0,599,50,146,.342,15,42,.357,35,104,.337,.394,4,8,.500,8,44,52,114,24,4,37,20,119
15463,GSW,2002,Marc Jackson,27,17,0,169,22,65,.338,0,0,,22,65,.338,.338,40,48,.833,17,26,43,7,5,3,12,25,84
15464,GSW,2002,Dean Oliver,23,20,0,139,17,46,.370,2,13,.154,15,33,.455,.391,6,9,.667,0,8,8,21,3,0,11,16,42
15465,GSW,2002,Cedric Henderson,26,12,0,70,15,31,.484,2,4,.500,13,27,.481,.516,4,7,.571,1,2,3,4,6,2,8,4,36
15466,GSW,2002,Dean Garrett,35,5,0,31,4,15,.267,0,0,,4,15,.267,.267,0,0,,3,7,10,1,2,1,3,6,8
15467,GSW,2001,Antawn Jamison,24,82,82,3394,800,1812,.442,62,205,.302,738,1607,.459,.459,382,534,.715,280,435,715,164,114,28,199,225,2044
15468,GSW,2001,Mookie Blaylock,33,69,59,2352,317,801,.396,73,225,.324,244,576,.424,.441,53,76,.697,71,201,272,462,163,20,128,134,760
15469,GSW,2001,Larry Hughes,22,50,45,1846,308,805,.383,14,75,.187,294,730,.403,.391,193,252,.766,76,200,276,223,96,29,152,147,823
15470,GSW,2001,Bob Sura,27,53,42,1684,202,518,.390,47,172,.273,155,346,.448,.435,135,189,.714,54,173,227,242,54,8,160,127,586
15471,GSW,2001,Vonteego Cummings,24,66,11,1495,178,517,.344,48,143,.336,130,374,.348,.391,79,116,.681,47,90,137,227,67,14,91,160,483
15472,GSW,2001,Adonal Foyle,25,58,37,1457,156,375,.416,0,0,,156,375,.416,.416,30,68,.441,156,249,405,48,31,156,79,136,342
15473,GSW,2001,Marc Jackson,26,48,35,1410,237,508,.467,5,23,.217,232,485,.478,.471,154,192,.802,119,242,361,59,34,27,93,138,633
15474,GSW,2001,Chris Porter,22,51,35,1147,173,445,.389,0,5,.000,173,440,.393,.389,94,141,.667,89,100,189,61,45,6,59,111,440
15475,GSW,2001,Erick Dampier,25,43,26,1038,126,314,.401,0,2,.000,126,312,.404,.401,67,126,.532,97,153,250,59,17,58,82,123,319
15476,GSW,2001,Corie Blount,32,38,0,918,107,247,.433,2,8,.250,105,239,.439,.437,43,68,.632,146,169,315,51,29,17,55,90,259
15477,GSW,2001,Adam Keefe,30,67,13,836,64,159,.403,1,3,.333,63,156,.404,.406,39,63,.619,90,119,209,36,28,20,40,102,168
15478,GSW,2001,Chris Mills,31,15,8,493,71,191,.372,7,25,.280,64,166,.386,.390,31,36,.861,24,69,93,18,9,5,20,43,180
15479,GSW,2001,Vinny Del Negro,34,29,1,396,30,90,.333,1,9,.111,29,81,.358,.339,16,16,1.000,4,27,31,62,6,0,15,36,77
15480,GSW,2001,Chris Mullin,37,20,8,374,36,106,.340,19,52,.365,17,54,.315,.429,24,28,.857,10,31,41,19,16,10,19,28,115
15481,GSW,2001,Paul McPherson,22,22,0,287,62,120,.517,2,6,.333,60,114,.526,.525,24,34,.706,20,11,31,22,13,1,24,32,150
15482,GSW,2001,Danny Fortson,24,6,6,203,29,50,.580,0,0,,29,50,.580,.580,42,54,.778,29,69,98,5,2,0,10,22,100
15483,GSW,2001,Bill Curley,28,15,2,177,24,43,.558,1,1,1.000,23,42,.548,.570,11,15,.733,21,16,37,3,6,8,14,41,60
15484,GSW,2001,Chris Garner,25,8,0,149,7,37,.189,0,7,.000,7,30,.233,.189,5,6,.833,2,10,12,18,7,1,9,18,19
15485,GSW,2001,Chucky Brown,32,6,0,74,9,20,.450,0,2,.000,9,18,.500,.450,6,10,.600,3,15,18,5,3,1,2,10,24
15486,GSW,2001,John Coker,29,6,0,32,1,8,.125,0,0,,1,8,.125,.125,0,0,,3,2,5,2,1,0,2,4,2
15487,GSW,2001,Rubén Garcés,27,3,0,11,0,7,.000,0,0,,0,7,.000,.000,0,0,,4,3,7,1,1,1,0,0,0
15488,GSW,2001,Randy Livingston,25,2,0,7,0,2,.000,0,1,.000,0,1,.000,.000,0,0,,0,1,1,1,0,0,0,0,0
15489,GSW,2000,Mookie Blaylock,32,73,72,2459,327,837,.391,101,301,.336,226,536,.422,.451,67,95,.705,55,215,270,489,146,22,143,122,822
15490,GSW,2000,Jason Caffey,26,71,56,2159,323,675,.479,0,2,.000,323,673,.480,.479,206,345,.597,189,293,482,119,62,20,170,269,852
15491,GSW,2000,Donyell Marshall,26,64,51,2071,331,840,.394,49,138,.355,282,702,.402,.423,199,255,.780,189,448,637,167,68,68,123,180,910
15492,GSW,2000,Vonteego Cummings,23,75,11,1793,265,655,.405,49,151,.325,216,504,.429,.442,127,169,.751,57,127,184,247,91,13,132,174,706
15493,GSW,2000,Adonal Foyle,24,76,59,1654,193,380,.508,0,0,,193,380,.508,.508,34,90,.378,174,250,424,42,26,136,71,218,420
15494,GSW,2000,Antawn Jamison,23,43,41,1556,356,756,.471,2,7,.286,354,749,.473,.472,127,208,.611,172,187,359,90,30,15,113,115,841
15495,GSW,2000,Larry Hughes,21,32,32,1306,267,686,.389,18,74,.243,249,612,.407,.402,173,235,.736,61,129,190,130,61,16,100,97,725
15496,GSW,2000,Tony Farmer,30,74,9,1199,127,312,.407,8,44,.182,119,268,.444,.420,203,265,.766,118,177,295,74,66,16,82,167,465
15497,GSW,2000,John Starks,34,33,30,1108,192,508,.378,56,161,.348,136,347,.392,.433,45,54,.833,10,81,91,170,37,3,64,93,485
15498,GSW,2000,Sam Jacobson,24,49,5,663,103,203,.507,9,24,.375,94,179,.525,.530,30,39,.769,25,45,70,30,29,3,31,112,245
15499,GSW,2000,Chris Mills,30,20,11,649,123,292,.421,8,30,.267,115,262,.439,.435,68,84,.810,46,77,123,47,18,4,25,60,322
15500,GSW,2000,Erick Dampier,24,21,12,495,70,173,.405,0,0,,70,173,.405,.405,27,51,.529,48,86,134,19,8,15,29,75,167
15501,GSW,2000,Mark Davis,26,23,7,464,56,137,.409,0,2,.000,56,135,.415,.409,31,47,.660,31,53,84,38,25,4,40,52,143
15502,GSW,2000,Terry Cummings,38,22,0,398,76,177,.429,0,0,,76,177,.429,.429,32,39,.821,45,62,107,21,13,8,27,74,184
15503,GSW,2000,Billy Owens,30,16,4,386,38,100,.380,2,7,.286,36,93,.387,.390,25,42,.595,36,73,109,38,7,5,24,47,103
15504,GSW,2000,Sam Mack,29,23,5,333,37,122,.303,21,64,.328,16,58,.276,.389,19,20,.950,7,32,39,24,18,1,19,45,114
15505,GSW,2000,Tim Legler,33,23,4,284,28,78,.359,7,21,.333,21,57,.368,.404,14,18,.778,4,19,23,24,4,1,6,33,77
15506,GSW,2000,Bill Curley,27,24,0,259,23,57,.404,0,1,.000,23,56,.411,.404,18,25,.720,14,28,42,14,11,4,17,51,64
15507,GSW,2000,Damon Jones,23,13,1,196,25,54,.463,11,23,.478,14,31,.452,.565,7,9,.778,0,16,16,39,6,0,15,13,68
15508,GSW,2000,Tim Young,23,25,0,137,13,39,.333,0,0,,13,39,.333,.333,28,36,.778,13,22,35,5,2,1,9,18,54
15509,GSW,2000,Drew Barry,26,8,0,85,9,18,.500,3,9,.333,6,9,.667,.583,1,2,.500,0,8,8,17,2,0,6,14,22
15510,GSW,2000,Chris Carr,25,7,0,74,11,33,.333,1,8,.125,10,25,.400,.348,16,19,.842,5,8,13,3,0,1,5,12,39
15511,GSW,2000,Jamel Thomas,26,4,0,27,3,8,.375,0,2,.000,3,6,.500,.375,0,0,,1,2,3,4,1,0,4,2,6
15512,GSW,1999,John Starks,33,50,50,1686,269,728,.370,78,269,.290,191,459,.416,.423,74,100,.740,33,130,163,235,69,5,83,135,690
15513,GSW,1999,Erick Dampier,23,50,50,1414,161,414,.389,0,0,,161,414,.389,.389,120,204,.588,164,218,382,54,26,58,92,165,442
15514,GSW,1999,Chris Mills,29,47,24,1395,186,453,.411,32,115,.278,154,338,.456,.446,79,96,.823,49,188,237,103,39,14,58,125,483
15515,GSW,1999,Bimbo Coles,30,48,32,1272,183,414,.442,6,25,.240,177,389,.455,.449,83,101,.822,21,96,117,222,45,11,82,113,455
15516,GSW,1999,Donyell Marshall,25,48,20,1250,208,494,.421,26,72,.361,182,422,.431,.447,88,121,.727,115,227,342,66,47,37,80,123,530
15517,GSW,1999,Antawn Jamison,22,47,24,1058,178,394,.452,3,10,.300,175,384,.456,.456,90,153,.588,131,170,301,34,38,16,68,102,449
15518,GSW,1999,Terry Cummings,37,50,0,1011,186,424,.439,1,1,1.000,185,423,.437,.440,81,114,.711,95,160,255,58,46,10,58,168,454
15519,GSW,1999,Jason Caffey,25,35,32,876,123,277,.444,0,1,.000,123,276,.446,.444,62,98,.633,79,126,205,18,24,9,75,113,308
15520,GSW,1999,Muggsy Bogues,34,36,5,714,76,154,.494,0,6,.000,76,148,.514,.494,31,36,.861,16,57,73,134,43,1,47,44,183
15521,GSW,1999,Tony Delk,25,36,13,630,92,253,.364,16,66,.242,76,187,.406,.395,46,71,.648,11,43,54,95,16,6,45,47,246
15522,GSW,1999,Adonal Foyle,23,44,0,614,52,121,.430,0,0,,52,121,.430,.430,25,51,.490,79,115,194,18,15,43,31,90,129
15523,GSW,1999,Felton Spencer,31,26,0,159,15,33,.455,0,0,,15,33,.455,.455,12,26,.462,18,28,46,0,5,10,9,41,42
15524,GSW,1999,Duane Ferrell,33,8,0,46,1,14,.071,0,0,,1,14,.071,.071,3,4,.750,5,1,6,0,1,1,1,4,5
15525,GSW,1998,Erick Dampier,22,82,82,2656,352,791,.445,0,2,.000,352,789,.446,.445,267,399,.669,272,443,715,94,39,139,175,281,971
15526,GSW,1998,Donyell Marshall,24,73,73,2611,451,1090,.414,63,201,.313,388,889,.436,.443,158,216,.731,210,418,628,159,95,73,147,226,1123
15527,GSW,1998,Tony Delk,24,74,9,1647,311,794,.392,41,156,.263,270,638,.423,.418,110,149,.738,38,132,170,169,73,12,105,88,773
15528,GSW,1998,Joe Smith,22,49,49,1645,343,800,.429,0,7,.000,343,793,.433,.429,160,208,.769,141,197,338,67,44,38,106,169,846
15529,GSW,1998,Muggsy Bogues,33,59,31,1554,139,318,.437,4,16,.250,135,302,.447,.443,59,66,.894,30,101,131,327,65,3,104,56,341
15530,GSW,1998,Bimbo Coles,29,53,44,1471,166,438,.379,13,57,.228,153,381,.402,.394,78,88,.886,17,106,123,248,51,13,89,135,423
15531,GSW,1998,Jim Jackson,27,31,31,1258,230,572,.402,22,79,.278,208,493,.422,.421,103,128,.805,61,112,173,158,38,2,118,74,585
15532,GSW,1998,Clarence Weatherspoon,27,31,31,1035,127,277,.458,0,0,,127,277,.458,.458,77,103,.748,89,169,258,49,42,22,50,86,331
15533,GSW,1998,Brian Shaw,31,39,32,1028,103,307,.336,21,67,.313,82,240,.342,.370,24,33,.727,20,131,151,173,35,14,75,93,251
15534,GSW,1998,Felton Spencer,30,68,0,813,59,129,.457,0,0,,59,129,.457,.457,44,79,.557,93,133,226,17,23,37,49,175,162
15535,GSW,1998,Jason Caffey,24,29,6,713,126,267,.472,0,1,.000,126,266,.474,.472,63,97,.649,84,87,171,31,12,3,57,89,315
15536,GSW,1998,Adonal Foyle,22,55,1,656,69,170,.406,0,1,.000,69,169,.408,.406,27,62,.435,73,111,184,14,13,52,50,94,165
15537,GSW,1998,Todd Fuller,23,57,1,613,86,205,.420,0,4,.000,86,201,.428,.420,55,80,.688,61,135,196,10,6,16,37,89,227
15538,GSW,1998,Latrell Sprewell,27,14,13,547,110,277,.397,9,48,.188,101,229,.441,.413,70,94,.745,7,44,51,68,19,5,44,26,299
15539,GSW,1998,Duane Ferrell,32,50,5,461,41,111,.369,0,6,.000,41,105,.390,.369,12,22,.545,25,22,47,26,21,6,18,50,94
15540,GSW,1998,David Vaughn,24,22,0,322,46,114,.404,0,1,.000,46,113,.407,.404,22,34,.647,34,68,102,18,10,6,31,48,114
15541,GSW,1998,Gerald Madkins,28,19,0,243,13,34,.382,6,15,.400,7,19,.368,.471,5,7,.714,2,13,15,45,13,1,13,18,37
15542,GSW,1998,Dickey Simpkins,25,19,0,196,22,48,.458,0,1,.000,22,47,.468,.458,10,26,.385,19,27,46,16,5,2,19,19,54
15543,GSW,1998,Brandon Williams,22,9,2,140,16,50,.320,3,9,.333,13,41,.317,.350,2,4,.500,4,11,15,3,6,3,9,18,37
15544,GSW,1998,Carl Thomas,28,10,0,139,25,65,.385,5,21,.238,20,44,.455,.423,7,10,.700,4,6,10,9,5,1,6,12,62
15545,GSW,1998,B.J. Armstrong,30,4,0,59,6,19,.316,0,1,.000,6,18,.333,.316,5,7,.714,4,3,7,6,4,0,7,6,17
15546,GSW,1998,Jeff Grayer,32,4,0,23,4,7,.571,2,3,.667,2,4,.500,.714,0,0,,0,4,4,1,2,0,2,7,10
15547,GSW,1997,Latrell Sprewell,26,80,79,3353,649,1444,.449,147,415,.354,502,1029,.488,.500,493,585,.843,58,308,366,507,132,45,322,153,1938
15548,GSW,1997,Joe Smith,21,80,80,3086,587,1293,.454,12,46,.261,575,1247,.461,.459,307,377,.814,261,418,679,125,74,86,192,244,1493
15549,GSW,1997,Chris Mullin,33,79,63,2733,438,792,.553,83,202,.411,355,590,.602,.605,184,213,.864,75,242,317,322,130,33,192,155,1143
15550,GSW,1997,Mark Price,32,70,49,1876,263,589,.447,112,283,.396,151,306,.493,.542,155,171,.906,36,143,179,342,67,3,161,100,793
15551,GSW,1997,Felton Spencer,29,72,64,1539,137,282,.486,0,0,,137,282,.486,.486,94,161,.584,152,258,410,21,34,50,87,273,368
15552,GSW,1997,Bimbo Coles,28,51,13,1183,122,314,.389,30,102,.294,92,212,.434,.436,37,49,.755,39,79,118,149,35,7,59,96,311
15553,GSW,1997,Andrew DeClercq,23,71,1,1065,142,273,.520,0,0,,142,273,.520,.520,91,151,.603,122,176,298,32,33,27,76,229,375
15554,GSW,1997,Donyell Marshall,23,61,20,1022,174,421,.413,35,111,.315,139,310,.448,.455,61,98,.622,92,184,276,54,25,46,55,96,444
15555,GSW,1997,B.J. Armstrong,29,49,17,1020,148,327,.453,25,90,.278,123,237,.519,.491,68,79,.861,7,67,74,126,25,2,53,56,389
15556,GSW,1997,Todd Fuller,22,75,18,949,114,266,.429,0,0,,114,266,.429,.429,76,110,.691,108,141,249,24,10,20,52,146,304
15557,GSW,1997,Ray Owes,24,57,1,592,75,180,.417,1,5,.200,74,175,.423,.419,26,46,.565,64,99,163,15,15,20,23,86,177
15558,GSW,1997,Donald Royal,30,36,1,509,37,96,.385,0,2,.000,37,94,.394,.385,62,78,.795,33,62,95,14,11,9,22,55,136
15559,GSW,1997,Scott Burrell,26,29,0,457,53,140,.379,22,61,.361,31,79,.392,.457,15,23,.652,25,54,79,35,14,8,28,60,143
15560,GSW,1997,Melvin Booker,24,16,4,409,44,101,.436,11,35,.314,33,66,.500,.490,18,20,.900,7,21,28,50,3,2,20,28,117
15561,GSW,1997,Lou Roe,24,17,0,107,14,48,.292,3,11,.273,11,37,.297,.323,9,19,.474,7,7,14,6,3,1,11,10,40
15562,GSW,1997,Clifford Rozier,24,1,0,5,0,1,.000,0,0,,0,1,.000,.000,0,0,,0,0,0,0,0,0,0,0,0
15563,GSW,1996,Latrell Sprewell,25,78,78,3064,515,1202,.428,91,282,.323,424,920,.461,.466,352,446,.789,124,256,380,328,127,45,222,150,1473
15564,GSW,1996,Joe Smith,20,82,82,2821,469,1024,.458,10,28,.357,459,996,.461,.463,303,392,.773,300,417,717,79,85,134,138,224,1251
15565,GSW,1996,B.J. Armstrong,28,82,64,2262,340,727,.468,98,207,.473,242,520,.465,.535,234,279,.839,22,162,184,401,68,6,128,147,1012
15566,GSW,1996,Rony Seikaly,30,64,60,1813,285,568,.502,2,3,.667,283,565,.501,.504,204,282,.723,166,333,499,71,40,69,180,219,776
15567,GSW,1996,Jerome Kersey,33,76,58,1620,205,500,.410,3,17,.176,202,483,.418,.413,97,147,.660,154,209,363,114,91,45,75,205,510
15568,GSW,1996,Chris Mullin,32,55,19,1617,269,539,.499,59,150,.393,210,389,.540,.554,137,160,.856,44,115,159,194,75,32,122,127,734
15569,GSW,1996,Tim Hardaway,29,52,18,1487,255,606,.421,85,232,.366,170,374,.455,.491,140,182,.769,22,109,131,360,74,11,125,131,735
15570,GSW,1996,Donyell Marshall,22,62,6,934,125,314,.398,28,94,.298,97,220,.441,.443,64,83,.771,65,148,213,49,22,31,48,83,342
15571,GSW,1996,Chris Gatling,28,47,2,862,171,308,.555,0,1,.000,171,307,.557,.555,84,132,.636,78,164,242,26,19,29,60,135,426
15572,GSW,1996,Kevin Willis,33,28,18,778,130,300,.433,1,4,.250,129,296,.436,.435,54,77,.701,74,144,218,19,13,16,62,95,315
15573,GSW,1996,Bimbo Coles,27,29,3,733,87,218,.399,25,82,.305,62,136,.456,.456,29,38,.763,11,48,59,126,31,5,48,78,228
15574,GSW,1996,Clifford Rozier,23,59,1,723,79,135,.585,0,2,.000,79,133,.594,.585,26,55,.473,71,100,171,22,19,30,40,135,184
15575,GSW,1996,Jon Barry,26,68,0,712,91,185,.492,44,93,.473,47,92,.511,.611,31,37,.838,17,46,63,85,33,11,42,51,257
15576,GSW,1996,Andrew DeClercq,22,22,1,203,24,50,.480,0,1,.000,24,49,.490,.480,11,19,.579,18,21,39,9,7,5,4,30,59
15577,GSW,1996,David Wood,31,21,0,96,7,14,.500,1,3,.333,6,11,.545,.536,7,8,.875,7,9,16,5,2,1,3,23,22
15578,GSW,1996,Robert Churchwell,23,4,0,20,3,8,.375,0,0,,3,8,.375,.375,0,0,,0,3,3,1,0,0,2,1,6
15579,GSW,1996,Geert Hammink,26,3,0,10,1,2,.500,0,0,,1,2,.500,.500,2,3,.667,0,1,1,0,0,0,0,1,4
15580,GSW,1995,Latrell Sprewell,24,69,69,2771,490,1171,.418,90,326,.276,400,845,.473,.457,350,448,.781,58,198,256,279,112,46,230,108,1420
15581,GSW,1995,Tim Hardaway,28,62,62,2321,430,1007,.427,168,444,.378,262,563,.465,.510,219,288,.760,46,144,190,578,88,12,214,155,1247
15582,GSW,1995,Keith Jennings,26,80,24,1722,190,425,.447,75,204,.368,115,221,.520,.535,134,153,.876,26,122,148,373,95,2,120,133,589
15583,GSW,1995,Clifford Rozier,22,66,34,1494,189,390,.485,2,7,.286,187,383,.488,.487,68,152,.447,200,286,486,45,35,39,89,196,448
15584,GSW,1995,Chris Gatling,27,58,22,1470,324,512,.633,0,1,.000,324,511,.634,.633,148,250,.592,144,299,443,51,39,52,117,184,796
15585,GSW,1995,David Wood,30,78,13,1336,153,326,.469,31,91,.341,122,235,.519,.517,91,117,.778,83,158,241,65,28,13,53,217,428
15586,GSW,1995,Tom Gugliotta,25,40,40,1324,176,397,.443,28,90,.311,148,307,.482,.479,55,97,.567,100,197,297,122,50,23,93,98,435
15587,GSW,1995,Victor Alexander,25,50,29,1237,230,447,.515,6,25,.240,224,422,.531,.521,36,60,.600,87,204,291,60,28,29,76,145,502
15588,GSW,1995,Donyell Marshall,21,32,23,1050,187,453,.413,37,137,.270,150,316,.475,.454,64,100,.640,73,136,209,48,20,38,57,94,475
15589,GSW,1995,Rony Seikaly,29,36,35,1035,162,314,.516,0,0,,162,314,.516,.516,111,160,.694,77,189,266,45,20,37,104,122,435
15590,GSW,1995,Carlos Rogers,23,49,18,1017,180,340,.529,2,14,.143,178,326,.546,.532,76,146,.521,108,170,278,37,22,52,84,124,438
15591,GSW,1995,Chris Mullin,31,25,23,890,170,348,.489,42,93,.452,128,255,.502,.549,94,107,.879,25,90,115,125,38,19,93,53,476
15592,GSW,1995,Ricky Pierce,35,27,6,673,111,254,.437,23,70,.329,88,184,.478,.482,93,106,.877,12,52,64,40,22,2,24,38,338
15593,GSW,1995,Ryan Lorthridge,22,37,2,672,106,223,.475,3,14,.214,103,209,.493,.482,57,88,.648,24,47,71,101,28,1,57,42,272
15594,GSW,1995,Dwayne Morton,23,41,6,395,50,129,.388,9,25,.360,41,104,.394,.422,58,85,.682,21,37,58,18,11,15,27,45,167
15595,GSW,1995,Tim Legler,28,24,0,371,60,115,.522,26,50,.520,34,65,.523,.635,30,34,.882,12,28,40,27,12,1,20,33,176
15596,GSW,1995,Manute Bol,32,5,2,81,6,10,.600,3,5,.600,3,5,.600,.750,0,0,,1,11,12,0,0,9,1,10,15
15597,GSW,1995,Rod Higgins,35,5,2,46,3,12,.250,1,6,.167,2,6,.333,.292,3,4,.750,4,3,7,3,1,1,1,7,10
15598,GSW,1994,Latrell Sprewell,23,82,82,3533,613,1417,.433,141,391,.361,472,1026,.460,.482,353,456,.774,80,321,401,385,180,76,226,158,1720
15599,GSW,1994,Billy Owens,24,79,72,2738,492,971,.507,3,15,.200,489,956,.512,.508,199,326,.610,230,410,640,326,83,60,214,269,1186
15600,GSW,1994,Chris Webber,20,76,76,2438,572,1037,.552,0,14,.000,572,1023,.559,.552,189,355,.532,305,389,694,272,93,164,206,247,1333
15601,GSW,1994,Avery Johnson,28,82,70,2332,356,724,.492,0,12,.000,356,712,.500,.492,178,253,.704,41,135,176,433,113,8,172,160,890
15602,GSW,1994,Chris Mullin,30,62,39,2324,410,869,.472,55,151,.364,355,718,.494,.503,165,219,.753,64,281,345,315,107,53,178,114,1040
15603,GSW,1994,Victor Alexander,24,69,39,1318,266,502,.530,2,13,.154,264,489,.540,.532,68,129,.527,114,194,308,66,28,32,86,168,602
15604,GSW,1994,Chris Gatling,26,82,23,1296,271,461,.588,0,1,.000,271,460,.589,.588,129,208,.620,143,254,397,41,40,63,84,223,671
15605,GSW,1994,Keith Jennings,25,76,2,1097,138,342,.404,56,151,.371,82,191,.429,.485,100,120,.833,16,73,89,218,65,0,74,62,432
15606,GSW,1994,Jeff Grayer,28,67,4,1096,191,363,.526,2,12,.167,189,351,.538,.529,71,118,.602,76,115,191,62,33,13,63,103,455
15607,GSW,1994,Byron Houston,24,71,2,866,81,177,.458,1,7,.143,80,170,.471,.460,33,54,.611,67,127,194,32,33,31,49,181,196
15608,GSW,1994,Josh Grant,26,53,0,382,59,146,.404,17,61,.279,42,85,.494,.462,22,29,.759,27,62,89,24,18,8,30,62,157
15609,GSW,1994,Jud Buechler,25,36,0,218,42,84,.500,12,29,.414,30,55,.545,.571,10,20,.500,13,19,32,16,8,1,12,24,106
15610,GSW,1994,Andre Spencer,29,5,1,63,9,18,.500,0,0,,9,18,.500,.500,3,4,.750,4,8,12,3,1,2,2,6,21
15611,GSW,1994,Todd Lichti,27,5,0,58,10,28,.357,2,2,1.000,8,26,.308,.393,9,11,.818,3,7,10,3,0,0,0,9,31
15612,GSW,1994,Dell Demps,23,2,0,11,2,6,.333,0,0,,2,6,.333,.333,0,2,.000,0,0,0,1,2,0,1,1,4
15613,GSW,1994,Tod Murphy,30,2,0,10,0,0,,0,0,,0,0,,,0,0,,0,1,1,1,0,0,0,2,0
15614,GSW,1993,Latrell Sprewell,22,77,69,2741,449,968,.464,73,198,.369,376,770,.488,.502,211,283,.746,79,192,271,295,126,52,203,166,1182
15615,GSW,1993,Tim Hardaway,26,66,66,2609,522,1168,.447,102,309,.330,420,859,.489,.491,273,367,.744,60,203,263,699,116,12,220,152,1419
15616,GSW,1993,Tyrone Hill,24,74,66,2070,251,494,.508,0,4,.000,251,490,.512,.508,138,221,.624,255,499,754,68,41,40,92,320,640
15617,GSW,1993,Chris Mullin,29,46,46,1902,474,930,.510,60,133,.451,414,797,.519,.542,183,226,.810,42,190,232,166,68,41,139,76,1191
15618,GSW,1993,Victor Alexander,23,72,59,1753,344,667,.516,10,22,.455,334,645,.518,.523,111,162,.685,132,288,420,93,34,53,120,218,809
15619,GSW,1993,Jud Buechler,24,70,9,1287,176,403,.437,20,59,.339,156,344,.453,.462,65,87,.747,81,114,195,94,47,19,55,98,437
15620,GSW,1993,Byron Houston,23,79,8,1274,145,325,.446,2,7,.286,143,318,.450,.449,129,194,.665,119,196,315,69,44,43,87,253,421
15621,GSW,1993,Chris Gatling,25,70,11,1248,249,462,.539,0,6,.000,249,456,.546,.539,150,207,.725,129,191,320,40,44,53,102,197,648
15622,GSW,1993,Billy Owens,23,37,37,1201,247,493,.501,1,11,.091,246,482,.510,.502,117,183,.639,108,156,264,144,35,28,106,105,612
15623,GSW,1993,Jeff Grayer,27,48,12,1025,165,353,.467,2,14,.143,163,339,.481,.470,91,136,.669,71,86,157,70,31,8,54,120,423
15624,GSW,1993,Šarūnas Marčiulionis,28,30,8,836,178,328,.543,3,15,.200,175,313,.559,.547,162,213,.761,40,57,97,105,51,2,76,92,521
15625,GSW,1993,Sean Higgins,24,29,4,591,96,215,.447,13,37,.351,83,178,.466,.477,35,47,.745,23,45,68,66,13,5,64,54,240
15626,GSW,1993,Andre Spencer,28,17,1,407,73,160,.456,0,2,.000,73,158,.462,.456,41,54,.759,38,42,80,24,15,7,24,61,187
15627,GSW,1993,Paul Pressey,34,18,0,268,29,66,.439,0,4,.000,29,62,.468,.439,21,27,.778,8,23,31,30,11,5,23,36,79
15628,GSW,1993,Ed Nealy,32,30,4,229,16,46,.348,7,22,.318,9,24,.375,.424,7,10,.700,8,40,48,13,9,1,5,35,46
15629,GSW,1993,Alton Lister,34,20,9,174,19,42,.452,0,0,,19,42,.452,.452,7,13,.538,15,29,44,5,0,9,18,40,45
15630,GSW,1993,Keith Jennings,24,8,0,136,25,42,.595,5,9,.556,20,33,.606,.655,14,18,.778,2,9,11,23,4,0,7,18,69
15631,GSW,1993,Pat Durham,25,5,1,78,6,25,.240,0,0,,6,25,.240,.240,9,12,.750,5,9,14,4,1,1,7,6,21
15632,GSW,1993,Joe Courtney,23,7,0,70,9,23,.391,0,0,,9,23,.391,.391,4,5,.800,2,15,17,2,3,4,3,8,22
15633,GSW,1993,Barry Stevens,30,2,0,6,1,2,.500,0,0,,1,2,.500,.500,0,0,,2,0,2,0,0,0,0,1,2
15634,GSW,1992,Chris Mullin,28,81,81,3346,830,1584,.524,64,175,.366,766,1409,.544,.544,350,420,.833,127,323,450,286,173,62,202,171,2074
15635,GSW,1992,Tim Hardaway,25,81,81,3332,734,1592,.461,127,376,.338,607,1216,.499,.501,298,389,.766,81,229,310,807,164,13,267,208,1893
15636,GSW,1992,Billy Owens,22,80,77,2510,468,891,.525,1,9,.111,467,882,.529,.526,204,312,.654,243,396,639,188,90,65,179,276,1141
15637,GSW,1992,Šarūnas Marčiulionis,27,72,5,2117,491,912,.538,3,10,.300,488,902,.541,.540,376,477,.788,68,140,208,243,116,10,193,237,1361
15638,GSW,1992,Tyrone Hill,23,82,75,1886,254,487,.522,0,1,.000,254,486,.523,.522,163,235,.694,182,411,593,47,73,43,106,315,671
15639,GSW,1992,Mario Elie,28,79,32,1677,221,424,.521,23,70,.329,198,354,.559,.548,155,182,.852,69,158,227,174,68,15,83,159,620
15640,GSW,1992,Vincent Askew,25,80,10,1496,193,379,.509,1,10,.100,192,369,.520,.511,111,160,.694,89,144,233,188,47,23,84,128,498
15641,GSW,1992,Victor Alexander,22,80,28,1350,243,459,.529,0,1,.000,243,458,.531,.529,103,149,.691,106,230,336,32,45,62,91,176,589
15642,GSW,1992,Chris Gatling,24,54,1,612,117,206,.568,0,4,.000,117,202,.579,.568,72,109,.661,75,107,182,16,31,36,44,101,306
15643,GSW,1992,Rod Higgins,32,25,6,535,87,211,.412,33,95,.347,54,116,.466,.491,48,59,.814,30,55,85,22,15,13,15,75,255
15644,GSW,1992,Tom Tolbert,26,35,0,310,33,86,.384,2,8,.250,31,78,.397,.395,22,40,.550,14,41,55,21,10,6,20,73,90
15645,GSW,1992,Alton Lister,33,26,12,293,44,79,.557,0,0,,44,79,.557,.557,14,33,.424,21,71,92,14,5,16,20,61,102
15646,GSW,1992,Jim Petersen,29,27,2,169,18,40,.450,0,2,.000,18,38,.474,.450,7,10,.700,12,33,45,9,5,6,5,35,43
15647,GSW,1992,Jud Buechler,23,15,0,121,10,33,.303,0,1,.000,10,32,.313,.303,9,12,.750,10,18,28,10,9,3,7,11,29
15648,GSW,1992,Jaren Jackson,24,5,0,54,11,23,.478,0,0,,11,23,.478,.478,4,6,.667,5,5,10,3,2,0,4,7,26
15649,GSW,1992,Kenny Battle,27,8,0,46,8,13,.615,0,1,.000,8,12,.667,.615,2,4,.500,1,6,7,4,1,2,2,6,18
15650,GSW,1992,Tony Massenburg,24,7,0,22,5,8,.625,0,0,,5,8,.625,.625,6,9,.667,4,8,12,0,0,0,3,10,16
15651,GSW,1992,Mike Smrek,29,2,0,3,0,0,,0,0,,0,0,,,0,0,,0,1,1,0,0,0,0,0,0
15652,GSW,1992,Billy Thompson,28,1,0,1,0,0,,0,0,,0,0,,,0,0,,0,0,0,0,0,0,0,0,0
15653,GSW,1991,Chris Mullin,27,82,82,3315,777,1449,.536,40,133,.301,737,1316,.560,.550,513,580,.884,141,302,443,329,173,63,245,176,2107
15654,GSW,1991,Tim Hardaway,24,82,82,3215,739,1551,.476,97,252,.385,642,1299,.494,.508,306,381,.803,87,245,332,793,214,12,270,228,1881
15655,GSW,1991,Mitch Richmond,25,77,77,3027,703,1424,.494,40,115,.348,663,1309,.506,.508,394,465,.847,147,305,452,238,126,34,230,207,1840
15656,GSW,1991,Rod Higgins,31,82,9,2024,259,559,.463,73,220,.332,186,339,.549,.529,185,226,.819,109,245,354,113,52,37,65,198,776
15657,GSW,1991,Alton Lister,32,77,65,1552,188,393,.478,0,1,.000,188,392,.480,.478,115,202,.569,121,362,483,93,20,90,106,282,491
15658,GSW,1991,Tom Tolbert,25,62,32,1371,183,433,.423,7,21,.333,176,412,.427,.431,127,172,.738,87,188,275,76,35,38,80,195,500
15659,GSW,1991,Tyrone Hill,22,74,22,1192,147,299,.492,0,0,,147,299,.492,.492,96,152,.632,157,226,383,19,33,30,72,264,390
15660,GSW,1991,Šarūnas Marčiulionis,26,50,10,987,183,365,.501,1,6,.167,182,359,.507,.503,178,246,.724,51,67,118,85,62,4,75,136,545
15661,GSW,1991,Jim Petersen,28,62,21,834,114,236,.483,1,4,.250,113,232,.487,.485,50,76,.658,69,131,200,27,13,41,48,153,279
15662,GSW,1991,Kevin Pritchard,23,62,1,773,88,229,.384,5,31,.161,83,198,.419,.395,62,77,.805,16,49,65,81,30,8,59,104,243
15663,GSW,1991,Mario Elie,27,30,0,624,77,152,.507,3,8,.375,74,144,.514,.516,74,87,.851,46,63,109,44,19,10,27,83,231
15664,GSW,1991,Paul Mokeski,34,36,1,257,21,59,.356,3,9,.333,18,50,.360,.381,12,15,.800,20,47,67,9,8,3,7,58,57
15665,GSW,1991,Steve Johnson,33,24,8,228,34,63,.540,0,0,,34,63,.540,.540,22,37,.595,18,39,57,17,4,4,25,50,90
15666,GSW,1991,Larry Robinson,23,24,0,170,24,59,.407,0,0,,24,59,.407,.407,8,15,.533,15,8,23,11,9,1,16,23,56
15667,GSW,1991,Les Jepsen,23,21,0,105,11,36,.306,0,1,.000,11,35,.314,.306,6,9,.667,17,20,37,1,1,3,3,16,28
15668,GSW,1991,Vincent Askew,24,7,0,85,12,25,.480,0,0,,12,25,.480,.480,9,11,.818,7,4,11,13,2,0,6,21,33
15669,GSW,1991,Mike Smrek,28,5,0,25,6,11,.545,0,0,,6,11,.545,.545,2,4,.500,3,4,7,1,2,0,2,9,14
15670,GSW,1991,Bart Kofoed,26,5,0,21,0,3,.000,0,0,,0,3,.000,.000,3,6,.500,2,1,3,4,0,0,2,4,3
15671,GSW,1990,Chris Mullin,26,78,78,2830,682,1272,.536,87,234,.372,595,1038,.573,.570,505,568,.889,130,333,463,319,123,45,239,142,1956
15672,GSW,1990,Mitch Richmond,24,78,78,2799,640,1287,.497,34,95,.358,606,1192,.508,.510,406,469,.866,98,262,360,223,98,24,201,210,1720
15673,GSW,1990,Tim Hardaway,23,79,78,2663,464,985,.471,23,84,.274,441,901,.489,.483,211,276,.764,57,253,310,689,165,12,260,232,1162
15674,GSW,1990,Terry Teagle,29,82,49,2376,538,1122,.480,3,14,.214,535,1108,.483,.481,244,294,.830,114,253,367,155,91,15,144,231,1323
15675,GSW,1990,Rod Higgins,30,82,22,1993,304,632,.481,67,193,.347,237,439,.540,.534,234,285,.821,120,302,422,129,47,53,93,184,909
15676,GSW,1990,Šarūnas Marčiulionis,25,75,3,1695,289,557,.519,10,39,.256,279,518,.539,.528,317,403,.787,84,137,221,121,94,7,137,230,905
15677,GSW,1990,Tom Tolbert,24,70,21,1347,218,442,.493,5,18,.278,213,424,.502,.499,175,241,.726,122,241,363,58,23,25,79,191,616
15678,GSW,1990,Manute Bol,27,75,20,1310,56,169,.331,9,48,.188,47,121,.388,.358,25,49,.510,33,243,276,36,13,238,51,194,146
15679,GSW,1990,Winston Garland,25,51,4,891,108,288,.375,1,10,.100,107,278,.385,.377,53,63,.841,31,80,111,157,48,5,81,77,270
15680,GSW,1990,Jim Petersen,27,43,19,592,60,141,.426,0,1,.000,60,140,.429,.426,52,73,.712,49,111,160,23,17,20,36,103,172
15681,GSW,1990,Uwe Blab,27,40,33,481,33,87,.379,0,0,,33,87,.379,.379,17,31,.548,28,71,99,24,1,22,30,93,83
15682,GSW,1990,Kelvin Upshaw,27,23,0,252,51,104,.490,2,9,.222,49,95,.516,.500,24,31,.774,6,22,28,26,25,0,15,34,128
15683,GSW,1990,Chris Welp,26,14,2,142,16,38,.421,0,0,,16,38,.421,.421,18,23,.783,11,25,36,4,5,8,9,37,50
15684,GSW,1990,Mike Smrek,27,13,3,107,10,24,.417,0,0,,10,24,.417,.417,1,6,.167,11,23,34,1,4,11,9,18,21
15685,GSW,1990,Marques Johnson,33,10,0,99,12,32,.375,2,3,.667,10,29,.345,.406,14,17,.824,8,9,17,9,0,1,10,12,40
15686,GSW,1990,John Shasky,25,14,0,51,4,14,.286,0,0,,4,14,.286,.286,2,6,.333,4,9,13,1,1,2,2,10,10
15687,GSW,1990,Alton Lister,31,3,0,40,4,8,.500,0,1,.000,4,7,.571,.500,4,7,.571,5,3,8,2,1,0,0,8,12
15688,GSW,1990,Leonard Taylor,23,10,0,37,0,6,.000,0,1,.000,0,5,.000,.000,11,16,.688,4,8,12,1,0,0,5,4,11
15689,GSW,1989,Chris Mullin,25,82,82,3093,830,1630,.509,23,100,.230,807,1530,.527,.516,493,553,.892,152,331,483,415,176,39,296,178,2176
15690,GSW,1989,Mitch Richmond,23,79,79,2717,649,1386,.468,33,90,.367,616,1296,.475,.480,410,506,.810,158,310,468,334,82,13,269,223,1741
15691,GSW,1989,Winston Garland,24,79,79,2661,466,1074,.434,10,43,.233,456,1031,.442,.439,203,251,.809,101,227,328,505,175,14,187,216,1145
15692,GSW,1989,Larry Smith,31,80,78,1897,219,397,.552,0,0,,219,397,.552,.552,18,58,.310,272,380,652,118,61,54,110,248,456
15693,GSW,1989,Rod Higgins,29,81,1,1887,301,633,.476,66,168,.393,235,465,.505,.528,188,229,.821,111,265,376,160,39,42,76,172,856
15694,GSW,1989,Manute Bol,26,80,4,1769,127,344,.369,20,91,.220,107,253,.423,.398,40,66,.606,116,346,462,27,11,345,79,226,314
15695,GSW,1989,Otis Smith,25,80,5,1597,311,715,.435,7,37,.189,304,678,.448,.440,174,218,.798,128,202,330,140,88,40,129,165,803
15696,GSW,1989,Terry Teagle,28,66,41,1569,409,859,.476,2,12,.167,407,847,.481,.477,182,225,.809,110,153,263,96,79,17,116,173,1002
15697,GSW,1989,Ralph Sampson,28,61,36,1086,164,365,.449,3,8,.375,161,357,.451,.453,62,95,.653,105,202,307,77,31,65,90,170,393
15698,GSW,1989,Steve Alford,24,57,3,868,145,313,.463,20,53,.377,125,260,.481,.495,49,59,.831,10,59,69,83,44,3,44,54,359
15699,GSW,1989,John Starks,23,36,0,316,51,125,.408,10,26,.385,41,99,.414,.448,34,52,.654,15,26,41,27,23,3,39,36,146
15700,GSW,1989,Tellis Frank,23,32,2,245,34,91,.374,0,1,.000,34,90,.378,.374,39,51,.765,26,35,61,15,14,6,29,59,107
15701,GSW,1989,Ben McDonald,26,11,0,103,13,19,.684,0,0,,13,19,.684,.684,9,15,.600,4,8,12,5,4,0,3,11,35
15702,GSW,1989,Jerome Whitehead,32,5,0,42,3,6,.500,0,0,,3,6,.500,.500,1,2,.500,0,5,5,2,1,0,2,8,7
15703,GSW,1989,Orlando Graham,23,7,0,22,3,10,.300,0,0,,3,10,.300,.300,2,4,.500,8,3,11,0,0,0,2,6,8
15704,GSW,1989,John Stroeder,30,4,0,20,2,5,.400,0,0,,2,5,.400,.400,0,0,,5,9,14,3,0,2,2,1,4
15705,GSW,1989,Shelton Jones,22,2,0,13,3,5,.600,0,0,,3,5,.600,.600,0,0,,2,0,2,2,3,0,1,0,6
15706,GSW,1988,Rod Higgins,28,68,67,2188,381,725,.526,19,39,.487,362,686,.528,.539,273,322,.848,94,199,293,188,70,31,111,188,1054
15707,GSW,1988,Winston Garland,23,67,62,2122,340,775,.439,13,39,.333,327,736,.444,.447,138,157,.879,68,159,227,429,116,7,167,188,831
15708,GSW,1988,Ben McDonald,25,81,41,2039,258,552,.467,9,35,.257,249,517,.482,.476,87,111,.784,133,202,335,138,39,8,93,246,612
15709,GSW,1988,Chris Mullin,24,60,55,2033,470,926,.508,34,97,.351,436,829,.526,.526,239,270,.885,58,147,205,290,113,32,156,136,1213
15710,GSW,1988,Tellis Frank,22,78,29,1597,242,565,.428,0,1,.000,242,564,.429,.428,150,207,.725,95,235,330,111,53,23,109,267,634
15711,GSW,1988,Otis Smith,24,57,12,1358,288,569,.506,13,41,.317,275,528,.521,.518,157,201,.781,110,107,217,144,86,36,95,137,746
15712,GSW,1988,Jerome Whitehead,31,72,27,1221,174,360,.483,0,0,,174,360,.483,.483,59,82,.720,109,212,321,39,32,21,49,209,407
15713,GSW,1988,Dave Feitl,25,70,19,1128,182,404,.450,0,4,.000,182,400,.455,.450,94,134,.701,83,252,335,53,15,9,87,146,458
15714,GSW,1988,Terry Teagle,27,47,4,958,248,546,.454,1,9,.111,247,537,.460,.455,97,121,.802,41,40,81,61,32,4,80,95,594
15715,GSW,1988,Ralph Sampson,27,29,25,958,180,411,.438,0,5,.000,180,406,.443,.438,86,111,.775,82,208,290,85,24,55,109,101,446
15716,GSW,1988,Steve Harris,24,44,16,885,189,401,.471,0,6,.000,189,395,.478,.471,74,97,.763,41,64,105,70,42,6,50,74,452
15717,GSW,1988,Sleepy Floyd,27,18,18,680,132,301,.439,1,20,.050,131,281,.466,.440,116,139,.835,26,65,91,178,27,2,67,46,381
15718,GSW,1988,Dave Hoppen,23,36,8,607,80,172,.465,0,1,.000,80,171,.468,.465,51,59,.864,54,113,167,30,13,6,35,84,211
15719,GSW,1988,Larry Smith,30,20,10,499,58,123,.472,0,1,.000,58,122,.475,.472,11,27,.407,79,103,182,25,12,11,36,63,127
15720,GSW,1988,Tony White,22,35,0,462,94,203,.463,0,5,.000,94,198,.475,.463,30,41,.732,11,17,28,49,19,2,34,43,218
15721,GSW,1988,Joe Barry Carroll,29,14,14,408,79,209,.378,0,1,.000,79,208,.380,.378,59,74,.797,21,72,93,19,13,25,43,46,217
15722,GSW,1988,Dirk Minniefield,27,11,0,202,25,48,.521,1,5,.200,24,43,.558,.531,14,23,.609,8,13,21,38,15,0,16,26,65
15723,GSW,1988,Kevin Henderson,23,12,2,170,19,48,.396,0,1,.000,19,47,.404,.396,10,14,.714,6,11,17,21,8,0,15,24,48
15724,GSW,1988,Mark Wade,22,11,0,123,3,20,.150,0,2,.000,3,18,.167,.150,2,4,.500,3,12,15,34,7,1,13,13,8
15725,GSW,1988,Chris Washburn,22,8,0,86,14,32,.438,0,0,,14,32,.438,.438,5,8,.625,9,11,20,3,1,0,7,10,33
15726,GSW,1988,Kermit Washington,36,6,1,56,7,14,.500,0,0,,7,14,.500,.500,2,2,1.000,9,10,19,0,4,4,4,13,16
15727,GSW,1987,Sleepy Floyd,26,82,82,3064,503,1030,.488,73,190,.384,430,840,.512,.524,462,537,.860,56,212,268,848,146,18,280,199,1541
15728,GSW,1987,Joe Barry Carroll,28,81,81,2724,690,1461,.472,0,0,,690,1461,.472,.472,340,432,.787,173,416,589,214,92,123,226,255,1720
15729,GSW,1987,Chris Mullin,23,82,82,2377,477,928,.514,19,63,.302,458,865,.529,.524,269,326,.825,39,142,181,261,98,36,154,217,1242
15730,GSW,1987,Larry Smith,29,80,78,2374,297,544,.546,0,1,.000,297,543,.547,.546,113,197,.574,366,551,917,95,71,56,135,295,707
15731,GSW,1987,Terry Teagle,26,82,0,1650,370,808,.458,0,10,.000,370,798,.464,.458,182,234,.778,68,107,175,105,68,13,117,190,922
15732,GSW,1987,Greg Ballard,32,82,7,1579,248,564,.440,15,40,.375,233,524,.445,.453,68,91,.747,99,241,340,108,50,15,70,167,579
15733,GSW,1987,Rod Higgins,27,73,28,1497,214,412,.519,3,17,.176,211,395,.534,.523,200,240,.833,72,165,237,96,40,21,76,145,631
15734,GSW,1987,Ben McDonald,24,63,34,1284,164,360,.456,1,8,.125,163,352,.463,.457,24,38,.632,63,120,183,84,27,8,43,200,353
15735,GSW,1987,Purvis Short,29,34,15,950,240,501,.479,4,17,.235,236,484,.488,.483,137,160,.856,55,82,137,86,45,7,68,103,621
15736,GSW,1987,Jerome Whitehead,30,73,1,937,147,327,.450,0,1,.000,147,326,.451,.450,79,113,.699,110,152,262,24,16,12,50,175,373
15737,GSW,1987,Perry Moss,28,64,0,698,91,207,.440,1,14,.071,90,193,.466,.442,49,69,.710,29,66,95,90,42,3,57,96,232
15738,GSW,1987,Chris Washburn,21,35,2,385,57,145,.393,0,1,.000,57,144,.396,.393,18,51,.353,36,65,101,16,6,8,39,51,132
15739,GSW,1987,Clinton Smith,23,41,0,341,50,117,.427,0,2,.000,50,115,.435,.427,27,36,.750,26,30,56,45,13,1,26,36,127
15740,GSW,1987,Kevin Henderson,22,5,0,45,3,8,.375,0,0,,3,8,.375,.375,2,2,1.000,1,2,3,11,1,0,4,9,8
15741,GSW,1986,Joe Barry Carroll,27,79,79,2801,650,1404,.463,0,2,.000,650,1402,.464,.463,377,501,.752,193,477,670,176,101,143,275,277,1677
15742,GSW,1986,Sleepy Floyd,25,82,82,2764,510,1007,.506,39,119,.328,471,888,.530,.526,351,441,.796,76,221,297,746,157,16,290,199,1410
15743,GSW,1986,Larry Smith,28,77,74,2441,314,586,.536,0,1,.000,314,585,.537,.536,112,227,.493,384,472,856,95,62,50,135,286,740
15744,GSW,1986,Purvis Short,28,64,63,2427,633,1313,.482,15,49,.306,618,1264,.489,.488,351,406,.865,126,203,329,237,92,22,184,229,1632
15745,GSW,1986,Terry Teagle,25,82,52,2158,475,958,.496,4,25,.160,471,933,.505,.498,211,265,.796,96,139,235,115,71,34,136,241,1165
15746,GSW,1986,Greg Ballard,31,75,14,1792,272,570,.477,17,35,.486,255,535,.477,.492,101,126,.802,132,285,417,83,65,8,54,174,662
15747,GSW,1986,Chris Mullin,22,55,30,1391,287,620,.463,5,27,.185,282,593,.476,.467,189,211,.896,42,73,115,105,70,23,75,130,768
15748,GSW,1986,Geoff Huston,28,82,0,1208,140,273,.513,2,6,.333,138,267,.517,.516,63,92,.685,10,55,65,342,38,4,83,67,345
15749,GSW,1986,Jerome Whitehead,29,81,3,1079,126,294,.429,0,0,,126,294,.429,.429,60,97,.619,94,234,328,19,18,19,64,176,312
15750,GSW,1986,Pete Verhoeven,26,61,5,749,90,167,.539,1,2,.500,89,165,.539,.542,25,43,.581,65,95,160,29,29,17,30,141,206
15751,GSW,1986,Peter Thibeaux,24,42,8,531,100,233,.429,2,5,.400,98,228,.430,.433,29,48,.604,28,47,75,28,23,15,39,82,231
15752,GSW,1986,Lester Conner,26,36,0,413,51,136,.375,2,7,.286,49,129,.380,.382,40,54,.741,25,37,62,43,24,1,15,23,144
15753,GSW,1986,Guy Williams,25,5,0,25,2,5,.400,0,0,,2,5,.400,.400,3,6,.500,0,6,6,0,1,2,0,7,7
15754,GSW,1986,Ron Crevier,27,1,0,1,0,1,.000,0,0,,0,1,.000,.000,0,0,,0,0,0,0,0,0,0,0,0
15755,GSW,1985,Purvis Short,27,78,77,3081,819,1780,.460,47,150,.313,772,1630,.474,.473,501,613,.817,157,241,398,234,116,27,241,255,2186
15756,GSW,1985,Sleepy Floyd,24,82,82,2873,610,1372,.445,42,143,.294,568,1229,.462,.460,336,415,.810,62,140,202,406,134,41,251,226,1598
15757,GSW,1985,Jerome Whitehead,28,79,78,2536,421,825,.510,0,0,,421,825,.510,.510,184,235,.783,219,403,622,53,45,43,141,322,1026
15758,GSW,1985,Larry Smith,27,80,78,2497,366,690,.530,0,0,,366,690,.530,.530,155,256,.605,405,464,869,96,78,54,160,285,887
15759,GSW,1985,Lester Conner,25,79,49,2258,246,546,.451,4,20,.200,242,526,.460,.454,144,192,.750,87,159,246,369,161,13,138,136,640
15760,GSW,1985,Mickey Johnson,32,66,9,1565,304,714,.426,7,30,.233,297,684,.434,.431,260,316,.823,149,247,396,149,70,35,142,221,875
15761,GSW,1985,Othell Wilson,23,74,23,1260,134,291,.460,3,16,.188,131,275,.476,.466,54,76,.711,35,96,131,217,77,12,95,122,325
15762,GSW,1985,Chuck Aleksinas,25,74,4,1114,161,337,.478,0,1,.000,161,336,.479,.478,55,75,.733,87,183,270,36,15,15,72,171,377
15763,GSW,1985,Mike Bratz,29,56,6,746,106,250,.424,6,26,.231,100,224,.446,.436,69,82,.841,11,47,58,122,47,4,54,76,287
15764,GSW,1985,Gary Plummer,22,66,0,702,92,232,.397,1,4,.250,91,228,.399,.399,65,92,.707,54,80,134,26,15,14,50,127,250
15765,GSW,1985,Peter Thibeaux,23,51,1,461,94,195,.482,0,2,.000,94,193,.487,.482,43,67,.642,29,40,69,17,11,17,34,85,231
15766,GSW,1985,Steve Burtt,22,47,0,418,72,188,.383,0,1,.000,72,187,.385,.383,53,77,.688,10,18,28,20,21,4,33,76,197
15767,GSW,1985,Terry Teagle,24,19,3,344,73,135,.541,2,4,.500,71,131,.542,.548,25,35,.714,22,21,43,14,13,5,14,34,173
15768,GSW,1984,Joe Barry Carroll,25,80,80,2962,663,1390,.477,0,1,.000,663,1389,.477,.477,313,433,.723,235,401,636,198,103,142,268,244,1639
15769,GSW,1984,Purvis Short,26,79,76,2945,714,1509,.473,22,72,.306,692,1437,.482,.480,353,445,.793,184,254,438,246,103,11,228,252,1803
15770,GSW,1984,Lester Conner,24,82,82,2573,360,730,.493,1,6,.167,359,724,.496,.494,186,259,.718,132,173,305,401,162,12,143,176,907
15771,GSW,1984,Sleepy Floyd,23,77,73,2555,484,1045,.463,8,45,.178,476,1000,.476,.467,315,386,.816,87,184,271,269,103,31,196,216,1291
15772,GSW,1984,Mickey Johnson,31,78,25,2122,359,852,.421,5,29,.172,354,823,.430,.424,339,432,.785,198,320,518,219,101,30,216,290,1062
15773,GSW,1984,Larry Smith,26,75,63,2091,244,436,.560,0,0,,244,436,.560,.560,94,168,.560,282,390,672,72,61,22,124,274,582
15774,GSW,1984,Mike Bratz,28,82,0,1428,213,521,.409,15,51,.294,198,470,.421,.423,120,137,.876,41,102,143,252,84,6,109,155,561
15775,GSW,1984,Don Collins,25,61,6,957,187,387,.483,1,5,.200,186,382,.487,.484,65,89,.730,62,67,129,67,43,14,80,119,440
15776,GSW,1984,Darren Tillis,23,72,1,730,108,254,.425,0,2,.000,108,252,.429,.425,41,63,.651,75,109,184,24,12,60,51,176,257
15777,GSW,1984,Pace Mannion,23,57,0,469,50,126,.397,3,13,.231,47,113,.416,.409,18,23,.783,23,36,59,47,25,2,23,63,121
15778,GSW,1984,Chris Engler,24,46,1,360,33,83,.398,0,0,,33,83,.398,.398,14,23,.609,27,70,97,11,9,3,24,68,80
15779,GSW,1984,Russell Cross,22,45,0,354,64,112,.571,0,0,,64,112,.571,.571,38,91,.418,35,47,82,22,12,7,19,58,166
15780,GSW,1984,Ron Brewer,28,13,3,210,27,58,.466,0,1,.000,27,57,.474,.466,11,17,.647,5,8,13,6,6,5,7,10,65
15781,GSW,1984,Sam Williams,24,7,0,59,11,26,.423,0,0,,11,26,.423,.423,6,7,.857,4,9,13,2,6,3,3,6,28
15782,GSW,1984,Lorenzo Romar,25,3,0,15,2,5,.400,0,1,.000,2,4,.500,.400,2,4,.500,0,1,1,1,0,0,0,1,6
15783,GSW,1983,Joe Barry Carroll,24,79,79,2988,785,1529,.513,0,3,.000,785,1526,.514,.513,337,469,.719,220,468,688,169,108,155,285,260,1907
15784,GSW,1983,Purvis Short,25,67,57,2397,589,1209,.487,4,15,.267,585,1194,.490,.489,255,308,.828,145,209,354,228,94,14,194,242,1437
15785,GSW,1983,Lorenzo Romar,24,82,64,2130,266,572,.465,10,33,.303,256,539,.475,.474,78,105,.743,23,115,138,455,98,5,141,142,620
15786,GSW,1983,Sam Williams,23,75,28,1533,252,479,.526,0,1,.000,252,478,.527,.526,123,171,.719,153,240,393,45,71,89,101,244,627
15787,GSW,1983,Larry Smith,25,49,41,1433,180,306,.588,0,0,,180,306,.588,.588,53,99,.535,209,276,485,46,36,20,83,186,413
15788,GSW,1983,Lester Conner,23,75,10,1416,145,303,.479,0,4,.000,145,299,.485,.479,79,113,.699,69,152,221,253,116,7,99,141,369
15789,GSW,1983,Ron Brewer,27,53,34,1401,246,562,.438,7,15,.467,239,547,.437,.444,98,119,.824,50,57,107,69,70,19,72,96,597
15790,GSW,1983,Lewis Lloyd,23,73,24,1350,293,566,.518,1,4,.250,292,562,.520,.519,100,139,.719,77,183,260,130,61,31,118,109,687
15791,GSW,1983,Micheal Ray Richardson,27,33,25,1074,176,427,.412,4,31,.129,172,396,.434,.417,55,87,.632,45,100,145,245,101,9,137,124,411
15792,GSW,1983,Mickey Johnson,30,30,9,899,162,359,.451,1,17,.059,161,342,.471,.453,141,170,.829,88,157,245,100,25,23,105,131,466
15793,GSW,1983,Sleepy Floyd,22,33,11,754,134,311,.431,6,11,.545,128,300,.427,.441,112,135,.830,40,55,95,71,39,8,66,78,386
15794,GSW,1983,Rickey Brown,24,50,7,743,118,245,.482,0,2,.000,118,243,.486,.482,40,65,.615,56,122,178,16,8,21,60,126,276
15795,GSW,1983,World B. Free,29,19,18,700,164,364,.451,0,3,.000,164,361,.454,.451,106,149,.711,22,22,44,89,15,3,50,66,434
15796,GSW,1983,Chris Engler,23,54,1,369,38,94,.404,0,0,,38,94,.404,.404,5,16,.313,43,61,104,11,7,17,24,95,81
15797,GSW,1983,Derek Smith,21,27,0,154,21,51,.412,0,2,.000,21,49,.429,.412,17,25,.680,10,28,38,2,0,4,11,40,59
15798,GSW,1983,Joe Hassett,27,6,2,139,19,44,.432,1,9,.111,18,35,.514,.443,0,0,,3,8,11,21,2,0,9,14,39
15799,GSW,1983,Hank McDowell,23,14,0,130,13,29,.448,0,0,,13,29,.448,.448,14,18,.778,15,15,30,4,2,4,8,26,40
15800,GSW,1983,Larry Kenon,30,11,0,121,17,39,.436,0,0,,17,39,.436,.436,7,11,.636,13,13,26,5,1,0,6,13,41
15801,GSW,1983,Terry Duerod,26,5,0,49,9,19,.474,0,0,,9,19,.474,.474,0,0,,0,3,3,5,2,1,9,5,18
15802,GSW,1982,Bernard King,25,79,77,2861,740,1307,.566,1,5,.200,739,1302,.568,.567,352,499,.705,140,329,469,282,78,23,267,285,1833
15803,GSW,1982,World B. Free,28,78,78,2796,650,1452,.448,10,56,.179,640,1396,.458,.451,479,647,.740,118,130,248,419,71,8,208,222,1789
15804,GSW,1982,Joe Barry Carroll,23,76,75,2627,527,1016,.519,0,1,.000,527,1015,.519,.519,235,323,.728,210,423,633,64,64,127,206,265,1289
15805,GSW,1982,Larry Smith,24,74,55,2213,220,412,.534,0,1,.000,220,411,.535,.534,88,159,.553,279,534,813,83,65,54,105,291,528
15806,GSW,1982,Mike Gale,31,75,70,1793,185,373,.496,0,5,.000,185,368,.503,.496,51,65,.785,37,152,189,261,121,28,126,173,421
15807,GSW,1982,Purvis Short,24,76,8,1782,456,935,.488,6,28,.214,450,907,.496,.491,177,221,.801,123,143,266,209,65,10,122,220,1095
15808,GSW,1982,Rickey Brown,23,82,11,1260,192,418,.459,0,0,,192,418,.459,.459,86,122,.705,136,228,364,19,36,29,84,243,470
15809,GSW,1982,Lorenzo Romar,23,79,11,1259,203,403,.504,3,15,.200,200,388,.515,.507,79,96,.823,12,86,98,226,60,13,89,103,488
15810,GSW,1982,Sam Williams,22,59,22,1073,154,277,.556,0,0,,154,277,.556,.556,49,89,.551,91,217,308,38,45,76,64,156,357
15811,GSW,1982,Sonny Parker,26,71,0,899,116,245,.473,0,0,,116,245,.473,.473,48,72,.667,73,104,177,89,39,11,51,101,280
15812,GSW,1982,Joe Hassett,26,68,2,787,144,382,.377,71,214,.332,73,168,.435,.470,31,37,.838,13,40,53,104,30,3,36,94,390
15813,GSW,1982,Hank McDowell,22,30,1,335,34,84,.405,0,0,,34,84,.405,.405,27,41,.659,41,59,100,20,6,8,21,52,95
15814,GSW,1982,Lewis Lloyd,22,16,0,95,25,45,.556,0,0,,25,45,.556,.556,7,11,.636,9,7,16,6,5,1,14,20,57
15815,GSW,1981,Joe Barry Carroll,22,82,,2919,616,1254,.491,0,2,.000,616,1252,.492,.491,315,440,.716,274,485,759,117,50,121,243,313,1547
15816,GSW,1981,Bernard King,24,81,,2914,731,1244,.588,2,6,.333,729,1238,.589,.588,307,437,.703,178,373,551,287,72,34,265,304,1771
15817,GSW,1981,Larry Smith,23,82,,2578,304,594,.512,0,0,,304,594,.512,.512,177,301,.588,433,561,994,93,70,63,146,316,785
15818,GSW,1981,World B. Free,27,65,,2370,516,1157,.446,5,31,.161,511,1126,.454,.448,528,649,.814,48,111,159,361,85,11,195,183,1565
15819,GSW,1981,Purvis Short,23,79,,2309,549,1157,.475,3,17,.176,546,1140,.479,.476,168,205,.820,151,240,391,249,78,19,143,244,1269
15820,GSW,1981,John Lucas,27,66,,1919,222,506,.439,4,24,.167,218,482,.452,.443,107,145,.738,34,120,154,464,83,2,185,140,555
15821,GSW,1981,Sonny Parker,25,73,,1317,191,388,.492,0,0,,191,388,.492,.492,94,128,.734,101,93,194,106,67,13,84,112,476
15822,GSW,1981,Clifford Ray,32,66,,838,64,152,.421,0,0,,64,152,.421,.421,29,62,.468,73,144,217,52,24,13,74,194,157
15823,GSW,1981,Lorenzo Romar,22,53,,726,87,211,.412,2,6,.333,85,205,.415,.417,43,63,.683,10,46,56,136,27,3,52,64,219
15824,GSW,1981,Billy Reid,23,59,,597,84,185,.454,0,5,.000,84,180,.467,.454,22,39,.564,27,33,60,71,33,5,78,111,190
15825,GSW,1981,Rickey Brown,22,45,,580,83,162,.512,0,0,,83,162,.512,.512,16,21,.762,52,114,166,21,9,14,31,103,182
15826,GSW,1981,Joe Hassett,25,24,,434,84,198,.424,43,116,.371,41,82,.500,.533,7,8,.875,13,30,43,56,8,2,11,44,218
15827,GSW,1981,Phil Chenier,30,9,,82,11,33,.333,1,3,.333,10,30,.333,.348,6,6,1.000,1,7,8,7,0,0,4,10,29
15828,GSW,1981,Bill Mayfield,23,7,,54,8,18,.444,0,0,,8,18,.444,.444,1,2,.500,7,2,9,1,0,1,3,8,17
15829,GSW,1981,Rudy White,27,4,,43,9,18,.500,0,0,,9,18,.500,.500,4,4,1.000,0,0,0,2,4,0,3,7,22
15830,GSW,1981,Tom Abernethy,26,10,,39,1,3,.333,0,0,,1,3,.333,.333,2,3,.667,1,7,8,1,1,0,2,5,4
15831,GSW,1981,John Mengelt,31,2,,11,0,4,.000,0,0,,0,4,.000,.000,0,0,,0,0,0,2,0,0,0,0,0
15832,GSW,1980,Sonny Parker,24,82,82,2849,483,988,.489,0,2,.000,483,986,.490,.489,237,302,.785,166,298,464,254,173,32,163,195,1203
15833,GSW,1980,John Lucas,26,80,,2763,388,830,.467,12,42,.286,376,788,.477,.475,222,289,.768,61,159,220,602,138,3,184,196,1010
15834,GSW,1980,Robert Parish,26,72,,2119,510,1006,.507,0,1,.000,510,1005,.507,.507,203,284,.715,247,536,783,122,58,115,225,248,1223
15835,GSW,1980,Jo Jo White,33,78,,2052,336,706,.476,1,6,.167,335,700,.479,.477,97,114,.851,42,139,181,239,88,13,157,186,770
15836,GSW,1980,Wayne Cooper,23,79,,1781,367,750,.489,1,4,.250,366,746,.491,.490,136,181,.751,202,305,507,42,20,79,140,246,871
15837,GSW,1980,Clifford Ray,31,81,,1683,203,383,.530,0,2,.000,203,381,.533,.530,84,149,.564,122,344,466,183,51,32,155,266,490
15838,GSW,1980,Purvis Short,22,62,,1636,461,916,.503,0,6,.000,461,910,.507,.503,134,165,.812,119,197,316,123,63,9,122,186,1056
15839,GSW,1980,Phil Smith,27,51,,1552,325,685,.474,7,22,.318,318,663,.480,.480,135,171,.789,28,118,146,187,62,15,121,154,792
15840,GSW,1980,Tom Abernethy,25,67,,1222,153,318,.481,0,1,.000,153,317,.483,.481,56,82,.683,62,129,191,87,35,12,39,118,362
15841,GSW,1980,Raymond Townsend,24,75,,1159,171,421,.406,4,26,.154,167,395,.423,.411,60,84,.714,33,56,89,116,60,4,65,113,406
15842,GSW,1980,Darnell Hillman,30,49,,708,82,179,.458,0,0,,82,179,.458,.458,34,68,.500,59,121,180,47,21,24,59,128,198
15843,GSW,1980,John Coughran,28,24,,160,29,81,.358,2,9,.222,27,72,.375,.370,8,14,.571,2,17,19,12,7,1,13,24,68
15844,GSW,1980,Bubba Wilson,24,16,,143,7,25,.280,0,0,,7,25,.280,.280,3,6,.500,6,10,16,12,2,0,8,11,17
15845,GSW,1980,Cheese Johnson,22,9,,53,12,30,.400,0,0,,12,30,.400,.400,3,5,.600,6,8,14,2,1,0,4,11,27
15846,OKC,2024,Shai Gilgeous-Alexander,25,75,75,2553,796,1487,.535,95,269,.353,701,1218,.576,.567,567,649,.874,65,350,415,465,150,67,162,184,2254
15847,OKC,2024,Chet Holmgren,21,82,82,2413,505,953,.530,129,349,.370,376,604,.623,.598,218,275,.793,129,519,648,200,53,190,131,197,1357
15848,OKC,2024,Luguentz Dort,24,79,79,2246,288,657,.438,156,396,.394,132,261,.506,.557,128,155,.826,74,210,284,113,72,47,74,228,860
15849,OKC,2024,Jalen Williams,22,71,71,2223,536,993,.540,103,241,.427,433,752,.576,.592,180,221,.814,37,245,282,322,80,45,123,175,1355
15850,OKC,2024,Josh Giddey,21,80,80,2011,402,847,.475,82,243,.337,320,604,.530,.523,100,124,.806,111,403,514,386,51,44,168,111,986
15851,OKC,2024,Cason Wallace,20,82,13,1692,217,442,.491,98,234,.419,119,208,.572,.602,29,37,.784,52,135,187,120,76,37,45,129,561
15852,OKC,2024,Isaiah Joe,24,78,1,1445,222,485,.458,147,353,.416,75,132,.568,.609,45,52,.865,32,148,180,99,46,22,47,87,636
15853,OKC,2024,Aaron Wiggins,25,78,4,1228,212,377,.562,62,126,.492,150,251,.598,.645,56,71,.789,60,126,186,86,56,19,56,91,542
15854,OKC,2024,Kenrich Williams,29,69,1,1029,131,280,.468,56,141,.397,75,139,.540,.568,7,14,.500,61,148,209,93,38,9,32,101,325
15855,OKC,2024,Jaylin Williams,21,69,1,897,95,228,.417,53,144,.368,42,84,.500,.533,33,41,.805,36,198,234,110,28,27,34,98,276
15856,OKC,2024,Gordon Hayward,33,26,3,447,48,106,.453,15,29,.517,33,77,.429,.524,27,39,.692,13,51,64,42,12,1,15,21,138
15857,OKC,2024,Ousmane Dieng,20,33,0,365,49,116,.422,21,70,.300,28,46,.609,.513,14,16,.875,10,41,51,37,8,5,19,22,133
15858,OKC,2024,Vasilije Micić,30,30,0,361,37,91,.407,11,45,.244,26,46,.565,.467,14,19,.737,1,23,24,76,9,3,29,22,99
15859,OKC,2024,Lindy Waters III,26,38,0,280,49,104,.471,37,85,.435,12,19,.632,.649,2,2,1.000,7,33,40,24,5,7,7,23,137
15860,OKC,2024,Tre Mann,22,13,0,119,20,40,.500,8,19,.421,12,21,.571,.600,1,1,1.000,4,20,24,20,3,0,9,3,49
15861,OKC,2024,Olivier Sarr,24,15,0,98,11,19,.579,2,6,.333,9,13,.692,.632,10,15,.667,10,26,36,2,0,7,3,18,34
15862,OKC,2024,Mike Muscala,32,16,0,91,8,22,.364,1,11,.091,7,11,.636,.386,0,1,.000,7,14,21,4,1,1,4,8,17
15863,OKC,2024,Dāvis Bertāns,31,15,0,91,10,26,.385,10,24,.417,0,2,.000,.577,14,15,.933,2,8,10,9,3,3,1,10,44
15864,OKC,2024,Bismack Biyombo,31,10,0,73,7,12,.583,0,0,,7,12,.583,.583,4,8,.500,5,13,18,2,1,3,4,7,18
15865,OKC,2024,Keyontae Johnson,23,9,0,66,5,16,.313,1,3,.333,4,13,.308,.344,0,0,,4,6,10,4,1,0,4,5,11
15866,OKC,2024,Aleksej Pokusevski,22,10,0,60,4,16,.250,2,11,.182,2,5,.400,.313,2,4,.500,2,8,10,5,1,1,3,5,12
15867,OKC,2024,Adam Flagler,24,2,0,14,1,7,.143,1,6,.167,0,1,.000,.214,0,0,,0,0,0,4,0,0,0,0,3
15868,OKC,2023,Shai Gilgeous-Alexander,24,68,68,2416,704,1381,.510,58,168,.345,646,1213,.533,.531,669,739,.905,59,270,329,371,112,65,192,192,2135
15869,OKC,2023,Josh Giddey,20,76,76,2367,539,1118,.482,76,234,.325,463,884,.524,.516,106,145,.731,148,451,599,469,57,31,211,143,1260
15870,OKC,2023,Jalen Williams,21,75,62,2276,414,794,.521,73,205,.356,341,589,.579,.567,155,191,.812,84,253,337,248,103,35,123,191,1056
15871,OKC,2023,Luguentz Dort,23,74,73,2272,339,873,.388,135,409,.330,204,464,.440,.466,200,259,.772,128,216,344,154,75,23,92,243,1013
15872,OKC,2023,Isaiah Joe,23,73,10,1395,224,508,.441,161,394,.409,63,114,.553,.599,82,100,.820,27,148,175,88,48,8,39,105,691
15873,OKC,2023,Aaron Wiggins,24,70,14,1297,186,363,.512,48,122,.393,138,241,.573,.579,59,71,.831,68,142,210,80,39,15,55,110,479
15874,OKC,2023,Kenrich Williams,28,53,10,1206,179,346,.517,50,134,.373,129,212,.608,.590,17,39,.436,97,164,261,105,45,14,32,112,425
15875,OKC,2023,Tre Mann,21,67,5,1183,197,501,.393,81,257,.315,116,244,.475,.474,42,55,.764,27,128,155,120,40,11,62,99,517
15876,OKC,2023,Jaylin Williams,20,49,36,914,102,234,.436,46,113,.407,56,121,.463,.534,38,54,.704,44,197,241,76,28,12,37,111,288
15877,OKC,2023,Jeremiah Robinson-Earl,22,43,20,814,110,248,.444,37,111,.333,73,137,.533,.518,35,42,.833,71,109,180,43,24,11,19,71,292
15878,OKC,2023,Aleksej Pokusevski,21,34,25,701,108,249,.434,38,104,.365,70,145,.483,.510,22,35,.629,45,114,159,64,20,43,43,58,276
15879,OKC,2023,Mike Muscala,31,43,5,622,89,203,.438,56,142,.394,33,61,.541,.576,31,39,.795,23,112,135,38,11,19,14,70,265
15880,OKC,2023,Ousmane Dieng,19,39,1,569,76,181,.420,26,98,.265,50,83,.602,.492,15,23,.652,19,86,105,46,14,7,26,42,193
15881,OKC,2023,Darius Bazley,22,36,1,555,71,158,.449,18,45,.400,53,113,.469,.506,36,65,.554,29,93,122,32,19,29,22,35,196
15882,OKC,2023,Lindy Waters III,25,41,0,531,70,178,.393,58,162,.358,12,16,.750,.556,16,20,.800,16,59,75,28,14,11,10,42,214
15883,OKC,2023,Dario Šarić,28,20,0,273,51,99,.515,18,46,.391,33,53,.623,.606,27,32,.844,14,51,65,17,7,2,19,30,147
15884,OKC,2023,Eugene Omoruyi,25,23,2,272,44,94,.468,8,31,.258,36,63,.571,.511,17,28,.607,22,30,52,11,14,0,16,46,113
15885,OKC,2023,Olivier Sarr,23,9,1,114,15,30,.500,1,8,.125,14,22,.636,.517,5,7,.714,12,19,31,4,1,5,4,17,36
15886,OKC,2023,Jared Butler,22,6,1,77,15,32,.469,7,14,.500,8,18,.444,.578,0,0,,1,3,4,8,5,0,5,5,37
15887,OKC,2022,Shai Gilgeous-Alexander,23,56,56,1942,477,1052,.453,89,297,.300,388,755,.514,.496,328,405,.810,37,241,278,331,71,46,154,142,1371
15888,OKC,2022,Darius Bazley,21,69,53,1924,274,649,.422,80,269,.297,194,380,.511,.484,117,170,.688,71,365,436,97,58,70,90,68,745
15889,OKC,2022,Josh Giddey,19,54,54,1700,281,670,.419,56,213,.263,225,457,.492,.461,56,79,.709,98,323,421,345,51,20,171,88,674
15890,OKC,2022,Luguentz Dort,22,51,51,1665,293,726,.404,130,391,.332,163,335,.487,.493,161,191,.843,38,174,212,88,46,18,88,149,877
15891,OKC,2022,Tre Mann,20,60,26,1367,231,588,.393,98,272,.360,133,316,.421,.476,65,82,.793,25,146,171,91,47,12,71,102,625
15892,OKC,2022,Aleksej Pokusevski,20,61,12,1233,186,456,.408,57,197,.289,129,259,.498,.470,35,50,.700,73,245,318,131,39,38,94,88,464
15893,OKC,2022,Aaron Wiggins,23,50,35,1209,156,337,.463,42,138,.304,114,199,.573,.525,62,85,.729,51,127,178,68,30,10,54,93,416
15894,OKC,2022,Jeremiah Robinson-Earl,21,49,36,1087,134,324,.414,58,165,.352,76,159,.478,.503,40,54,.741,75,199,274,49,29,15,39,75,366
15895,OKC,2022,Kenrich Williams,27,49,0,1072,146,317,.461,41,121,.339,105,196,.536,.525,30,55,.545,75,145,220,108,44,10,46,81,363
15896,OKC,2022,Isaiah Roby,23,45,28,948,166,323,.514,44,99,.444,122,224,.545,.582,78,116,.672,75,142,217,71,36,34,43,109,454
15897,OKC,2022,Théo Maledon,20,51,7,908,119,317,.375,44,150,.293,75,167,.449,.445,79,100,.790,20,111,131,111,31,11,65,67,361
15898,OKC,2022,Ty Jerome,24,48,4,801,124,328,.378,54,186,.290,70,142,.493,.460,38,47,.809,19,59,78,109,30,5,37,73,340
15899,OKC,2022,Vit Krejci,21,30,8,690,68,167,.407,32,98,.327,36,69,.522,.503,19,22,.864,18,83,101,57,19,8,29,65,187
15900,OKC,2022,Derrick Favors,30,39,18,653,94,182,.516,2,16,.125,92,166,.554,.522,16,25,.640,58,126,184,25,17,12,9,62,206
15901,OKC,2022,Mike Muscala,30,43,0,592,113,248,.456,70,163,.429,43,85,.506,.597,48,57,.842,21,108,129,22,18,26,14,58,344
15902,OKC,2022,Lindy Waters III,24,25,1,465,71,175,.406,53,146,.363,18,29,.621,.557,4,5,.800,6,67,73,24,19,8,11,31,199
15903,OKC,2022,Olivier Sarr,22,22,2,421,58,101,.574,13,29,.448,45,72,.625,.639,24,29,.828,34,59,93,19,6,15,22,52,153
15904,OKC,2022,Jaylen Hoard,22,7,5,240,44,90,.489,9,25,.360,35,65,.538,.539,6,14,.429,30,54,84,17,6,5,8,14,103
15905,OKC,2022,Mamadi Diakite,25,13,3,188,25,47,.532,0,5,.000,25,42,.595,.532,6,11,.545,17,42,59,2,5,9,7,33,56
15906,OKC,2022,Zavier Simpson,24,4,4,174,19,52,.365,1,8,.125,18,44,.409,.375,5,5,1.000,2,19,21,30,5,4,10,15,44
15907,OKC,2022,Georgios Kalaitzakis,23,4,4,166,26,56,.464,8,22,.364,18,34,.529,.536,10,21,.476,2,11,13,12,10,1,16,11,70
15908,OKC,2022,Paul Watson,27,9,3,156,12,35,.343,6,26,.231,6,9,.667,.429,1,2,.500,3,24,27,8,3,3,4,10,31
15909,OKC,2022,Melvin Frazier,25,3,0,120,13,48,.271,1,21,.048,12,27,.444,.281,5,7,.714,5,8,13,1,1,0,3,8,32
15910,OKC,2022,Gabriel Deck,26,7,0,56,8,14,.571,2,4,.500,6,10,.600,.643,0,0,,1,5,6,5,1,0,2,2,18
15911,OKC,2022,Scotty Hopson,32,1,0,18,2,4,.500,0,1,.000,2,3,.667,.500,0,0,,0,1,1,1,0,0,2,1,4
15912,OKC,2022,Rob Edwards,25,2,0,11,1,4,.250,1,4,.250,0,0,,.375,0,0,,0,3,3,0,0,0,1,0,3
15913,OKC,2021,Théo Maledon,19,65,49,1778,226,614,.368,105,313,.335,121,301,.402,.454,101,135,.748,25,186,211,227,56,11,141,126,658
15914,OKC,2021,Darius Bazley,20,55,55,1714,273,690,.396,83,286,.290,190,404,.470,.456,125,178,.702,51,345,396,99,29,25,122,60,754
15915,OKC,2021,Luguentz Dort,21,52,52,1543,247,639,.387,113,329,.343,134,310,.432,.475,122,164,.744,38,151,189,88,45,19,79,134,729
15916,OKC,2021,Kenrich Williams,26,66,13,1426,219,411,.533,52,117,.444,167,294,.568,.596,36,63,.571,84,189,273,152,55,17,76,143,526
15917,OKC,2021,Isaiah Roby,22,61,34,1425,207,429,.483,32,109,.294,175,320,.547,.520,87,117,.744,89,252,341,107,52,37,113,162,533
15918,OKC,2021,Shai Gilgeous-Alexander,22,35,35,1180,287,565,.508,71,170,.418,216,395,.547,.571,185,229,.808,19,147,166,207,27,23,106,70,830
15919,OKC,2021,Aleksej Pokusevski,19,45,28,1090,139,408,.341,58,207,.280,81,201,.403,.412,31,42,.738,30,182,212,97,20,42,99,58,367
15920,OKC,2021,Moses Brown,21,43,32,920,146,268,.545,0,0,,146,268,.545,.545,78,126,.619,154,229,383,10,31,47,43,93,370
15921,OKC,2021,Ty Jerome,23,33,1,788,128,287,.446,71,168,.423,57,119,.479,.570,26,34,.765,10,81,91,120,20,6,47,61,353
15922,OKC,2021,Al Horford,34,28,28,782,162,360,.450,56,152,.368,106,208,.510,.528,18,22,.818,29,159,188,94,25,26,29,48,398
15923,OKC,2021,Hamidou Diallo,22,32,5,761,143,297,.481,12,41,.293,131,256,.512,.502,83,132,.629,37,128,165,77,31,12,49,83,381
15924,OKC,2021,Svi Mykhailiuk,23,30,9,690,124,283,.438,48,143,.336,76,140,.543,.523,14,20,.700,13,76,89,53,24,6,49,30,310
15925,OKC,2021,Mike Muscala,29,35,0,645,119,267,.446,68,184,.370,51,83,.614,.573,33,36,.917,19,113,132,28,8,11,21,54,339
15926,OKC,2021,Justin Jackson,25,33,3,544,86,212,.406,34,111,.306,52,101,.515,.486,30,35,.857,14,57,71,51,15,2,31,31,236
15927,OKC,2021,Tony Bradley,23,22,0,397,80,122,.656,0,2,.000,80,120,.667,.656,31,44,.705,46,89,135,20,9,17,27,33,191
15928,OKC,2021,George Hill,34,14,14,369,61,120,.508,22,57,.386,39,63,.619,.600,21,25,.840,8,21,29,43,12,2,12,12,165
15929,OKC,2021,Josh Hall,20,21,1,336,30,99,.303,4,37,.108,26,62,.419,.323,22,44,.500,6,53,59,28,4,1,25,37,86
15930,OKC,2021,Jaylen Hoard,21,19,0,320,44,88,.500,0,11,.000,44,77,.571,.500,28,41,.683,21,44,65,24,13,5,17,19,116
15931,OKC,2021,Gabriel Deck,25,10,0,212,32,67,.478,2,15,.133,30,52,.577,.493,18,22,.818,16,24,40,24,8,0,6,9,84
15932,OKC,2021,Darius Miller,30,18,0,197,22,48,.458,17,42,.405,5,6,.833,.635,12,12,1.000,2,22,24,21,13,5,8,13,73
15933,OKC,2021,Charlie Brown Jr.,23,9,1,152,13,43,.302,5,21,.238,8,22,.364,.360,9,10,.900,3,14,17,9,4,2,6,19,40
15934,OKC,2021,Justin Robinson,23,9,0,88,7,21,.333,4,14,.286,3,7,.429,.429,3,5,.600,1,6,7,9,3,0,2,10,21
15935,OKC,2020,Shai Gilgeous-Alexander,21,70,70,2428,478,1015,.471,87,251,.347,391,764,.512,.514,288,357,.807,47,365,412,232,79,47,134,117,1331
15936,OKC,2020,Chris Paul,34,70,70,2208,434,887,.489,111,304,.365,323,583,.554,.552,253,279,.907,26,323,349,472,111,11,161,158,1232
15937,OKC,2020,Dennis Schröder,26,65,2,1999,453,965,.469,125,325,.385,328,640,.513,.534,198,236,.839,19,217,236,262,45,14,166,146,1229
15938,OKC,2020,Danilo Gallinari,31,62,62,1834,358,817,.438,178,439,.405,180,378,.476,.547,266,298,.893,34,288,322,119,42,5,76,75,1160
15939,OKC,2020,Steven Adams,26,63,63,1680,283,478,.592,1,3,.333,282,475,.594,.593,117,201,.582,207,376,583,146,51,67,94,122,684
15940,OKC,2020,Terrance Ferguson,21,56,38,1257,78,220,.355,49,168,.292,29,52,.558,.466,15,20,.750,23,51,74,51,27,17,31,155,220
15941,OKC,2020,Darius Bazley,19,61,9,1130,125,317,.394,49,141,.348,76,176,.432,.472,43,62,.694,30,216,246,41,23,41,45,55,342
15942,OKC,2020,Nerlens Noel,25,61,7,1127,184,269,.684,1,3,.333,183,266,.688,.686,80,106,.755,91,209,300,57,59,91,66,166,449
15943,OKC,2020,Hamidou Diallo,21,46,3,896,132,296,.446,16,57,.281,116,239,.485,.473,38,63,.603,44,123,167,36,37,9,51,101,318
15944,OKC,2020,Abdel Nader,26,55,6,867,123,263,.468,48,128,.375,75,135,.556,.559,51,66,.773,14,86,100,38,23,20,43,78,345
15945,OKC,2020,Luguentz Dort,20,36,28,820,86,218,.394,30,101,.297,56,117,.479,.463,42,53,.792,24,57,81,27,31,4,22,97,244
15946,OKC,2020,Mike Muscala,28,47,2,572,77,189,.407,54,143,.378,23,46,.500,.550,18,22,.818,16,92,108,40,9,12,17,58,226
15947,OKC,2020,Deonte Burton,26,39,0,356,43,125,.344,10,53,.189,33,72,.458,.384,8,14,.571,7,50,57,17,7,10,19,34,104
15948,OKC,2020,Andre Roberson,28,7,0,87,8,29,.276,3,14,.214,5,15,.333,.328,1,2,.500,7,20,27,4,1,3,2,13,20
15949,OKC,2020,Devon Hall,24,11,0,81,6,30,.200,4,17,.235,2,13,.154,.267,4,8,.500,2,5,7,13,4,1,5,6,20
15950,OKC,2020,Kevin Hervey,23,10,0,52,7,27,.259,3,20,.150,4,7,.571,.315,0,0,,1,11,12,5,1,1,0,4,17
15951,OKC,2020,Justin Patton,22,5,0,24,4,10,.400,1,4,.250,3,6,.500,.450,0,0,,1,4,5,2,0,0,2,4,9
15952,OKC,2020,Isaiah Roby,21,3,0,11,0,1,.000,0,0,,0,1,.000,.000,0,0,,0,2,2,0,0,0,1,1,0
15953,OKC,2019,Paul George,28,77,77,2841,707,1614,.438,292,757,.386,415,857,.484,.529,453,540,.839,105,523,628,318,170,34,205,214,2159
15954,OKC,2019,Steven Adams,25,80,80,2669,481,809,.595,0,2,.000,481,807,.596,.595,146,292,.500,391,369,760,124,117,76,135,204,1108
15955,OKC,2019,Russell Westbrook,30,73,73,2630,630,1473,.428,119,411,.290,511,1062,.481,.468,296,451,.656,109,698,807,784,142,33,325,245,1675
15956,OKC,2019,Jerami Grant,24,80,77,2612,409,823,.497,115,293,.392,294,530,.555,.567,157,221,.710,96,321,417,79,61,100,67,214,1090
15957,OKC,2019,Dennis Schröder,25,79,14,2314,457,1104,.414,124,364,.341,333,740,.450,.470,186,227,.819,38,246,284,323,65,12,172,189,1224
15958,OKC,2019,Terrance Ferguson,20,74,74,1931,185,431,.429,106,290,.366,79,141,.560,.552,37,51,.725,33,108,141,72,40,16,47,231,513
15959,OKC,2019,Nerlens Noel,24,77,2,1055,162,276,.587,0,0,,162,276,.587,.587,54,79,.684,127,198,325,45,66,96,48,166,378
15960,OKC,2019,Patrick Patterson,29,63,5,861,82,219,.374,46,137,.336,36,82,.439,.479,19,30,.633,42,105,147,31,16,13,22,46,229
15961,OKC,2019,Abdel Nader,25,61,1,694,91,215,.423,32,100,.320,59,115,.513,.498,27,36,.750,14,102,116,20,20,12,26,68,241
15962,OKC,2019,Álex Abrines,25,31,2,588,56,157,.357,41,127,.323,15,30,.500,.487,12,13,.923,5,43,48,20,17,6,14,53,165
15963,OKC,2019,Hamidou Diallo,20,51,3,526,75,165,.455,4,24,.167,71,141,.504,.467,36,59,.610,38,59,97,17,21,10,23,77,190
15964,OKC,2019,Markieff Morris,29,24,1,387,61,156,.391,20,59,.339,41,97,.423,.455,14,19,.737,20,71,91,19,11,2,7,58,156
15965,OKC,2019,Raymond Felton,34,33,0,379,55,135,.407,20,61,.328,35,74,.473,.481,12,13,.923,4,30,34,52,10,6,14,29,142
15966,OKC,2019,Deonte Burton,25,32,0,240,33,82,.402,8,27,.296,25,55,.455,.451,8,12,.667,4,24,28,9,6,8,9,31,82
15967,OKC,2019,Timothé Luwawu-Cabarrot,23,21,1,123,13,43,.302,5,22,.227,8,21,.381,.360,4,6,.667,4,14,18,4,4,1,5,14,35
15968,OKC,2019,Donte Grantham,23,3,0,2,0,2,.000,0,2,.000,0,0,,.000,0,0,,0,0,0,0,0,0,0,0,0
15969,OKC,2019,Tyler Davis,21,1,0,1,0,1,.000,0,0,,0,1,.000,.000,0,0,,1,0,1,0,0,0,0,0,0
15970,OKC,2019,Jawun Evans,22,1,0,1,0,1,.000,0,1,.000,0,0,,.000,0,0,,0,0,0,0,0,0,0,0,0
15971,OKC,2018,Russell Westbrook,29,80,80,2914,757,1687,.449,97,326,.298,660,1361,.485,.477,417,566,.737,152,652,804,820,147,20,381,200,2028
15972,OKC,2018,Paul George,27,79,79,2891,576,1340,.430,244,609,.401,332,731,.454,.521,338,411,.822,72,375,447,263,161,39,212,233,1734
15973,OKC,2018,Carmelo Anthony,33,78,78,2501,472,1168,.404,169,474,.357,303,694,.437,.476,148,193,.767,67,386,453,103,47,49,99,197,1261
15974,OKC,2018,Steven Adams,24,76,76,2487,448,712,.629,0,2,.000,448,710,.631,.629,160,286,.559,384,301,685,88,92,78,128,215,1056
15975,OKC,2018,Jerami Grant,23,81,1,1647,244,456,.535,32,110,.291,212,346,.613,.570,162,240,.675,86,233,319,57,31,77,54,155,682
15976,OKC,2018,Raymond Felton,33,82,2,1365,224,552,.406,81,230,.352,143,322,.444,.479,36,44,.818,25,131,156,203,49,16,76,91,565
15977,OKC,2018,Patrick Patterson,28,82,3,1270,106,266,.398,66,171,.386,40,95,.421,.523,40,46,.870,32,161,193,57,48,23,33,87,318
15978,OKC,2018,Álex Abrines,24,75,8,1134,115,291,.395,84,221,.380,31,70,.443,.540,39,46,.848,26,88,114,28,38,8,25,124,353
15979,OKC,2018,Andre Roberson,26,39,39,1037,87,162,.537,8,36,.222,79,126,.627,.562,12,38,.316,75,110,185,46,45,35,30,89,194
15980,OKC,2018,Josh Huestis,26,69,10,982,60,182,.330,33,115,.287,27,67,.403,.420,6,20,.300,42,119,161,20,15,43,26,82,159
15981,OKC,2018,Terrance Ferguson,19,61,12,763,70,169,.414,40,120,.333,30,49,.612,.533,9,10,.900,19,28,47,19,24,10,11,83,189
15982,OKC,2018,Corey Brewer,31,18,16,514,64,144,.444,23,67,.343,41,77,.532,.524,31,39,.795,20,41,61,24,38,6,11,56,182
15983,OKC,2018,Dakari Johnson,22,31,6,161,22,39,.564,0,0,,22,39,.564,.564,11,20,.550,16,18,34,8,6,8,3,27,55
15984,OKC,2018,Nick Collison,37,15,0,75,13,19,.684,0,0,,13,19,.684,.684,5,13,.385,7,13,20,4,0,0,7,7,31
15985,OKC,2018,Kyle Singler,29,12,0,59,7,21,.333,2,5,.400,5,16,.313,.381,7,13,.538,1,9,10,2,1,0,3,4,23
15986,OKC,2018,Daniel Hamilton,22,6,0,28,5,11,.455,2,5,.400,3,6,.500,.545,0,0,,0,5,5,8,1,0,2,2,12
15987,OKC,2018,PJ Dozier,21,2,0,3,1,2,.500,0,0,,1,2,.500,.500,0,0,,0,1,1,0,0,0,1,1,2
15988,OKC,2017,Russell Westbrook,28,81,81,2802,824,1941,.425,200,583,.343,624,1358,.459,.476,710,840,.845,137,727,864,840,132,31,438,190,2558
15989,OKC,2017,Steven Adams,23,80,80,2389,374,655,.571,0,1,.000,374,654,.572,.571,157,257,.611,281,332,613,86,89,78,146,195,905
15990,OKC,2017,Andre Roberson,25,79,79,2376,215,463,.464,45,184,.245,170,279,.609,.513,47,111,.423,98,305,403,79,94,79,51,204,522
15991,OKC,2017,Victor Oladipo,24,67,67,2222,412,932,.442,127,352,.361,285,580,.491,.510,116,154,.753,39,252,291,176,78,21,119,155,1067
15992,OKC,2017,Domantas Sabonis,20,81,66,1632,192,481,.399,51,159,.321,141,322,.438,.452,44,67,.657,46,242,288,82,39,32,83,200,479
15993,OKC,2017,Enes Freedom,24,72,0,1533,402,737,.545,5,38,.132,397,699,.568,.549,224,285,.786,195,287,482,67,32,38,123,154,1033
15994,OKC,2017,Jerami Grant,22,78,4,1490,146,311,.469,43,114,.377,103,197,.523,.539,86,139,.619,38,161,199,46,33,75,41,144,421
15995,OKC,2017,Álex Abrines,23,68,6,1055,134,341,.393,94,247,.381,40,94,.426,.531,44,49,.898,18,68,86,40,37,8,33,114,406
15996,OKC,2017,Semaj Christon,24,64,1,973,77,223,.345,12,63,.190,65,160,.406,.372,17,31,.548,19,68,87,130,28,7,43,79,183
15997,OKC,2017,Joffrey Lauvergne,25,50,0,739,111,244,.455,27,78,.346,84,166,.506,.510,37,58,.638,51,132,183,51,18,6,40,71,286
15998,OKC,2017,Anthony Morrow,31,40,7,627,86,223,.386,35,119,.294,51,104,.490,.464,23,26,.885,11,18,29,19,22,2,6,40,230
15999,OKC,2017,Taj Gibson,31,23,16,487,89,179,.497,1,1,1.000,88,178,.494,.500,28,39,.718,38,65,103,13,14,15,28,40,207
16000,OKC,2017,Doug McDermott,25,22,1,430,56,124,.452,21,58,.362,35,66,.530,.536,12,17,.706,6,43,49,13,2,1,6,22,145
16001,OKC,2017,Kyle Singler,28,32,2,385,34,83,.410,7,37,.189,27,46,.587,.452,13,17,.765,8,40,48,9,7,5,11,29,88
16002,OKC,2017,Cameron Payne,22,20,0,320,43,130,.331,16,52,.308,27,78,.346,.392,4,4,1.000,2,29,31,40,10,4,16,38,106
16003,OKC,2017,Nick Collison,36,20,0,128,14,23,.609,0,1,.000,14,22,.636,.609,5,8,.625,9,22,31,12,2,2,4,17,33
16004,OKC,2017,Norris Cole,28,13,0,125,16,52,.308,3,13,.231,13,39,.333,.337,8,10,.800,0,11,11,14,8,0,7,18,43
16005,OKC,2017,Ersan İlyasova,29,3,0,62,6,16,.375,3,12,.250,3,4,.750,.469,0,0,,2,14,16,1,3,1,4,5,15
16006,OKC,2017,Josh Huestis,25,2,0,31,6,11,.545,2,4,.500,4,7,.571,.636,0,1,.000,4,5,9,3,0,3,0,0,14
16007,OKC,2016,Russell Westbrook,27,80,80,2750,656,1444,.454,101,341,.296,555,1103,.503,.489,465,573,.812,145,481,626,834,163,20,342,200,1878
16008,OKC,2016,Kevin Durant,27,72,72,2578,698,1381,.505,186,481,.387,512,900,.569,.573,447,498,.898,45,544,589,361,69,85,250,137,2029
16009,OKC,2016,Serge Ibaka,26,78,78,2500,416,869,.479,60,184,.326,356,685,.520,.513,91,121,.752,141,392,533,66,38,148,108,211,983
16010,OKC,2016,Dion Waiters,24,78,15,2152,282,706,.399,86,240,.358,196,466,.421,.460,112,157,.713,36,166,202,154,81,15,120,143,762
16011,OKC,2016,Steven Adams,22,80,80,2014,261,426,.613,0,0,,261,426,.613,.613,114,196,.582,219,314,533,62,42,89,84,223,636
16012,OKC,2016,Enes Freedom,23,82,1,1721,414,719,.576,10,21,.476,404,698,.579,.583,200,251,.797,249,415,664,33,26,33,115,166,1038
16013,OKC,2016,Andre Roberson,24,70,70,1553,136,274,.496,32,103,.311,104,171,.608,.555,33,54,.611,79,172,251,47,53,42,35,133,337
16014,OKC,2016,Kyle Singler,27,68,2,977,86,221,.389,30,97,.309,56,124,.452,.457,29,44,.659,50,91,141,24,30,9,32,120,231
16015,OKC,2016,Anthony Morrow,30,68,6,926,136,333,.408,79,204,.387,57,129,.442,.527,29,39,.744,10,52,62,24,22,5,17,64,380
16016,OKC,2016,Nick Collison,35,59,4,699,50,109,.459,0,2,.000,50,107,.467,.459,23,33,.697,68,103,171,52,15,16,50,107,123
16017,OKC,2016,Cameron Payne,21,57,1,698,114,278,.410,36,111,.324,78,167,.467,.475,19,24,.792,9,76,85,108,36,6,44,80,283
16018,OKC,2016,Randy Foye,32,27,1,572,52,149,.349,25,81,.309,27,68,.397,.433,22,27,.815,8,43,51,49,13,13,28,48,151
16019,OKC,2016,D.J. Augustin,28,34,0,519,46,121,.380,24,61,.393,22,60,.367,.479,26,34,.765,5,38,43,66,13,2,30,41,142
16020,OKC,2016,Mitch McGary,23,20,0,72,11,23,.478,0,4,.000,11,19,.579,.478,4,10,.400,4,14,18,3,1,2,7,10,26
16021,OKC,2016,Josh Huestis,24,5,0,55,5,12,.417,4,6,.667,1,6,.167,.583,0,4,.000,2,8,10,0,1,2,3,3,14
16022,OKC,2016,Steve Novak,32,7,0,24,6,12,.500,5,9,.556,1,3,.333,.708,0,0,,0,4,4,0,0,0,1,1,17
16023,OKC,2016,Nazr Mohammed,38,5,0,19,3,5,.600,0,0,,3,5,.600,.600,2,2,1.000,1,3,4,0,0,0,3,4,8
16024,OKC,2015,Russell Westbrook,26,67,67,2302,627,1471,.426,86,288,.299,541,1183,.457,.455,546,654,.835,124,364,488,574,140,14,293,184,1886
16025,OKC,2015,Serge Ibaka,25,64,64,2116,374,786,.476,77,205,.376,297,581,.511,.525,92,110,.836,135,364,499,55,30,155,97,194,917
16026,OKC,2015,Anthony Morrow,29,74,0,1806,285,615,.463,141,325,.434,144,290,.497,.578,79,89,.888,40,155,195,60,54,11,38,135,790
16027,OKC,2015,Steven Adams,21,70,67,1771,217,399,.544,0,2,.000,217,397,.547,.544,103,205,.502,199,324,523,66,38,86,99,222,537
16028,OKC,2015,Dion Waiters,23,47,20,1422,237,604,.392,51,160,.319,186,444,.419,.435,70,112,.625,29,106,135,89,46,11,63,96,595
16029,OKC,2015,Reggie Jackson,24,50,13,1398,249,576,.432,44,158,.278,205,418,.490,.470,99,115,.861,28,173,201,214,42,5,91,94,641
16030,OKC,2015,Andre Roberson,23,67,65,1286,92,201,.458,21,85,.247,71,116,.612,.510,23,48,.479,60,195,255,70,53,29,46,141,228
16031,OKC,2015,Nick Collison,34,66,2,1101,106,253,.419,16,60,.267,90,193,.466,.451,45,65,.692,90,160,250,90,35,25,45,156,273
16032,OKC,2015,Kendrick Perkins,30,51,3,981,82,186,.441,0,1,.000,82,185,.443,.441,38,75,.507,80,199,279,43,14,38,74,135,202
16033,OKC,2015,Kevin Durant,26,27,27,913,238,467,.510,64,159,.403,174,308,.565,.578,146,171,.854,16,162,178,110,24,25,74,40,686
16034,OKC,2015,Enes Freedom,22,26,26,809,196,346,.566,3,4,.750,193,342,.564,.571,90,116,.776,130,157,287,29,13,13,52,75,485
16035,OKC,2015,D.J. Augustin,27,28,1,677,69,186,.371,34,96,.354,35,90,.389,.462,31,36,.861,7,54,61,88,16,1,35,32,203
16036,OKC,2015,Jeremy Lamb,22,47,8,633,104,250,.416,38,111,.342,66,139,.475,.492,49,55,.891,8,99,107,44,21,6,27,52,295
16037,OKC,2015,Perry Jones,23,43,13,631,73,184,.397,14,60,.233,59,124,.476,.435,24,37,.649,6,70,76,18,17,8,24,50,184
16038,OKC,2015,Mitch McGary,22,32,2,485,88,165,.533,0,2,.000,88,163,.540,.533,25,40,.625,53,112,165,14,16,16,31,72,201
16039,OKC,2015,Kyle Singler,26,26,18,456,32,96,.333,20,54,.370,12,42,.286,.438,11,16,.688,10,45,55,18,14,7,13,55,95
16040,OKC,2015,Lance Thomas,26,22,13,450,45,126,.357,0,1,.000,45,125,.360,.357,23,33,.697,28,47,75,20,11,0,17,38,113
16041,OKC,2015,Sebastian Telfair,29,16,1,327,46,125,.368,18,60,.300,28,65,.431,.440,24,34,.706,2,28,30,45,10,0,18,29,134
16042,OKC,2015,Ish Smith,26,30,0,155,15,45,.333,1,5,.200,14,40,.350,.344,6,9,.667,5,22,27,28,4,1,9,12,37
16043,OKC,2015,Steve Novak,31,13,0,88,6,21,.286,3,15,.200,3,6,.500,.357,0,0,,1,5,6,5,0,1,2,10,15
16044,OKC,2015,Grant Jerrett,21,5,0,25,3,17,.176,1,13,.077,2,4,.500,.206,0,0,,1,3,4,1,0,2,2,7,7
16045,OKC,2014,Kevin Durant,25,81,81,3122,849,1688,.503,192,491,.391,657,1197,.549,.560,703,805,.873,58,540,598,445,103,59,285,174,2593
16046,OKC,2014,Serge Ibaka,24,81,81,2666,524,978,.536,23,60,.383,501,918,.546,.548,156,199,.784,224,485,709,85,39,219,123,233,1227
16047,OKC,2014,Reggie Jackson,23,80,36,2277,403,916,.440,83,245,.339,320,671,.477,.485,158,177,.893,43,270,313,331,85,9,168,142,1047
16048,OKC,2014,Thabo Sefolosha,29,61,61,1584,141,340,.415,48,152,.316,93,188,.495,.485,53,69,.768,50,170,220,94,79,17,55,90,383
16049,OKC,2014,Jeremy Lamb,21,78,0,1538,263,609,.432,88,247,.356,175,362,.483,.504,51,64,.797,27,162,189,115,56,26,61,143,665
16050,OKC,2014,Derek Fisher,39,81,0,1428,141,361,.391,88,229,.384,53,132,.402,.512,55,71,.775,12,110,122,117,70,3,49,157,425
16051,OKC,2014,Russell Westbrook,25,46,46,1412,346,791,.437,68,214,.318,278,577,.482,.480,242,293,.826,55,208,263,319,88,7,177,104,1002
16052,OKC,2014,Nick Collison,33,81,0,1353,134,241,.556,4,17,.235,130,224,.580,.564,66,93,.710,116,177,293,104,30,28,71,187,338
16053,OKC,2014,Kendrick Perkins,29,62,62,1207,87,193,.451,0,1,.000,87,192,.453,.451,37,67,.552,82,223,305,67,26,32,90,177,211
16054,OKC,2014,Steven Adams,20,81,20,1197,93,185,.503,0,0,,93,185,.503,.503,79,136,.581,142,190,332,43,40,57,71,203,265
16055,OKC,2014,Perry Jones,22,62,7,764,83,181,.459,22,61,.361,61,120,.508,.519,28,42,.667,28,86,114,26,14,19,21,62,216
16056,OKC,2014,Caron Butler,33,22,0,598,76,186,.409,45,102,.441,31,84,.369,.530,16,19,.842,5,66,71,26,24,6,8,56,213
16057,OKC,2014,Andre Roberson,22,40,16,399,33,68,.485,2,13,.154,31,55,.564,.500,7,10,.700,36,58,94,15,19,10,19,74,75
16058,OKC,2014,Hasheem Thabeet,26,23,0,192,13,23,.565,0,0,,13,23,.565,.565,1,5,.200,9,31,40,1,4,9,14,47,27
16059,OKC,2014,Ryan Gomes,31,5,0,34,3,8,.375,0,2,.000,3,6,.500,.375,0,0,,0,4,4,1,0,0,1,5,6
16060,OKC,2014,Reggie Williams,27,3,0,17,5,9,.556,1,3,.333,4,6,.667,.611,0,0,,0,0,0,1,1,0,2,1,11
16061,OKC,2014,Mustafa Shakur,29,3,0,11,0,3,.000,0,1,.000,0,2,.000,.000,1,2,.500,0,0,0,4,0,0,2,2,1
16062,OKC,2014,Royal Ivey,32,2,0,5,0,2,.000,0,1,.000,0,1,.000,.000,0,0,,0,1,1,0,0,0,0,1,0
16063,OKC,2013,Kevin Durant,24,81,81,3119,731,1433,.510,139,334,.416,592,1099,.539,.559,679,750,.905,46,594,640,374,116,105,280,143,2280
16064,OKC,2013,Russell Westbrook,24,82,82,2861,673,1535,.438,97,300,.323,576,1235,.466,.470,460,575,.800,111,317,428,607,145,24,273,189,1903
16065,OKC,2013,Serge Ibaka,23,80,80,2486,446,778,.573,20,57,.351,426,721,.591,.586,143,191,.749,222,395,617,43,28,242,125,213,1055
16066,OKC,2013,Thabo Sefolosha,28,81,81,2229,224,466,.481,108,258,.419,116,208,.558,.597,57,69,.826,58,259,317,125,103,44,64,177,613
16067,OKC,2013,Kevin Martin,29,77,0,2136,350,778,.450,158,371,.426,192,407,.472,.551,219,246,.890,31,147,178,106,72,8,101,138,1077
16068,OKC,2013,Kendrick Perkins,28,78,78,1954,143,313,.457,0,1,.000,143,312,.458,.457,44,72,.611,110,356,466,111,43,83,109,227,330
16069,OKC,2013,Nick Collison,32,81,2,1583,176,296,.595,0,4,.000,176,292,.603,.595,60,78,.769,123,210,333,121,51,30,69,197,412
16070,OKC,2013,Reggie Jackson,22,70,0,993,149,325,.458,24,104,.231,125,221,.566,.495,52,62,.839,21,145,166,122,29,13,53,84,374
16071,OKC,2013,Hasheem Thabeet,25,66,4,770,64,106,.604,0,0,,64,106,.604,.604,32,53,.604,69,126,195,11,30,60,41,148,160
16072,OKC,2013,Eric Maynor,25,37,0,391,36,115,.313,15,46,.326,21,69,.304,.378,17,21,.810,5,13,18,73,10,0,31,19,104
16073,OKC,2013,Derek Fisher,38,24,0,346,32,96,.333,20,57,.351,12,39,.308,.438,14,15,.933,2,20,22,16,14,1,12,31,98
16074,OKC,2013,DeAndre Liggins,24,39,1,290,21,47,.447,7,19,.368,14,28,.500,.521,9,18,.500,13,40,53,15,18,3,14,33,58
16075,OKC,2013,Perry Jones,21,38,1,280,39,99,.394,0,2,.000,39,97,.402,.394,10,15,.667,12,50,62,10,5,6,15,23,88
16076,OKC,2013,Jeremy Lamb,20,23,0,147,24,68,.353,9,30,.300,15,38,.395,.419,14,14,1.000,5,13,18,5,2,2,6,13,71
16077,OKC,2013,Ronnie Brewer,27,14,0,142,6,23,.261,1,5,.200,5,18,.278,.283,0,0,,13,27,40,10,9,0,4,6,13
16078,OKC,2013,Daniel Orton,22,13,0,104,12,26,.462,0,0,,12,26,.462,.462,9,17,.529,13,13,26,4,4,3,4,13,33
16079,OKC,2012,Kevin Durant,23,66,66,2546,643,1297,.496,133,344,.387,510,953,.535,.547,431,501,.860,40,487,527,231,88,77,248,133,1850
16080,OKC,2012,Russell Westbrook,23,66,66,2331,578,1266,.457,62,196,.316,516,1070,.482,.481,340,413,.823,96,205,301,362,112,21,239,147,1558
16081,OKC,2012,James Harden,22,62,2,1946,309,629,.491,114,292,.390,195,337,.579,.582,312,369,.846,30,222,252,229,62,15,137,150,1044
16082,OKC,2012,Serge Ibaka,22,66,66,1792,262,490,.535,1,3,.333,261,487,.536,.536,78,118,.661,193,305,498,28,33,241,79,179,603
16083,OKC,2012,Kendrick Perkins,27,65,65,1744,128,262,.489,0,0,,128,262,.489,.489,73,112,.652,120,306,426,78,25,73,118,189,329
16084,OKC,2012,Nick Collison,31,63,0,1307,120,201,.597,0,1,.000,120,200,.600,.597,44,62,.710,119,155,274,82,33,28,61,153,284
16085,OKC,2012,Daequan Cook,24,57,22,989,109,296,.368,79,228,.346,30,68,.441,.502,14,22,.636,12,110,122,15,22,11,16,69,311
16086,OKC,2012,Thabo Sefolosha,27,42,42,914,67,155,.432,31,71,.437,36,84,.429,.532,38,43,.884,21,107,128,47,37,17,40,78,203
16087,OKC,2012,Nazr Mohammed,34,63,1,692,79,169,.467,0,1,.000,79,168,.470,.467,13,23,.565,59,111,170,14,20,37,26,101,171
16088,OKC,2012,Reggie Jackson,21,45,0,501,51,159,.321,13,62,.210,38,97,.392,.362,25,29,.862,14,39,53,71,25,1,36,31,140
16089,OKC,2012,Derek Fisher,37,20,0,407,37,108,.343,11,35,.314,26,73,.356,.394,13,14,.929,2,27,29,28,11,1,15,32,98
16090,OKC,2012,Royal Ivey,30,34,0,354,26,73,.356,18,53,.340,8,20,.400,.479,1,8,.125,1,23,24,10,14,0,9,36,71
16091,OKC,2012,Cole Aldrich,23,26,0,173,22,42,.524,0,0,,22,42,.524,.524,13,14,.929,13,35,48,3,8,16,9,22,57
16092,OKC,2012,Lazar Hayward,25,26,0,141,13,38,.342,4,14,.286,9,24,.375,.395,7,12,.583,2,14,16,4,3,1,9,18,37
16093,OKC,2012,Eric Maynor,24,9,0,137,14,39,.359,6,17,.353,8,22,.364,.436,4,4,1.000,3,10,13,22,5,0,11,13,38
16094,OKC,2012,Ryan Reid,25,5,0,17,4,5,.800,0,0,,4,5,.800,.800,0,0,,1,1,2,0,0,0,1,1,8
16095,OKC,2011,Kevin Durant,22,78,78,3038,711,1538,.462,145,414,.350,566,1124,.504,.509,594,675,.880,57,476,533,214,88,76,218,159,2161
16096,OKC,2011,Russell Westbrook,22,82,82,2847,614,1390,.442,34,103,.330,580,1287,.451,.454,531,631,.842,121,258,379,670,155,30,316,207,1793
16097,OKC,2011,Serge Ibaka,21,82,44,2216,335,617,.543,0,1,.000,335,616,.544,.543,138,184,.750,214,408,622,22,31,198,71,267,808
16098,OKC,2011,James Harden,21,82,5,2189,298,684,.436,113,324,.349,185,360,.514,.518,289,343,.843,42,213,255,176,92,24,106,207,998
16099,OKC,2011,Thabo Sefolosha,26,79,79,2049,157,333,.471,28,102,.275,129,231,.558,.514,59,79,.747,65,281,346,111,97,38,55,171,401
16100,OKC,2011,Jeff Green,24,49,49,1815,270,618,.437,56,184,.304,214,434,.493,.482,148,181,.818,57,217,274,89,40,21,76,142,744
16101,OKC,2011,Nick Collison,30,71,2,1524,137,242,.566,0,0,,137,242,.566,.566,55,73,.753,119,197,316,69,42,31,55,210,329
16102,OKC,2011,Eric Maynor,23,82,0,1200,134,333,.402,37,96,.385,97,237,.409,.458,43,59,.729,25,96,121,238,35,6,77,96,348
16103,OKC,2011,Nenad Krstić,27,47,47,1018,152,305,.498,0,0,,152,305,.498,.498,53,66,.803,77,130,207,19,18,17,33,107,357
16104,OKC,2011,Daequan Cook,23,43,0,598,79,181,.436,65,154,.422,14,27,.519,.616,16,20,.800,8,64,72,20,14,1,17,51,239
16105,OKC,2011,Nazr Mohammed,33,24,7,429,75,131,.573,0,0,,75,131,.573,.573,15,24,.625,46,70,116,6,16,10,19,63,165
16106,OKC,2011,Kendrick Perkins,26,17,17,429,35,71,.493,0,0,,35,71,.493,.493,17,32,.531,39,96,135,16,7,16,31,54,87
16107,OKC,2011,D.J. White,24,23,0,219,30,65,.462,0,0,,30,65,.462,.462,5,10,.500,12,40,52,4,6,8,7,31,65
16108,OKC,2011,Royal Ivey,29,25,0,155,16,38,.421,7,16,.438,9,22,.409,.513,2,2,1.000,2,14,16,7,6,1,5,17,41
16109,OKC,2011,Cole Aldrich,22,18,0,142,8,15,.533,0,0,,8,15,.533,.533,2,4,.500,13,22,35,4,5,7,8,30,18
16110,OKC,2011,Byron Mullens,21,13,0,85,9,28,.321,0,0,,9,28,.321,.321,7,14,.500,6,18,24,0,2,3,8,11,25
16111,OKC,2011,Nate Robinson,26,4,0,30,4,15,.267,2,8,.250,2,7,.286,.333,3,4,.750,0,1,1,6,0,0,2,8,13
16112,OKC,2011,Morris Peterson,33,4,0,23,2,5,.400,0,1,.000,2,4,.500,.400,0,0,,0,3,3,1,0,0,0,5,4
16113,OKC,2010,Kevin Durant,21,82,82,3239,794,1668,.476,128,351,.365,666,1317,.506,.514,756,840,.900,105,518,623,231,112,84,271,171,2472
16114,OKC,2010,Jeff Green,23,82,82,3043,485,1070,.453,104,312,.333,381,758,.503,.502,165,223,.740,112,378,490,134,104,72,135,221,1239
16115,OKC,2010,Russell Westbrook,21,82,82,2813,485,1160,.418,23,104,.221,462,1056,.438,.428,329,422,.780,143,258,401,652,108,34,268,204,1322
16116,OKC,2010,Thabo Sefolosha,25,82,82,2348,194,441,.440,41,131,.313,153,310,.494,.486,60,89,.674,76,311,387,145,97,46,90,154,489
16117,OKC,2010,Nenad Krstić,26,76,76,1741,281,560,.502,1,5,.200,280,555,.505,.503,76,106,.717,134,249,383,52,32,45,58,177,639
16118,OKC,2010,James Harden,20,76,0,1738,233,578,.403,93,248,.375,140,330,.424,.484,194,240,.808,47,197,244,137,80,20,106,200,753
16119,OKC,2010,Nick Collison,29,75,5,1557,182,309,.589,1,4,.250,181,305,.593,.591,74,107,.692,152,232,384,38,37,48,63,230,439
16120,OKC,2010,Serge Ibaka,20,73,0,1323,201,370,.543,1,2,.500,200,368,.543,.545,58,92,.630,138,259,397,10,25,97,68,194,461
16121,OKC,2010,Eric Maynor,22,55,0,906,102,235,.434,17,47,.362,85,188,.452,.470,27,39,.692,11,80,91,185,27,8,57,82,248
16122,OKC,2010,Etan Thomas,31,23,1,321,31,68,.456,0,0,,31,68,.456,.456,13,22,.591,18,46,64,1,4,16,18,39,75
16123,OKC,2010,Kevin Ollie,37,25,0,263,18,45,.400,0,1,.000,18,44,.409,.400,8,8,1.000,3,22,25,20,9,0,6,16,44
16124,OKC,2010,Kyle Weaver,23,12,0,144,12,33,.364,7,19,.368,5,14,.357,.470,5,6,.833,1,17,18,11,6,6,4,13,36
16125,OKC,2010,Shaun Livingston,24,10,0,130,5,16,.313,0,2,.000,5,14,.357,.313,0,0,,4,16,20,14,5,2,8,9,10
16126,OKC,2010,D.J. White,23,12,0,102,25,41,.610,0,0,,25,41,.610,.610,9,10,.900,10,13,23,4,5,3,3,12,59
16127,OKC,2010,Mike Wilks,30,4,0,59,6,12,.500,2,3,.667,4,9,.444,.583,2,4,.500,1,3,4,4,0,0,4,5,16
16128,OKC,2010,Byron Mullens,20,13,0,54,7,19,.368,0,0,,7,19,.368,.368,0,0,,3,7,10,1,2,0,4,13,14
16129,OKC,2010,Antonio Anderson,24,1,0,15,1,3,.333,0,0,,1,3,.333,.333,0,0,,1,0,1,0,0,0,1,1,2
16130,OKC,2010,Ryan Bowen,34,1,0,8,1,1,1.000,0,0,,1,1,1.000,1.000,2,2,1.000,1,1,2,0,1,0,0,2,4
16131,OKC,2009,Kevin Durant,20,74,74,2885,661,1390,.476,97,230,.422,564,1160,.486,.510,452,524,.863,77,405,482,205,96,53,225,134,1871
16132,OKC,2009,Jeff Green,22,78,78,2873,476,1068,.446,96,247,.389,380,821,.463,.491,242,307,.788,120,399,519,155,81,33,173,202,1290
16133,OKC,2009,Russell Westbrook,20,82,65,2668,436,1095,.398,35,129,.271,401,966,.415,.414,349,428,.815,178,221,399,435,110,16,274,191,1256
16134,OKC,2009,Nick Collison,28,71,40,1831,243,428,.568,0,2,.000,243,426,.570,.568,98,136,.721,181,308,489,66,51,50,73,239,584
16135,OKC,2009,Earl Watson,29,68,18,1776,174,453,.384,20,85,.235,154,368,.418,.406,80,106,.755,36,147,183,391,50,11,156,137,448
16136,OKC,2009,Kyle Weaver,22,56,19,1166,113,246,.459,32,93,.344,81,153,.529,.524,41,58,.707,31,99,130,101,47,25,69,81,299
16137,OKC,2009,Nenad Krstić,25,46,29,1141,191,407,.469,0,0,,191,407,.469,.469,63,79,.797,85,168,253,29,21,49,45,114,445
16138,OKC,2009,Desmond Mason,31,39,19,1064,124,285,.435,0,3,.000,124,282,.440,.435,46,85,.541,41,116,157,46,15,30,56,96,294
16139,OKC,2009,Chris Wilcox,26,37,6,719,130,268,.485,0,3,.000,130,265,.491,.485,52,87,.598,65,130,195,33,18,11,55,89,312
16140,OKC,2009,Thabo Sefolosha,24,23,22,718,73,175,.417,9,37,.243,64,138,.464,.443,40,48,.833,28,91,119,46,40,26,27,54,195
16141,OKC,2009,Joe Smith,33,36,3,691,99,218,.454,2,4,.500,97,214,.453,.459,38,54,.704,53,110,163,25,10,26,15,72,238
16142,OKC,2009,Damien Wilkins,29,41,14,636,77,213,.362,27,72,.375,50,141,.355,.425,37,46,.804,20,50,70,37,22,7,37,55,218
16143,OKC,2009,Robert Swift,23,26,10,343,37,71,.521,0,0,,37,71,.521,.521,12,16,.750,21,68,89,9,5,17,8,50,86
16144,OKC,2009,Johan Petro,23,22,12,342,46,113,.407,0,1,.000,46,112,.411,.407,10,15,.667,27,68,95,6,16,5,15,51,102
16145,OKC,2009,Malik Rose,34,20,0,310,34,90,.378,0,3,.000,34,87,.391,.378,32,40,.800,13,52,65,26,9,2,19,48,100
16146,OKC,2009,Chucky Atkins,34,19,0,297,25,86,.291,10,40,.250,15,46,.326,.349,11,12,.917,5,13,18,31,8,1,13,22,71
16147,OKC,2009,Shaun Livingston,23,8,1,190,28,52,.538,0,0,,28,52,.538,.538,6,6,1.000,3,23,26,16,5,2,6,8,62
16148,OKC,2009,D.J. White,22,7,0,130,26,50,.520,0,0,,26,50,.520,.520,10,13,.769,10,22,32,6,3,5,3,10,62
16149,OKC,2009,Mouhamed Sene,22,5,0,23,5,7,.714,0,0,,5,7,.714,.714,7,9,.778,3,6,9,0,1,2,3,2,17
16150,OKC,2009,Steven Hill,23,1,0,2,1,1,1.000,0,0,,1,1,1.000,1.000,0,0,,2,1,3,0,0,0,0,0,2
16151,SEA,2008,Kevin Durant,19,80,80,2768,587,1366,.430,59,205,.288,528,1161,.455,.451,391,448,.873,70,278,348,192,78,75,232,122,1624
16152,SEA,2008,Earl Watson,28,78,73,2269,339,747,.454,49,132,.371,290,615,.472,.487,111,145,.766,43,182,225,531,69,11,175,158,838
16153,SEA,2008,Jeff Green,21,80,52,2253,320,749,.427,21,76,.276,299,673,.444,.441,177,238,.744,101,278,379,119,46,49,158,198,838
16154,SEA,2008,Nick Collison,27,78,35,2223,322,641,.502,0,2,.000,322,639,.504,.502,123,167,.737,254,476,730,113,47,60,118,250,767
16155,SEA,2008,Damien Wilkins,28,76,31,1843,271,673,.403,50,155,.323,221,518,.427,.440,106,144,.736,72,173,245,150,62,19,89,128,698
16156,SEA,2008,Chris Wilcox,25,62,55,1739,334,638,.524,0,3,.000,334,635,.526,.524,160,248,.645,126,307,433,74,46,36,103,174,828
16157,SEA,2008,Johan Petro,22,72,28,1310,184,439,.419,0,1,.000,184,438,.420,.419,64,87,.736,98,272,370,32,35,42,73,173,432
16158,SEA,2008,Luke Ridnour,26,61,5,1223,147,368,.399,21,71,.296,126,297,.424,.428,78,91,.857,13,81,94,241,37,14,80,120,393
16159,SEA,2008,Wally Szczerbiak,30,50,1,1180,236,513,.460,71,166,.428,165,347,.476,.529,113,134,.843,16,120,136,69,14,5,56,67,656
16160,SEA,2008,Kurt Thomas,35,42,39,1060,139,271,.513,0,0,,139,271,.513,.513,39,56,.696,94,275,369,53,35,43,28,131,317
16161,SEA,2008,Delonte West,24,35,5,727,97,250,.388,19,56,.339,78,194,.402,.426,26,39,.667,13,83,96,113,30,10,66,44,239
16162,SEA,2008,Mickaël Gelabale,24,39,0,465,69,157,.439,16,37,.432,53,120,.442,.490,14,18,.778,16,42,58,33,10,9,27,31,168
16163,SEA,2008,Francisco Elson,31,22,2,279,30,88,.341,0,1,.000,30,87,.345,.341,6,13,.462,17,48,65,8,6,6,17,34,66
16164,SEA,2008,Donyell Marshall,34,15,0,184,19,54,.352,7,30,.233,12,24,.500,.417,12,13,.923,15,31,46,5,4,7,9,15,57
16165,SEA,2008,Robert Swift,22,8,4,98,6,17,.353,0,0,,6,17,.353,.353,2,2,1.000,6,12,18,1,5,6,10,16,14
16166,SEA,2008,Adrian Griffin,33,13,0,85,6,16,.375,0,0,,6,16,.375,.375,2,2,1.000,9,13,22,5,5,1,5,8,14
16167,SEA,2008,Mouhamed Sene,21,13,0,62,11,24,.458,0,0,,11,24,.458,.458,8,17,.471,7,9,16,1,0,7,0,9,30
16168,SEA,2008,Mike Wilks,28,3,0,22,5,9,.556,0,1,.000,5,8,.625,.556,2,2,1.000,0,1,1,5,1,0,3,2,12
16169,SEA,2008,Ronald Dupree,27,4,0,18,1,3,.333,0,0,,1,3,.333,.333,2,2,1.000,1,7,8,1,1,0,0,0,4
16170,SEA,2008,Ira Newble,33,2,0,17,2,7,.286,0,2,.000,2,5,.400,.286,0,0,,0,0,0,1,0,0,0,0,4
16171,SEA,2008,Eddie Gill,29,1,0,5,0,2,.000,0,1,.000,0,1,.000,.000,0,0,,0,0,0,1,0,0,1,0,0
16172,SEA,2007,Chris Wilcox,24,82,81,2586,433,819,.529,0,6,.000,433,813,.533,.529,240,351,.684,178,451,629,82,70,38,127,248,1106
16173,SEA,2007,Nick Collison,26,82,56,2378,318,636,.500,0,2,.000,318,634,.502,.500,154,199,.774,229,437,666,82,48,66,123,289,790
16174,SEA,2007,Rashard Lewis,27,60,60,2348,463,1005,.461,151,387,.390,312,618,.505,.536,265,315,.841,91,305,396,145,68,39,118,143,1342
16175,SEA,2007,Ray Allen,31,55,55,2219,505,1153,.438,165,443,.372,340,710,.479,.510,279,309,.903,57,190,247,228,82,11,154,113,1454
16176,SEA,2007,Earl Watson,27,77,25,2152,263,687,.383,92,280,.329,171,407,.420,.450,108,147,.735,34,151,185,437,99,23,167,152,726
16177,SEA,2007,Luke Ridnour,25,71,58,2091,301,695,.433,49,139,.353,252,556,.453,.468,128,159,.805,28,136,164,368,83,19,156,181,779
16178,SEA,2007,Damien Wilkins,27,82,31,2037,262,602,.435,50,122,.410,212,480,.442,.477,150,170,.882,87,142,229,156,92,16,116,157,724
16179,SEA,2007,Johan Petro,21,81,13,1510,226,438,.516,0,0,,226,438,.516,.516,50,77,.649,92,243,335,45,39,47,82,237,502
16180,SEA,2007,Mickaël Gelabale,23,70,14,1239,122,264,.462,11,47,.234,111,217,.512,.483,66,82,.805,59,114,173,56,24,22,49,108,321
16181,SEA,2007,Mike Wilks,27,47,4,534,66,141,.468,5,15,.333,61,126,.484,.486,33,42,.786,15,39,54,79,15,4,31,53,170
16182,SEA,2007,Andre Brown,25,38,0,271,42,74,.568,0,1,.000,42,73,.575,.568,9,15,.600,26,48,74,2,6,4,29,26,93
16183,SEA,2007,Mouhamed Sene,20,28,3,169,18,49,.367,0,0,,18,49,.367,.367,17,29,.586,16,29,45,0,3,12,11,33,53
16184,SEA,2007,Danny Fortson,30,14,6,158,15,30,.500,0,1,.000,15,29,.517,.500,10,13,.769,13,30,43,1,1,0,15,38,40
16185,SEA,2007,Andreas Glyniadakis,25,13,4,81,8,17,.471,0,0,,8,17,.471,.471,1,2,.500,2,6,8,1,0,0,9,19,17
16186,SEA,2007,Desmon Farmer,25,8,0,32,5,15,.333,2,8,.250,3,7,.429,.400,1,1,1.000,0,1,1,9,1,0,1,2,13
16187,SEA,2007,Randy Livingston,31,4,0,26,0,3,.000,0,0,,0,3,.000,.000,0,0,,1,0,1,4,0,0,1,2,0
16188,SEA,2006,Ray Allen,30,78,78,3022,681,1500,.454,269,653,.412,412,847,.486,.544,324,359,.903,71,261,332,286,105,16,188,151,1955
16189,SEA,2006,Rashard Lewis,26,78,77,2876,538,1151,.467,142,370,.384,396,781,.507,.529,350,428,.818,111,279,390,182,102,50,141,191,1568
16190,SEA,2006,Luke Ridnour,24,79,77,2625,334,799,.418,43,149,.289,291,650,.448,.445,199,227,.877,47,188,235,550,123,22,162,178,910
16191,SEA,2006,Damien Wilkins,26,82,12,1525,193,435,.444,14,56,.250,179,379,.472,.460,136,162,.840,79,113,192,107,72,12,85,144,536
16192,SEA,2006,Nick Collison,25,66,27,1448,207,394,.525,0,3,.000,207,391,.529,.525,79,113,.699,143,225,368,74,21,35,77,213,493
16193,SEA,2006,Johan Petro,20,68,41,1282,153,300,.510,0,0,,153,300,.510,.510,47,75,.627,109,187,296,15,25,51,60,213,353
16194,SEA,2006,Vladimir Radmanović,25,47,16,1089,154,384,.401,72,196,.367,82,188,.436,.495,55,62,.887,39,148,187,72,32,15,53,130,435
16195,SEA,2006,Ronald Murray,26,48,2,1085,179,451,.397,17,76,.224,162,375,.432,.416,99,138,.717,18,68,86,120,30,4,79,69,474
16196,SEA,2006,Robert Swift,20,47,20,987,124,241,.515,0,0,,124,241,.515,.515,53,91,.582,94,170,264,8,15,56,49,142,301
16197,SEA,2006,Chris Wilcox,23,29,23,872,167,282,.592,0,0,,167,282,.592,.592,74,94,.787,72,165,237,34,18,13,40,80,408
16198,SEA,2006,Reggie Evans,25,41,23,788,88,173,.509,0,1,.000,88,172,.512,.509,66,120,.550,114,162,276,23,24,5,41,95,242
16199,SEA,2006,Earl Watson,26,24,0,603,98,227,.432,42,100,.420,56,127,.441,.524,38,52,.731,7,65,72,129,31,3,61,64,276
16200,SEA,2006,Mikki Moore,30,47,1,583,54,124,.435,0,2,.000,54,122,.443,.435,46,62,.742,44,86,130,27,7,15,40,92,154
16201,SEA,2006,Vitaly Potapenko,30,24,12,321,32,64,.500,0,0,,32,64,.500,.500,10,17,.588,26,36,62,7,2,2,14,44,74
16202,SEA,2006,Danny Fortson,29,23,1,276,27,51,.529,0,0,,27,51,.529,.529,33,43,.767,31,47,78,2,4,2,26,76,87
16203,SEA,2006,Mateen Cleaves,28,27,0,230,25,71,.352,4,16,.250,21,55,.382,.380,19,24,.792,2,12,14,42,3,2,14,30,73
16204,SEA,2006,Mike Wilks,26,10,0,105,12,31,.387,1,5,.200,11,26,.423,.403,19,29,.655,3,9,12,14,6,0,9,7,44
16205,SEA,2006,Noel Felix,24,12,0,82,6,25,.240,1,3,.333,5,22,.227,.260,5,8,.625,3,10,13,2,2,3,8,13,18
16206,SEA,2006,Rick Brunson,33,4,0,31,5,8,.625,0,1,.000,5,7,.714,.625,0,0,,0,2,2,2,0,0,3,1,10
16207,SEA,2005,Ray Allen,29,78,78,3064,640,1494,.428,209,556,.376,431,938,.459,.498,378,428,.883,79,268,347,289,84,5,171,167,1867
16208,SEA,2005,Rashard Lewis,25,71,71,2697,532,1151,.462,173,432,.400,359,719,.499,.537,220,283,.777,110,278,388,94,75,62,123,158,1457
16209,SEA,2005,Luke Ridnour,23,82,82,2571,299,739,.405,67,178,.376,232,561,.414,.450,159,180,.883,55,149,204,483,94,23,149,185,824
16210,SEA,2005,Antonio Daniels,29,75,2,2026,273,623,.438,49,165,.297,224,458,.489,.478,248,304,.816,20,149,169,309,51,3,78,78,843
16211,SEA,2005,Reggie Evans,24,79,79,1881,131,275,.476,0,2,.000,131,273,.480,.476,125,234,.534,254,482,736,58,58,15,104,202,387
16212,SEA,2005,Vladimir Radmanović,24,63,0,1856,266,650,.409,128,329,.389,138,321,.430,.508,81,103,.786,52,237,289,86,57,31,80,172,741
16213,SEA,2005,Nick Collison,24,82,4,1396,190,354,.537,0,3,.000,190,351,.541,.537,83,118,.703,156,220,376,32,34,50,62,252,463
16214,SEA,2005,Jerome James,29,80,80,1330,174,342,.509,0,2,.000,174,340,.512,.509,47,65,.723,81,160,241,19,23,111,88,279,395
16215,SEA,2005,Danny Fortson,28,62,0,1047,118,226,.522,0,0,,118,226,.522,.522,227,258,.880,157,191,348,8,15,7,91,265,463
16216,SEA,2005,Ronald Murray,25,49,6,883,131,363,.361,24,95,.253,107,268,.399,.394,59,80,.738,15,83,98,65,30,11,57,59,345
16217,SEA,2005,Damien Wilkins,25,29,7,520,73,168,.435,16,59,.271,57,109,.523,.482,21,34,.618,29,37,66,26,22,10,16,55,183
16218,SEA,2005,Vitaly Potapenko,29,33,1,335,45,87,.517,0,1,.000,45,86,.523,.517,27,31,.871,30,48,78,9,7,3,12,53,117
16219,SEA,2005,Robert Swift,19,16,0,72,5,11,.455,0,0,,5,11,.455,.455,5,9,.556,1,4,5,2,1,7,4,16,15
16220,SEA,2005,Mateen Cleaves,27,14,0,65,5,14,.357,0,2,.000,5,12,.417,.357,3,4,.750,2,4,6,7,2,0,2,2,13
16221,SEA,2005,Ibo Kutluay,30,5,0,12,0,1,.000,0,0,,0,1,.000,.000,0,0,,0,1,1,0,0,0,2,1,0
16222,SEA,2004,Rashard Lewis,24,80,80,2931,535,1229,.435,145,386,.376,390,843,.463,.494,206,270,.763,133,385,518,175,99,54,135,233,1421
16223,SEA,2004,Vladimir Radmanović,23,77,38,2321,345,812,.425,140,377,.371,205,435,.471,.511,95,127,.748,104,302,406,142,80,42,109,187,925
16224,SEA,2004,Ray Allen,28,56,56,2152,447,1017,.440,148,378,.392,299,639,.468,.512,245,271,.904,69,217,286,268,71,11,156,132,1287
16225,SEA,2004,Ronald Murray,24,82,18,2021,389,915,.425,67,229,.293,322,686,.469,.462,168,235,.715,45,159,204,205,81,28,149,158,1013
16226,SEA,2004,Brent Barry,32,59,53,1803,215,427,.504,114,252,.452,101,175,.577,.637,91,110,.827,21,183,204,342,85,16,139,121,635
16227,SEA,2004,Antonio Daniels,28,71,32,1512,187,398,.470,42,116,.362,145,282,.514,.523,155,184,.842,23,119,142,298,45,6,61,64,571
16228,SEA,2004,Vitaly Potapenko,28,65,39,1419,200,409,.489,0,0,,200,409,.489,.489,59,92,.641,101,188,289,53,22,28,77,161,459
16229,SEA,2004,Reggie Evans,23,75,27,1280,67,165,.406,0,3,.000,67,162,.414,.406,83,148,.561,156,252,408,33,54,10,65,176,217
16230,SEA,2004,Calvin Booth,27,71,35,1206,135,290,.466,0,2,.000,135,288,.469,.466,75,94,.798,86,194,280,28,17,101,45,150,345
16231,SEA,2004,Luke Ridnour,22,69,6,1114,145,350,.414,27,80,.338,118,270,.437,.453,65,79,.823,35,73,108,163,52,7,80,105,382
16232,SEA,2004,Jerome James,28,65,24,990,129,259,.498,0,0,,129,259,.498,.498,66,100,.660,78,152,230,32,20,60,82,180,324
16233,SEA,2004,Ansu Sesay,27,57,2,583,81,178,.455,6,21,.286,75,157,.478,.472,32,46,.696,43,49,92,19,19,20,23,66,200
16234,SEA,2004,Richie Frahm,26,54,0,469,63,139,.453,34,92,.370,29,47,.617,.576,23,26,.885,12,44,56,24,16,4,7,50,183
16235,SEA,2004,Leon Smith,23,1,0,4,1,2,.500,0,0,,1,2,.500,.500,0,0,,1,1,2,0,0,0,0,1,2
16236,SEA,2003,Rashard Lewis,23,77,77,3044,519,1149,.452,75,217,.346,444,932,.476,.484,283,345,.820,152,351,503,133,99,35,143,205,1396
16237,SEA,2003,Brent Barry,31,75,68,2480,264,577,.458,118,293,.403,146,284,.514,.560,128,161,.795,48,253,301,384,113,15,142,199,774
16238,SEA,2003,Gary Payton,34,52,52,2123,444,992,.448,34,114,.298,410,878,.467,.465,162,234,.692,56,192,248,457,93,12,131,117,1084
16239,SEA,2003,Predrag Drobnjak,27,82,69,1984,325,789,.412,30,85,.353,295,704,.419,.431,91,115,.791,111,209,320,86,48,38,65,180,771
16240,SEA,2003,Vladimir Radmanović,22,72,16,1910,274,668,.410,104,293,.355,170,375,.453,.488,72,102,.706,76,247,323,97,64,22,100,136,724
16241,SEA,2003,Desmond Mason,25,52,15,1811,291,667,.436,16,55,.291,275,612,.449,.448,134,181,.740,88,247,335,95,47,21,74,136,732
16242,SEA,2003,Reggie Evans,22,67,60,1365,66,140,.471,0,0,,66,140,.471,.471,80,154,.519,167,278,445,34,38,11,52,173,212
16243,SEA,2003,Ray Allen,27,29,29,1197,247,560,.441,78,222,.351,169,338,.500,.511,138,150,.920,49,114,163,170,46,3,81,71,710
16244,SEA,2003,Kevin Ollie,30,29,1,770,82,186,.441,1,1,1.000,81,185,.438,.444,66,87,.759,13,70,83,110,32,1,36,51,231
16245,SEA,2003,Jerome James,27,51,16,766,111,232,.478,0,0,,111,232,.478,.478,54,92,.587,78,138,216,27,12,82,75,166,276
16246,SEA,2003,Kenny Anderson,32,38,1,689,102,232,.440,0,5,.000,102,227,.449,.440,29,35,.829,17,70,87,121,40,1,33,63,233
16247,SEA,2003,Calvin Booth,26,47,0,575,52,119,.437,0,2,.000,52,117,.444,.437,34,47,.723,32,77,109,12,11,33,22,74,138
16248,SEA,2003,Ansu Sesay,26,45,4,448,41,107,.383,0,0,,41,107,.383,.383,12,21,.571,34,39,73,23,14,5,25,62,94
16249,SEA,2003,Vitaly Potapenko,27,26,2,403,41,93,.441,0,0,,41,93,.441,.441,22,29,.759,25,64,89,4,9,8,25,46,104
16250,SEA,2003,Elden Campbell,34,15,0,184,16,48,.333,0,0,,16,48,.333,.333,16,21,.762,13,26,39,9,9,8,8,27,48
16251,SEA,2003,Joseph Forte,21,17,0,86,10,35,.286,0,3,.000,10,32,.313,.286,4,6,.667,4,7,11,11,4,0,10,6,24
16252,SEA,2003,Ronald Murray,23,2,0,20,2,5,.400,0,1,.000,2,4,.500,.400,0,0,,0,3,3,2,0,0,4,0,4
16253,SEA,2002,Gary Payton,33,82,82,3301,737,1578,.467,74,236,.314,663,1342,.494,.490,267,335,.797,80,316,396,737,131,26,209,179,1815
16254,SEA,2002,Brent Barry,30,81,81,3040,401,790,.508,164,387,.424,237,403,.588,.611,198,234,.846,58,383,441,426,147,37,165,182,1164
16255,SEA,2002,Rashard Lewis,22,71,70,2585,455,972,.468,123,316,.389,332,656,.506,.531,162,200,.810,139,359,498,123,104,40,97,174,1195
16256,SEA,2002,Desmond Mason,24,75,20,2420,357,769,.464,16,59,.271,341,710,.480,.475,201,237,.848,92,259,351,104,67,27,104,170,931
16257,SEA,2002,Vin Baker,30,55,41,1710,315,649,.485,1,8,.125,314,641,.490,.486,143,226,.633,168,182,350,72,22,36,127,197,774
16258,SEA,2002,Vladimir Radmanović,21,61,16,1230,146,354,.412,66,157,.420,80,197,.406,.506,49,72,.681,45,185,230,81,56,24,72,119,407
16259,SEA,2002,Predrag Drobnjak,26,64,12,1174,191,414,.461,0,2,.000,191,412,.464,.461,55,73,.753,75,144,219,51,20,31,51,109,437
16260,SEA,2002,Art Long,29,63,27,989,120,244,.492,0,0,,120,244,.492,.492,45,85,.529,107,144,251,41,22,28,63,180,285
16261,SEA,2002,Earl Watson,22,64,0,964,96,212,.453,16,44,.364,80,168,.476,.491,23,36,.639,31,52,83,125,60,5,51,93,231
16262,SEA,2002,Jerome James,26,56,40,949,134,273,.491,0,0,,134,273,.491,.491,30,60,.500,89,143,232,24,25,86,74,174,298
16263,SEA,2002,Shammond Williams,26,50,2,603,81,193,.420,28,75,.373,53,118,.449,.492,31,39,.795,16,47,63,83,21,2,35,35,221
16264,SEA,2002,Calvin Booth,25,15,15,279,35,82,.427,0,0,,35,82,.427,.427,23,24,.958,20,34,54,16,6,13,16,47,93
16265,SEA,2002,Olumide Oyedeji,20,36,1,221,22,41,.537,0,0,,22,41,.537,.537,11,18,.611,27,52,79,4,4,2,14,36,55
16266,SEA,2002,Randy Livingston,26,13,0,176,15,54,.278,1,8,.125,14,46,.304,.287,10,11,.909,9,16,25,26,9,2,2,11,41
16267,SEA,2002,Ansu Sesay,25,9,0,142,22,44,.500,0,0,,22,44,.500,.500,14,20,.700,7,13,20,8,3,2,2,18,58
16268,SEA,2002,Antonio Harvey,31,5,3,47,4,12,.333,0,0,,4,12,.333,.333,1,2,.500,5,4,9,5,1,3,3,8,9
16269,SEA,2001,Gary Payton,32,79,79,3244,725,1591,.456,102,272,.375,623,1319,.472,.488,271,354,.766,73,288,361,642,127,26,209,184,1823
16270,SEA,2001,Rashard Lewis,21,78,78,2720,426,887,.480,123,285,.432,303,602,.503,.550,176,213,.826,143,398,541,125,91,45,129,191,1151
16271,SEA,2001,Vin Baker,29,76,27,2129,347,822,.422,1,16,.063,346,806,.429,.423,232,321,.723,179,251,430,90,38,73,158,264,927
16272,SEA,2001,Patrick Ewing,38,79,79,2107,294,684,.430,0,2,.000,294,682,.431,.430,172,251,.685,124,461,585,92,53,91,151,229,760
16273,SEA,2001,Ruben Patterson,25,76,22,2059,370,749,.494,2,36,.056,368,713,.516,.495,246,361,.681,183,199,382,161,103,45,155,176,988
16274,SEA,2001,Brent Barry,29,67,20,1778,198,401,.494,109,229,.476,89,172,.517,.630,84,103,.816,33,178,211,225,80,14,86,126,589
16275,SEA,2001,Desmond Mason,23,78,14,1522,189,439,.431,18,67,.269,171,372,.460,.451,67,91,.736,72,177,249,63,39,20,53,146,463
16276,SEA,2001,Emanual Davis,32,62,39,1290,133,318,.418,50,127,.394,83,191,.435,.497,45,55,.818,28,126,154,137,64,12,77,101,361
16277,SEA,2001,Shammond Williams,25,69,6,1238,161,368,.438,61,133,.459,100,235,.426,.520,84,96,.875,34,98,132,190,31,4,82,83,467
16278,SEA,2001,Jelani McCoy,23,70,44,1143,138,264,.523,0,0,,138,264,.523,.523,41,93,.441,92,159,251,57,18,49,75,141,317
16279,SEA,2001,Rubén Wolkowyski,27,34,1,305,25,79,.316,0,2,.000,25,77,.325,.316,25,34,.735,12,34,46,3,6,18,12,38,75
16280,SEA,2001,Olumide Oyedeji,19,30,1,221,18,37,.486,0,0,,18,37,.486,.486,9,12,.750,24,43,67,2,7,10,11,40,45
16281,SEA,2001,Pervis Ellison,33,9,0,40,2,7,.286,0,0,,2,7,.286,.286,2,2,1.000,2,10,12,3,0,2,3,13,6
16282,SEA,2001,David Wingate,37,1,0,9,3,3,1.000,0,0,,3,3,1.000,1.000,0,0,,0,0,0,2,0,0,0,1,6
16283,SEA,2000,Gary Payton,31,82,82,3425,747,1666,.448,177,520,.340,570,1146,.497,.502,311,423,.735,100,429,529,732,153,18,224,178,1982
16284,SEA,2000,Vin Baker,28,79,75,2849,514,1129,.455,2,8,.250,512,1121,.457,.456,281,412,.682,227,378,605,148,47,66,213,288,1311
16285,SEA,2000,Brent Barry,28,80,74,2726,327,707,.463,164,399,.411,163,308,.529,.579,127,157,.809,50,322,372,291,103,31,142,228,945
16286,SEA,2000,Horace Grant,34,76,76,2688,266,599,.444,0,4,.000,266,595,.447,.444,80,111,.721,167,424,591,188,55,60,61,192,612
16287,SEA,2000,Ruben Patterson,24,81,74,2097,354,661,.536,12,27,.444,342,634,.539,.545,222,321,.692,218,216,434,126,94,40,144,190,942
16288,SEA,2000,Rashard Lewis,20,82,8,1575,275,566,.486,40,120,.333,235,446,.527,.521,84,123,.683,127,209,336,70,62,36,78,163,674
16289,SEA,2000,Vernon Maxwell,34,47,0,989,169,490,.345,67,223,.300,102,267,.382,.413,108,148,.730,15,64,79,75,38,9,53,83,513
16290,SEA,2000,Jelani McCoy,22,58,2,746,102,177,.576,0,0,,102,177,.576,.576,45,91,.495,54,125,179,24,15,46,45,127,249
16291,SEA,2000,Greg Foster,31,60,5,718,91,224,.406,3,15,.200,88,209,.421,.413,18,28,.643,16,91,107,41,10,18,28,105,203
16292,SEA,2000,Emanual Davis,31,54,2,701,80,220,.364,31,103,.301,49,117,.419,.434,26,38,.684,15,85,100,70,38,5,44,72,217
16293,SEA,2000,Shammond Williams,24,43,5,517,84,225,.373,24,81,.296,60,144,.417,.427,33,51,.647,12,40,52,78,18,0,40,39,225
16294,SEA,2000,Chuck Person,35,37,0,340,37,123,.301,24,95,.253,13,28,.464,.398,4,8,.500,6,47,53,22,5,2,12,56,102
16295,SEA,2000,Vladimir Stepania,23,30,1,202,29,79,.367,0,6,.000,29,73,.397,.367,17,36,.472,21,26,47,3,10,11,22,44,75
16296,SEA,2000,Lazaro Borrell,27,17,6,167,28,63,.444,0,3,.000,28,60,.467,.444,6,11,.545,14,26,40,10,6,3,6,9,62
16297,SEA,2000,Fred Vinson,29,8,0,40,5,17,.294,2,7,.286,3,10,.300,.353,1,2,.500,0,1,1,0,3,0,4,2,13
16298,SEA,1999,Gary Payton,30,50,50,2008,401,923,.434,83,281,.295,318,642,.495,.479,199,276,.721,62,182,244,436,109,12,154,115,1084
16299,SEA,1999,Detlef Schrempf,36,50,39,1765,259,549,.472,34,86,.395,225,463,.486,.503,200,243,.823,77,293,370,184,41,26,103,152,752
16300,SEA,1999,Hersey Hawkins,32,50,34,1644,171,408,.419,55,180,.306,116,228,.509,.487,119,132,.902,51,150,201,123,80,18,80,90,516
16301,SEA,1999,Olden Polynice,34,48,47,1481,169,358,.472,1,1,1.000,168,357,.471,.473,29,94,.309,184,241,425,43,20,30,49,150,368
16302,SEA,1999,Dale Ellis,38,48,5,1232,174,395,.441,94,217,.433,80,178,.449,.559,53,70,.757,25,90,115,38,25,3,45,77,495
16303,SEA,1999,Vin Baker,27,34,31,1162,198,437,.453,0,3,.000,198,434,.456,.453,72,160,.450,86,125,211,56,32,34,76,121,468
16304,SEA,1999,Aaron Williams,27,40,2,458,52,123,.423,0,1,.000,52,122,.426,.423,54,74,.730,54,74,128,22,14,24,30,75,158
16305,SEA,1999,Billy Owens,29,21,19,451,65,165,.394,5,11,.455,60,154,.390,.409,28,35,.800,35,45,80,38,12,4,33,37,163
16306,SEA,1999,Don MacLean,29,17,10,365,63,159,.396,9,33,.273,54,126,.429,.425,50,80,.625,18,47,65,16,5,5,25,34,185
16307,SEA,1999,John Crotty,29,24,0,363,47,116,.405,13,35,.371,34,81,.420,.461,40,47,.851,8,22,30,58,9,0,33,30,147
16308,SEA,1999,Jelani McCoy,21,26,0,331,56,76,.737,0,0,,56,76,.737,.737,21,42,.500,27,52,79,4,11,20,10,42,133
16309,SEA,1999,Vladimir Stepania,22,23,6,313,53,125,.424,0,3,.000,53,122,.434,.424,21,40,.525,27,48,75,12,10,23,32,58,127
16310,SEA,1999,Drew Barry,25,17,0,183,10,32,.313,8,24,.333,2,8,.250,.438,9,13,.692,3,17,20,29,7,1,12,24,37
16311,SEA,1999,Rashard Lewis,19,20,7,145,19,52,.365,1,6,.167,18,46,.391,.375,8,14,.571,13,12,25,4,8,1,20,19,47
16312,SEA,1999,Moochie Norris,25,12,0,140,13,40,.325,6,15,.400,7,25,.280,.400,6,16,.375,4,16,20,24,7,0,16,17,38
16313,SEA,1999,James Cotton,23,10,0,59,6,18,.333,0,3,.000,6,15,.400,.333,13,18,.722,2,8,10,0,3,0,3,6,25
16314,SEA,1998,Gary Payton,29,82,82,3145,579,1278,.453,134,397,.338,445,881,.505,.505,279,375,.744,77,299,376,679,185,18,229,195,1571
16315,SEA,1998,Vin Baker,26,82,82,2944,631,1164,.542,1,7,.143,630,1157,.545,.543,311,526,.591,286,370,656,152,91,86,174,278,1574
16316,SEA,1998,Detlef Schrempf,35,78,78,2742,437,898,.487,61,147,.415,376,751,.501,.521,297,352,.844,135,419,554,341,60,19,168,205,1232
16317,SEA,1998,Hersey Hawkins,31,82,82,2597,280,636,.440,125,301,.415,155,335,.463,.539,177,204,.868,71,263,334,221,148,17,102,153,862
16318,SEA,1998,Dale Ellis,37,79,0,1939,348,700,.497,127,274,.464,221,426,.519,.588,111,142,.782,51,133,184,89,60,5,74,128,934
16319,SEA,1998,Sam Perkins,36,81,0,1675,196,471,.416,87,222,.392,109,249,.438,.508,101,128,.789,53,202,255,113,62,29,62,158,580
16320,SEA,1998,Jim McIlvaine,25,78,72,1211,101,223,.453,0,3,.000,101,220,.459,.453,45,81,.556,96,163,259,19,24,137,54,240,247
16321,SEA,1998,Greg Anthony,30,80,0,1021,150,349,.430,66,159,.415,84,190,.442,.524,53,80,.663,18,93,111,205,64,3,91,97,419
16322,SEA,1998,Aaron Williams,26,65,9,757,115,220,.523,0,1,.000,115,219,.525,.523,66,85,.776,48,99,147,14,19,38,50,119,296
16323,SEA,1998,Jerome Kersey,35,37,2,717,97,233,.416,1,10,.100,96,223,.430,.418,39,65,.600,56,79,135,44,52,14,36,104,234
16324,SEA,1998,David Wingate,34,58,2,546,66,140,.471,3,7,.429,63,133,.474,.482,15,29,.517,19,60,79,37,21,3,37,58,150
16325,SEA,1998,Nate McMillan,33,18,1,279,23,67,.343,15,34,.441,8,33,.242,.455,1,1,1.000,13,27,40,55,14,4,12,41,62
16326,SEA,1998,Eric Snow,24,17,0,74,10,23,.435,0,1,.000,10,22,.455,.435,5,10,.500,0,4,4,13,0,1,12,15,25
16327,SEA,1998,Stephen Howard,27,13,0,53,8,21,.381,0,0,,8,21,.381,.381,9,18,.500,6,6,12,3,3,1,6,13,25
16328,SEA,1998,James Cotton,22,9,0,33,8,21,.381,0,4,.000,8,17,.471,.381,8,9,.889,2,4,6,0,1,1,6,3,24
16329,SEA,1998,George Zídek,24,6,0,22,3,14,.214,1,2,.500,2,12,.167,.250,4,4,1.000,0,4,4,1,0,0,1,5,11
16330,SEA,1997,Gary Payton,28,82,82,3213,706,1482,.476,119,380,.313,587,1102,.533,.517,254,355,.715,106,272,378,583,197,13,215,208,1785
16331,SEA,1997,Hersey Hawkins,30,82,82,2755,369,795,.464,143,355,.403,226,440,.514,.554,258,295,.875,92,228,320,250,159,12,130,146,1139
16332,SEA,1997,Shawn Kemp,27,81,75,2750,526,1032,.510,12,33,.364,514,999,.515,.516,452,609,.742,275,532,807,156,125,81,280,320,1516
16333,SEA,1997,Detlef Schrempf,34,61,60,2192,356,724,.492,57,161,.354,299,563,.531,.531,253,316,.801,87,307,394,266,63,16,150,151,1022
16334,SEA,1997,Sam Perkins,35,81,4,1976,290,661,.439,122,309,.395,168,352,.477,.531,187,229,.817,74,226,300,103,69,49,77,134,889
16335,SEA,1997,Jim McIlvaine,24,82,79,1477,130,276,.471,1,7,.143,129,269,.480,.473,53,107,.495,132,198,330,23,39,164,62,247,314
16336,SEA,1997,Larry Stewart,28,70,21,982,112,252,.444,9,37,.243,103,215,.479,.462,67,93,.720,75,96,171,52,31,23,63,108,300
16337,SEA,1997,David Wingate,33,65,2,929,89,214,.416,25,71,.352,64,143,.448,.474,33,40,.825,23,51,74,80,44,5,37,108,236
16338,SEA,1997,Craig Ehlo,35,62,0,848,87,248,.351,27,95,.284,60,153,.392,.405,13,26,.500,39,71,110,68,36,4,45,71,214
16339,SEA,1997,Terry Cummings,35,45,3,828,155,319,.486,3,5,.600,152,314,.484,.491,57,82,.695,70,113,183,39,33,7,45,113,370
16340,SEA,1997,Nate McMillan,32,37,2,798,61,149,.409,28,84,.333,33,65,.508,.503,19,29,.655,15,103,118,140,58,6,32,78,169
16341,SEA,1997,Eric Snow,23,67,0,775,74,164,.451,4,15,.267,70,149,.470,.463,47,66,.712,17,53,70,159,37,3,48,94,199
16342,SEA,1997,Greg Graham,26,28,0,197,29,80,.363,9,31,.290,20,49,.408,.419,26,40,.650,2,11,13,11,12,1,10,12,93
16343,SEA,1997,Steve Scheffler,29,7,0,29,6,7,.857,0,0,,6,7,.857,.857,1,2,.500,1,2,3,0,0,0,5,5,13
16344,SEA,1997,Antonio Harvey,26,6,0,26,5,11,.455,0,0,,5,11,.455,.455,5,6,.833,2,8,10,1,0,4,1,8,15
16345,SEA,1997,Elmore Spencer,27,1,0,5,0,1,.000,0,0,,0,1,.000,.000,0,0,,0,0,0,0,1,0,1,0,0
16346,SEA,1996,Gary Payton,27,81,81,3162,618,1276,.484,98,299,.328,520,977,.532,.523,229,306,.748,104,235,339,608,231,19,260,221,1563
16347,SEA,1996,Hersey Hawkins,29,82,82,2823,443,936,.473,146,380,.384,297,556,.534,.551,249,285,.874,86,211,297,218,149,14,164,172,1281
16348,SEA,1996,Shawn Kemp,26,79,76,2631,526,937,.561,5,12,.417,521,925,.563,.564,493,664,.742,276,628,904,173,93,127,315,299,1550
16349,SEA,1996,Detlef Schrempf,33,63,60,2200,360,740,.486,73,179,.408,287,561,.512,.536,287,370,.776,73,255,328,276,56,8,146,179,1080
16350,SEA,1996,Sam Perkins,34,82,20,2169,325,797,.408,129,363,.355,196,434,.452,.489,191,241,.793,101,266,367,120,83,48,82,174,970
16351,SEA,1996,Vincent Askew,29,69,2,1725,215,436,.493,29,86,.337,186,350,.531,.526,123,161,.764,65,153,218,163,47,15,96,178,582
16352,SEA,1996,Ervin Johnson,28,81,60,1519,180,352,.511,1,3,.333,179,349,.513,.513,85,127,.669,129,304,433,48,40,129,98,245,446
16353,SEA,1996,Nate McMillan,31,55,14,1261,100,238,.420,46,121,.380,54,117,.462,.517,29,41,.707,41,169,210,197,95,18,75,143,275
16354,SEA,1996,Frank Brickowski,36,63,8,986,123,252,.488,32,79,.405,91,173,.526,.552,61,86,.709,26,125,151,58,26,8,78,185,339
16355,SEA,1996,David Wingate,32,60,3,695,88,212,.415,15,34,.441,73,178,.410,.450,32,41,.780,17,39,56,58,20,4,42,66,223
16356,SEA,1996,Eric Snow,22,43,1,389,42,100,.420,2,10,.200,40,90,.444,.430,29,49,.592,9,34,43,73,28,0,38,53,115
16357,SEA,1996,Steve Scheffler,28,35,2,181,24,45,.533,1,5,.200,23,40,.575,.544,9,19,.474,15,18,33,2,6,2,8,25,58
16358,SEA,1996,Sherell Ford,23,28,1,139,30,80,.375,4,25,.160,26,55,.473,.400,26,34,.765,12,12,24,5,8,1,6,27,90
16359,SEA,1995,Gary Payton,26,82,82,3015,685,1345,.509,70,232,.302,615,1113,.553,.535,249,348,.716,108,173,281,583,204,13,201,206,1689
16360,SEA,1995,Detlef Schrempf,32,82,82,2886,521,997,.523,93,181,.514,428,816,.525,.569,437,521,.839,135,373,508,310,93,35,176,252,1572
16361,SEA,1995,Shawn Kemp,25,82,79,2679,545,997,.547,2,7,.286,543,990,.548,.548,438,585,.749,318,575,893,149,102,122,259,337,1530
16362,SEA,1995,Sam Perkins,33,82,37,2356,346,742,.466,136,343,.397,210,399,.526,.558,215,269,.799,96,302,398,135,72,45,77,186,1043
16363,SEA,1995,Kendall Gill,26,73,58,2125,392,858,.457,63,171,.368,329,687,.479,.494,155,209,.742,99,191,290,192,117,28,138,186,1002
16364,SEA,1995,Nate McMillan,30,80,18,2070,166,397,.418,53,155,.342,113,242,.467,.485,34,58,.586,65,237,302,421,165,53,126,275,419
16365,SEA,1995,Vincent Askew,28,71,1,1721,248,504,.492,31,94,.330,217,410,.529,.523,176,238,.739,65,116,181,176,49,13,85,191,703
16366,SEA,1995,Šarūnas Marčiulionis,30,66,4,1194,216,457,.473,35,87,.402,181,370,.489,.511,145,198,.732,17,51,68,110,72,3,98,126,612
16367,SEA,1995,Ervin Johnson,27,64,30,907,85,192,.443,0,1,.000,85,191,.445,.443,29,46,.630,101,188,289,16,17,67,54,163,199
16368,SEA,1995,Bill Cartwright,37,29,19,430,27,69,.391,0,0,,27,69,.391,.391,15,24,.625,25,62,87,10,6,3,18,70,69
16369,SEA,1995,Byron Houston,25,39,0,258,49,107,.458,6,22,.273,43,85,.506,.486,28,38,.737,20,35,55,6,13,5,20,50,132
16370,SEA,1995,Steve Scheffler,27,18,0,102,12,23,.522,0,0,,12,23,.522,.522,15,18,.833,8,15,23,4,2,2,3,9,39
16371,SEA,1995,Dontonio Wingfield,20,20,0,81,18,51,.353,2,12,.167,16,39,.410,.373,8,10,.800,11,19,30,3,5,3,8,15,46
16372,SEA,1995,Rich King,25,2,0,6,0,2,.000,0,0,,0,2,.000,.000,0,2,.000,0,0,0,0,0,0,0,1,0
16373,SEA,1994,Gary Payton,25,82,82,2881,584,1159,.504,15,54,.278,569,1105,.515,.510,166,279,.595,105,164,269,494,188,19,173,227,1349
16374,SEA,1994,Detlef Schrempf,31,81,80,2728,445,903,.493,22,68,.324,423,835,.507,.505,300,390,.769,144,310,454,275,73,9,173,273,1212
16375,SEA,1994,Shawn Kemp,24,79,73,2597,533,990,.538,1,4,.250,532,986,.540,.539,364,491,.741,312,539,851,207,142,166,259,312,1431
16376,SEA,1994,Kendall Gill,25,79,77,2435,429,969,.443,38,120,.317,391,849,.461,.462,215,275,.782,91,177,268,275,151,32,143,194,1111
16377,SEA,1994,Sam Perkins,32,81,41,2170,341,779,.438,99,270,.367,242,509,.475,.501,218,272,.801,120,246,366,111,67,31,103,197,999
16378,SEA,1994,Nate McMillan,29,73,8,1887,177,396,.447,52,133,.391,125,263,.475,.513,31,55,.564,50,233,283,387,216,22,126,201,437
16379,SEA,1994,Michael Cage,32,82,42,1708,171,314,.545,0,1,.000,171,313,.546,.545,36,74,.486,164,280,444,45,77,38,51,179,378
16380,SEA,1994,Vincent Askew,27,80,3,1690,273,567,.481,6,31,.194,267,536,.498,.487,175,211,.829,60,124,184,194,73,19,70,145,727
16381,SEA,1994,Ricky Pierce,34,51,0,1022,272,577,.471,6,32,.188,266,545,.488,.477,189,211,.896,29,54,83,91,42,5,64,84,739
16382,SEA,1994,Ervin Johnson,26,45,3,280,44,106,.415,0,0,,44,106,.415,.415,29,46,.630,48,70,118,7,10,22,24,45,117
16383,SEA,1994,Steve Scheffler,26,35,1,152,28,46,.609,0,0,,28,46,.609,.609,19,20,.950,11,15,26,6,7,0,8,25,75
16384,SEA,1994,Chris King,24,15,0,86,19,48,.396,2,7,.286,17,41,.415,.417,15,26,.577,5,10,15,11,4,0,12,12,55
16385,SEA,1994,Rich King,24,27,0,78,15,34,.441,0,1,.000,15,33,.455,.441,11,22,.500,9,11,20,8,1,2,7,18,41
16386,SEA,1994,Alphonso Ford,22,6,0,16,7,13,.538,1,1,1.000,6,12,.500,.577,1,2,.500,0,0,0,1,2,0,1,2,16
16387,SEA,1993,Shawn Kemp,23,78,68,2582,515,1047,.492,0,4,.000,515,1043,.494,.492,358,503,.712,287,546,833,155,119,146,217,327,1388
16388,SEA,1993,Gary Payton,24,82,78,2548,476,963,.494,7,34,.206,469,929,.505,.498,151,196,.770,95,186,281,399,177,21,148,250,1110
16389,SEA,1993,Derrick McKey,26,77,68,2439,387,780,.496,40,112,.357,347,668,.519,.522,220,297,.741,121,206,327,197,105,58,152,208,1034
16390,SEA,1993,Ricky Pierce,33,77,72,2218,524,1071,.489,42,113,.372,482,958,.503,.509,313,352,.889,58,134,192,220,100,7,160,167,1403
16391,SEA,1993,Michael Cage,31,82,66,2156,219,416,.526,0,1,.000,219,415,.528,.526,61,130,.469,268,391,659,69,76,46,59,183,499
16392,SEA,1993,Nate McMillan,28,73,25,1977,213,459,.464,25,65,.385,188,394,.477,.491,95,134,.709,84,222,306,384,173,33,139,240,546
16393,SEA,1993,Eddie Johnson,33,82,0,1869,463,991,.467,17,56,.304,446,935,.477,.476,234,257,.911,124,148,272,135,36,4,134,173,1177
16394,SEA,1993,Dana Barros,25,69,2,1243,214,474,.451,64,169,.379,150,305,.492,.519,49,59,.831,18,89,107,151,63,3,58,78,541
16395,SEA,1993,Vincent Askew,26,64,4,1053,144,292,.493,2,6,.333,142,286,.497,.497,94,134,.701,55,95,150,117,38,18,61,124,384
16396,SEA,1993,Sam Perkins,31,30,13,762,139,272,.511,19,42,.452,120,230,.522,.546,66,83,.795,52,93,145,28,20,31,32,86,363
16397,SEA,1993,Benoit Benjamin,28,31,6,448,81,163,.497,0,0,,81,163,.497,.497,47,67,.701,27,86,113,12,17,35,42,73,209
16398,SEA,1993,Gerald Paddio,27,41,3,307,71,159,.447,2,8,.250,69,151,.457,.453,14,21,.667,17,33,50,33,14,6,16,24,158
16399,SEA,1993,Steve Scheffler,25,29,5,166,25,48,.521,0,0,,25,48,.521,.521,16,24,.667,15,21,36,5,6,1,5,37,66
16400,SEA,1993,Rich King,23,3,0,12,2,5,.400,0,0,,2,5,.400,.400,2,2,1.000,1,4,5,1,0,0,3,1,6
16401,SEA,1992,Ricky Pierce,32,78,78,2658,620,1306,.475,33,123,.268,587,1183,.496,.487,417,455,.916,93,140,233,241,86,20,189,213,1690
16402,SEA,1992,Gary Payton,23,81,79,2549,331,734,.451,3,23,.130,328,711,.461,.453,99,148,.669,123,172,295,506,147,21,174,248,764
16403,SEA,1992,Michael Cage,30,82,69,2461,307,542,.566,0,5,.000,307,537,.572,.566,106,171,.620,266,462,728,92,99,55,78,237,720
16404,SEA,1992,Eddie Johnson,32,81,19,2366,534,1164,.459,27,107,.252,507,1057,.480,.470,291,338,.861,118,174,292,161,55,11,130,199,1386
16405,SEA,1992,Benoit Benjamin,27,63,61,1941,354,740,.478,0,2,.000,354,738,.480,.478,171,249,.687,130,383,513,76,39,118,175,185,879
16406,SEA,1992,Shawn Kemp,22,64,23,1808,362,718,.504,0,3,.000,362,715,.506,.504,270,361,.748,264,401,665,86,70,124,156,261,994
16407,SEA,1992,Derrick McKey,25,52,44,1757,285,604,.472,19,50,.380,266,554,.480,.488,188,222,.847,95,173,268,120,61,47,114,142,777
16408,SEA,1992,Nate McMillan,27,72,30,1652,177,405,.437,27,98,.276,150,307,.489,.470,54,84,.643,92,160,252,359,129,29,112,218,435
16409,SEA,1992,Dana Barros,24,75,1,1331,238,493,.483,83,186,.446,155,307,.505,.567,60,79,.759,17,64,81,125,51,4,56,84,619
16410,SEA,1992,Tony Brown,31,35,2,401,63,160,.394,12,41,.293,51,119,.429,.431,30,37,.811,23,33,56,32,18,4,21,51,168
16411,SEA,1992,Marty Conlon,24,45,1,381,48,101,.475,0,0,,48,101,.475,.475,24,32,.750,33,36,69,12,9,7,27,40,120
16412,SEA,1992,Bart Kofoed,27,44,0,239,25,53,.472,1,7,.143,24,46,.522,.481,15,26,.577,6,20,26,51,2,2,20,26,66
16413,SEA,1992,Rich King,22,40,2,213,27,71,.380,0,1,.000,27,70,.386,.380,34,45,.756,20,29,49,12,4,5,18,42,88
16414,SEA,1992,Quintin Dailey,31,11,1,98,9,37,.243,0,1,.000,9,36,.250,.243,13,16,.813,2,10,12,4,5,1,10,6,31
16415,SEA,1991,Derrick McKey,24,73,55,2503,438,847,.517,4,19,.211,434,828,.524,.519,235,278,.845,172,251,423,169,91,56,158,220,1115
16416,SEA,1991,Shawn Kemp,21,81,66,2442,462,909,.508,2,12,.167,460,897,.513,.509,288,436,.661,267,412,679,144,77,123,202,319,1214
16417,SEA,1991,Gary Payton,22,82,82,2244,259,575,.450,1,13,.077,258,562,.459,.451,69,97,.711,108,135,243,528,165,15,180,249,588
16418,SEA,1991,Michael Cage,29,82,55,2141,226,445,.508,0,3,.000,226,442,.511,.508,70,112,.625,177,381,558,89,85,58,83,194,522
16419,SEA,1991,Sedale Threatt,29,80,57,2066,433,835,.519,10,35,.286,423,800,.529,.525,137,173,.792,25,74,99,273,113,8,138,191,1013
16420,SEA,1991,Eddie Johnson,31,66,27,1773,455,936,.486,33,99,.333,422,837,.504,.504,208,228,.912,91,134,225,94,49,7,98,144,1151
16421,SEA,1991,Nate McMillan,26,78,0,1434,132,305,.433,17,48,.354,115,257,.447,.461,57,93,.613,71,180,251,371,104,20,122,211,338
16422,SEA,1991,Olden Polynice,26,48,0,960,165,303,.545,0,0,,165,303,.545,.545,67,114,.588,114,156,270,16,26,19,53,94,397
16423,SEA,1991,Benoit Benjamin,26,31,27,899,157,313,.502,0,0,,157,313,.502,.502,87,126,.690,62,192,254,45,28,54,97,74,401
16424,SEA,1991,Ricky Pierce,31,32,2,840,202,436,.463,9,23,.391,193,413,.467,.474,148,160,.925,30,44,74,72,22,2,54,80,561
16425,SEA,1991,Dale Ellis,30,30,24,800,181,391,.463,27,89,.303,154,302,.510,.497,62,84,.738,28,64,92,64,33,3,49,59,451
16426,SEA,1991,Dana Barros,23,66,0,750,154,311,.495,32,81,.395,122,230,.530,.547,78,85,.918,17,54,71,111,23,1,54,40,418
16427,SEA,1991,Xavier McDaniel,27,15,15,529,139,290,.479,0,3,.000,139,287,.484,.479,49,69,.710,36,45,81,38,26,4,40,50,327
16428,SEA,1991,Quintin Dailey,30,30,0,299,73,155,.471,0,1,.000,73,154,.474,.471,38,62,.613,11,21,32,16,7,1,19,25,184
16429,SEA,1991,Dave Corzine,34,28,0,147,17,38,.447,0,0,,17,38,.447,.447,13,22,.591,10,23,33,4,5,5,2,18,47
16430,SEA,1991,Scott Meents,27,13,0,53,7,28,.250,1,1,1.000,6,27,.222,.268,2,4,.500,3,7,10,8,7,4,6,5,17
16431,SEA,1990,Derrick McKey,23,80,80,2748,468,949,.493,3,23,.130,465,926,.502,.495,315,403,.782,170,319,489,187,87,81,192,247,1254
16432,SEA,1990,Michael Cage,28,82,82,2595,325,645,.504,0,0,,325,645,.504,.504,148,212,.698,306,515,821,70,79,45,94,232,798
16433,SEA,1990,Xavier McDaniel,26,69,67,2432,611,1233,.496,5,17,.294,606,1216,.498,.498,244,333,.733,165,282,447,171,73,36,187,231,1471
16434,SEA,1990,Nate McMillan,25,82,69,2338,207,438,.473,11,31,.355,196,407,.482,.485,98,153,.641,127,276,403,598,140,37,187,289,523
16435,SEA,1990,Dale Ellis,29,55,49,2033,502,1011,.497,96,256,.375,406,755,.538,.544,193,236,.818,90,148,238,110,59,7,119,124,1293
16436,SEA,1990,Dana Barros,22,81,25,1630,299,738,.405,95,238,.399,204,500,.408,.470,89,110,.809,35,97,132,205,53,1,123,97,782
16437,SEA,1990,Sedale Threatt,28,65,18,1481,303,599,.506,8,32,.250,295,567,.520,.513,130,157,.828,43,72,115,216,65,8,77,164,744
16438,SEA,1990,Shawn Kemp,20,81,1,1120,203,424,.479,2,12,.167,201,412,.488,.481,117,159,.736,146,200,346,26,47,70,107,204,525
16439,SEA,1990,Olden Polynice,25,79,7,1085,156,289,.540,1,2,.500,155,287,.540,.542,47,99,.475,128,172,300,15,25,21,35,187,360
16440,SEA,1990,Brad Sellers,27,45,0,587,84,198,.424,0,3,.000,84,195,.431,.424,49,61,.803,31,39,70,32,11,19,34,63,217
16441,SEA,1990,Avery Johnson,24,53,10,575,55,142,.387,1,4,.250,54,138,.391,.391,29,40,.725,21,22,43,162,26,1,48,55,140
16442,SEA,1990,Quintin Dailey,29,30,2,491,97,240,.404,1,5,.200,96,235,.409,.406,52,66,.788,18,33,51,34,12,0,34,63,247
16443,SEA,1990,Jim Farmer,25,38,0,400,89,203,.438,8,27,.296,81,176,.460,.458,57,80,.713,17,26,43,25,17,1,27,44,243
16444,SEA,1990,Steve Johnson,32,21,0,242,48,90,.533,0,0,,48,90,.533,.533,21,35,.600,19,31,50,16,3,5,25,52,117
16445,SEA,1990,Scott Meents,26,26,0,148,19,44,.432,0,0,,19,44,.432,.432,17,23,.739,7,23,30,7,4,3,9,12,55
16446,SEA,1989,Dale Ellis,28,82,82,3190,857,1710,.501,162,339,.478,695,1371,.507,.549,377,462,.816,156,186,342,164,108,22,218,197,2253
16447,SEA,1989,Derrick McKey,22,82,82,2804,487,970,.502,30,89,.337,457,881,.519,.518,301,375,.803,167,297,464,219,105,70,188,264,1305
16448,SEA,1989,Michael Cage,27,80,71,2536,314,630,.498,0,4,.000,314,626,.502,.498,197,265,.743,276,489,765,126,92,52,124,184,825
16449,SEA,1989,Xavier McDaniel,25,82,10,2385,677,1385,.489,11,36,.306,666,1349,.494,.493,312,426,.732,177,256,433,134,84,40,210,231,1677
16450,SEA,1989,Nate McMillan,24,75,74,2341,199,485,.410,15,70,.214,184,415,.443,.426,119,189,.630,143,245,388,696,156,42,211,236,532
16451,SEA,1989,Alton Lister,30,82,82,1806,271,543,.499,0,0,,271,543,.499,.499,115,178,.646,207,338,545,54,28,180,117,310,657
16452,SEA,1989,Sedale Threatt,27,63,0,1220,235,476,.494,11,30,.367,224,446,.502,.505,63,77,.818,31,86,117,238,83,4,77,155,544
16453,SEA,1989,John Lucas,35,74,8,842,119,299,.398,18,68,.265,101,231,.437,.428,54,77,.701,22,57,79,260,60,1,66,53,310
16454,SEA,1989,Olden Polynice,24,80,0,835,91,180,.506,0,2,.000,91,178,.511,.506,51,86,.593,98,108,206,21,37,30,46,164,233
16455,SEA,1989,Russ Schoene,28,69,1,774,135,349,.387,42,110,.382,93,239,.389,.447,46,57,.807,58,107,165,36,37,24,48,136,358
16456,SEA,1989,Jerry Reynolds,26,56,0,737,149,357,.417,3,15,.200,146,342,.427,.422,127,167,.760,49,51,100,62,53,26,57,58,428
16457,SEA,1989,Avery Johnson,23,43,0,291,29,83,.349,1,9,.111,28,74,.378,.355,9,16,.563,11,13,24,73,21,3,18,34,68
16458,SEA,1989,Greg Ballard,34,2,0,15,1,8,.125,0,1,.000,1,7,.143,.125,4,4,1.000,2,5,7,0,0,0,0,3,6
16459,SEA,1989,Mike Champion,24,2,0,4,0,3,.000,0,1,.000,0,2,.000,.000,0,0,,0,0,0,0,0,0,1,2,0
16460,SEA,1988,Dale Ellis,27,75,73,2790,764,1519,.503,107,259,.413,657,1260,.521,.538,303,395,.767,167,173,340,197,74,11,172,221,1938
16461,SEA,1988,Xavier McDaniel,24,78,77,2703,687,1407,.488,14,50,.280,673,1357,.496,.493,281,393,.715,206,312,518,263,96,52,223,230,1669
16462,SEA,1988,Tom Chambers,28,82,82,2680,611,1364,.448,33,109,.303,578,1255,.461,.460,419,519,.807,135,355,490,212,87,53,209,297,1674
16463,SEA,1988,Nate McMillan,23,82,82,2453,235,496,.474,9,24,.375,226,472,.479,.483,145,205,.707,117,221,338,702,169,47,189,238,624
16464,SEA,1988,Alton Lister,29,82,55,1812,173,343,.504,1,2,.500,172,341,.504,.506,114,188,.606,200,427,627,58,27,140,90,319,461
16465,SEA,1988,Derrick McKey,21,82,4,1706,255,519,.491,11,30,.367,244,489,.499,.502,173,224,.772,115,213,328,107,70,63,108,237,694
16466,SEA,1988,Kevin Williams,26,80,9,1084,199,450,.442,1,7,.143,198,443,.447,.443,103,122,.844,61,66,127,96,62,7,68,207,502
16467,SEA,1988,Olden Polynice,23,82,0,1080,118,254,.465,0,2,.000,118,252,.468,.465,101,158,.639,122,208,330,33,32,26,81,215,337
16468,SEA,1988,Russ Schoene,27,81,2,973,208,454,.458,17,58,.293,191,396,.482,.477,51,63,.810,78,120,198,53,39,13,57,151,484
16469,SEA,1988,Danny Young,25,77,0,949,89,218,.408,22,77,.286,67,141,.475,.459,43,53,.811,18,57,75,218,52,2,37,69,243
16470,SEA,1988,Clemon Johnson,31,74,26,723,49,105,.467,0,0,,49,105,.467,.467,22,32,.688,66,108,174,17,13,24,29,104,120
16471,SEA,1988,Sam Vincent,24,43,0,548,72,152,.474,5,13,.385,67,139,.482,.490,46,60,.767,17,32,49,137,21,4,52,63,195
16472,SEA,1988,Sedale Threatt,26,26,0,354,84,162,.519,1,7,.143,83,155,.535,.522,25,30,.833,11,22,33,53,33,5,19,29,194
16473,SEA,1987,Dale Ellis,26,82,76,3073,785,1520,.516,86,240,.358,699,1280,.546,.545,385,489,.787,187,260,447,238,104,32,238,267,2041
16474,SEA,1987,Xavier McDaniel,23,82,82,3031,806,1583,.509,3,14,.214,803,1569,.512,.510,275,395,.696,338,367,705,207,115,52,234,300,1890
16475,SEA,1987,Tom Chambers,27,82,82,3018,660,1446,.456,54,145,.372,606,1301,.466,.475,535,630,.849,163,382,545,245,81,50,268,307,1909
16476,SEA,1987,Alton Lister,28,75,75,2288,346,687,.504,0,1,.000,346,686,.504,.504,179,265,.675,223,482,705,110,32,180,169,289,871
16477,SEA,1987,Nate McMillan,22,71,50,1972,143,301,.475,0,7,.000,143,294,.486,.475,87,141,.617,101,230,331,583,125,45,155,238,373
16478,SEA,1987,Danny Young,24,73,26,1482,132,288,.458,29,79,.367,103,209,.493,.509,59,71,.831,23,90,113,353,74,3,85,72,352
16479,SEA,1987,Maurice Lucas,34,63,0,1120,175,388,.451,0,5,.000,175,383,.457,.451,150,187,.802,88,219,307,65,34,21,75,171,500
16480,SEA,1987,Clemon Johnson,30,78,7,1051,88,178,.494,0,2,.000,88,176,.500,.494,70,110,.636,106,171,277,21,21,42,36,137,246
16481,SEA,1987,Kevin Williams,25,65,0,703,132,296,.446,0,7,.000,132,289,.457,.446,55,66,.833,47,36,83,66,45,8,63,154,319
16482,SEA,1987,Russ Schoene,26,63,0,579,71,190,.374,2,13,.154,69,177,.390,.379,29,46,.630,52,65,117,27,20,11,42,94,173
16483,SEA,1987,Eddie Johnson,31,24,0,508,85,186,.457,5,15,.333,80,171,.468,.470,42,55,.764,11,35,46,115,12,1,41,36,217
16484,SEA,1987,Michael Phelps,25,60,6,469,75,176,.426,1,10,.100,74,166,.446,.429,31,44,.705,16,34,50,64,21,2,32,60,182
16485,SEA,1987,Terence Stansbury,25,44,0,375,67,156,.429,11,29,.379,56,127,.441,.465,31,50,.620,8,16,24,57,13,0,29,78,176
16486,SEA,1987,Gerald Henderson,31,6,6,155,25,50,.500,0,3,.000,25,47,.532,.500,17,18,.944,6,3,9,32,6,0,15,17,67
16487,SEA,1987,Curtis Kitchen,23,6,0,31,3,6,.500,0,1,.000,3,5,.600,.500,3,4,.750,4,5,9,1,2,3,0,4,9
16488,SEA,1986,Jack Sikma,30,80,78,2790,508,1100,.462,0,13,.000,508,1087,.467,.462,355,411,.864,146,602,748,301,92,73,214,293,1371
16489,SEA,1986,Xavier McDaniel,22,82,80,2706,576,1176,.490,2,10,.200,574,1166,.492,.491,250,364,.687,307,348,655,193,101,37,248,305,1404
16490,SEA,1986,Gerald Henderson,30,82,82,2568,434,900,.482,18,52,.346,416,848,.491,.492,185,223,.830,89,98,187,487,138,11,184,230,1071
16491,SEA,1986,Tom Chambers,26,66,26,2019,432,928,.466,13,48,.271,419,880,.476,.473,346,414,.836,126,305,431,132,55,37,194,248,1223
16492,SEA,1986,Danny Young,23,82,29,1901,227,449,.506,24,74,.324,203,375,.541,.532,90,106,.849,29,91,120,303,110,9,92,113,568
16493,SEA,1986,Al Wood,27,78,34,1749,355,817,.435,5,37,.135,350,780,.449,.438,187,239,.782,80,164,244,114,57,19,107,171,902
16494,SEA,1986,Tim McCormick,23,77,42,1705,253,444,.570,1,2,.500,252,442,.570,.571,174,244,.713,140,263,403,83,19,28,110,219,681
16495,SEA,1986,Danny Vranes,27,80,19,1569,131,284,.461,0,4,.000,131,280,.468,.461,39,75,.520,115,166,281,68,63,31,58,218,301
16496,SEA,1986,Ricky Sobers,33,78,0,1279,240,541,.444,13,43,.302,227,498,.456,.456,110,125,.880,29,70,99,180,44,2,85,139,603
16497,SEA,1986,Michael Phelps,24,70,18,880,117,286,.409,1,12,.083,116,274,.423,.411,44,74,.595,29,60,89,71,45,1,62,86,279
16498,SEA,1986,Frank Brickowski,26,40,2,311,30,58,.517,0,0,,30,58,.517,.517,18,27,.667,16,38,54,21,11,7,23,74,78
16499,SEA,1986,George Johnson,37,41,0,264,12,23,.522,0,0,,12,23,.522,.522,11,16,.688,26,34,60,13,6,37,14,46,35
16500,SEA,1986,Rod Higgins,26,12,0,94,9,27,.333,1,4,.250,8,23,.348,.352,3,5,.600,3,9,12,6,2,1,4,11,22
16501,SEA,1986,David Pope,23,11,0,74,9,20,.450,1,1,1.000,8,19,.421,.475,2,4,.500,6,5,11,4,2,1,2,11,21
16502,SEA,1986,Alex Stivrins,23,3,0,14,1,4,.250,0,0,,1,4,.250,.250,1,4,.250,3,0,3,1,0,0,3,2,3
16503,SEA,1986,Brian Martin,23,3,0,7,1,2,.500,0,0,,1,2,.500,.500,0,0,,1,3,4,0,0,1,2,2,2
16504,SEA,1985,Tom Chambers,25,81,60,2923,629,1302,.483,6,22,.273,623,1280,.487,.485,475,571,.832,164,415,579,209,70,57,260,312,1739
16505,SEA,1985,Gerald Henderson,29,79,78,2648,427,891,.479,9,38,.237,418,853,.490,.484,199,255,.780,71,119,190,559,140,9,231,196,1062
16506,SEA,1985,Al Wood,26,80,79,2545,515,1061,.485,7,33,.212,508,1028,.494,.489,166,214,.776,99,180,279,236,84,52,120,187,1203
16507,SEA,1985,Jack Sikma,29,68,68,2402,461,943,.489,2,10,.200,459,933,.492,.490,335,393,.852,164,559,723,285,83,91,160,239,1259
16508,SEA,1985,Danny Vranes,26,76,70,2163,186,402,.463,1,4,.250,185,398,.465,.464,67,127,.528,154,282,436,152,76,57,119,256,440
16509,SEA,1985,Tim McCormick,22,78,27,1584,269,483,.557,0,1,.000,269,482,.558,.557,188,263,.715,146,252,398,78,18,33,114,207,726
16510,SEA,1985,Ricky Sobers,32,71,12,1490,280,628,.446,8,28,.286,272,600,.453,.452,132,162,.815,27,76,103,252,49,9,158,156,700
16511,SEA,1985,Jon Sundvold,23,73,1,1150,170,400,.425,12,38,.316,158,362,.436,.440,48,59,.814,17,53,70,206,36,1,85,87,400
16512,SEA,1985,Frank Brickowski,25,78,9,1115,150,305,.492,0,4,.000,150,301,.498,.492,85,127,.669,76,184,260,100,34,15,100,171,385
16513,SEA,1985,Reggie King,27,60,5,860,63,149,.423,0,0,,63,149,.423,.423,41,59,.695,44,78,122,53,28,11,42,74,167
16514,SEA,1985,Cory Blackwell,21,60,0,551,87,237,.367,0,2,.000,87,235,.370,.367,28,55,.509,42,54,96,26,25,3,44,55,202
16515,SEA,1985,John Schweitz,24,19,0,110,25,74,.338,0,4,.000,25,70,.357,.338,7,10,.700,6,15,21,18,0,1,14,12,57
16516,SEA,1985,Scooter McCray,24,6,0,93,6,10,.600,0,0,,6,10,.600,.600,3,4,.750,6,11,17,7,1,3,10,13,15
16517,SEA,1985,Joe Cooper,27,3,1,45,7,15,.467,0,0,,7,15,.467,.467,3,6,.500,3,6,9,2,2,1,0,7,17
16518,SEA,1985,Danny Young,22,3,0,26,2,10,.200,0,1,.000,2,9,.222,.200,0,0,,0,3,3,2,3,0,2,2,4
16519,SEA,1984,Jack Sikma,28,82,82,2993,576,1155,.499,0,2,.000,576,1153,.500,.499,411,480,.856,225,686,911,327,95,92,236,301,1563
16520,SEA,1984,Gus Williams,30,80,80,2818,598,1306,.458,4,25,.160,594,1281,.464,.459,297,396,.750,67,137,204,675,189,25,232,151,1497
16521,SEA,1984,Tom Chambers,24,82,44,2570,554,1110,.499,0,12,.000,554,1098,.505,.499,375,469,.800,219,313,532,133,47,51,192,309,1483
16522,SEA,1984,Al Wood,25,81,81,2236,467,945,.494,3,21,.143,464,924,.502,.496,223,271,.823,94,181,275,166,64,32,126,207,1160
16523,SEA,1984,Danny Vranes,25,80,72,2174,258,495,.521,0,1,.000,258,494,.522,.521,153,236,.648,150,245,395,132,51,54,121,263,669
16524,SEA,1984,Reggie King,26,77,42,2086,233,448,.520,0,2,.000,233,446,.522,.520,136,206,.660,134,336,470,179,54,24,127,159,602
16525,SEA,1984,Jon Sundvold,22,73,2,1284,217,488,.445,9,37,.243,208,451,.461,.454,64,72,.889,23,68,91,239,29,1,81,81,507
16526,SEA,1984,Steve Hawes,33,79,0,1153,114,237,.481,1,4,.250,113,233,.485,.483,61,78,.782,50,170,220,99,24,16,52,144,290
16527,SEA,1984,Fred Brown,35,71,1,1129,258,506,.510,9,34,.265,249,472,.528,.519,77,86,.895,14,48,62,194,49,2,70,84,602
16528,SEA,1984,Scooter McCray,23,47,6,520,47,121,.388,0,0,,47,121,.388,.388,35,50,.700,45,70,115,44,11,19,34,73,129
16529,SEA,1984,David Thompson,29,19,0,349,89,165,.539,0,1,.000,89,164,.543,.539,62,73,.849,18,26,44,13,10,13,27,30,240
16530,SEA,1984,Steve Hayes,28,43,0,253,26,50,.520,0,0,,26,50,.520,.520,5,14,.357,19,43,62,13,5,18,13,52,57
16531,SEA,1984,Clay Johnson,27,25,0,176,20,50,.400,1,1,1.000,19,49,.388,.410,14,22,.636,6,6,12,14,8,2,12,24,55
16532,SEA,1984,Charles Bradley,24,8,0,39,3,7,.429,0,0,,3,7,.429,.429,5,7,.714,0,3,3,5,0,1,8,6,11
16533,SEA,1983,Gus Williams,29,80,80,2761,660,1384,.477,2,43,.047,658,1341,.491,.478,278,370,.751,72,133,205,643,182,26,230,117,1600
16534,SEA,1983,Lonnie Shelton,27,82,79,2572,437,915,.478,1,6,.167,436,909,.480,.478,141,187,.754,158,337,495,237,75,72,172,310,1016
16535,SEA,1983,Jack Sikma,27,75,71,2564,484,1043,.464,0,8,.000,484,1035,.468,.464,400,478,.837,213,645,858,233,87,65,190,263,1368
16536,SEA,1983,David Thompson,28,75,64,2155,445,925,.481,2,10,.200,443,915,.484,.482,298,380,.784,96,174,270,222,47,33,163,142,1190
16537,SEA,1983,Danny Vranes,24,82,73,2054,226,429,.527,0,1,.000,226,428,.528,.527,115,209,.550,177,248,425,120,53,49,102,254,567
16538,SEA,1983,James Donaldson,25,82,11,1789,289,496,.583,0,0,,289,496,.583,.583,150,218,.688,131,370,501,97,19,101,132,171,728
16539,SEA,1983,Greg Kelser,25,80,9,1507,247,450,.549,0,3,.000,247,447,.553,.549,173,257,.673,158,245,403,97,52,35,149,243,667
16540,SEA,1983,Fred Brown,34,80,1,1432,371,714,.520,14,32,.438,357,682,.523,.529,58,72,.806,32,65,97,242,59,13,110,98,814
16541,SEA,1983,Phil Smith,30,79,17,1238,175,400,.438,3,8,.375,172,392,.439,.441,101,133,.759,27,103,130,216,44,8,102,113,454
16542,SEA,1983,Ray Tolbert,24,45,2,712,100,190,.526,0,2,.000,100,188,.532,.526,24,44,.545,46,105,151,31,16,24,51,97,224
16543,SEA,1983,Steve Hawes,32,31,1,556,72,146,.493,3,7,.429,69,139,.496,.503,23,32,.719,28,105,133,36,9,6,34,79,170
16544,SEA,1983,Mark Radford,23,54,2,439,84,172,.488,4,18,.222,80,154,.519,.500,30,73,.411,12,35,47,104,34,4,74,78,202
16545,SEA,1983,John Greig,21,9,0,26,7,13,.538,0,0,,7,13,.538,.538,5,6,.833,2,4,6,0,0,1,2,4,19
16546,SEA,1982,Jack Sikma,26,82,82,3049,581,1212,.479,2,13,.154,579,1199,.483,.480,447,523,.855,223,815,1038,277,102,107,213,268,1611
16547,SEA,1982,Gus Williams,28,80,80,2876,773,1592,.486,9,40,.225,764,1552,.492,.488,320,436,.734,92,152,244,549,172,36,197,163,1875
16548,SEA,1982,Lonnie Shelton,26,81,81,2667,508,1046,.486,0,8,.000,508,1038,.489,.486,188,240,.783,161,348,509,252,99,43,199,317,1204
16549,SEA,1982,Bill Hanzlik,24,81,76,1974,167,357,.468,0,4,.000,167,353,.473,.468,138,176,.784,99,167,266,183,81,30,106,250,472
16550,SEA,1982,Wally Walker,27,70,70,1965,302,629,.480,0,2,.000,302,627,.482,.480,90,134,.672,108,197,305,218,36,28,111,215,694
16551,SEA,1982,Fred Brown,33,82,2,1785,393,863,.455,25,77,.325,368,786,.468,.470,111,129,.860,42,98,140,238,69,4,96,111,922
16552,SEA,1982,James Donaldson,24,82,1,1710,255,419,.609,0,0,,255,419,.609,.609,151,240,.629,138,352,490,51,27,139,115,186,661
16553,SEA,1982,Danny Vranes,23,77,1,1075,143,262,.546,0,1,.000,143,261,.548,.546,89,148,.601,71,127,198,56,28,21,68,150,375
16554,SEA,1982,Phil Smith,29,26,2,596,87,186,.468,0,3,.000,87,183,.475,.468,40,55,.727,17,52,69,74,22,8,39,62,214
16555,SEA,1982,Greg Kelser,24,49,10,558,81,185,.438,0,0,,81,185,.438,.438,78,119,.655,67,87,154,45,13,14,62,99,240
16556,SEA,1982,Ray Tolbert,23,52,0,492,80,158,.506,0,1,.000,80,157,.510,.506,15,27,.556,39,60,99,25,8,14,33,64,175
16557,SEA,1982,Mark Radford,22,43,0,369,54,100,.540,2,3,.667,52,97,.536,.550,35,69,.507,13,16,29,57,16,2,42,65,145
16558,SEA,1982,Armond Hill,28,21,4,243,19,37,.514,0,0,,19,37,.514,.514,17,23,.739,6,19,25,25,5,2,14,37,55
16559,SEA,1982,John Johnson,34,14,1,187,22,45,.489,0,0,,22,45,.489,.489,15,20,.750,3,15,18,29,4,3,17,20,59
16560,SEA,1982,James Bailey,24,10,0,180,31,65,.477,0,0,,31,65,.477,.477,4,11,.364,17,31,48,13,3,7,19,42,66
16561,SEA,1982,Vinnie Johnson,25,7,0,104,9,22,.409,0,1,.000,9,21,.429,.409,9,12,.750,7,8,15,11,6,2,5,8,27
16562,SEA,1981,Jack Sikma,25,82,82,2920,595,1311,.454,0,5,.000,595,1306,.456,.454,340,413,.823,184,668,852,248,78,93,201,282,1530
16563,SEA,1981,James Bailey,23,82,,2539,444,889,.499,1,2,.500,443,887,.499,.500,256,361,.709,192,415,607,98,74,143,219,332,1145
16564,SEA,1981,John Johnson,33,80,,2324,373,866,.431,0,1,.000,373,865,.431,.431,173,214,.808,135,227,362,312,57,25,230,202,919
16565,SEA,1981,Vinnie Johnson,24,81,,2311,419,785,.534,1,5,.200,418,780,.536,.534,214,270,.793,193,173,366,341,78,20,216,198,1053
16566,SEA,1981,Fred Brown,32,78,,1986,505,1035,.488,23,64,.359,482,971,.496,.499,173,208,.832,53,122,175,233,88,13,131,141,1206
16567,SEA,1981,Wally Walker,26,82,,1796,290,626,.463,0,3,.000,290,623,.465,.463,109,169,.645,105,210,315,122,53,15,115,168,689
16568,SEA,1981,Bill Hanzlik,23,74,,1259,138,289,.478,1,5,.200,137,284,.482,.479,119,150,.793,67,86,153,111,58,20,84,168,396
16569,SEA,1981,Armond Hill,27,51,,1114,78,219,.356,0,6,.000,78,213,.366,.356,99,122,.811,31,77,108,174,40,8,69,147,255
16570,SEA,1981,Paul Westphal,30,36,,1078,221,500,.442,6,25,.240,215,475,.453,.448,153,184,.832,11,57,68,148,46,14,78,70,601
16571,SEA,1981,James Donaldson,23,68,,980,129,238,.542,0,0,,129,238,.542,.542,101,170,.594,107,202,309,42,8,74,68,79,359
16572,SEA,1981,Dennis Awtrey,32,47,,607,44,93,.473,0,0,,44,93,.473,.473,14,20,.700,33,75,108,54,12,8,33,85,102
16573,SEA,1981,Lonnie Shelton,25,14,,440,73,174,.420,0,0,,73,174,.420,.420,36,55,.655,31,47,78,35,22,3,41,48,182
16574,SEA,1981,Jacky Dorsey,26,29,,253,20,70,.286,0,0,,20,70,.286,.286,13,25,.520,23,65,88,9,9,1,14,47,53
16575,SEA,1981,Rudy White,27,12,,165,14,47,.298,0,1,.000,14,46,.304,.298,11,12,.917,1,10,11,18,5,1,9,16,39
16576,SEA,1981,John Shumate,28,2,,8,0,3,.000,0,0,,0,3,.000,.000,2,3,.667,1,0,1,0,0,0,1,3,2
16577,SEA,1980,Gus Williams,26,82,82,2969,739,1533,.482,7,36,.194,732,1497,.489,.484,331,420,.788,127,148,275,397,200,37,181,160,1816
16578,SEA,1980,Dennis Johnson,25,81,,2937,574,1361,.422,12,58,.207,562,1303,.431,.426,380,487,.780,173,241,414,332,144,82,227,267,1540
16579,SEA,1980,Jack Sikma,24,82,82,2793,470,989,.475,0,1,.000,470,988,.476,.475,235,292,.805,198,710,908,279,68,77,202,232,1175
16580,SEA,1980,John Johnson,32,81,,2533,377,772,.488,0,0,,377,772,.488,.488,161,201,.801,163,263,426,424,76,35,247,213,915
16581,SEA,1980,Lonnie Shelton,24,76,,2243,425,802,.530,1,5,.200,424,797,.532,.531,184,241,.763,199,383,582,145,92,79,169,292,1035
16582,SEA,1980,Fred Brown,31,80,,1701,404,843,.479,39,88,.443,365,755,.483,.502,113,135,.837,35,120,155,174,65,17,105,117,960
16583,SEA,1980,Paul Silas,36,82,,1595,113,299,.378,0,0,,113,299,.378,.378,89,136,.654,204,232,436,66,25,5,83,120,315
16584,SEA,1980,Tom LaGarde,24,82,,1164,146,306,.477,0,0,,146,306,.477,.477,90,137,.657,127,185,312,91,19,34,97,206,382
16585,SEA,1980,Wally Walker,25,70,,844,139,274,.507,0,0,,139,274,.507,.507,48,64,.750,64,106,170,53,21,4,50,102,326
16586,SEA,1980,James Bailey,22,67,,726,122,271,.450,0,0,,122,271,.450,.450,68,101,.673,71,126,197,28,21,54,79,116,312
16587,SEA,1980,Vinnie Johnson,23,38,,325,45,115,.391,0,1,.000,45,114,.395,.391,31,39,.795,19,36,55,54,19,4,42,40,121
16588,LAL,2024,Anthony Davis,30,76,76,2700,713,1283,.556,29,107,.271,684,1176,.582,.567,421,516,.816,239,722,961,266,91,178,159,177,1876
16589,LAL,2024,Austin Reaves,25,82,57,2629,457,940,.486,154,420,.367,303,520,.583,.568,232,272,.853,57,295,352,450,66,25,174,153,1300
16590,LAL,2024,LeBron James,39,71,71,2504,685,1269,.540,149,363,.410,536,906,.592,.599,303,404,.750,61,457,518,589,89,38,245,78,1822
16591,LAL,2024,D'Angelo Russell,27,76,69,2484,492,1080,.456,226,545,.415,266,535,.497,.560,159,192,.828,28,208,236,482,69,36,156,156,1369
16592,LAL,2024,Taurean Prince,29,78,49,2108,253,572,.442,141,356,.396,112,216,.519,.566,50,68,.735,21,209,230,119,58,35,73,146,697
16593,LAL,2024,Rui Hachimura,25,68,39,1826,363,676,.537,98,232,.422,265,444,.597,.609,99,134,.739,58,236,294,81,41,25,46,101,923
16594,LAL,2024,Cam Reddish,24,48,26,984,91,234,.389,37,110,.336,54,124,.435,.468,41,54,.759,27,72,99,48,47,14,31,64,260
16595,LAL,2024,Max Christie,20,67,7,944,103,241,.427,42,118,.356,61,123,.496,.515,36,46,.783,15,127,142,60,20,17,35,57,284
16596,LAL,2024,Jaxson Hayes,23,70,5,877,126,175,.720,0,8,.000,126,167,.754,.720,51,82,.622,69,142,211,33,34,29,43,123,303
16597,LAL,2024,Christian Wood,28,50,1,872,123,264,.466,35,114,.307,88,150,.587,.532,66,94,.702,39,215,254,49,16,33,50,72,347
16598,LAL,2024,Spencer Dinwiddie,30,28,4,678,56,141,.397,35,90,.389,21,51,.412,.521,44,50,.880,4,43,47,68,13,13,29,52,191
16599,LAL,2024,Jarred Vanderbilt,24,29,6,581,59,114,.518,8,27,.296,51,87,.586,.553,24,36,.667,41,97,138,36,36,5,28,43,150
16600,LAL,2024,Gabe Vincent,27,11,0,218,15,49,.306,3,28,.107,12,21,.571,.337,1,2,.500,4,5,9,21,9,0,5,19,34
16601,LAL,2024,Jalen Hood-Schifino,20,21,0,109,10,45,.222,2,15,.133,8,30,.267,.244,12,20,.600,2,11,13,8,3,2,9,13,34
16602,LAL,2024,Maxwell Lewis,21,34,0,103,4,21,.190,1,9,.111,3,12,.250,.214,2,3,.667,2,2,4,6,2,1,10,5,11
16603,LAL,2024,Skylar Mays,26,17,0,77,10,21,.476,2,5,.400,8,16,.500,.524,0,0,,1,5,6,10,7,1,2,6,22
16604,LAL,2024,Colin Castleton,23,16,0,59,9,16,.563,0,0,,9,16,.563,.563,6,6,1.000,6,6,12,3,2,0,3,11,24
16605,LAL,2024,D'Moi Hodge,25,7,0,41,5,15,.333,3,12,.250,2,3,.667,.433,1,2,.500,0,0,0,5,1,1,1,4,14
16606,LAL,2024,Dylan Windler,27,8,0,28,4,9,.444,4,8,.500,0,1,.000,.667,0,0,,0,3,3,6,0,0,0,2,12
16607,LAL,2024,Harry Giles,25,7,0,19,1,6,.167,0,3,.000,1,3,.333,.167,0,0,,0,4,4,0,1,0,0,0,2
16608,LAL,2024,Alex Fudge,20,4,0,14,1,6,.167,0,2,.000,1,4,.250,.167,2,2,1.000,2,0,2,0,0,0,1,1,4
16609,LAL,2023,Dennis Schröder,29,66,50,1986,270,650,.415,74,225,.329,196,425,.461,.472,216,252,.857,21,144,165,298,50,10,112,145,830
16610,LAL,2023,LeBron James,38,55,54,1954,609,1219,.500,121,377,.321,488,842,.580,.549,251,327,.768,65,392,457,375,50,32,178,88,1590
16611,LAL,2023,Anthony Davis,29,56,54,1904,542,962,.563,19,74,.257,523,888,.589,.573,348,444,.784,195,507,702,148,59,114,122,146,1451
16612,LAL,2023,Troy Brown Jr.,23,76,45,1860,200,465,.430,107,281,.381,93,184,.505,.545,34,39,.872,62,246,308,95,59,16,49,120,541
16613,LAL,2023,Austin Reaves,24,64,22,1843,259,490,.529,86,216,.398,173,274,.631,.616,229,265,.864,33,160,193,215,33,19,99,108,833
16614,LAL,2023,Russell Westbrook,34,52,3,1491,304,729,.417,63,213,.296,241,516,.467,.460,156,238,.655,59,262,321,391,53,23,184,121,827
16615,LAL,2023,Lonnie Walker IV,24,56,32,1297,236,527,.448,91,249,.365,145,278,.522,.534,91,106,.858,14,95,109,64,30,17,46,71,654
16616,LAL,2023,Patrick Beverley,34,45,45,1211,97,241,.402,55,158,.348,42,83,.506,.517,39,50,.780,24,116,140,118,40,25,42,124,288
16617,LAL,2023,Wenyen Gabriel,25,68,2,1024,155,260,.596,10,36,.278,145,224,.647,.615,52,84,.619,116,170,286,36,26,35,46,144,372
16618,LAL,2023,Thomas Bryant,25,41,25,876,197,301,.654,22,50,.440,175,251,.697,.691,80,108,.741,67,212,279,29,14,23,28,77,496
16619,LAL,2023,Rui Hachimura,24,33,9,738,126,260,.485,21,71,.296,105,189,.556,.525,44,61,.721,34,121,155,23,8,14,17,33,317
16620,LAL,2023,Jarred Vanderbilt,23,26,24,625,74,140,.529,10,33,.303,64,107,.598,.564,29,37,.784,49,124,173,42,30,6,29,57,187
16621,LAL,2023,Malik Beasley,26,26,14,621,105,268,.392,66,187,.353,39,81,.481,.515,13,21,.619,8,78,86,31,21,1,30,32,289
16622,LAL,2023,Kendrick Nunn,27,39,2,528,102,251,.406,41,126,.325,61,125,.488,.488,17,21,.810,5,50,55,34,11,3,31,35,262
16623,LAL,2023,D'Angelo Russell,26,17,17,526,107,221,.484,46,111,.414,61,110,.555,.588,36,49,.735,7,43,50,103,10,8,39,23,296
16624,LAL,2023,Max Christie,19,41,3,512,44,106,.415,26,62,.419,18,44,.409,.538,14,16,.875,7,68,75,21,9,7,13,33,128
16625,LAL,2023,Juan Toscano-Anderson,29,30,7,365,33,66,.500,4,20,.200,29,46,.630,.530,11,15,.733,14,47,61,25,10,7,17,46,81
16626,LAL,2023,Damian Jones,27,22,1,176,20,37,.541,0,3,.000,20,34,.588,.541,15,20,.750,18,37,55,4,3,12,9,17,55
16627,LAL,2023,Matt Ryan,25,12,0,129,15,49,.306,13,35,.371,2,14,.143,.439,4,5,.800,2,12,14,4,2,0,3,14,47
16628,LAL,2023,Mo Bamba,24,9,1,88,11,27,.407,5,16,.313,6,11,.545,.500,6,11,.545,11,30,41,4,1,5,8,19,33
16629,LAL,2023,Cole Swider,23,7,0,41,3,9,.333,3,8,.375,0,1,.000,.500,0,0,,1,6,7,4,0,0,0,3,9
16630,LAL,2023,Scotty Pippen Jr.,22,6,0,32,4,12,.333,1,3,.333,3,9,.333,.375,5,9,.556,2,2,4,2,2,1,2,3,14
16631,LAL,2023,Davon Reed,27,8,0,27,3,4,.750,1,2,.500,2,2,1.000,.875,1,4,.250,1,3,4,4,2,0,0,3,8
16632,LAL,2023,Sterling Brown,27,4,0,24,0,4,.000,0,2,.000,0,2,.000,.000,0,0,,3,5,8,2,3,0,0,4,0
16633,LAL,2022,Russell Westbrook,33,78,78,2678,548,1233,.444,79,265,.298,469,968,.485,.476,266,399,.667,110,470,580,550,75,20,295,235,1441
16634,LAL,2022,Malik Monk,23,76,37,2139,391,826,.473,173,442,.391,218,384,.568,.578,93,117,.795,37,219,256,218,61,29,122,138,1048
16635,LAL,2022,LeBron James,37,56,56,2084,640,1221,.524,161,448,.359,479,773,.620,.590,254,336,.756,63,396,459,349,73,59,196,121,1695
16636,LAL,2022,Carmelo Anthony,37,69,3,1793,319,723,.441,149,397,.375,170,326,.521,.544,132,159,.830,62,226,288,68,47,52,59,166,919
16637,LAL,2022,Talen Horton-Tucker,21,60,19,1511,224,538,.416,49,182,.269,175,356,.492,.462,100,125,.800,37,156,193,159,59,29,82,148,597
16638,LAL,2022,Austin Reaves,23,61,19,1418,146,318,.459,53,167,.317,93,151,.616,.542,99,118,.839,45,148,193,110,29,20,40,87,444
16639,LAL,2022,Avery Bradley,31,62,45,1406,148,350,.423,82,210,.390,66,140,.471,.540,16,18,.889,31,105,136,47,53,9,38,118,394
16640,LAL,2022,Anthony Davis,28,40,40,1404,370,695,.532,13,70,.186,357,625,.571,.542,174,244,.713,106,288,394,122,49,90,82,97,927
16641,LAL,2022,Stanley Johnson,25,48,27,1094,117,251,.466,33,105,.314,84,146,.575,.532,53,74,.716,34,121,155,80,43,14,35,109,320
16642,LAL,2022,Dwight Howard,36,60,27,971,134,219,.612,8,15,.533,126,204,.618,.630,96,146,.658,118,238,356,35,34,36,47,115,372
16643,LAL,2022,Wayne Ellington,34,43,9,810,98,237,.414,82,211,.389,16,26,.615,.586,9,11,.818,10,67,77,30,23,5,19,42,287
16644,LAL,2022,Kent Bazemore,32,39,14,545,45,139,.324,29,80,.363,16,59,.271,.428,13,17,.765,13,56,69,34,25,9,21,70,132
16645,LAL,2022,Trevor Ariza,36,24,11,462,33,99,.333,20,74,.270,13,25,.520,.434,10,18,.556,10,72,82,27,13,6,11,20,96
16646,LAL,2022,DeAndre Jordan,33,32,19,408,60,89,.674,0,0,,60,89,.674,.674,12,26,.462,51,121,172,13,10,26,21,50,132
16647,LAL,2022,D.J. Augustin,34,21,0,373,39,86,.453,29,68,.426,10,18,.556,.622,5,5,1.000,4,23,27,33,7,1,11,22,112
16648,LAL,2022,Wenyen Gabriel,24,19,5,311,49,97,.505,6,23,.261,43,74,.581,.536,23,38,.605,34,48,82,12,4,9,13,57,127
16649,LAL,2022,Rajon Rondo,35,18,0,289,23,71,.324,8,30,.267,15,41,.366,.380,1,2,.500,10,39,49,67,12,5,34,25,55
16650,LAL,2022,Isaiah Thomas,32,4,1,101,12,39,.308,5,22,.227,7,17,.412,.372,8,11,.727,1,7,8,6,0,2,5,12,37
16651,LAL,2022,Mason Jones,23,4,0,51,7,15,.467,1,4,.250,6,11,.545,.500,12,15,.800,1,9,10,4,2,0,1,8,27
16652,LAL,2022,Darren Collison,34,3,0,37,2,7,.286,0,3,.000,2,4,.500,.286,0,0,,0,4,4,2,1,0,1,5,4
16653,LAL,2022,Mac McClung,23,1,0,22,2,5,.400,1,3,.333,1,2,.500,.500,1,1,1.000,0,3,3,1,1,1,2,5,6
16654,LAL,2022,Chaundee Brown Jr.,23,2,0,21,1,7,.143,0,3,.000,1,4,.250,.143,0,0,,0,2,2,0,0,0,1,0,2
16655,LAL,2022,Jay Huff,23,4,0,20,0,3,.000,0,2,.000,0,1,.000,.000,0,0,,1,3,4,1,1,1,1,1,0
16656,LAL,2022,Sekou Doumbouya,21,2,0,16,5,8,.625,1,2,.500,4,6,.667,.688,3,4,.750,2,4,6,0,3,2,2,1,14
16657,LAL,2022,Jemerrio Jones,26,2,0,15,2,3,.667,0,0,,2,3,.667,.667,0,0,,2,1,3,0,1,0,0,2,4
16658,LAL,2021,Dennis Schröder,27,61,61,1956,332,760,.437,71,212,.335,261,548,.476,.484,206,243,.848,30,181,211,351,70,13,163,159,941
16659,LAL,2021,Kyle Kuzma,25,68,32,1954,335,757,.443,137,380,.361,198,377,.525,.533,67,97,.691,108,309,417,127,35,41,113,121,874
16660,LAL,2021,Kentavious Caldwell-Pope,27,67,67,1902,218,506,.431,120,293,.410,98,213,.460,.549,97,112,.866,27,152,179,127,62,26,66,114,653
16661,LAL,2021,Montrezl Harrell,27,69,1,1580,375,603,.622,0,10,.000,375,593,.632,.622,181,256,.707,158,270,428,73,46,49,74,128,931
16662,LAL,2021,LeBron James,36,45,45,1504,422,823,.513,104,285,.365,318,538,.591,.576,178,255,.698,29,317,346,350,48,25,168,70,1126
16663,LAL,2021,Talen Horton-Tucker,20,65,4,1304,224,489,.458,37,131,.282,187,358,.522,.496,100,129,.775,25,144,169,181,63,21,105,127,585
16664,LAL,2021,Alex Caruso,26,58,6,1216,133,305,.436,55,137,.401,78,168,.464,.526,49,76,.645,31,139,170,160,64,15,76,108,370
16665,LAL,2021,Markieff Morris,31,61,27,1200,153,378,.405,65,209,.311,88,169,.521,.491,36,50,.720,48,218,266,73,22,19,54,105,407
16666,LAL,2021,Anthony Davis,27,36,36,1162,301,613,.491,26,100,.260,275,513,.536,.512,158,214,.738,62,224,286,110,45,59,74,60,786
16667,LAL,2021,Wesley Matthews,34,58,10,1130,89,252,.353,66,197,.335,23,55,.418,.484,35,41,.854,20,73,93,54,38,17,26,80,279
16668,LAL,2021,Marc Gasol,36,52,42,993,88,194,.454,50,122,.410,38,72,.528,.582,36,50,.720,38,177,215,109,26,58,53,115,262
16669,LAL,2021,Andre Drummond,27,21,21,520,102,192,.531,0,0,,102,192,.531,.531,46,76,.605,65,149,214,30,23,20,43,80,250
16670,LAL,2021,Ben McLemore,27,21,1,368,55,141,.390,42,114,.368,13,27,.481,.539,16,21,.762,4,30,34,11,3,6,14,37,168
16671,LAL,2021,Alfonzo McKinnie,28,39,0,258,48,93,.516,16,39,.410,32,54,.593,.602,10,18,.556,22,32,54,6,7,0,5,26,122
16672,LAL,2021,Damian Jones,25,8,6,112,16,17,.941,0,0,,16,17,.941,.941,11,12,.917,8,18,26,1,1,7,5,22,43
16673,LAL,2021,Devontae Cacok,24,20,1,98,17,29,.586,0,0,,17,29,.586,.586,5,11,.455,12,20,32,1,5,4,5,8,39
16674,LAL,2021,Jared Dudley,35,12,0,81,2,9,.222,2,6,.333,0,3,.000,.333,0,0,,4,17,21,5,1,1,2,7,6
16675,LAL,2021,Quinn Cook,27,16,0,62,12,26,.462,5,13,.385,7,13,.538,.558,4,5,.800,0,5,5,5,1,1,3,2,33
16676,LAL,2021,Kostas Antetokounmpo,23,15,0,56,3,10,.300,0,0,,3,10,.300,.300,6,13,.462,4,15,19,1,2,4,11,8,12
16677,LAL,2020,LeBron James,35,67,67,2316,643,1303,.493,148,425,.348,495,878,.564,.550,264,381,.693,66,459,525,684,78,36,261,118,1698
16678,LAL,2020,Anthony Davis,26,62,62,2131,551,1096,.503,72,218,.330,479,878,.546,.536,444,525,.846,142,435,577,200,91,143,154,156,1618
16679,LAL,2020,Kentavious Caldwell-Pope,26,69,26,1762,237,507,.467,92,239,.385,145,268,.541,.558,79,102,.775,38,104,142,111,57,14,62,128,645
16680,LAL,2020,Danny Green,32,68,68,1687,197,474,.416,120,327,.367,77,147,.524,.542,33,48,.688,51,174,225,91,85,32,63,136,547
16681,LAL,2020,Kyle Kuzma,24,61,9,1526,291,668,.436,86,272,.316,205,396,.518,.500,114,155,.735,52,221,273,80,28,26,91,126,782
16682,LAL,2020,Dwight Howard,34,69,2,1306,202,277,.729,3,5,.600,199,272,.732,.735,110,214,.514,172,335,507,45,31,79,84,222,517
16683,LAL,2020,Avery Bradley,29,49,44,1186,170,383,.444,63,173,.364,107,210,.510,.526,20,24,.833,18,97,115,63,43,5,47,110,423
16684,LAL,2020,Alex Caruso,25,64,2,1175,120,291,.412,40,120,.333,80,171,.468,.481,69,94,.734,17,106,123,124,70,18,53,98,349
16685,LAL,2020,JaVale McGee,32,68,68,1130,195,306,.637,3,6,.500,192,300,.640,.642,53,82,.646,125,265,390,37,36,94,55,159,446
16686,LAL,2020,Rajon Rondo,33,48,3,984,137,328,.418,41,125,.328,96,203,.473,.480,27,41,.659,23,119,142,240,40,2,91,58,342
16687,LAL,2020,Quinn Cook,26,44,1,508,91,214,.425,31,85,.365,60,129,.465,.498,11,14,.786,11,40,51,49,12,2,33,27,224
16688,LAL,2020,Troy Daniels,28,41,0,456,62,158,.392,40,112,.357,22,46,.478,.519,10,16,.625,12,34,46,14,8,3,9,30,174
16689,LAL,2020,Jared Dudley,34,45,1,364,24,60,.400,18,42,.429,6,18,.333,.550,2,2,1.000,6,46,52,28,15,3,8,41,68
16690,LAL,2020,Markieff Morris,30,14,1,199,28,69,.406,13,39,.333,15,30,.500,.500,5,6,.833,16,29,45,8,5,6,6,29,74
16691,LAL,2020,Dion Waiters,28,7,0,165,31,73,.425,7,30,.233,24,43,.558,.473,14,16,.875,2,11,13,17,4,4,13,16,83
16692,LAL,2020,Talen Horton-Tucker,19,6,1,81,14,30,.467,4,13,.308,10,17,.588,.533,2,4,.500,2,5,7,6,8,1,6,10,34
16693,LAL,2020,J.R. Smith,34,6,0,79,7,22,.318,1,11,.091,6,11,.545,.341,2,2,1.000,0,5,5,3,1,0,4,5,17
16694,LAL,2020,Kostas Antetokounmpo,22,5,0,20,3,3,1.000,0,0,,3,3,1.000,1.000,1,2,.500,2,1,3,2,0,0,1,2,7
16695,LAL,2020,Devontae Cacok,23,1,0,9,3,6,.500,0,0,,3,6,.500,.500,0,0,,2,3,5,1,0,0,0,0,6
16696,LAL,2020,Zach Norvell,22,2,0,5,0,1,.000,0,0,,0,1,.000,.000,0,0,,0,1,1,0,0,0,0,0,0
16697,LAL,2019,Kyle Kuzma,23,70,68,2314,496,1087,.456,128,422,.303,368,665,.553,.515,188,250,.752,60,322,382,178,41,26,133,170,1308
16698,LAL,2019,Kentavious Caldwell-Pope,25,82,23,2035,325,756,.430,151,435,.347,174,321,.542,.530,137,158,.867,48,190,238,110,73,13,65,137,938
16699,LAL,2019,LeBron James,34,55,55,1937,558,1095,.510,111,327,.339,447,768,.582,.560,278,418,.665,57,408,465,454,72,33,197,94,1505
16700,LAL,2019,Brandon Ingram,21,52,52,1760,362,729,.497,31,94,.330,331,635,.521,.518,195,289,.675,41,226,267,154,28,31,129,149,950
16701,LAL,2019,Josh Hart,23,67,22,1715,189,464,.407,92,274,.336,97,190,.511,.506,55,80,.688,35,213,248,93,64,40,58,147,525
16702,LAL,2019,JaVale McGee,31,75,62,1671,400,641,.624,1,12,.083,399,629,.634,.625,96,152,.632,195,371,566,52,47,148,108,208,897
16703,LAL,2019,Lonzo Ball,21,47,45,1423,185,456,.406,75,228,.329,110,228,.482,.488,20,48,.417,54,197,251,255,69,19,103,114,465
16704,LAL,2019,Rajon Rondo,32,46,29,1369,175,432,.405,51,142,.359,124,290,.428,.464,23,36,.639,34,209,243,367,57,7,127,100,424
16705,LAL,2019,Lance Stephenson,28,68,3,1123,184,432,.426,73,197,.371,111,235,.472,.510,50,73,.685,32,183,215,140,41,7,86,111,491
16706,LAL,2019,Tyson Chandler,36,48,6,786,53,87,.609,0,1,.000,53,86,.616,.609,41,69,.594,85,183,268,31,19,22,35,89,147
16707,LAL,2019,Alex Caruso,24,25,4,531,77,173,.445,24,50,.480,53,123,.431,.514,51,64,.797,20,47,67,77,24,9,42,54,229
16708,LAL,2019,Reggie Bullock,27,19,16,524,63,153,.412,34,99,.343,29,54,.537,.523,17,21,.810,2,48,50,20,16,7,11,30,177
16709,LAL,2019,Ivica Zubac,21,33,12,516,112,193,.580,0,0,,112,193,.580,.580,57,66,.864,54,108,162,25,4,27,33,73,281
16710,LAL,2019,Moritz Wagner,21,43,5,446,71,171,.415,22,77,.286,49,94,.521,.480,43,53,.811,17,68,85,24,11,13,39,57,207
16711,LAL,2019,Svi Mykhailiuk,21,39,0,420,44,132,.333,27,85,.318,17,47,.362,.436,12,20,.600,8,26,34,33,13,1,20,25,127
16712,LAL,2019,Johnathan Williams,23,24,0,372,65,110,.591,0,2,.000,65,108,.602,.591,27,48,.563,48,51,99,13,8,7,16,62,157
16713,LAL,2019,Michael Beasley,30,26,2,277,75,153,.490,3,17,.176,72,136,.529,.500,28,39,.718,13,47,60,25,9,10,27,42,181
16714,LAL,2019,Mike Muscala,27,17,4,265,36,83,.434,21,57,.368,15,26,.577,.560,7,8,.875,6,38,44,14,4,11,5,18,100
16715,LAL,2019,Jemerrio Jones,23,6,2,143,12,33,.364,2,10,.200,10,23,.435,.394,1,2,.500,16,33,49,13,7,5,5,10,27
16716,LAL,2019,Isaac Bonga,19,22,0,120,5,33,.152,0,8,.000,5,25,.200,.152,9,15,.600,9,16,25,15,9,4,6,9,19
16717,LAL,2019,Scott Machado,28,4,0,19,4,6,.667,1,1,1.000,3,5,.600,.750,1,1,1.000,0,0,0,3,1,0,0,2,10
16718,LAL,2019,Andre Ingram,33,4,0,15,0,6,.000,0,3,.000,0,3,.000,.000,0,0,,1,1,2,0,1,0,1,0,0
16719,LAL,2018,Kentavious Caldwell-Pope,24,74,74,2458,340,798,.426,159,415,.383,181,383,.473,.526,153,194,.789,60,327,387,162,106,16,97,145,992
16720,LAL,2018,Kyle Kuzma,22,77,37,2401,468,1039,.450,159,434,.366,309,605,.511,.527,147,208,.707,88,395,483,141,49,34,140,160,1242
16721,LAL,2018,Julius Randle,23,82,49,2190,504,904,.558,10,45,.222,494,859,.575,.563,305,425,.718,181,473,654,210,43,45,213,274,1323
16722,LAL,2018,Brandon Ingram,20,59,59,1975,358,761,.470,41,105,.390,317,656,.483,.497,192,282,.681,57,257,314,230,45,43,149,163,949
16723,LAL,2018,Lonzo Ball,20,52,50,1780,203,564,.360,90,295,.305,113,269,.420,.440,32,71,.451,69,291,360,376,88,43,136,117,528
16724,LAL,2018,Brook Lopez,29,74,72,1735,369,793,.465,112,325,.345,257,468,.549,.536,111,158,.703,74,220,294,126,30,98,98,195,961
16725,LAL,2018,Josh Hart,22,63,23,1461,176,375,.469,78,197,.396,98,178,.551,.573,66,94,.702,42,221,263,80,47,16,47,107,496
16726,LAL,2018,Jordan Clarkson,25,53,2,1256,299,667,.448,68,210,.324,231,457,.505,.499,105,132,.795,44,115,159,173,39,3,95,63,771
16727,LAL,2018,Larry Nance Jr.,25,42,17,922,152,253,.601,1,4,.250,151,249,.606,.603,55,87,.632,108,176,284,57,59,20,41,113,360
16728,LAL,2018,Corey Brewer,31,54,2,694,78,172,.453,8,43,.186,70,129,.543,.477,34,51,.667,23,70,93,41,41,8,38,83,198
16729,LAL,2018,Tyler Ennis,23,54,11,683,94,224,.420,14,56,.250,80,168,.476,.451,22,29,.759,19,76,95,105,30,10,38,75,224
16730,LAL,2018,Alex Caruso,23,37,7,562,50,116,.431,13,43,.302,37,73,.507,.487,21,30,.700,15,50,65,75,23,10,42,52,134
16731,LAL,2018,Isaiah Thomas,28,17,1,456,87,227,.383,33,101,.327,54,126,.429,.456,58,63,.921,10,26,36,85,6,1,54,33,265
16732,LAL,2018,Ivica Zubac,20,43,0,410,61,122,.500,0,1,.000,61,121,.504,.500,39,51,.765,45,78,123,25,8,15,26,47,161
16733,LAL,2018,Travis Wear,27,17,0,228,25,72,.347,17,47,.362,8,25,.320,.465,8,8,1.000,0,38,38,7,4,5,6,30,75
16734,LAL,2018,Andrew Bogut,33,24,5,216,17,25,.680,0,0,,17,25,.680,.680,2,2,1.000,26,52,78,15,4,13,19,40,36
16735,LAL,2018,Channing Frye,34,9,0,150,20,43,.465,9,25,.360,11,18,.611,.570,3,4,.750,2,23,25,10,1,1,4,15,52
16736,LAL,2018,Gary Payton II,25,11,0,115,17,41,.415,4,13,.308,13,28,.464,.463,1,6,.167,9,18,27,12,4,2,4,13,39
16737,LAL,2018,Thomas Bryant,20,15,0,72,8,21,.381,1,10,.100,7,11,.636,.405,5,9,.556,3,14,17,6,1,2,2,6,22
16738,LAL,2018,Andre Ingram,32,2,0,64,8,17,.471,5,9,.556,3,8,.375,.618,3,3,1.000,1,5,6,7,3,3,3,3,24
16739,LAL,2018,Vander Blue,25,5,0,45,1,5,.200,0,2,.000,1,3,.333,.200,1,2,.500,0,1,1,3,1,0,3,2,3
16740,LAL,2018,Luol Deng,32,1,1,13,1,2,.500,0,0,,1,2,.500,.500,0,0,,0,0,0,1,1,0,1,0,2
16741,LAL,2018,Nigel Hayes,23,2,0,11,1,3,.333,0,2,.000,1,1,1.000,.333,1,1,1.000,0,0,0,2,0,0,0,0,3
16742,LAL,2018,Derrick Williams,26,2,0,9,1,4,.250,0,2,.000,1,2,.500,.250,0,0,,0,1,1,0,0,0,0,0,2
16743,LAL,2017,Jordan Clarkson,24,82,19,2397,477,1071,.445,117,356,.329,360,715,.503,.500,134,168,.798,49,197,246,213,88,8,164,150,1205
16744,LAL,2017,Brandon Ingram,19,79,40,2279,276,686,.402,55,187,.294,221,499,.443,.442,133,214,.621,60,256,316,166,50,36,116,158,740
16745,LAL,2017,Julius Randle,22,74,73,2132,377,773,.488,17,63,.270,360,710,.507,.499,204,282,.723,150,486,636,264,49,37,173,248,975
16746,LAL,2017,D'Angelo Russell,20,63,60,1811,351,867,.405,135,384,.352,216,483,.447,.483,147,188,.782,31,190,221,303,87,16,176,130,984
16747,LAL,2017,Nick Young,31,60,60,1556,272,633,.430,170,421,.404,102,212,.481,.564,77,90,.856,25,113,138,58,37,14,36,137,791
16748,LAL,2017,Luol Deng,31,56,49,1486,164,424,.387,51,165,.309,113,259,.436,.447,46,63,.730,63,232,295,74,48,20,43,61,425
16749,LAL,2017,Larry Nance Jr.,24,63,7,1442,190,361,.526,10,36,.278,180,325,.554,.540,59,80,.738,120,249,369,96,82,39,56,149,449
16750,LAL,2017,Lou Williams,30,58,1,1403,326,734,.444,122,317,.385,204,417,.489,.527,304,344,.884,14,118,132,183,65,11,120,67,1078
16751,LAL,2017,Timofey Mozgov,30,54,52,1104,169,328,.515,0,1,.000,169,327,.517,.515,63,78,.808,104,160,264,43,16,31,72,133,401
16752,LAL,2017,Tarik Black,25,67,16,1091,150,294,.510,1,2,.500,149,292,.510,.512,82,109,.752,144,199,343,39,29,44,58,173,383
16753,LAL,2017,Ivica Zubac,19,38,11,609,126,238,.529,0,3,.000,126,235,.536,.529,32,49,.653,41,118,159,30,14,33,30,66,284
16754,LAL,2017,Thomas Robinson,25,48,1,560,105,196,.536,0,1,.000,105,195,.538,.536,31,66,.470,84,139,223,31,26,9,46,76,241
16755,LAL,2017,David Nwaba,24,20,2,397,47,81,.580,1,5,.200,46,76,.605,.586,25,39,.641,17,46,63,14,13,7,11,36,120
16756,LAL,2017,Tyler Ennis,22,22,2,392,65,144,.451,21,54,.389,44,90,.489,.524,19,22,.864,5,21,26,52,19,2,21,29,170
16757,LAL,2017,Corey Brewer,30,24,3,358,53,121,.438,5,24,.208,48,97,.495,.459,18,24,.750,11,41,52,36,24,8,19,29,129
16758,LAL,2017,José Calderón,35,24,11,292,32,77,.416,12,34,.353,20,43,.465,.494,4,4,1.000,8,34,42,51,7,1,26,22,80
16759,LAL,2017,Marcelo Huertas,33,23,1,237,25,68,.368,4,19,.211,21,49,.429,.397,9,17,.529,2,22,24,52,10,2,19,16,63
16760,LAL,2017,Metta World Peace,37,25,2,160,19,68,.279,9,38,.237,10,30,.333,.346,10,16,.625,5,15,20,11,10,2,7,18,57
16761,LAL,2016,Jordan Clarkson,23,79,79,2552,475,1098,.433,111,320,.347,364,778,.468,.483,164,204,.804,93,220,313,192,88,7,135,168,1225
16762,LAL,2016,Julius Randle,21,81,60,2286,358,835,.429,10,36,.278,348,799,.436,.435,193,270,.715,172,657,829,144,53,29,149,242,919
16763,LAL,2016,D'Angelo Russell,19,80,48,2259,392,956,.410,130,370,.351,262,586,.447,.478,140,190,.737,47,227,274,266,93,13,196,142,1054
16764,LAL,2016,Lou Williams,29,67,35,1907,283,693,.408,110,320,.344,173,373,.464,.488,352,424,.830,31,138,169,167,62,19,107,107,1028
16765,LAL,2016,Roy Hibbert,29,81,81,1878,182,411,.443,0,2,.000,182,409,.445,.443,117,145,.807,132,266,398,95,32,110,76,252,481
16766,LAL,2016,Kobe Bryant,37,66,66,1863,398,1113,.358,133,467,.285,265,646,.410,.417,232,281,.826,41,206,247,184,62,13,129,115,1161
16767,LAL,2016,Brandon Bass,30,66,0,1342,174,317,.549,0,2,.000,174,315,.552,.549,125,148,.845,104,181,285,74,33,55,42,125,473
16768,LAL,2016,Larry Nance Jr.,23,63,22,1266,158,300,.527,1,10,.100,157,290,.541,.528,32,47,.681,101,211,312,44,54,23,41,124,349
16769,LAL,2016,Nick Young,30,54,2,1033,126,372,.339,77,237,.325,49,135,.363,.442,63,76,.829,14,83,97,34,23,7,30,50,392
16770,LAL,2016,Marcelo Huertas,32,53,0,869,97,230,.422,16,61,.262,81,169,.479,.457,27,29,.931,18,72,90,182,26,7,80,76,237
16771,LAL,2016,Anthony Brown,23,29,11,599,39,126,.310,20,70,.286,19,56,.339,.389,17,20,.850,9,61,70,19,14,5,15,34,115
16772,LAL,2016,Metta World Peace,36,35,5,590,55,177,.311,26,84,.310,29,93,.312,.384,40,57,.702,19,70,89,27,22,11,15,67,176
16773,LAL,2016,Tarik Black,24,39,0,496,57,104,.548,0,0,,57,104,.548,.548,19,45,.422,44,113,157,16,14,18,22,78,133
16774,LAL,2016,Ryan Kelly,24,36,0,470,55,149,.369,5,37,.135,50,112,.446,.386,37,54,.685,21,100,121,20,13,10,18,39,152
16775,LAL,2016,Robert Sacre,26,25,1,320,31,75,.413,0,0,,31,75,.413,.413,25,38,.658,32,40,72,14,4,10,12,43,87
16776,LAL,2015,Wesley Johnson,27,76,59,2245,286,691,.414,91,259,.351,195,432,.451,.480,90,112,.804,67,252,319,124,59,45,87,162,753
16777,LAL,2015,Jeremy Lin,26,74,30,1907,277,654,.424,65,176,.369,212,478,.444,.473,213,268,.795,26,170,196,339,82,32,166,189,832
16778,LAL,2015,Jordan Hill,27,70,57,1874,357,777,.459,3,11,.273,354,766,.462,.461,124,168,.738,174,382,556,103,34,52,106,164,841
16779,LAL,2015,Ed Davis,25,79,24,1840,282,469,.601,0,0,,282,469,.601,.601,92,189,.487,230,370,600,94,49,98,58,202,656
16780,LAL,2015,Carlos Boozer,33,71,26,1692,371,743,.499,0,0,,371,743,.499,.499,94,150,.627,111,371,482,95,41,12,92,184,836
16781,LAL,2015,Wayne Ellington,27,65,36,1675,254,617,.412,90,243,.370,164,374,.439,.485,52,64,.813,31,179,210,105,33,2,50,77,650
16782,LAL,2015,Jordan Clarkson,22,59,38,1476,267,596,.448,38,121,.314,229,475,.482,.480,131,158,.829,56,135,191,206,51,12,96,109,703
16783,LAL,2015,Ryan Kelly,23,52,34,1233,104,309,.337,45,134,.336,59,175,.337,.409,79,95,.832,13,133,146,92,30,24,37,118,332
16784,LAL,2015,Kobe Bryant,36,35,35,1207,266,713,.373,54,184,.293,212,529,.401,.411,196,241,.813,26,173,199,197,47,7,128,65,782
16785,LAL,2015,Robert Sacre,25,67,18,1133,126,306,.412,0,1,.000,126,305,.413,.412,55,82,.671,89,144,233,55,28,43,36,121,307
16786,LAL,2015,Nick Young,29,42,0,1000,174,476,.366,83,225,.369,91,251,.363,.453,132,148,.892,17,79,96,41,23,11,44,83,563
16787,LAL,2015,Ronnie Price,31,43,20,982,77,223,.345,31,109,.284,46,114,.404,.415,36,45,.800,19,50,69,165,67,4,52,118,221
16788,LAL,2015,Tarik Black,23,38,27,803,112,190,.589,0,0,,112,190,.589,.589,50,89,.562,84,157,241,34,13,22,29,102,274
16789,LAL,2015,Jabari Brown,22,19,5,568,70,170,.412,23,62,.371,47,108,.435,.479,64,85,.753,3,33,36,40,12,2,32,33,227
16790,LAL,2015,Dwight Buycks,25,6,0,123,18,40,.450,7,11,.636,11,29,.379,.538,9,10,.900,2,10,12,14,3,0,12,3,52
16791,LAL,2015,Xavier Henry,23,9,0,86,3,13,.231,0,0,,3,13,.231,.231,14,24,.583,2,2,4,3,3,0,3,6,20
16792,LAL,2015,Vander Blue,22,2,1,74,9,30,.300,2,10,.200,7,20,.350,.333,2,5,.400,2,7,9,8,3,0,6,4,22
16793,LAL,2015,Julius Randle,20,1,0,14,1,3,.333,0,0,,1,3,.333,.333,0,2,.000,0,0,0,0,0,0,1,1,2
16794,LAL,2014,Jodie Meeks,26,77,70,2556,413,892,.463,162,404,.401,251,488,.514,.554,221,258,.857,30,164,194,138,111,4,111,119,1209
16795,LAL,2014,Wesley Johnson,26,79,62,2240,277,651,.425,100,271,.369,177,380,.466,.502,61,77,.792,70,278,348,124,86,77,90,207,715
16796,LAL,2014,Pau Gasol,33,60,60,1884,425,885,.480,4,14,.286,421,871,.483,.482,187,254,.736,124,456,580,201,27,92,141,124,1041
16797,LAL,2014,Nick Young,28,64,9,1810,387,889,.435,135,350,.386,252,539,.468,.511,235,285,.825,29,137,166,95,46,12,95,156,1144
16798,LAL,2014,Kendall Marshall,22,54,45,1564,170,419,.406,71,178,.399,99,241,.411,.490,19,36,.528,15,140,155,477,48,4,150,76,430
16799,LAL,2014,Jordan Hill,26,72,32,1500,286,521,.549,0,1,.000,286,520,.550,.549,124,181,.685,194,341,535,54,29,64,75,172,696
16800,LAL,2014,Ryan Kelly,22,59,25,1312,157,371,.423,48,142,.338,109,229,.476,.488,110,135,.815,42,177,219,95,32,45,47,147,472
16801,LAL,2014,Robert Sacre,24,65,13,1089,143,300,.477,0,0,,143,300,.477,.477,64,94,.681,82,172,254,51,24,47,44,134,350
16802,LAL,2014,Jordan Farmar,27,41,5,912,151,364,.415,70,160,.438,81,204,.397,.511,44,59,.746,20,84,104,199,38,8,95,65,416
16803,LAL,2014,Xavier Henry,22,43,5,908,144,345,.417,28,81,.346,116,264,.439,.458,116,177,.655,25,89,114,51,44,7,57,79,432
16804,LAL,2014,Steve Blake,33,27,27,891,88,233,.378,52,131,.397,36,102,.353,.489,28,35,.800,8,95,103,205,34,2,71,49,256
16805,LAL,2014,Shawne Williams,27,36,13,751,73,192,.380,42,129,.326,31,63,.492,.490,14,20,.700,25,142,167,30,19,30,21,93,202
16806,LAL,2014,Chris Kaman,31,39,13,736,176,346,.509,0,3,.000,176,343,.513,.509,52,68,.765,54,175,229,58,11,40,74,93,404
16807,LAL,2014,Kent Bazemore,24,23,15,643,111,246,.451,33,89,.371,78,157,.497,.518,47,73,.644,5,72,77,71,31,7,51,60,302
16808,LAL,2014,Steve Nash,39,15,10,313,36,94,.383,8,24,.333,28,70,.400,.426,22,24,.917,4,25,29,86,7,2,31,18,102
16809,LAL,2014,MarShon Brooks,25,18,0,228,43,88,.489,11,19,.579,32,69,.464,.551,18,26,.692,8,22,30,21,12,3,17,16,115
16810,LAL,2014,Manny Harris,24,9,0,180,28,70,.400,7,20,.350,21,50,.420,.450,10,12,.833,7,27,34,11,4,1,9,10,73
16811,LAL,2014,Kobe Bryant,35,6,6,177,31,73,.425,3,16,.188,28,57,.491,.445,18,21,.857,2,24,26,38,7,1,34,9,83
16812,LAL,2014,Elias Harris,24,2,0,11,0,1,.000,0,0,,0,1,.000,.000,0,0,,1,0,1,1,1,0,0,0,0
16813,LAL,2013,Kobe Bryant,34,78,78,3013,738,1595,.463,132,407,.324,606,1188,.510,.504,525,626,.839,66,367,433,469,106,25,287,173,2133
16814,LAL,2013,Dwight Howard,27,76,76,2722,470,813,.578,1,6,.167,469,807,.581,.579,355,721,.492,251,694,945,108,84,186,225,291,1296
16815,LAL,2013,Metta World Peace,33,75,66,2530,332,824,.403,141,412,.342,191,412,.464,.488,124,169,.734,101,271,372,112,122,42,98,198,929
16816,LAL,2013,Jodie Meeks,25,78,10,1663,205,530,.387,122,342,.357,83,188,.441,.502,86,96,.896,37,134,171,69,58,5,52,103,618
16817,LAL,2013,Pau Gasol,32,49,42,1655,270,579,.466,8,28,.286,262,551,.475,.473,125,178,.702,111,310,421,200,24,61,104,93,673
16818,LAL,2013,Antawn Jamison,36,76,6,1636,267,575,.464,84,233,.361,183,342,.535,.537,94,136,.691,109,253,362,50,30,22,53,124,712
16819,LAL,2013,Steve Nash,38,50,50,1627,236,475,.497,57,130,.438,179,345,.519,.557,107,116,.922,26,116,142,333,30,5,126,70,636
16820,LAL,2013,Earl Clark,25,59,36,1363,170,386,.440,35,104,.337,135,282,.479,.486,53,76,.697,82,243,325,65,36,44,62,102,428
16821,LAL,2013,Steve Blake,32,45,13,1175,114,270,.422,72,171,.421,42,99,.424,.556,27,35,.771,21,111,132,173,34,6,62,83,327
16822,LAL,2013,Chris Duhon,30,46,9,820,47,123,.382,33,91,.363,14,32,.438,.516,6,13,.462,11,57,68,133,20,1,40,56,133
16823,LAL,2013,Darius Morris,22,48,17,683,73,188,.388,24,66,.364,49,122,.402,.452,24,37,.649,24,33,57,76,21,2,45,58,194
16824,LAL,2013,Jordan Hill,25,29,1,458,77,155,.497,0,2,.000,77,153,.503,.497,40,61,.656,82,84,166,13,8,19,26,55,194
16825,LAL,2013,Robert Sacre,23,32,3,203,18,48,.375,0,0,,18,48,.375,.375,7,11,.636,9,25,34,6,0,10,10,38,43
16826,LAL,2013,Devin Ebanks,23,19,3,197,24,73,.329,6,22,.273,18,51,.353,.370,11,14,.786,10,31,41,10,3,1,11,23,65
16827,LAL,2013,Andrew Goudelock,24,1,0,6,0,2,.000,0,0,,0,2,.000,.000,0,0,,1,0,1,0,0,0,0,0,0
16828,LAL,2013,Darius Johnson-Odom,23,4,0,6,0,4,.000,0,1,.000,0,3,.000,.000,0,0,,1,3,4,1,0,0,0,0,0
16829,LAL,2012,Pau Gasol,31,65,65,2430,459,917,.501,7,27,.259,452,890,.508,.504,204,261,.782,183,495,678,237,37,88,142,127,1129
16830,LAL,2012,Kobe Bryant,33,58,58,2232,574,1336,.430,87,287,.303,487,1049,.464,.462,381,451,.845,66,247,313,264,69,18,204,105,1616
16831,LAL,2012,Andrew Bynum,24,60,60,2112,444,796,.558,1,5,.200,443,791,.560,.558,234,338,.692,192,517,709,85,27,116,152,104,1123
16832,LAL,2012,Metta World Peace,32,64,45,1720,183,465,.394,56,189,.296,127,276,.460,.454,71,115,.617,71,147,218,140,69,27,69,137,493
16833,LAL,2012,Matt Barnes,31,63,16,1440,175,387,.452,46,138,.333,129,249,.518,.512,95,128,.742,97,247,344,126,35,48,73,152,491
16834,LAL,2012,Steve Blake,31,53,5,1237,101,268,.377,53,158,.335,48,110,.436,.476,21,27,.778,9,76,85,175,39,2,72,75,276
16835,LAL,2012,Derek Fisher,37,43,43,1101,92,240,.383,24,74,.324,68,166,.410,.433,44,53,.830,10,82,92,142,40,3,58,85,252
16836,LAL,2012,Troy Murphy,31,59,0,956,77,171,.450,28,67,.418,49,104,.471,.532,6,9,.667,40,151,191,51,15,16,26,98,188
16837,LAL,2012,Josh McRoberts,24,50,6,718,56,118,.475,3,7,.429,53,111,.477,.487,23,36,.639,61,110,171,51,15,18,31,74,138
16838,LAL,2012,Ramon Sessions,25,23,19,701,101,211,.479,17,35,.486,84,176,.477,.519,72,101,.713,14,73,87,142,17,2,59,37,291
16839,LAL,2012,Andrew Goudelock,23,40,0,419,68,174,.391,28,75,.373,40,99,.404,.471,11,12,.917,5,26,31,20,4,0,21,32,175
16840,LAL,2012,Devin Ebanks,22,24,12,396,37,89,.416,0,9,.000,37,80,.463,.416,23,35,.657,26,28,54,12,11,6,18,26,97
16841,LAL,2012,Jason Kapono,30,27,0,269,21,55,.382,8,27,.296,13,28,.464,.455,4,4,1.000,2,12,14,11,3,0,6,21,54
16842,LAL,2012,Darius Morris,21,19,0,169,18,42,.429,4,9,.444,14,33,.424,.476,6,9,.667,2,14,16,21,2,0,19,16,46
16843,LAL,2012,Jordan Hill,24,7,1,82,14,30,.467,0,0,,14,30,.467,.467,5,8,.625,14,17,31,2,5,6,7,11,33
16844,LAL,2012,Luke Walton,31,9,0,65,6,14,.429,0,4,.000,6,10,.600,.429,0,0,,6,8,14,5,2,0,2,9,12
16845,LAL,2012,Christian Eyenga,22,1,0,19,3,6,.500,0,1,.000,3,5,.600,.500,2,2,1.000,1,1,2,1,0,1,1,0,8
16846,LAL,2011,Pau Gasol,30,82,82,3037,593,1120,.529,1,3,.333,592,1117,.530,.530,354,430,.823,268,568,836,273,48,130,142,203,1541
16847,LAL,2011,Kobe Bryant,32,82,82,2779,740,1639,.451,115,356,.323,625,1283,.487,.487,483,583,.828,83,336,419,388,99,12,243,172,2078
16848,LAL,2011,Lamar Odom,31,82,35,2639,473,893,.530,68,178,.382,405,715,.566,.568,166,246,.675,175,535,710,249,47,61,139,200,1180
16849,LAL,2011,Metta World Peace,31,82,82,2410,261,658,.397,83,233,.356,178,425,.419,.460,92,136,.676,100,167,267,175,124,36,90,181,697
16850,LAL,2011,Derek Fisher,36,82,82,2297,206,529,.389,63,159,.396,143,370,.386,.449,83,103,.806,14,138,152,224,99,8,70,192,558
16851,LAL,2011,Steve Blake,30,79,0,1581,110,306,.359,73,193,.378,37,113,.327,.479,26,30,.867,19,137,156,170,40,3,73,99,319
16852,LAL,2011,Shannon Brown,25,82,0,1568,273,643,.425,74,212,.349,199,431,.462,.482,92,101,.911,35,122,157,96,67,16,75,124,712
16853,LAL,2011,Andrew Bynum,23,54,47,1500,237,413,.574,0,0,,237,413,.574,.574,138,209,.660,170,338,508,73,19,106,74,140,612
16854,LAL,2011,Matt Barnes,30,53,0,1020,131,279,.470,34,107,.318,97,172,.564,.530,60,77,.779,73,155,228,71,39,22,58,127,356
16855,LAL,2011,Luke Walton,30,54,0,484,38,116,.328,8,34,.235,30,82,.366,.362,7,10,.700,9,58,67,62,9,4,31,38,91
16856,LAL,2011,Derrick Caracter,22,41,0,215,32,66,.485,0,0,,32,66,.485,.485,17,23,.739,19,24,43,7,4,10,19,47,81
16857,LAL,2011,Devin Ebanks,21,20,0,118,21,51,.412,2,5,.400,19,46,.413,.431,18,23,.783,15,12,27,2,4,5,6,7,62
16858,LAL,2011,Theo Ratliff,37,10,0,71,1,6,.167,0,0,,1,6,.167,.167,0,2,.000,6,7,13,3,2,5,3,7,2
16859,LAL,2011,Sasha Vujačić,26,11,0,54,8,23,.348,3,7,.429,5,16,.313,.413,1,2,.500,1,3,4,5,1,0,5,7,20
16860,LAL,2011,Joe Smith,35,12,0,44,2,12,.167,0,0,,2,12,.167,.167,2,2,1.000,2,16,18,3,0,4,3,10,6
16861,LAL,2011,Trey Johnson,26,1,0,13,2,3,.667,0,0,,2,3,.667,.667,2,2,1.000,0,0,0,0,0,0,0,1,6
16862,LAL,2010,Kobe Bryant,31,73,73,2835,716,1569,.456,99,301,.329,617,1268,.487,.488,439,541,.811,78,313,391,365,113,20,233,187,1970
16863,LAL,2010,Metta World Peace,30,77,77,2605,306,740,.414,105,296,.355,201,444,.453,.484,128,186,.688,99,232,331,234,106,21,121,165,845
16864,LAL,2010,Lamar Odom,30,82,38,2585,342,739,.463,58,182,.319,284,557,.510,.502,140,202,.693,184,618,802,267,75,59,150,227,882
16865,LAL,2010,Pau Gasol,29,65,65,2403,452,844,.536,0,5,.000,452,839,.539,.536,286,362,.790,243,491,734,218,37,113,143,152,1190
16866,LAL,2010,Derek Fisher,35,82,82,2227,212,558,.380,78,224,.348,134,334,.401,.450,113,132,.856,25,145,170,201,90,9,78,202,615
16867,LAL,2010,Andrew Bynum,22,65,65,1977,392,688,.570,0,1,.000,392,687,.571,.570,193,261,.739,177,364,541,68,35,94,115,193,977
16868,LAL,2010,Shannon Brown,24,82,7,1700,253,592,.427,62,189,.328,191,403,.474,.480,99,121,.818,30,153,183,108,57,31,67,129,667
16869,LAL,2010,Jordan Farmar,23,82,0,1474,224,515,.435,86,229,.376,138,286,.483,.518,57,85,.671,14,117,131,127,52,11,72,109,591
16870,LAL,2010,Josh Powell,27,63,0,581,71,194,.366,7,16,.438,64,178,.360,.384,20,31,.645,44,72,116,35,9,6,33,71,169
16871,LAL,2010,Sasha Vujačić,25,67,1,575,66,164,.402,25,81,.309,41,83,.494,.479,28,33,.848,25,54,79,41,20,4,17,67,185
16872,LAL,2010,D.J. Mbenga,29,49,2,355,48,103,.466,0,0,,48,103,.466,.466,9,19,.474,32,55,87,8,5,29,15,54,105
16873,LAL,2010,Luke Walton,29,29,0,272,30,84,.357,7,17,.412,23,67,.343,.399,2,4,.500,12,26,38,40,10,1,12,19,69
16874,LAL,2010,Adam Morrison,25,31,0,241,32,85,.376,5,21,.238,27,64,.422,.406,5,8,.625,10,22,32,18,3,2,10,17,74
16875,LAL,2009,Pau Gasol,28,81,81,2999,592,1045,.567,1,2,.500,591,1043,.567,.567,343,439,.781,262,518,780,284,52,81,157,172,1528
16876,LAL,2009,Kobe Bryant,30,82,82,2960,800,1712,.467,118,336,.351,682,1376,.496,.502,483,564,.856,90,339,429,399,120,37,210,189,2201
16877,LAL,2009,Derek Fisher,34,82,82,2441,292,688,.424,120,302,.397,172,386,.446,.512,110,130,.846,25,163,188,261,95,6,72,187,814
16878,LAL,2009,Lamar Odom,29,78,32,2316,346,703,.492,33,103,.320,313,600,.522,.516,160,257,.623,176,461,637,204,77,98,138,235,885
16879,LAL,2009,Trevor Ariza,23,82,20,1999,274,596,.460,61,191,.319,213,405,.526,.511,120,169,.710,111,241,352,145,137,24,87,166,729
16880,LAL,2009,Andrew Bynum,21,50,50,1446,281,502,.560,0,0,,281,502,.560,.560,152,215,.707,137,261,398,71,18,90,85,157,714
16881,LAL,2009,Sasha Vujačić,24,80,0,1293,155,401,.387,81,223,.363,74,178,.416,.488,70,76,.921,19,116,135,113,77,7,35,154,461
16882,LAL,2009,Jordan Farmar,22,65,0,1192,161,412,.391,49,146,.336,112,266,.421,.450,45,77,.584,22,95,117,155,57,10,87,105,416
16883,LAL,2009,Luke Walton,28,65,34,1166,134,307,.436,17,57,.298,117,250,.468,.464,41,57,.719,55,125,180,177,32,10,69,105,326
16884,LAL,2009,Vladimir Radmanović,28,46,28,771,95,214,.444,60,136,.441,35,78,.449,.584,23,27,.852,18,99,117,38,28,7,47,51,273
16885,LAL,2009,Josh Powell,26,60,1,703,106,239,.444,0,0,,106,239,.444,.444,38,50,.760,71,105,176,27,9,17,51,98,250
16886,LAL,2009,D.J. Mbenga,28,23,0,181,27,57,.474,0,1,.000,27,56,.482,.474,7,8,.875,9,22,31,9,10,24,13,33,61
16887,LAL,2009,Shannon Brown,23,18,0,136,22,42,.524,6,9,.667,16,33,.485,.595,8,9,.889,3,17,20,10,4,2,9,9,58
16888,LAL,2009,Chris Mihm,29,18,0,105,15,40,.375,0,0,,15,40,.375,.375,6,7,.857,15,19,34,10,1,6,10,23,36
16889,LAL,2009,Adam Morrison,24,8,0,44,4,12,.333,1,4,.250,3,8,.375,.375,1,2,.500,2,6,8,3,0,0,3,4,10
16890,LAL,2009,Sun Yue,23,10,0,28,3,11,.273,0,6,.000,3,5,.600,.273,0,0,,0,0,0,2,1,1,3,10,6
16891,LAL,2008,Kobe Bryant,29,82,82,3192,775,1690,.459,150,415,.361,625,1275,.490,.503,623,742,.840,94,423,517,441,151,40,257,227,2323
16892,LAL,2008,Lamar Odom,28,77,77,2921,417,795,.525,31,113,.274,386,682,.566,.544,229,328,.698,197,622,819,273,75,72,156,222,1094
16893,LAL,2008,Derek Fisher,33,82,82,2249,339,777,.436,112,276,.406,227,501,.453,.508,166,188,.883,24,146,170,239,86,3,90,188,956
16894,LAL,2008,Luke Walton,27,74,31,1729,215,478,.450,28,84,.333,187,394,.475,.479,77,109,.706,85,206,291,218,60,18,100,133,535
16895,LAL,2008,Jordan Farmar,21,82,0,1690,291,631,.461,114,307,.371,177,324,.546,.552,53,78,.679,39,144,183,225,77,5,108,105,749
16896,LAL,2008,Vladimir Radmanović,27,65,41,1483,198,437,.453,95,234,.406,103,203,.507,.562,52,65,.800,56,159,215,123,46,12,73,147,543
16897,LAL,2008,Ronny Turiaf,25,78,21,1458,188,397,.474,0,1,.000,188,396,.475,.474,140,186,.753,95,211,306,128,28,108,72,199,516
16898,LAL,2008,Sasha Vujačić,23,72,0,1279,219,482,.454,118,270,.437,101,212,.476,.577,76,91,.835,19,135,154,72,36,5,52,107,632
16899,LAL,2008,Andrew Bynum,20,35,25,1008,189,297,.636,0,0,,189,297,.636,.636,82,118,.695,105,251,356,61,12,72,52,98,460
16900,LAL,2008,Pau Gasol,27,27,27,918,196,333,.589,0,1,.000,196,332,.590,.589,116,147,.789,61,150,211,95,14,42,44,54,508
16901,LAL,2008,Kwame Brown,25,23,14,509,53,103,.515,0,0,,53,103,.515,.515,26,64,.406,31,100,131,28,16,19,37,58,132
16902,LAL,2008,Trevor Ariza,22,24,3,431,55,105,.524,5,15,.333,50,90,.556,.548,41,60,.683,25,59,84,36,26,8,18,36,156
16903,LAL,2008,Chris Mihm,28,23,5,278,32,95,.337,0,0,,32,95,.337,.337,18,27,.667,28,49,77,13,4,14,17,42,82
16904,LAL,2008,D.J. Mbenga,27,26,0,196,30,61,.492,0,0,,30,61,.492,.492,4,10,.400,15,26,41,6,4,16,8,38,64
16905,LAL,2008,Javaris Crittenton,20,22,0,171,26,53,.491,1,3,.333,25,50,.500,.500,19,28,.679,7,14,21,18,7,0,22,12,72
16906,LAL,2008,Maurice Evans,29,7,0,96,9,28,.321,1,7,.143,8,21,.381,.339,12,15,.800,4,5,9,12,5,1,0,10,31
16907,LAL,2008,Coby Karl,24,17,0,71,9,26,.346,4,13,.308,5,13,.385,.423,8,10,.800,3,11,14,9,4,2,5,4,30
16908,LAL,2008,Brian Cook,27,6,2,70,4,21,.190,2,10,.200,2,11,.182,.238,4,4,1.000,4,6,10,3,2,0,4,6,14
16909,LAL,2008,Ira Newble,33,6,0,31,3,9,.333,1,2,.500,2,7,.286,.389,0,0,,6,5,11,3,1,1,3,5,7
16910,LAL,2007,Kobe Bryant,28,77,77,3140,813,1757,.463,137,398,.344,676,1359,.497,.502,667,768,.868,75,364,439,413,111,36,255,205,2430
16911,LAL,2007,Smush Parker,25,82,80,2457,342,785,.436,110,301,.365,232,484,.479,.506,113,175,.646,45,161,206,228,119,10,153,211,907
16912,LAL,2007,Lamar Odom,27,56,56,2202,319,681,.468,54,182,.297,265,499,.531,.508,198,283,.700,102,445,547,270,53,32,163,182,890
16913,LAL,2007,Luke Walton,26,60,60,1982,264,557,.474,48,124,.387,216,433,.499,.517,108,145,.745,87,215,302,257,60,21,118,117,684
16914,LAL,2007,Andrew Bynum,19,82,53,1793,247,443,.558,0,3,.000,247,440,.561,.558,143,214,.668,139,345,484,94,12,128,115,249,637
16915,LAL,2007,Maurice Evans,28,76,10,1732,234,542,.432,48,133,.361,186,409,.455,.476,122,155,.787,93,128,221,74,38,14,57,126,638
16916,LAL,2007,Kwame Brown,24,41,28,1132,143,242,.591,0,1,.000,143,241,.593,.591,59,134,.440,81,163,244,75,39,49,76,124,345
16917,LAL,2007,Jordan Farmar,20,72,2,1090,124,294,.422,45,137,.328,79,157,.503,.498,27,38,.711,22,97,119,137,44,7,73,77,320
16918,LAL,2007,Ronny Turiaf,24,72,1,1087,147,268,.549,0,1,.000,147,267,.551,.549,89,134,.664,88,171,259,63,17,78,52,202,383
16919,LAL,2007,Brian Cook,26,65,24,1018,185,408,.453,46,115,.400,139,293,.474,.510,34,47,.723,61,154,215,65,25,27,51,134,450
16920,LAL,2007,Vladimir Radmanović,26,55,15,986,134,316,.424,40,118,.339,94,198,.475,.487,53,73,.726,53,127,180,66,25,18,69,125,361
16921,LAL,2007,Sasha Vujačić,22,73,4,935,105,268,.392,60,161,.373,45,107,.421,.504,43,49,.878,28,79,107,64,41,1,30,103,313
16922,LAL,2007,Shammond Williams,31,30,0,345,35,86,.407,20,50,.400,15,36,.417,.523,4,6,.667,11,29,40,31,12,0,13,20,94
16923,LAL,2007,Aaron McKie,34,10,0,131,11,17,.647,0,0,,11,17,.647,.647,0,0,,1,17,18,13,4,0,8,14,22
16924,LAL,2006,Kobe Bryant,27,80,80,3277,978,2173,.450,180,518,.347,798,1655,.482,.491,696,819,.850,71,354,425,360,147,30,250,233,2832
16925,LAL,2006,Lamar Odom,26,80,80,3221,445,925,.481,80,215,.372,365,710,.514,.524,216,313,.690,181,557,738,443,75,64,213,256,1186
16926,LAL,2006,Smush Parker,24,82,82,2773,348,779,.447,120,328,.366,228,451,.506,.524,125,180,.694,37,234,271,302,140,16,147,213,941
16927,LAL,2006,Kwame Brown,23,72,49,1978,204,388,.526,0,1,.000,204,387,.527,.526,128,235,.545,182,291,473,72,27,46,100,196,536
16928,LAL,2006,Devean George,28,71,5,1542,170,425,.400,50,160,.313,120,265,.453,.459,58,86,.674,82,192,274,68,66,34,54,159,448
16929,LAL,2006,Chris Mihm,26,59,56,1541,230,459,.501,0,0,,230,459,.501,.501,144,201,.716,137,236,373,61,16,73,83,214,604
16930,LAL,2006,Brian Cook,25,81,46,1535,261,511,.511,36,84,.429,225,427,.527,.546,84,101,.832,88,186,274,74,37,32,61,205,642
16931,LAL,2006,Sasha Vujačić,21,82,4,1449,108,312,.346,59,172,.343,49,140,.350,.441,46,52,.885,33,126,159,139,48,3,50,150,321
16932,LAL,2006,Luke Walton,25,69,6,1333,135,328,.412,18,55,.327,117,273,.429,.439,57,76,.750,88,159,247,156,41,15,78,119,345
16933,LAL,2006,Andrew Bynum,18,46,0,338,33,82,.402,0,0,,33,82,.402,.402,8,27,.296,34,46,80,9,4,22,17,56,74
16934,LAL,2006,Laron Profit,28,25,1,279,40,84,.476,3,18,.167,37,66,.561,.494,21,24,.875,8,35,43,15,11,5,24,25,104
16935,LAL,2006,Ronny Turiaf,23,23,1,161,15,30,.500,0,0,,15,30,.500,.500,15,27,.556,11,26,37,8,3,10,7,30,45
16936,LAL,2006,Devin Green,23,27,0,135,6,28,.214,0,2,.000,6,26,.231,.214,13,21,.619,10,14,24,7,3,0,5,13,25
16937,LAL,2006,Aaron McKie,33,14,0,121,3,12,.250,0,2,.000,3,10,.300,.250,1,2,.500,3,17,20,11,5,0,2,7,7
16938,LAL,2006,Jim Jackson,35,13,0,92,9,31,.290,4,11,.364,5,20,.250,.355,0,0,,0,12,12,4,2,0,5,5,22
16939,LAL,2006,Von Wafer,20,16,0,73,6,38,.158,2,17,.118,4,21,.190,.184,6,8,.750,5,3,8,4,3,0,1,12,20
16940,LAL,2006,Stanislav Medvedenko,26,2,0,6,1,2,.500,0,0,,1,2,.500,.500,0,0,,0,0,0,1,0,0,0,1,2
16941,LAL,2005,Chucky Atkins,30,82,82,2903,388,910,.426,176,455,.387,212,455,.466,.523,163,203,.803,31,166,197,358,73,2,151,181,1115
16942,LAL,2005,Caron Butler,24,77,77,2746,441,991,.445,38,125,.304,403,866,.465,.464,275,319,.862,146,304,450,146,110,23,125,213,1195
16943,LAL,2005,Kobe Bryant,26,66,66,2689,573,1324,.433,131,387,.339,442,937,.472,.482,542,664,.816,95,297,392,398,86,53,270,174,1819
16944,LAL,2005,Lamar Odom,25,64,64,2320,366,774,.473,36,117,.308,330,657,.502,.496,207,298,.695,134,519,653,238,42,65,161,211,975
16945,LAL,2005,Chris Mihm,25,75,75,1870,280,552,.507,0,2,.000,280,550,.509,.507,175,258,.678,197,305,502,50,14,108,110,237,735
16946,LAL,2005,Jumaine Jones,25,76,23,1830,210,486,.432,102,261,.391,108,225,.480,.537,55,75,.733,107,291,398,65,44,24,49,165,577
16947,LAL,2005,Brian Grant,32,69,8,1136,103,209,.493,0,0,,103,209,.493,.493,57,79,.722,101,156,257,34,23,23,43,175,263
16948,LAL,2005,Brian Cook,24,72,0,1087,176,422,.417,78,199,.392,98,223,.439,.509,28,37,.757,63,153,216,35,23,26,29,139,458
16949,LAL,2005,Tierre Brown,25,76,0,1066,124,348,.356,26,72,.361,98,276,.355,.394,59,75,.787,21,72,93,155,32,1,74,59,333
16950,LAL,2005,Luke Walton,24,61,5,768,74,180,.411,16,61,.262,58,119,.487,.456,34,48,.708,55,87,142,93,26,11,58,70,198
16951,LAL,2005,Stanislav Medvedenko,25,43,4,423,71,156,.455,0,1,.000,71,155,.458,.455,23,28,.821,31,48,79,13,9,2,13,64,165
16952,LAL,2005,Sasha Vujačić,20,35,3,403,33,117,.282,17,63,.270,16,54,.296,.355,18,19,.947,13,49,62,51,12,2,15,41,101
16953,LAL,2005,Devean George,27,15,3,306,37,104,.356,21,58,.362,16,46,.348,.457,15,20,.750,13,40,53,14,8,2,12,32,110
16954,LAL,2005,Vlade Divac,36,15,0,130,13,31,.419,0,0,,13,31,.419,.419,8,12,.667,18,14,32,19,4,1,14,25,34
16955,LAL,2005,Kareem Rush,24,14,0,91,4,20,.200,2,10,.200,2,10,.200,.250,2,2,1.000,3,7,10,3,2,1,3,7,12
16956,LAL,2005,Tony Bobbitt,25,2,0,12,2,5,.400,1,2,.500,1,3,.333,.500,0,0,,0,3,3,0,0,0,0,1,5
16957,LAL,2004,Gary Payton,35,82,82,2825,482,1024,.471,55,165,.333,427,859,.497,.498,180,252,.714,72,270,342,449,96,19,151,169,1199
16958,LAL,2004,Shaquille O'Neal,31,67,67,2464,554,948,.584,0,0,,554,948,.584,.584,331,676,.490,246,523,769,196,34,166,195,225,1439
16959,LAL,2004,Kobe Bryant,25,65,64,2447,516,1178,.438,71,217,.327,445,961,.463,.468,454,533,.852,103,256,359,330,112,28,171,176,1557
16960,LAL,2004,Devean George,26,82,48,1951,233,571,.408,65,186,.349,168,385,.436,.465,73,96,.760,87,245,332,112,81,38,88,189,604
16961,LAL,2004,Derek Fisher,29,82,3,1769,203,576,.352,52,179,.291,151,397,.380,.398,122,153,.797,30,122,152,187,103,4,79,115,580
16962,LAL,2004,Stanislav Medvedenko,24,68,38,1442,237,537,.441,0,3,.000,237,534,.444,.441,89,116,.767,148,195,343,57,38,18,59,191,563
16963,LAL,2004,Karl Malone,40,42,42,1373,193,400,.483,0,1,.000,193,399,.484,.483,168,225,.747,61,306,367,163,50,20,103,116,554
16964,LAL,2004,Kareem Rush,23,72,15,1244,190,432,.440,48,138,.348,142,294,.483,.495,31,52,.596,20,77,97,59,33,20,48,109,459
16965,LAL,2004,Horace Grant,38,55,10,1106,92,224,.411,0,1,.000,92,223,.413,.411,39,54,.722,79,154,233,71,24,21,29,70,223
16966,LAL,2004,Bryon Russell,33,72,1,945,98,244,.402,43,112,.384,55,132,.417,.490,50,65,.769,32,114,146,71,32,12,37,110,289
16967,LAL,2004,Rick Fox,34,38,34,846,73,186,.392,15,61,.246,58,125,.464,.433,22,30,.733,29,73,102,98,29,4,48,99,183
16968,LAL,2004,Luke Walton,23,72,2,730,65,153,.425,13,39,.333,52,114,.456,.467,31,44,.705,39,88,127,113,28,8,44,70,174
16969,LAL,2004,Brian Cook,23,35,2,442,67,141,.475,0,5,.000,67,136,.493,.475,21,28,.750,31,70,101,20,16,16,17,64,155
16970,LAL,2004,Jamal Sampson,20,10,2,130,11,23,.478,0,0,,11,23,.478,.478,7,12,.583,23,29,52,7,2,4,6,16,29
16971,LAL,2004,Jannero Pargo,24,13,0,63,6,16,.375,2,4,.500,4,12,.333,.438,0,0,,0,6,6,11,2,0,12,5,14
16972,LAL,2004,Maurice Carter,27,4,0,50,5,14,.357,1,3,.333,4,11,.364,.393,11,12,.917,0,3,3,2,0,0,6,5,22
16973,LAL,2004,Ime Udoka,26,4,0,28,3,9,.333,0,1,.000,3,8,.375,.333,2,4,.500,1,4,5,2,2,1,3,3,8
16974,LAL,2003,Kobe Bryant,24,82,82,3401,868,1924,.451,124,324,.383,744,1600,.465,.483,601,713,.843,106,458,564,481,181,67,288,218,2461
16975,LAL,2003,Derek Fisher,28,82,82,2829,339,775,.437,85,212,.401,254,563,.451,.492,100,125,.800,40,199,239,298,93,15,94,195,863
16976,LAL,2003,Shaquille O'Neal,30,67,66,2535,695,1211,.574,0,0,,695,1211,.574,.574,451,725,.622,259,483,742,206,38,159,196,229,1841
16977,LAL,2003,Robert Horry,32,80,26,2343,184,476,.387,51,177,.288,133,299,.445,.440,103,134,.769,181,333,514,233,96,61,112,247,522
16978,LAL,2003,Rick Fox,33,76,75,2181,262,621,.422,105,280,.375,157,341,.460,.506,52,69,.754,64,259,323,253,69,14,121,215,681
16979,LAL,2003,Devean George,25,71,7,1613,180,461,.390,49,132,.371,131,329,.398,.444,83,105,.790,91,195,286,92,56,38,65,180,492
16980,LAL,2003,Samaki Walker,26,67,39,1243,115,274,.420,0,1,.000,115,273,.421,.420,66,101,.653,115,253,368,64,20,55,56,143,296
16981,LAL,2003,Brian Shaw,36,72,0,900,101,261,.387,38,109,.349,63,152,.414,.460,10,15,.667,20,99,119,103,32,13,54,62,250
16982,LAL,2003,Kareem Rush,22,76,0,872,96,244,.393,19,68,.279,77,176,.438,.432,16,23,.696,26,68,94,68,10,11,63,71,227
16983,LAL,2003,Mark Madsen,27,54,22,781,69,163,.423,0,0,,69,163,.423,.423,36,61,.590,86,73,159,38,15,19,27,116,174
16984,LAL,2003,Stanislav Medvedenko,23,58,10,620,112,258,.434,0,2,.000,112,256,.438,.434,31,43,.721,66,75,141,18,11,8,37,118,255
16985,LAL,2003,Jannero Pargo,23,34,0,342,37,93,.398,7,24,.292,30,69,.435,.435,4,4,1.000,9,28,37,39,13,2,23,45,85
16986,LAL,2003,Tracy Murray,31,31,0,193,23,71,.324,8,38,.211,15,33,.455,.380,7,9,.778,5,18,23,12,5,3,14,22,61
16987,LAL,2003,Soumaila Samake,24,13,1,77,10,24,.417,0,0,,10,24,.417,.417,2,2,1.000,10,13,23,4,0,5,2,13,22
16988,LAL,2002,Kobe Bryant,23,80,80,3063,749,1597,.469,33,132,.250,716,1465,.489,.479,488,589,.829,112,329,441,438,118,35,223,228,2019
16989,LAL,2002,Shaquille O'Neal,29,67,66,2422,712,1229,.579,0,1,.000,712,1228,.580,.579,398,717,.555,235,480,715,200,41,137,171,199,1822
16990,LAL,2002,Rick Fox,32,82,82,2289,255,605,.421,65,208,.313,190,397,.479,.475,70,85,.824,90,299,389,283,67,21,132,244,645
16991,LAL,2002,Robert Horry,31,81,23,2140,183,460,.398,76,203,.374,107,257,.416,.480,108,138,.783,130,349,479,232,77,89,88,208,550
16992,LAL,2002,Derek Fisher,27,70,35,1974,274,666,.411,144,349,.413,130,317,.410,.520,94,111,.847,15,131,146,181,66,9,62,121,786
16993,LAL,2002,Devean George,24,82,1,1759,215,523,.411,66,178,.371,149,345,.432,.474,85,126,.675,78,225,303,111,71,42,66,190,581
16994,LAL,2002,Samaki Walker,25,69,63,1655,187,365,.512,0,0,,187,365,.512,.512,86,129,.667,129,352,481,64,28,88,53,170,460
16995,LAL,2002,Lindsey Hunter,31,82,47,1616,187,490,.382,79,208,.380,108,282,.383,.462,20,40,.500,18,103,121,129,66,19,55,120,473
16996,LAL,2002,Stanislav Medvedenko,22,71,6,729,145,304,.477,0,4,.000,145,300,.483,.477,41,62,.661,85,73,158,43,29,11,42,119,331
16997,LAL,2002,Mitch Richmond,36,64,2,709,100,247,.405,18,62,.290,82,185,.443,.441,42,44,.955,14,80,94,57,18,6,40,61,260
16998,LAL,2002,Mark Madsen,26,59,5,650,66,146,.452,0,2,.000,66,144,.458,.452,35,54,.648,89,73,162,44,16,13,22,104,167
16999,LAL,2002,Brian Shaw,35,58,0,631,61,173,.353,29,88,.330,32,85,.376,.436,18,26,.692,19,93,112,89,25,3,32,43,169
17000,LAL,2002,Jelani McCoy,24,21,0,104,12,21,.571,0,0,,12,21,.571,.571,2,8,.250,8,17,25,7,0,5,8,14,26
17001,LAL,2002,Joe Crispin,22,6,0,27,3,12,.250,0,4,.000,3,8,.375,.250,4,5,.800,0,1,1,2,1,0,1,2,10
17002,LAL,2002,Mike Penberthy,27,3,0,12,1,2,.500,0,0,,1,2,.500,.500,3,4,.750,0,2,2,2,2,0,0,0,5
17003,LAL,2001,Shaquille O'Neal,28,74,74,2924,813,1422,.572,0,2,.000,813,1420,.573,.572,499,972,.513,291,649,940,277,47,204,218,256,2125
17004,LAL,2001,Kobe Bryant,22,68,68,2783,701,1510,.464,61,200,.305,640,1310,.489,.484,475,557,.853,104,295,399,338,114,43,220,222,1938
17005,LAL,2001,Horace Grant,35,77,77,2390,263,569,.462,0,3,.000,263,566,.465,.462,131,169,.775,220,325,545,121,51,61,48,181,657
17006,LAL,2001,Rick Fox,31,82,77,2291,287,646,.444,118,300,.393,169,346,.488,.536,95,122,.779,80,245,325,262,70,29,136,225,787
17007,LAL,2001,Brian Shaw,34,80,28,1833,164,411,.399,42,135,.311,122,276,.442,.450,51,64,.797,48,256,304,258,49,27,97,159,421
17008,LAL,2001,Robert Horry,30,79,1,1587,147,380,.387,54,156,.346,93,224,.415,.458,59,83,.711,93,203,296,128,54,54,79,210,407
17009,LAL,2001,Isaiah Rider,29,67,6,1206,201,472,.426,34,92,.370,167,380,.439,.462,71,83,.855,44,112,156,111,27,7,98,105,507
17010,LAL,2001,Ron Harper,37,47,46,1139,127,271,.469,19,72,.264,108,199,.543,.504,34,48,.708,46,120,166,113,39,25,62,70,307
17011,LAL,2001,Mike Penberthy,26,53,0,851,92,222,.414,55,139,.396,37,83,.446,.538,28,31,.903,10,53,63,71,22,2,34,57,267
17012,LAL,2001,Derek Fisher,26,20,20,709,77,187,.412,25,63,.397,52,124,.419,.479,50,62,.806,5,54,59,87,39,2,29,50,229
17013,LAL,2001,Mark Madsen,25,70,3,641,55,113,.487,1,1,1.000,54,112,.482,.491,26,37,.703,74,78,152,24,8,8,27,111,137
17014,LAL,2001,Devean George,23,59,1,593,64,207,.309,15,68,.221,49,139,.353,.345,39,55,.709,35,75,110,19,15,15,34,87,182
17015,LAL,2001,Tyronn Lue,23,38,1,468,50,117,.427,11,34,.324,39,83,.470,.474,19,24,.792,5,27,32,45,19,0,27,54,130
17016,LAL,2001,Greg Foster,32,62,8,451,56,133,.421,3,9,.333,53,124,.427,.432,10,14,.714,29,83,112,32,9,12,25,76,125
17017,LAL,2001,Stanislav Medvedenko,21,7,0,39,12,25,.480,1,1,1.000,11,24,.458,.500,7,12,.583,1,8,9,2,1,1,3,9,32
17018,LAL,2000,Shaquille O'Neal,27,79,79,3163,956,1665,.574,0,1,.000,956,1664,.575,.574,432,824,.524,336,742,1078,299,36,239,223,255,2344
17019,LAL,2000,Glen Rice,32,80,80,2530,421,980,.430,84,229,.367,337,751,.449,.472,346,396,.874,56,271,327,176,47,12,114,179,1272
17020,LAL,2000,Kobe Bryant,21,66,62,2524,554,1183,.468,46,144,.319,508,1039,.489,.488,331,403,.821,108,308,416,323,106,62,182,220,1485
17021,LAL,2000,Ron Harper,36,80,78,2042,212,531,.399,33,106,.311,179,425,.421,.430,100,147,.680,96,241,337,270,85,39,132,164,557
17022,LAL,2000,A.C. Green,36,82,82,1929,173,387,.447,1,4,.250,172,383,.449,.448,66,95,.695,160,326,486,80,53,18,53,127,413
17023,LAL,2000,Derek Fisher,25,78,22,1803,167,483,.346,52,166,.313,115,317,.363,.400,105,145,.724,22,121,143,216,80,3,75,150,491
17024,LAL,2000,Robert Horry,29,76,0,1685,159,363,.438,29,94,.309,130,269,.483,.478,89,113,.788,133,228,361,118,84,80,73,189,436
17025,LAL,2000,Rick Fox,30,82,1,1473,206,498,.414,59,181,.326,147,317,.464,.473,63,78,.808,63,135,198,138,52,26,87,203,534
17026,LAL,2000,Brian Shaw,33,74,2,1249,123,322,.382,18,58,.310,105,264,.398,.410,41,54,.759,45,171,216,201,35,14,75,105,305
17027,LAL,2000,Travis Knight,25,63,0,410,46,118,.390,0,0,,46,118,.390,.390,17,28,.607,46,83,129,23,6,23,26,88,109
17028,LAL,2000,Devean George,22,49,1,345,56,144,.389,16,47,.340,40,97,.412,.444,27,41,.659,29,46,75,12,10,4,21,54,155
17029,LAL,2000,John Salley,35,45,3,303,25,69,.362,0,0,,25,69,.362,.362,21,28,.750,20,45,65,26,8,14,18,67,71
17030,LAL,2000,John Celestand,22,16,0,185,15,45,.333,2,9,.222,13,36,.361,.356,5,6,.833,1,10,11,20,7,0,16,22,37
17031,LAL,2000,Tyronn Lue,22,8,0,146,19,39,.487,4,8,.500,15,31,.484,.538,6,8,.750,2,10,12,17,3,0,9,17,48
17032,LAL,2000,Sam Jacobson,24,3,0,18,5,9,.556,0,0,,5,9,.556,.556,0,2,.000,0,1,1,2,1,0,2,1,10
17033,LAL,1999,Kobe Bryant,20,50,50,1896,362,779,.465,27,101,.267,335,678,.494,.482,245,292,.839,53,211,264,190,72,50,157,153,996
17034,LAL,1999,Shaquille O'Neal,26,49,49,1705,510,885,.576,0,1,.000,510,884,.577,.576,269,498,.540,187,338,525,114,36,82,122,155,1289
17035,LAL,1999,Derek Fisher,24,50,21,1131,99,263,.376,38,97,.392,61,166,.367,.449,60,79,.759,21,70,91,197,61,1,77,95,296
17036,LAL,1999,Derek Harper,37,45,29,1120,120,291,.412,43,117,.368,77,174,.443,.486,26,32,.813,13,54,67,187,44,4,52,66,309
17037,LAL,1999,Glen Rice,31,27,25,985,171,396,.432,53,135,.393,118,261,.452,.499,77,90,.856,9,90,99,71,17,6,45,67,472
17038,LAL,1999,Rick Fox,29,44,1,944,148,330,.448,32,95,.337,116,235,.494,.497,66,89,.742,26,63,89,89,28,10,56,114,394
17039,LAL,1999,Robert Horry,28,38,5,744,67,146,.459,20,45,.444,47,101,.465,.527,34,46,.739,56,96,152,56,36,39,49,103,188
17040,LAL,1999,Eddie Jones,27,20,20,724,96,227,.423,20,64,.313,76,163,.466,.467,59,80,.738,20,56,76,61,35,24,21,42,271
17041,LAL,1999,Dennis Rodman,37,23,11,657,16,46,.348,0,2,.000,16,44,.364,.348,17,39,.436,62,196,258,30,10,12,31,71,49
17042,LAL,1999,Travis Knight,24,37,23,525,67,130,.515,0,1,.000,67,129,.519,.515,22,29,.759,34,94,128,31,21,27,35,108,156
17043,LAL,1999,J.R. Reid,30,25,10,473,44,108,.407,0,1,.000,44,107,.411,.407,38,53,.717,24,75,99,23,15,0,23,72,126
17044,LAL,1999,Elden Campbell,30,17,1,325,44,101,.436,0,0,,44,101,.436,.436,38,62,.613,38,58,96,8,1,16,22,51,126
17045,LAL,1999,Sean Rooks,29,36,0,315,32,79,.405,0,2,.000,32,77,.416,.405,34,48,.708,33,39,72,9,2,9,21,61,98
17046,LAL,1999,Tyronn Lue,21,15,0,188,28,65,.431,7,16,.438,21,49,.429,.485,12,21,.571,2,4,6,25,5,0,11,28,75
17047,LAL,1999,Corie Blount,30,14,3,162,13,33,.394,0,1,.000,13,32,.406,.394,6,12,.500,24,22,46,2,1,4,6,27,32
17048,LAL,1999,Ruben Patterson,23,24,2,144,21,51,.412,1,6,.167,20,45,.444,.422,22,31,.710,17,13,30,2,5,3,12,16,65
17049,LAL,1999,Sam Jacobson,23,2,0,12,3,5,.600,0,1,.000,3,4,.750,.600,2,2,1.000,0,3,3,0,0,0,1,2,8
17050,LAL,1998,Eddie Jones,26,80,80,2910,486,1005,.484,143,368,.389,343,637,.538,.555,234,306,.765,85,217,302,246,160,55,146,164,1349
17051,LAL,1998,Rick Fox,28,82,82,2709,363,771,.471,86,265,.325,277,506,.547,.527,171,230,.743,78,280,358,276,100,48,201,309,983
17052,LAL,1998,Robert Horry,27,72,71,2192,200,420,.476,19,93,.204,181,327,.554,.499,117,169,.692,186,356,542,163,112,94,99,238,536
17053,LAL,1998,Shaquille O'Neal,25,60,57,2175,670,1147,.584,0,0,,670,1147,.584,.584,359,681,.527,208,473,681,142,39,144,175,193,1699
17054,LAL,1998,Kobe Bryant,19,79,1,2056,391,913,.428,75,220,.341,316,693,.456,.469,363,457,.794,79,163,242,199,74,40,157,180,1220
17055,LAL,1998,Nick Van Exel,26,64,46,2053,311,743,.419,123,316,.389,188,427,.440,.501,136,172,.791,31,163,194,442,64,6,104,120,881
17056,LAL,1998,Elden Campbell,29,81,28,1784,289,624,.463,1,2,.500,288,622,.463,.464,237,342,.693,143,312,455,78,35,102,115,209,816
17057,LAL,1998,Derek Fisher,23,82,36,1760,164,378,.434,31,81,.383,133,297,.448,.475,115,152,.757,38,155,193,333,75,5,119,126,474
17058,LAL,1998,Corie Blount,29,70,3,1029,107,187,.572,0,4,.000,107,183,.585,.572,39,78,.500,114,184,298,37,29,25,51,157,253
17059,LAL,1998,Sean Rooks,28,41,1,425,46,101,.455,0,0,,46,101,.455,.455,47,79,.595,46,72,118,24,2,23,19,68,139
17060,LAL,1998,Jon Barry,28,49,1,374,38,104,.365,18,61,.295,20,43,.465,.452,27,29,.931,8,29,37,51,24,3,22,33,121
17061,LAL,1998,Mario Bennett,24,45,4,354,80,135,.593,1,2,.500,79,133,.594,.596,16,44,.364,60,66,126,18,19,11,21,61,177
17062,LAL,1998,Shea Seals,22,4,0,9,1,8,.125,0,3,.000,1,5,.200,.125,2,4,.500,3,1,4,0,1,0,0,1,4
17063,LAL,1997,Eddie Jones,25,80,80,2998,473,1081,.438,152,389,.391,321,692,.464,.508,276,337,.819,90,236,326,270,189,49,169,226,1374
17064,LAL,1997,Nick Van Exel,25,79,79,2937,432,1075,.402,177,468,.378,255,607,.420,.484,165,200,.825,44,182,226,672,75,10,212,110,1206
17065,LAL,1997,Elden Campbell,28,77,77,2516,442,942,.469,1,4,.250,441,938,.470,.470,263,370,.711,207,408,615,126,46,117,130,276,1148
17066,LAL,1997,Shaquille O'Neal,24,51,51,1941,552,991,.557,0,4,.000,552,987,.559,.557,232,479,.484,195,445,640,159,46,147,146,180,1336
17067,LAL,1997,Jerome Kersey,34,70,44,1766,194,449,.432,17,65,.262,177,384,.461,.451,71,118,.602,112,251,363,89,119,49,74,219,476
17068,LAL,1997,Byron Scott,35,79,8,1440,163,379,.430,73,188,.388,90,191,.471,.526,127,151,.841,21,97,118,99,46,16,53,72,526
17069,LAL,1997,Travis Knight,22,71,14,1156,140,275,.509,0,0,,140,275,.509,.509,62,100,.620,130,189,319,39,31,58,49,170,342
17070,LAL,1997,Kobe Bryant,18,71,6,1103,176,422,.417,51,136,.375,125,286,.437,.477,136,166,.819,47,85,132,91,49,23,112,102,539
17071,LAL,1997,Corie Blount,28,58,18,1009,92,179,.514,1,3,.333,91,176,.517,.517,56,83,.675,113,163,276,35,22,26,50,121,241
17072,LAL,1997,Derek Fisher,22,80,3,921,104,262,.397,22,73,.301,82,189,.434,.439,79,120,.658,25,72,97,119,41,5,71,87,309
17073,LAL,1997,Sean Rooks,27,69,3,735,87,185,.470,0,1,.000,87,184,.473,.470,91,130,.700,56,107,163,42,17,38,51,123,265
17074,LAL,1997,Robert Horry,26,22,14,676,75,165,.455,25,76,.329,50,89,.562,.530,28,40,.700,28,90,118,56,38,29,26,72,203
17075,LAL,1997,George McCloud,29,23,2,286,34,96,.354,21,49,.429,13,47,.277,.464,6,9,.667,7,29,36,17,9,0,9,20,95
17076,LAL,1997,Cedric Ceballos,27,8,8,279,34,83,.410,5,21,.238,29,62,.468,.440,13,15,.867,11,42,53,15,5,6,17,19,86
17077,LAL,1997,Rumeal Robinson,30,15,3,126,17,48,.354,6,23,.261,11,25,.440,.417,5,8,.625,2,8,10,13,5,2,11,12,45
17078,LAL,1997,Joe Kleine,35,8,0,30,2,8,.250,0,0,,2,8,.250,.250,2,2,1.000,2,7,9,0,0,0,0,6,6
17079,LAL,1997,Larry Krystkowiak,32,3,0,11,1,2,.500,0,0,,1,2,.500,.500,1,2,.500,2,3,5,3,2,0,1,3,3
17080,LAL,1996,Elden Campbell,27,82,82,2699,447,888,.503,0,5,.000,447,883,.506,.503,249,349,.713,162,461,623,181,88,212,137,300,1143
17081,LAL,1996,Cedric Ceballos,26,78,71,2628,638,1203,.530,51,184,.277,587,1019,.576,.552,329,409,.804,215,321,536,119,94,22,167,144,1656
17082,LAL,1996,Nick Van Exel,24,74,74,2513,396,950,.417,144,403,.357,252,547,.461,.493,163,204,.799,29,152,181,509,70,10,156,115,1099
17083,LAL,1996,Vlade Divac,27,79,79,2470,414,807,.513,3,18,.167,411,789,.521,.515,189,295,.641,198,481,679,261,76,131,199,274,1020
17084,LAL,1996,Eddie Jones,24,70,66,2184,337,685,.492,83,227,.366,254,458,.555,.553,136,184,.739,45,188,233,246,129,45,99,162,893
17085,LAL,1996,Sedale Threatt,34,82,8,1687,241,526,.458,60,169,.355,181,357,.507,.515,54,71,.761,20,75,95,269,68,11,74,178,596
17086,LAL,1996,Anthony Peeler,26,73,12,1608,272,602,.452,105,254,.413,167,348,.480,.539,61,86,.709,45,92,137,118,59,10,56,139,710
17087,LAL,1996,George Lynch,25,76,6,1012,117,272,.430,4,13,.308,113,259,.436,.438,53,80,.663,82,127,209,51,47,10,40,106,291
17088,LAL,1996,Magic Johnson,36,32,9,958,137,294,.466,22,58,.379,115,236,.487,.503,172,201,.856,40,143,183,220,26,13,103,48,468
17089,LAL,1996,Derek Strong,27,63,0,746,72,169,.426,1,9,.111,71,160,.444,.429,69,85,.812,60,118,178,32,18,12,20,80,214
17090,LAL,1996,Corie Blount,27,57,2,715,79,167,.473,0,2,.000,79,165,.479,.473,25,44,.568,69,101,170,42,25,35,47,109,183
17091,LAL,1996,Fred Roberts,35,33,1,317,48,97,.495,4,14,.286,44,83,.530,.515,22,28,.786,18,29,47,26,16,4,24,24,122
17092,LAL,1996,Anthony Miller,24,27,0,123,15,35,.429,0,2,.000,15,33,.455,.429,6,10,.600,11,14,25,4,4,1,8,19,36
17093,LAL,1996,Frankie King,23,6,0,20,3,11,.273,0,1,.000,3,10,.300,.273,1,3,.333,1,1,2,2,2,0,2,4,7
17094,LAL,1995,Nick Van Exel,23,80,80,2944,465,1107,.420,183,511,.358,282,596,.473,.503,235,300,.783,27,196,223,660,97,6,220,157,1348
17095,LAL,1995,Vlade Divac,26,80,80,2807,485,957,.507,10,53,.189,475,904,.525,.512,297,382,.777,261,568,829,329,109,174,205,305,1277
17096,LAL,1995,Elden Campbell,26,73,59,2076,360,785,.459,0,1,.000,360,784,.459,.459,193,290,.666,168,277,445,92,69,132,98,246,913
17097,LAL,1995,Cedric Ceballos,25,58,54,2029,497,977,.509,58,146,.397,439,831,.528,.538,209,292,.716,169,295,464,105,60,19,143,131,1261
17098,LAL,1995,Eddie Jones,23,64,58,1981,342,744,.460,91,246,.370,251,498,.504,.521,122,169,.722,79,170,249,128,131,41,75,175,897
17099,LAL,1995,Anthony Peeler,25,73,24,1559,285,659,.432,84,216,.389,201,443,.454,.496,102,128,.797,62,106,168,122,52,13,82,143,756
17100,LAL,1995,Sedale Threatt,33,59,2,1384,217,437,.497,36,95,.379,181,342,.529,.538,88,111,.793,21,103,124,248,54,12,70,139,558
17101,LAL,1995,Sam Bowie,33,67,10,1225,118,267,.442,2,11,.182,116,256,.453,.446,68,89,.764,72,216,288,118,21,80,91,182,306
17102,LAL,1995,Tony Smith,26,61,4,1024,132,309,.427,32,91,.352,100,218,.459,.479,44,63,.698,43,64,107,102,46,7,50,111,340
17103,LAL,1995,George Lynch,24,56,15,953,138,295,.468,3,21,.143,135,274,.493,.473,62,86,.721,75,109,184,62,51,10,73,86,341
17104,LAL,1995,Antonio Harvey,24,59,8,572,77,176,.438,1,1,1.000,76,175,.434,.440,24,45,.533,39,63,102,23,15,41,25,87,179
17105,LAL,1995,Lloyd Daniels,27,25,14,541,71,182,.390,23,86,.267,48,96,.500,.453,20,25,.800,27,29,56,36,20,10,23,40,185
17106,LAL,1995,Anthony Miller,23,46,1,527,70,132,.530,2,5,.400,68,127,.535,.538,47,76,.618,67,85,152,35,20,7,38,77,189
17107,LAL,1995,Kurt Rambis,36,26,1,195,18,35,.514,0,0,,18,35,.514,.514,8,12,.667,10,24,34,16,3,9,8,35,44
17108,LAL,1995,Randolph Keys,28,6,0,83,9,26,.346,0,9,.000,9,17,.529,.346,2,2,1.000,6,11,17,2,1,2,2,16,20
17109,LAL,1995,Lester Conner,35,2,0,5,0,0,,0,0,,0,0,,,2,2,1.000,0,0,0,0,1,0,0,3,2
17110,LAL,1994,Nick Van Exel,22,81,80,2700,413,1049,.394,123,364,.338,290,685,.423,.452,150,192,.781,47,191,238,466,85,8,145,154,1099
17111,LAL,1994,Vlade Divac,25,79,73,2685,453,895,.506,9,47,.191,444,848,.524,.511,208,303,.686,282,569,851,307,92,112,191,288,1123
17112,LAL,1994,Sedale Threatt,32,81,20,2278,411,852,.482,5,33,.152,406,819,.496,.485,138,155,.890,28,125,153,344,110,19,106,186,965
17113,LAL,1994,Elden Campbell,25,76,74,2253,373,808,.462,0,2,.000,373,806,.463,.462,188,273,.689,167,352,519,86,64,146,98,241,934
17114,LAL,1994,George Lynch,23,71,46,1762,291,573,.508,0,5,.000,291,568,.512,.508,99,166,.596,220,190,410,96,102,27,87,177,681
17115,LAL,1994,Tony Smith,25,73,31,1617,272,617,.441,16,50,.320,256,567,.451,.454,85,119,.714,106,89,195,148,59,14,76,128,645
17116,LAL,1994,James Worthy,32,80,2,1597,340,838,.406,32,111,.288,308,727,.424,.425,100,135,.741,48,133,181,154,45,18,97,80,812
17117,LAL,1994,Doug Christie,23,65,34,1515,244,562,.434,39,119,.328,205,443,.463,.469,145,208,.697,93,142,235,136,89,28,140,186,672
17118,LAL,1994,Anthony Peeler,24,30,30,923,176,409,.430,14,63,.222,162,346,.468,.447,57,71,.803,48,61,109,94,43,8,59,93,423
17119,LAL,1994,Kurt Rambis,35,50,1,635,59,114,.518,0,1,.000,59,113,.522,.518,46,71,.648,84,105,189,32,22,23,26,89,164
17120,LAL,1994,Sam Bowie,32,25,7,556,75,172,.436,1,4,.250,74,168,.440,.439,72,83,.867,27,104,131,47,4,28,43,65,223
17121,LAL,1994,James Edwards,38,45,2,469,78,168,.464,0,0,,78,168,.464,.464,54,79,.684,11,54,65,22,4,3,30,90,210
17122,LAL,1994,Reggie Jordan,26,23,0,259,44,103,.427,2,4,.500,42,99,.424,.437,35,51,.686,46,21,67,26,14,5,14,26,125
17123,LAL,1994,Antonio Harvey,23,27,6,247,29,79,.367,0,0,,29,79,.367,.367,12,26,.462,26,33,59,5,8,19,17,39,70
17124,LAL,1994,Danny Schayes,34,13,0,133,14,38,.368,0,0,,14,38,.368,.368,8,10,.800,15,19,34,8,5,2,9,18,36
17125,LAL,1994,Trevor Wilson,25,5,4,126,19,39,.487,0,0,,19,39,.487,.487,13,25,.520,12,16,28,12,5,1,6,17,51
17126,LAL,1993,Sedale Threatt,31,82,82,2893,522,1028,.508,14,53,.264,508,975,.521,.515,177,215,.823,47,226,273,564,142,11,173,248,1235
17127,LAL,1993,A.C. Green,29,82,55,2819,379,706,.537,16,46,.348,363,660,.550,.548,277,375,.739,287,424,711,116,88,39,116,149,1051
17128,LAL,1993,Vlade Divac,24,82,69,2525,397,819,.485,21,75,.280,376,744,.505,.498,235,341,.689,220,509,729,232,128,140,214,311,1050
17129,LAL,1993,James Worthy,31,82,69,2359,510,1142,.447,30,111,.270,480,1031,.466,.460,171,211,.810,73,174,247,278,92,27,137,87,1221
17130,LAL,1993,Byron Scott,31,58,53,1677,296,659,.449,44,135,.326,252,524,.481,.483,156,184,.848,27,107,134,157,55,13,70,98,792
17131,LAL,1993,Anthony Peeler,23,77,11,1656,297,634,.468,46,118,.390,251,516,.486,.505,162,206,.786,64,115,179,166,60,14,123,193,802
17132,LAL,1993,Sam Perkins,31,49,49,1589,242,527,.459,5,29,.172,237,498,.476,.464,184,222,.829,111,268,379,128,40,51,76,139,673
17133,LAL,1993,Elden Campbell,24,79,13,1551,238,520,.458,0,3,.000,238,517,.460,.458,130,204,.637,127,205,332,48,59,100,69,165,606
17134,LAL,1993,Tony Smith,24,55,9,752,133,275,.484,2,11,.182,131,264,.496,.487,62,82,.756,46,41,87,63,50,7,40,72,330
17135,LAL,1993,Duane Cooper,23,65,0,645,62,158,.392,7,30,.233,55,128,.430,.415,25,35,.714,13,37,50,150,18,2,69,66,156
17136,LAL,1993,James Edwards,37,52,0,617,122,270,.452,0,0,,122,270,.452,.452,84,118,.712,30,70,100,41,10,7,51,122,328
17137,LAL,1993,Doug Christie,22,23,0,332,45,106,.425,2,12,.167,43,94,.457,.434,50,66,.758,24,27,51,53,22,5,50,53,142
17138,LAL,1993,Benoit Benjamin,28,28,0,306,52,108,.481,0,0,,52,108,.481,.481,22,37,.595,24,72,96,10,14,13,36,61,126
17139,LAL,1993,Alex Blackwell,22,27,0,109,14,42,.333,0,3,.000,14,39,.359,.333,6,8,.750,10,13,23,7,4,2,5,14,34
17140,LAL,1992,Sedale Threatt,30,82,82,3070,509,1041,.489,20,62,.323,489,979,.499,.499,202,243,.831,43,210,253,593,168,16,182,231,1240
17141,LAL,1992,A.C. Green,28,82,53,2902,382,803,.476,12,56,.214,370,747,.495,.483,340,457,.744,306,456,762,117,91,36,111,141,1116
17142,LAL,1992,Byron Scott,30,82,82,2679,460,1005,.458,54,157,.344,406,848,.479,.485,244,291,.838,74,236,310,226,105,28,119,140,1218
17143,LAL,1992,Sam Perkins,30,63,63,2332,361,803,.450,15,69,.217,346,734,.471,.459,304,372,.817,192,364,556,141,64,62,83,192,1041
17144,LAL,1992,James Worthy,30,54,54,2108,450,1007,.447,9,43,.209,441,964,.457,.451,166,204,.814,98,207,305,252,76,23,127,89,1075
17145,LAL,1992,Elden Campbell,23,81,47,1876,220,491,.448,0,2,.000,220,489,.450,.448,138,223,.619,155,268,423,59,53,159,73,203,578
17146,LAL,1992,Terry Teagle,31,82,0,1602,364,805,.452,1,4,.250,363,801,.453,.453,151,197,.766,91,92,183,113,66,9,114,148,880
17147,LAL,1992,Vlade Divac,23,36,18,979,157,317,.495,5,19,.263,152,298,.510,.503,86,112,.768,87,160,247,60,55,35,88,114,405
17148,LAL,1992,Tony Smith,23,63,0,820,113,283,.399,0,11,.000,113,272,.415,.399,49,75,.653,31,45,76,109,39,8,50,91,275
17149,LAL,1992,Rory Sparrow,33,42,0,471,57,143,.399,2,13,.154,55,130,.423,.406,8,13,.615,3,24,27,79,12,5,31,55,124
17150,LAL,1992,Jack Haley,28,49,9,394,31,84,.369,0,0,,31,84,.369,.369,14,29,.483,31,64,95,7,7,8,25,75,76
17151,LAL,1992,Chucky Brown,23,36,2,381,55,118,.466,0,3,.000,55,115,.478,.466,25,41,.610,29,47,76,23,9,7,27,41,135
17152,LAL,1992,Keith Owens,22,20,0,80,9,32,.281,0,0,,9,32,.281,.281,8,10,.800,8,7,15,3,5,4,2,11,26
17153,LAL,1992,Cliff Robinson,31,9,0,78,11,27,.407,0,1,.000,11,26,.423,.407,7,8,.875,7,12,19,9,5,0,7,4,29
17154,LAL,1992,Demetrius Calip,22,7,0,58,4,18,.222,1,5,.200,3,13,.231,.250,2,3,.667,1,4,5,12,1,0,5,8,11
17155,LAL,1991,James Worthy,29,78,74,3008,716,1455,.492,26,90,.289,690,1365,.505,.501,212,266,.797,107,249,356,275,104,35,127,117,1670
17156,LAL,1991,Magic Johnson,31,79,79,2933,466,976,.477,80,250,.320,386,726,.532,.518,519,573,.906,105,446,551,989,102,17,314,150,1531
17157,LAL,1991,Byron Scott,29,82,82,2630,501,1051,.477,71,219,.324,430,832,.517,.510,118,148,.797,54,192,246,177,95,21,85,146,1191
17158,LAL,1991,Sam Perkins,29,73,66,2504,368,744,.495,18,64,.281,350,680,.515,.507,229,279,.821,167,371,538,108,64,78,103,247,983
17159,LAL,1991,Vlade Divac,22,82,81,2310,360,637,.565,5,14,.357,355,623,.570,.569,196,279,.703,205,461,666,92,106,127,146,247,921
17160,LAL,1991,A.C. Green,27,82,21,2164,258,542,.476,11,55,.200,247,487,.507,.486,223,302,.738,201,315,516,71,59,23,99,117,750
17161,LAL,1991,Terry Teagle,30,82,0,1498,335,757,.443,0,9,.000,335,748,.448,.443,145,177,.819,82,99,181,82,31,8,83,165,815
17162,LAL,1991,Mychal Thompson,36,72,4,1077,113,228,.496,0,2,.000,113,226,.500,.496,62,88,.705,74,154,228,21,23,23,47,112,288
17163,LAL,1991,Tony Smith,22,64,1,695,97,220,.441,0,7,.000,97,213,.455,.441,40,57,.702,24,47,71,135,28,12,69,80,234
17164,LAL,1991,Larry Drew,32,48,2,496,54,125,.432,14,33,.424,40,92,.435,.488,17,22,.773,5,29,34,118,15,1,49,40,139
17165,LAL,1991,Elden Campbell,22,52,0,380,56,123,.455,0,0,,56,123,.455,.455,32,49,.653,40,56,96,10,11,38,16,71,144
17166,LAL,1991,Irving Thomas,25,26,0,108,17,50,.340,0,0,,17,50,.340,.340,12,21,.571,14,17,31,10,4,1,13,24,46
17167,LAL,1991,Tony Brown,30,7,0,27,2,3,.667,1,1,1.000,1,2,.500,.833,0,0,,0,4,4,3,0,0,4,8,5
17168,LAL,1990,James Worthy,28,80,80,2960,711,1298,.548,15,49,.306,696,1249,.557,.554,248,317,.782,160,318,478,288,99,49,160,190,1685
17169,LAL,1990,Magic Johnson,30,79,79,2937,546,1138,.480,106,276,.384,440,862,.510,.526,567,637,.890,128,394,522,907,132,34,289,167,1765
17170,LAL,1990,A.C. Green,26,82,82,2709,385,806,.478,13,46,.283,372,760,.489,.486,278,370,.751,262,450,712,90,66,50,116,207,1061
17171,LAL,1990,Byron Scott,28,77,77,2593,472,1005,.470,93,220,.423,379,785,.483,.516,160,209,.766,51,191,242,274,77,31,122,180,1197
17172,LAL,1990,Mychal Thompson,35,70,70,1883,281,562,.500,0,0,,281,562,.500,.500,144,204,.706,173,304,477,43,33,73,79,207,706
17173,LAL,1990,Michael Cooper,33,80,10,1851,191,493,.387,50,157,.318,141,336,.420,.438,83,94,.883,59,168,227,215,67,36,91,206,515
17174,LAL,1990,Vlade Divac,21,82,5,1611,274,549,.499,0,5,.000,274,544,.504,.499,153,216,.708,167,345,512,75,79,114,110,240,701
17175,LAL,1990,Orlando Woolridge,30,62,2,1421,306,550,.556,0,5,.000,306,545,.561,.556,176,240,.733,49,136,185,96,39,46,73,160,788
17176,LAL,1990,Larry Drew,31,80,3,1333,170,383,.444,32,81,.395,138,302,.457,.486,46,60,.767,12,86,98,217,47,4,95,92,418
17177,LAL,1990,Jay Vincent,30,24,1,200,41,78,.526,0,1,.000,41,77,.532,.526,8,12,.667,7,19,26,10,8,3,19,29,90
17178,LAL,1990,Mark McNamara,30,33,1,190,38,86,.442,0,0,,38,86,.442,.442,26,40,.650,22,41,63,3,2,1,21,31,102
17179,LAL,1990,Steve Bucknall,23,18,0,75,9,33,.273,0,1,.000,9,32,.281,.273,5,6,.833,5,2,7,10,2,1,11,10,23
17180,LAL,1990,Mel McCants,22,13,0,65,8,26,.308,0,0,,8,26,.308,.308,6,8,.750,1,5,6,2,3,1,1,11,22
17181,LAL,1990,Mike Higgins,22,6,0,18,0,0,,0,0,,0,0,,,1,2,.500,1,0,1,1,1,2,0,4,1
17182,LAL,1990,Jawann Oldham,32,3,0,9,2,3,.667,0,0,,2,3,.667,.667,1,2,.500,0,1,1,1,0,0,1,3,5
17183,LAL,1989,James Worthy,27,81,81,2960,702,1282,.548,2,23,.087,700,1259,.556,.548,251,321,.782,169,320,489,288,108,56,182,175,1657
17184,LAL,1989,Magic Johnson,29,77,77,2886,579,1137,.509,59,188,.314,520,949,.548,.535,513,563,.911,111,496,607,988,138,22,312,172,1730
17185,LAL,1989,Byron Scott,27,74,73,2605,588,1198,.491,77,193,.399,511,1005,.508,.523,195,226,.863,72,230,302,231,114,27,157,181,1448
17186,LAL,1989,A.C. Green,25,82,82,2510,401,758,.529,4,17,.235,397,741,.536,.532,282,359,.786,258,481,739,103,94,55,119,172,1088
17187,LAL,1989,Mychal Thompson,34,80,8,1994,291,521,.559,0,1,.000,291,520,.560,.559,156,230,.678,157,310,467,48,58,59,97,224,738
17188,LAL,1989,Michael Cooper,32,80,13,1943,213,494,.431,80,210,.381,133,284,.468,.512,81,93,.871,33,158,191,314,72,32,94,186,587
17189,LAL,1989,Kareem Abdul-Jabbar,41,74,74,1695,313,659,.475,0,3,.000,313,656,.477,.475,122,165,.739,103,231,334,74,38,85,95,196,748
17190,LAL,1989,Orlando Woolridge,29,74,0,1491,231,494,.468,0,1,.000,231,493,.469,.468,253,343,.738,81,189,270,58,30,65,103,130,715
17191,LAL,1989,Tony Campbell,26,63,2,787,158,345,.458,2,21,.095,156,324,.481,.461,70,83,.843,53,77,130,47,37,6,62,108,388
17192,LAL,1989,David Rivers,24,47,0,440,49,122,.402,1,6,.167,48,116,.414,.406,35,42,.833,13,30,43,106,23,9,61,50,134
17193,LAL,1989,Mark McNamara,29,39,0,318,32,64,.500,0,0,,32,64,.500,.500,49,78,.628,38,62,100,10,4,3,24,51,113
17194,LAL,1989,Jeff Lamp,29,37,0,176,27,69,.391,2,4,.500,25,65,.385,.406,4,5,.800,6,28,34,15,8,2,16,27,60
17195,LAL,1988,Byron Scott,26,81,81,3048,710,1348,.527,62,179,.346,648,1169,.554,.550,272,317,.858,76,257,333,335,155,27,161,204,1754
17196,LAL,1988,James Worthy,26,75,72,2655,617,1161,.531,2,16,.125,615,1145,.537,.532,242,304,.796,129,245,374,289,72,55,155,175,1478
17197,LAL,1988,Magic Johnson,28,72,70,2637,490,996,.492,11,56,.196,479,940,.510,.497,417,489,.853,88,361,449,858,114,13,269,147,1408
17198,LAL,1988,A.C. Green,24,82,64,2636,322,640,.503,0,2,.000,322,638,.505,.503,293,379,.773,245,465,710,93,87,45,120,204,937
17199,LAL,1988,Kareem Abdul-Jabbar,40,80,80,2308,480,903,.532,0,1,.000,480,902,.532,.532,205,269,.762,118,360,478,135,48,92,159,216,1165
17200,LAL,1988,Mychal Thompson,33,80,0,2007,370,722,.512,0,3,.000,370,719,.515,.512,185,292,.634,198,291,489,66,38,79,113,251,925
17201,LAL,1988,Michael Cooper,31,61,8,1793,189,482,.392,57,178,.320,132,304,.434,.451,97,113,.858,50,178,228,289,66,26,101,136,532
17202,LAL,1988,Kurt Rambis,29,70,20,845,102,186,.548,0,0,,102,186,.548,.548,73,93,.785,103,165,268,54,39,13,59,103,277
17203,LAL,1988,Wes Matthews,28,51,8,706,114,248,.460,7,30,.233,107,218,.491,.474,54,65,.831,16,50,66,138,25,3,69,65,289
17204,LAL,1988,Mike Smrek,25,48,2,421,44,103,.427,0,0,,44,103,.427,.427,44,66,.667,27,58,85,8,7,42,30,105,132
17205,LAL,1988,Milt Wagner,24,40,4,380,62,147,.422,2,10,.200,60,137,.438,.429,26,29,.897,4,24,28,61,6,4,22,42,152
17206,LAL,1988,Tony Campbell,25,13,1,242,57,101,.564,1,3,.333,56,98,.571,.569,28,39,.718,8,19,27,15,11,2,26,41,143
17207,LAL,1988,Ray Tolbert,29,14,0,82,16,28,.571,0,0,,16,28,.571,.571,10,13,.769,9,11,20,5,3,3,11,14,42
17208,LAL,1988,Billy Thompson,24,9,0,38,3,13,.231,0,0,,3,13,.231,.231,8,10,.800,2,7,9,1,1,0,6,11,14
17209,LAL,1988,Jeff Lamp,28,3,0,7,0,0,,0,0,,0,0,,,2,2,1.000,0,0,0,0,0,0,0,1,2
17210,LAL,1987,Magic Johnson,27,80,80,2904,683,1308,.522,8,39,.205,675,1269,.532,.525,535,631,.848,122,382,504,977,138,36,300,168,1909
17211,LAL,1987,James Worthy,25,82,82,2819,651,1207,.539,0,13,.000,651,1194,.545,.539,292,389,.751,158,308,466,226,108,83,168,206,1594
17212,LAL,1987,Byron Scott,25,82,82,2729,554,1134,.489,65,149,.436,489,985,.496,.517,224,251,.892,63,223,286,281,125,18,144,163,1397
17213,LAL,1987,Kareem Abdul-Jabbar,39,78,78,2441,560,993,.564,1,3,.333,559,990,.565,.564,245,343,.714,152,371,523,203,49,97,186,245,1366
17214,LAL,1987,Michael Cooper,30,82,2,2253,322,736,.438,89,231,.385,233,505,.461,.498,126,148,.851,58,196,254,373,78,43,102,199,859
17215,LAL,1987,A.C. Green,23,79,72,2240,316,587,.538,0,5,.000,316,582,.543,.538,220,282,.780,210,405,615,84,70,80,102,171,852
17216,LAL,1987,Kurt Rambis,28,78,10,1514,163,313,.521,0,0,,163,313,.521,.521,120,157,.764,159,294,453,63,74,41,104,201,446
17217,LAL,1987,Billy Thompson,23,59,0,762,142,261,.544,0,1,.000,142,260,.546,.544,48,74,.649,69,102,171,60,15,30,61,148,332
17218,LAL,1987,Mychal Thompson,32,33,1,680,129,269,.480,0,1,.000,129,268,.481,.480,75,101,.743,47,89,136,28,14,30,57,85,333
17219,LAL,1987,Wes Matthews,27,50,0,532,89,187,.476,1,3,.333,88,184,.478,.479,29,36,.806,13,34,47,100,23,4,51,53,208
17220,LAL,1987,Frank Brickowski,27,37,0,404,53,94,.564,0,0,,53,94,.564,.564,40,59,.678,40,57,97,12,14,4,25,105,146
17221,LAL,1987,Mike Smrek,24,35,3,233,30,60,.500,0,0,,30,60,.500,.500,16,25,.640,13,24,37,5,4,13,19,70,76
17222,LAL,1987,Adrian Branch,23,32,0,219,48,96,.500,0,2,.000,48,94,.511,.500,42,54,.778,23,30,53,16,16,3,24,39,138
17223,LAL,1986,Kareem Abdul-Jabbar,38,79,79,2629,755,1338,.564,0,2,.000,755,1336,.565,.564,336,439,.765,133,345,478,280,67,130,203,248,1846
17224,LAL,1986,Magic Johnson,26,72,70,2578,483,918,.526,10,43,.233,473,875,.541,.532,378,434,.871,85,341,426,907,113,16,273,133,1354
17225,LAL,1986,James Worthy,24,75,73,2454,629,1086,.579,0,13,.000,629,1073,.586,.579,242,314,.771,136,251,387,201,82,77,149,195,1500
17226,LAL,1986,Michael Cooper,29,82,15,2269,274,606,.452,63,163,.387,211,443,.476,.504,147,170,.865,44,200,244,466,89,43,151,238,758
17227,LAL,1986,Byron Scott,24,76,62,2190,507,989,.513,22,61,.361,485,928,.523,.524,138,176,.784,55,134,189,164,85,15,110,167,1174
17228,LAL,1986,Maurice Lucas,33,77,8,1750,302,653,.462,1,2,.500,301,651,.462,.463,180,230,.783,164,402,566,84,45,24,121,253,785
17229,LAL,1986,Kurt Rambis,27,74,74,1573,160,269,.595,0,0,,160,269,.595,.595,88,122,.721,156,361,517,69,66,33,97,198,408
17230,LAL,1986,A.C. Green,22,82,1,1542,209,388,.539,1,6,.167,208,382,.545,.540,102,167,.611,160,221,381,54,49,49,99,229,521
17231,LAL,1986,Mike McGee,26,71,19,1213,252,544,.463,41,114,.360,211,430,.491,.501,42,64,.656,51,89,140,83,53,7,70,131,587
17232,LAL,1986,Mitch Kupchak,31,55,0,783,124,257,.482,0,1,.000,124,256,.484,.482,84,112,.750,69,122,191,17,12,7,64,102,332
17233,LAL,1986,Larry Spriggs,26,43,7,471,88,192,.458,0,1,.000,88,191,.461,.458,38,49,.776,28,53,81,49,18,9,54,78,214
17234,LAL,1986,Ronnie Lester,27,27,0,222,26,52,.500,0,3,.000,26,49,.531,.500,15,19,.789,0,10,10,54,9,3,42,27,67
17235,LAL,1986,Pétur Guðmundsson,27,8,2,128,20,37,.541,0,0,,20,37,.541,.541,18,27,.667,17,21,38,3,3,4,11,25,58
17236,LAL,1986,Chuck Nevitt,26,4,0,25,3,11,.273,0,0,,3,11,.273,.273,4,6,.667,3,4,7,2,2,2,5,6,10
17237,LAL,1986,Jerome Henderson,26,1,0,3,2,3,.667,0,0,,2,3,.667,.667,0,0,,0,1,1,0,0,0,0,1,4
17238,LAL,1985,Magic Johnson,25,77,77,2781,504,899,.561,7,37,.189,497,862,.577,.565,391,464,.843,90,386,476,968,113,25,305,155,1406
17239,LAL,1985,James Worthy,23,80,76,2696,610,1066,.572,0,7,.000,610,1059,.576,.572,190,245,.776,169,342,511,201,87,67,198,196,1410
17240,LAL,1985,Kareem Abdul-Jabbar,37,79,79,2630,723,1207,.599,0,1,.000,723,1206,.600,.599,289,395,.732,162,460,622,249,63,162,197,238,1735
17241,LAL,1985,Byron Scott,23,81,65,2305,541,1003,.539,26,60,.433,515,943,.546,.552,187,228,.820,57,153,210,244,100,17,138,197,1295
17242,LAL,1985,Michael Cooper,28,82,20,2189,276,593,.465,35,123,.285,241,470,.513,.495,115,133,.865,56,199,255,429,93,49,156,208,702
17243,LAL,1985,Kurt Rambis,26,82,46,1617,181,327,.554,0,0,,181,327,.554,.554,68,103,.660,164,364,528,69,82,47,97,211,430
17244,LAL,1985,Larry Spriggs,25,75,32,1292,194,354,.548,0,3,.000,194,351,.553,.548,112,146,.767,77,150,227,132,47,13,115,195,500
17245,LAL,1985,Bob McAdoo,33,66,0,1254,284,546,.520,0,1,.000,284,545,.521,.520,122,162,.753,79,216,295,67,18,53,95,170,690
17246,LAL,1985,Mike McGee,25,76,3,1170,329,612,.538,22,61,.361,307,551,.557,.556,94,160,.588,97,68,165,71,39,7,81,147,774
17247,LAL,1985,Jamaal Wilkes,31,42,8,761,148,303,.488,0,1,.000,148,302,.490,.488,51,66,.773,35,59,94,41,19,3,49,65,347
17248,LAL,1985,Mitch Kupchak,30,58,3,716,123,244,.504,0,0,,123,244,.504,.504,60,91,.659,68,116,184,21,19,20,48,104,306
17249,LAL,1985,Ronnie Lester,26,32,1,278,34,82,.415,0,1,.000,34,81,.420,.415,21,31,.677,4,22,26,80,15,3,32,25,89
17250,LAL,1985,Chuck Nevitt,25,11,0,59,5,17,.294,0,0,,5,17,.294,.294,2,8,.250,5,15,20,3,0,15,10,20,12
17251,LAL,1985,Earl Jones,24,2,0,7,0,1,.000,0,0,,0,1,.000,.000,0,0,,0,0,0,0,0,0,1,0,0
17252,LAL,1984,Kareem Abdul-Jabbar,36,80,80,2622,716,1238,.578,0,1,.000,716,1237,.579,.578,285,394,.723,169,418,587,211,55,143,221,211,1717
17253,LAL,1984,Magic Johnson,24,67,66,2567,441,780,.565,6,29,.207,435,751,.579,.569,290,358,.810,99,392,491,875,150,49,306,169,1178
17254,LAL,1984,Jamaal Wilkes,30,75,74,2507,542,1055,.514,2,8,.250,540,1047,.516,.515,208,280,.743,130,210,340,214,72,41,137,205,1294
17255,LAL,1984,James Worthy,22,82,53,2415,495,890,.556,0,6,.000,495,884,.560,.556,195,257,.759,157,358,515,207,77,70,181,244,1185
17256,LAL,1984,Michael Cooper,27,82,9,2387,273,549,.497,38,121,.314,235,428,.549,.532,155,185,.838,53,209,262,482,113,67,148,267,739
17257,LAL,1984,Byron Scott,22,74,49,1637,334,690,.484,8,34,.235,326,656,.497,.490,112,139,.806,50,114,164,177,81,19,116,174,788
17258,LAL,1984,Bob McAdoo,32,70,0,1456,352,748,.471,0,5,.000,352,743,.474,.471,212,264,.803,82,207,289,74,42,50,127,182,916
17259,LAL,1984,Mike McGee,24,77,45,1425,347,584,.594,2,12,.167,345,572,.603,.596,61,113,.540,117,76,193,81,49,6,111,176,757
17260,LAL,1984,Swen Nater,34,69,0,829,124,253,.490,0,1,.000,124,252,.492,.490,63,91,.692,81,183,264,27,25,7,68,150,311
17261,LAL,1984,Kurt Rambis,25,47,31,743,63,113,.558,0,0,,63,113,.558,.558,42,66,.636,82,184,266,34,30,14,56,108,168
17262,LAL,1984,Calvin Garrett,27,41,0,478,78,152,.513,2,6,.333,76,146,.521,.520,30,39,.769,24,47,71,31,12,2,34,62,188
17263,LAL,1984,Larry Spriggs,24,38,0,363,44,82,.537,0,2,.000,44,80,.550,.537,36,50,.720,16,45,61,30,12,4,34,55,124
17264,LAL,1984,Mitch Kupchak,29,34,3,324,41,108,.380,0,1,.000,41,107,.383,.380,22,34,.647,35,52,87,7,4,6,22,46,104
17265,LAL,1984,Eddie Jordan,29,3,0,27,4,8,.500,0,0,,4,8,.500,.500,1,2,.500,0,4,4,5,4,0,8,5,9
17266,LAL,1983,Magic Johnson,23,79,79,2907,511,933,.548,0,21,.000,511,912,.560,.548,304,380,.800,214,469,683,829,176,47,301,200,1326
17267,LAL,1983,Norm Nixon,27,79,79,2711,533,1123,.475,0,13,.000,533,1110,.480,.475,125,168,.744,61,144,205,566,104,4,237,176,1191
17268,LAL,1983,Kareem Abdul-Jabbar,35,79,79,2554,722,1228,.588,0,2,.000,722,1226,.589,.588,278,371,.749,167,425,592,200,61,170,200,220,1722
17269,LAL,1983,Jamaal Wilkes,29,80,80,2552,684,1290,.530,0,6,.000,684,1284,.533,.530,203,268,.757,146,197,343,182,65,17,150,221,1571
17270,LAL,1983,Michael Cooper,26,82,3,2148,266,497,.535,5,21,.238,261,476,.548,.540,102,130,.785,82,192,274,315,115,50,128,208,639
17271,LAL,1983,James Worthy,21,77,1,1970,447,772,.579,1,4,.250,446,768,.581,.580,138,221,.624,157,242,399,132,91,64,178,221,1033
17272,LAL,1983,Kurt Rambis,24,78,77,1806,235,413,.569,0,2,.000,235,411,.572,.569,114,166,.687,164,367,531,90,105,63,145,233,584
17273,LAL,1983,Bob McAdoo,31,47,1,1019,292,562,.520,0,1,.000,292,561,.520,.520,119,163,.730,76,171,247,39,40,40,68,153,703
17274,LAL,1983,Dwight Jones,30,32,0,491,62,132,.470,0,1,.000,62,131,.473,.470,32,48,.667,28,86,114,22,13,9,35,82,156
17275,LAL,1983,Clay Johnson,26,48,0,447,53,135,.393,0,2,.000,53,133,.398,.393,38,48,.792,40,29,69,24,22,4,25,62,144
17276,LAL,1983,Mike McGee,23,39,7,381,69,163,.423,1,7,.143,68,156,.436,.426,17,23,.739,33,20,53,26,11,5,27,50,156
17277,LAL,1983,Mark Landsberger,27,39,4,356,43,102,.422,0,0,,43,102,.422,.422,12,25,.480,55,73,128,12,8,4,20,48,98
17278,LAL,1983,Eddie Jordan,28,35,0,333,40,132,.303,3,16,.188,37,116,.319,.314,11,17,.647,8,18,26,80,31,1,54,52,94
17279,LAL,1983,Billy Ray Bates,26,4,0,27,2,16,.125,0,0,,2,16,.125,.125,1,2,.500,1,0,1,0,1,0,0,1,5
17280,LAL,1983,Steve Mix,35,1,0,17,4,10,.400,0,0,,4,10,.400,.400,1,1,1.000,1,0,1,2,0,0,0,1,9
17281,LAL,1983,Joe Cooper,25,2,0,11,1,4,.250,0,0,,1,4,.250,.250,0,0,,2,0,2,0,1,1,3,3,2
17282,LAL,1982,Norm Nixon,26,82,82,3024,628,1274,.493,3,12,.250,625,1262,.495,.494,181,224,.808,38,138,176,652,132,7,238,264,1440
17283,LAL,1982,Magic Johnson,22,78,77,2991,556,1036,.537,6,29,.207,550,1007,.546,.540,329,433,.760,252,499,751,743,208,34,286,223,1447
17284,LAL,1982,Jamaal Wilkes,28,82,82,2906,744,1417,.525,0,4,.000,744,1413,.527,.525,246,336,.732,153,240,393,143,89,24,164,240,1734
17285,LAL,1982,Kareem Abdul-Jabbar,34,76,76,2677,753,1301,.579,0,3,.000,753,1298,.580,.579,312,442,.706,172,487,659,225,63,207,230,224,1818
17286,LAL,1982,Michael Cooper,25,76,14,2197,383,741,.517,2,17,.118,381,724,.526,.518,139,171,.813,84,185,269,230,120,61,151,216,907
17287,LAL,1982,Mark Landsberger,26,75,1,1134,144,329,.438,0,2,.000,144,327,.440,.438,33,65,.508,164,237,401,32,10,7,49,134,321
17288,LAL,1982,Kurt Rambis,23,64,43,1131,118,228,.518,0,1,.000,118,227,.520,.518,59,117,.504,116,232,348,56,60,76,77,167,295
17289,LAL,1982,Jim Brewer,30,71,9,966,81,175,.463,1,6,.167,80,169,.473,.466,7,19,.368,106,158,264,42,39,46,37,127,170
17290,LAL,1982,Mitch Kupchak,27,26,26,821,153,267,.573,0,0,,153,267,.573,.573,65,98,.663,64,146,210,33,12,10,43,80,371
17291,LAL,1982,Bob McAdoo,30,41,0,746,151,330,.458,0,5,.000,151,325,.465,.458,90,126,.714,45,114,159,32,22,36,51,109,392
17292,LAL,1982,Eddie Jordan,27,58,0,608,89,208,.428,1,9,.111,88,199,.442,.430,43,54,.796,4,39,43,131,62,1,66,98,222
17293,LAL,1982,Mike McGee,22,39,0,352,80,172,.465,0,4,.000,80,168,.476,.465,31,53,.585,34,15,49,16,18,3,34,59,191
17294,LAL,1982,Kevin McKenna,23,36,0,237,28,87,.322,0,2,.000,28,85,.329,.322,11,17,.647,18,11,29,14,10,2,20,45,67
17295,LAL,1982,Clay Johnson,25,7,0,65,11,20,.550,0,0,,11,20,.550,.550,3,6,.500,8,4,12,7,3,3,7,13,25
17296,LAL,1981,Jamaal Wilkes,27,81,,3028,786,1495,.526,1,13,.077,785,1482,.530,.526,254,335,.758,146,289,435,235,121,29,207,223,1827
17297,LAL,1981,Kareem Abdul-Jabbar,33,80,,2976,836,1457,.574,0,1,.000,836,1456,.574,.574,423,552,.766,197,624,821,272,59,228,249,244,2095
17298,LAL,1981,Norm Nixon,25,79,,2962,576,1210,.476,2,12,.167,574,1198,.479,.477,196,252,.778,64,168,232,696,146,11,285,226,1350
17299,LAL,1981,Michael Cooper,24,81,,2625,321,654,.491,4,19,.211,317,635,.499,.494,117,149,.785,121,215,336,332,133,78,164,249,763
17300,LAL,1981,Jim Chones,31,82,,2562,378,751,.503,0,4,.000,378,747,.506,.503,126,193,.653,180,477,657,153,39,96,159,324,882
17301,LAL,1981,Magic Johnson,21,37,,1371,312,587,.532,3,17,.176,309,570,.542,.534,171,225,.760,101,219,320,317,127,27,143,100,798
17302,LAL,1981,Jim Brewer,29,78,,1107,101,197,.513,0,2,.000,101,195,.518,.513,15,40,.375,127,154,281,55,43,58,48,158,217
17303,LAL,1981,Mark Landsberger,25,69,,1086,164,327,.502,0,1,.000,164,326,.503,.502,62,116,.534,152,225,377,27,19,6,65,135,390
17304,LAL,1981,Eddie Jordan,26,60,,987,120,279,.430,3,12,.250,117,267,.438,.435,63,95,.663,25,55,80,195,74,7,120,136,306
17305,LAL,1981,Butch Carter,22,54,,672,114,247,.462,3,10,.300,111,237,.468,.468,70,95,.737,34,31,65,52,23,1,50,99,301
17306,LAL,1981,Brad Holland,24,41,,295,47,111,.423,1,3,.333,46,108,.426,.428,35,49,.714,9,20,29,23,21,1,31,44,130
17307,LAL,1981,Alan Hardy,23,22,,111,22,59,.373,0,0,,22,59,.373,.373,7,10,.700,8,11,19,3,1,9,11,13,51
17308,LAL,1981,Tony Jackson,23,2,,14,1,3,.333,0,0,,1,3,.333,.333,0,0,,0,2,2,2,2,0,0,1,2
17309,LAL,1981,Myles Patrick,26,3,,9,2,5,.400,0,0,,2,5,.400,.400,1,2,.500,1,1,2,1,0,0,1,3,5
17310,LAL,1980,Norm Nixon,24,82,82,3226,624,1209,.516,1,8,.125,623,1201,.519,.517,197,253,.779,52,177,229,642,147,14,288,241,1446
17311,LAL,1980,Kareem Abdul-Jabbar,32,82,,3143,835,1383,.604,0,1,.000,835,1382,.604,.604,364,476,.765,190,696,886,371,81,280,297,216,2034
17312,LAL,1980,Jamaal Wilkes,26,82,82,3111,726,1358,.535,3,17,.176,723,1341,.539,.536,189,234,.808,176,349,525,250,129,28,157,220,1644
17313,LAL,1980,Magic Johnson,20,77,,2795,503,949,.530,7,31,.226,496,918,.540,.534,374,462,.810,166,430,596,563,187,41,305,218,1387
17314,LAL,1980,Jim Chones,30,82,,2394,372,760,.489,0,2,.000,372,758,.491,.489,125,169,.740,143,421,564,151,56,65,175,271,869
17315,LAL,1980,Michael Cooper,23,82,,1973,303,578,.524,5,20,.250,298,558,.534,.529,111,143,.776,101,128,229,221,86,38,142,215,722
17316,LAL,1980,Spencer Haywood,30,76,,1544,288,591,.487,1,4,.250,287,587,.489,.488,159,206,.772,132,214,346,93,35,57,134,197,736
17317,LAL,1980,Don Ford,27,52,,580,66,130,.508,0,1,.000,66,129,.512,.508,23,28,.821,23,75,98,36,11,15,30,86,155
17318,LAL,1980,Mark Landsberger,24,23,,374,66,137,.482,0,0,,66,137,.482,.482,29,56,.518,69,94,163,14,10,5,25,27,161
17319,LAL,1980,Brad Holland,23,38,,197,44,104,.423,3,15,.200,41,89,.461,.438,15,16,.938,4,13,17,22,15,1,13,24,106
17320,LAL,1980,Marty Byrnes,23,32,,194,25,50,.500,0,0,,25,50,.500,.500,13,15,.867,9,18,27,13,5,1,22,32,63
17321,LAL,1980,Ollie Mack,22,27,,155,21,50,.420,0,1,.000,21,49,.429,.420,9,18,.500,7,15,22,20,4,0,9,16,51
17322,LAL,1980,Ron Boone,33,6,,106,14,40,.350,0,0,,14,40,.350,.350,6,7,.857,4,7,11,7,5,0,13,13,34
17323,LAL,1980,Kenny Carr,24,5,,57,7,16,.438,0,0,,7,16,.438,.438,2,2,1.000,5,12,17,1,2,1,9,6,16
17324,LAL,1980,Butch Lee,23,11,,31,4,13,.308,0,0,,4,13,.308,.308,6,7,.857,4,4,8,9,1,0,7,2,14
17325,LAC,2024,Paul George,33,74,74,2502,582,1236,.471,243,588,.413,339,648,.523,.569,264,291,.907,37,351,388,262,113,37,153,202,1671
17326,LAC,2024,James Harden,34,72,72,2470,352,822,.428,186,488,.381,166,334,.497,.541,302,344,.878,34,335,369,614,77,57,185,127,1192
17327,LAC,2024,Kawhi Leonard,32,68,68,2330,610,1162,.525,140,336,.417,470,826,.569,.585,253,286,.885,84,332,416,244,111,59,119,97,1613
17328,LAC,2024,Norman Powell,30,76,3,1990,373,768,.486,167,384,.435,206,384,.536,.594,143,172,.831,16,179,195,82,43,22,66,137,1056
17329,LAC,2024,Terance Mann,27,75,71,1873,254,493,.515,71,204,.348,183,289,.633,.587,79,95,.832,87,167,254,119,43,15,48,145,658
17330,LAC,2024,Ivica Zubac,26,68,68,1794,337,519,.649,0,0,,337,519,.649,.649,120,166,.723,196,430,626,93,22,83,79,180,794
17331,LAC,2024,Russell Westbrook,35,68,11,1529,301,663,.454,42,154,.273,259,509,.509,.486,110,160,.688,93,250,343,306,74,23,144,121,754
17332,LAC,2024,Amir Coffey,26,70,13,1460,166,352,.472,70,184,.380,96,168,.571,.571,61,71,.859,29,119,148,76,41,14,33,102,463
17333,LAC,2024,Daniel Theis,31,59,3,1007,155,289,.536,26,70,.371,129,219,.589,.581,38,50,.760,85,159,244,61,21,51,42,126,374
17334,LAC,2024,Mason Plumlee,33,46,11,674,87,153,.569,0,6,.000,87,147,.592,.569,70,99,.707,60,174,234,55,14,17,36,68,244
17335,LAC,2024,Bones Hyland,23,37,5,540,97,251,.386,44,135,.326,53,116,.457,.474,18,23,.783,5,50,55,93,26,4,44,51,256
17336,LAC,2024,P.J. Tucker,38,28,7,420,16,45,.356,11,30,.367,5,15,.333,.478,3,3,1.000,27,44,71,16,13,5,6,45,46
17337,LAC,2024,Kobe Brown,24,44,0,394,37,90,.411,14,48,.292,23,42,.548,.489,1,2,.500,20,42,62,25,12,6,9,49,89
17338,LAC,2024,Brandon Boston Jr.,22,32,0,345,65,161,.404,14,52,.269,51,109,.468,.447,23,33,.697,19,33,52,13,11,8,24,40,167
17339,LAC,2024,Xavier Moon,29,14,1,119,15,46,.326,2,17,.118,13,29,.448,.348,1,2,.500,8,10,18,21,3,3,5,8,33
17340,LAC,2024,Robert Covington,33,3,3,69,3,9,.333,2,8,.250,1,1,1.000,.444,1,2,.500,2,6,8,7,6,2,0,7,9
17341,LAC,2024,Moussa Diabaté,22,11,0,64,10,19,.526,0,0,,10,19,.526,.526,9,14,.643,15,9,24,4,5,1,2,4,29
17342,LAC,2024,Nicolas Batum,35,3,0,54,3,8,.375,2,7,.286,1,1,1.000,.500,0,0,,0,7,7,5,3,4,1,5,8
17343,LAC,2024,KJ Martin,23,2,0,31,4,10,.400,1,5,.200,3,5,.600,.450,1,2,.500,1,2,3,1,2,1,2,3,10
17344,LAC,2024,Jordan Miller,24,8,0,28,5,9,.556,1,2,.500,4,7,.571,.611,2,2,1.000,3,2,5,0,0,0,1,2,13
17345,LAC,2024,Joshua Primo,21,2,0,10,1,3,.333,0,1,.000,1,2,.500,.333,0,0,,1,0,1,0,0,1,4,0,2
17346,LAC,2023,Ivica Zubac,25,76,76,2170,326,514,.634,0,2,.000,326,512,.637,.634,166,238,.697,236,520,756,77,29,98,117,219,818
17347,LAC,2023,Paul George,32,56,56,1939,459,1004,.457,158,426,.371,301,578,.521,.536,256,294,.871,45,297,342,288,83,20,176,159,1332
17348,LAC,2023,Terance Mann,26,81,36,1872,272,524,.519,77,198,.389,195,326,.598,.593,92,118,.780,77,199,276,184,42,22,80,149,713
17349,LAC,2023,Marcus Morris,33,65,65,1825,274,643,.426,112,308,.364,162,335,.484,.513,68,87,.782,29,229,258,114,42,21,56,136,728
17350,LAC,2023,Kawhi Leonard,31,52,50,1748,446,871,.512,104,250,.416,342,621,.551,.572,243,279,.871,57,281,338,204,72,28,88,84,1239
17351,LAC,2023,Nicolas Batum,34,78,19,1709,160,381,.420,124,317,.391,36,64,.563,.583,34,48,.708,62,237,299,121,54,44,50,149,478
17352,LAC,2023,Norman Powell,29,60,8,1567,340,710,.479,114,287,.397,226,423,.534,.559,225,277,.812,24,151,175,109,50,18,101,125,1019
17353,LAC,2023,Reggie Jackson,32,52,38,1338,214,512,.418,77,220,.350,137,292,.469,.493,61,66,.924,22,94,116,183,38,5,96,92,566
17354,LAC,2023,Robert Covington,32,48,0,779,102,229,.445,54,136,.397,48,93,.516,.563,30,40,.750,31,135,166,57,38,33,32,86,288
17355,LAC,2023,John Wall,32,34,3,755,138,338,.408,33,109,.303,105,229,.459,.457,77,113,.681,14,78,92,178,27,12,80,59,386
17356,LAC,2023,Luke Kennard,26,35,11,725,98,211,.464,59,132,.447,39,79,.494,.604,19,20,.950,6,77,83,37,19,4,30,47,274
17357,LAC,2023,Russell Westbrook,34,21,21,635,128,262,.489,26,73,.356,102,189,.540,.538,50,76,.658,30,72,102,160,23,10,71,41,332
17358,LAC,2023,Amir Coffey,25,50,9,625,56,145,.386,11,40,.275,45,105,.429,.424,49,63,.778,17,36,53,53,7,5,21,50,172
17359,LAC,2023,Eric Gordon,34,22,11,547,81,175,.463,47,111,.423,34,64,.531,.597,32,38,.842,4,33,37,47,13,8,21,33,241
17360,LAC,2023,Mason Plumlee,32,23,4,457,64,88,.727,0,0,,64,88,.727,.727,44,57,.772,42,117,159,40,11,12,30,56,172
17361,LAC,2023,Moses Brown,23,34,1,288,61,96,.635,0,0,,61,96,.635,.635,33,72,.458,57,82,139,4,3,14,14,38,155
17362,LAC,2023,Bones Hyland,22,14,0,265,55,137,.401,26,74,.351,29,63,.460,.496,15,20,.750,10,39,49,47,11,2,15,30,151
17363,LAC,2023,Brandon Boston Jr.,21,22,1,248,51,122,.418,12,29,.414,39,93,.419,.467,29,38,.763,7,23,30,20,9,0,12,21,143
17364,LAC,2023,Moussa Diabaté,21,22,1,195,24,47,.511,1,2,.500,23,45,.511,.521,10,16,.625,31,19,50,4,7,8,9,15,59
17365,LAC,2023,Jason Preston,23,14,0,124,18,41,.439,5,18,.278,13,23,.565,.500,0,2,.000,2,20,22,27,2,0,10,7,41
17366,LAC,2023,Xavier Moon,28,4,0,20,3,9,.333,1,3,.333,2,6,.333,.389,0,0,,0,3,3,5,0,0,1,2,7
17367,LAC,2022,Reggie Jackson,31,75,75,2337,479,1222,.392,167,512,.326,312,710,.439,.460,138,163,.847,39,232,271,359,55,15,173,159,1263
17368,LAC,2022,Terance Mann,25,81,33,2317,334,690,.484,76,208,.365,258,482,.535,.539,128,164,.780,104,321,425,209,55,21,84,178,872
17369,LAC,2022,Luke Kennard,25,70,13,1919,287,639,.449,190,423,.449,97,216,.449,.598,69,77,.896,20,209,229,146,42,6,60,101,833
17370,LAC,2022,Ivica Zubac,24,76,76,1852,310,495,.626,0,0,,310,495,.626,.626,165,227,.727,217,427,644,120,36,77,114,203,785
17371,LAC,2022,Amir Coffey,24,69,30,1567,211,466,.453,96,254,.378,115,212,.542,.556,101,117,.863,26,171,197,124,38,15,45,87,619
17372,LAC,2022,Marcus Morris,32,54,54,1564,300,691,.434,101,275,.367,199,416,.478,.507,129,148,.872,26,213,239,113,28,18,69,115,830
17373,LAC,2022,Nicolas Batum,33,59,54,1463,179,387,.463,108,270,.400,71,117,.607,.602,25,38,.658,29,225,254,100,58,42,40,80,491
17374,LAC,2022,Eric Bledsoe,32,54,29,1361,197,468,.421,51,163,.313,146,305,.479,.475,89,117,.761,28,154,182,225,69,19,116,85,534
17375,LAC,2022,Isaiah Hartenstein,23,68,0,1216,229,366,.626,14,30,.467,215,336,.640,.645,91,132,.689,117,215,332,160,50,77,84,167,563
17376,LAC,2022,Paul George,31,31,31,1077,268,636,.421,91,257,.354,177,379,.467,.493,127,148,.858,12,201,213,176,67,13,126,74,754
17377,LAC,2022,Brandon Boston Jr.,20,51,0,760,125,325,.385,34,111,.306,91,214,.425,.437,59,72,.819,17,94,111,51,26,13,31,43,343
17378,LAC,2022,Serge Ibaka,32,35,10,538,94,192,.490,24,62,.387,70,130,.538,.552,20,29,.690,40,110,150,36,7,26,33,56,232
17379,LAC,2022,Robert Covington,31,23,2,509,81,162,.500,49,109,.450,32,53,.604,.651,28,33,.848,18,99,117,24,29,28,17,58,239
17380,LAC,2022,Justise Winslow,25,37,1,480,63,141,.447,5,29,.172,58,112,.518,.465,25,41,.610,30,103,133,52,21,18,37,46,156
17381,LAC,2022,Xavier Moon,27,10,0,137,25,51,.490,5,14,.357,20,37,.541,.539,3,5,.600,2,12,14,24,7,3,6,9,58
17382,LAC,2022,Keon Johnson,19,15,0,135,17,51,.333,3,11,.273,14,40,.350,.363,16,21,.762,6,15,21,13,7,2,7,21,53
17383,LAC,2022,Rodney Hood,29,13,0,128,12,26,.462,6,11,.545,6,15,.400,.577,4,5,.800,2,8,10,8,3,2,4,4,34
17384,LAC,2022,Norman Powell,28,5,2,125,32,63,.508,13,24,.542,19,39,.487,.611,30,35,.857,3,11,14,14,2,4,7,14,107
17385,LAC,2022,Jay Scrubb,21,18,0,121,18,46,.391,6,21,.286,12,25,.480,.457,7,10,.700,2,14,16,8,4,3,7,9,49
17386,LAC,2022,Semi Ojeleye,27,10,0,98,12,29,.414,4,9,.444,8,20,.400,.483,13,16,.813,2,14,16,4,2,1,4,4,41
17387,LAC,2022,Wenyen Gabriel,24,6,0,46,5,13,.385,2,5,.400,3,8,.375,.462,2,4,.500,5,9,14,2,1,2,3,11,14
17388,LAC,2022,James Ennis III,31,2,0,28,7,11,.636,2,4,.500,5,7,.714,.727,4,4,1.000,2,3,5,0,1,1,1,4,20
17389,LAC,2022,Moses Wright,23,1,0,1,0,0,,0,0,,0,0,,,0,0,,0,0,0,1,0,0,0,0,0
17390,LAC,2021,Nicolas Batum,32,67,38,1835,191,412,.464,110,272,.404,81,140,.579,.597,48,58,.828,50,266,316,148,69,37,53,102,540
17391,LAC,2021,Paul George,30,54,54,1821,445,953,.467,171,416,.411,274,537,.510,.557,198,228,.868,45,314,359,280,62,24,179,132,1259
17392,LAC,2021,Kawhi Leonard,29,52,52,1773,465,908,.512,101,254,.398,364,654,.557,.568,261,295,.885,55,282,337,269,81,21,105,82,1292
17393,LAC,2021,Ivica Zubac,23,72,33,1609,257,394,.652,1,4,.250,256,390,.656,.654,135,171,.789,189,330,519,90,24,62,81,187,650
17394,LAC,2021,Reggie Jackson,30,67,43,1544,263,585,.450,122,282,.433,141,303,.465,.554,67,82,.817,24,168,192,205,41,7,74,127,715
17395,LAC,2021,Marcus Morris,31,57,29,1502,276,584,.473,140,296,.473,136,288,.472,.592,73,89,.820,35,199,234,58,34,15,57,117,765
17396,LAC,2021,Terance Mann,24,67,10,1263,178,350,.509,38,91,.418,140,259,.541,.563,78,94,.830,56,186,242,104,29,13,40,126,472
17397,LAC,2021,Luke Kennard,24,63,17,1232,197,414,.476,100,224,.446,97,190,.511,.597,26,31,.839,15,146,161,104,23,9,48,91,520
17398,LAC,2021,Serge Ibaka,31,41,39,955,186,365,.510,39,115,.339,147,250,.588,.563,43,53,.811,73,202,275,74,9,47,44,76,454
17399,LAC,2021,Lou Williams,34,42,3,918,181,430,.421,45,119,.378,136,311,.437,.473,103,119,.866,15,73,88,144,39,4,66,42,510
17400,LAC,2021,Patrick Beverley,32,37,34,832,93,220,.423,56,141,.397,37,79,.468,.550,36,45,.800,29,90,119,76,29,28,34,108,278
17401,LAC,2021,Patrick Patterson,31,38,5,582,72,165,.436,40,112,.357,32,53,.604,.558,13,17,.765,19,56,75,29,14,8,11,45,197
17402,LAC,2021,Amir Coffey,23,44,1,394,45,103,.437,23,56,.411,22,47,.468,.549,27,38,.711,10,34,44,22,10,0,15,30,140
17403,LAC,2021,Rajon Rondo,34,18,1,368,51,105,.486,19,44,.432,32,61,.525,.576,15,15,1.000,14,41,55,104,18,2,40,28,136
17404,LAC,2021,DeMarcus Cousins,30,16,0,207,51,95,.537,8,19,.421,43,76,.566,.579,15,22,.682,23,49,72,16,13,6,25,33,125
17405,LAC,2021,Daniel Oturu,21,30,0,161,22,52,.423,1,5,.200,21,47,.447,.433,9,12,.750,21,27,48,10,4,7,9,24,54
17406,LAC,2021,Yogi Ferrell,27,8,0,96,12,36,.333,6,19,.316,6,17,.353,.417,7,7,1.000,2,10,12,17,4,2,0,7,37
17407,LAC,2021,Mfiondu Kabengele,23,23,0,94,9,32,.281,4,18,.222,5,14,.357,.344,5,6,.833,1,13,14,5,2,3,6,18,27
17408,LAC,2021,Jay Scrubb,20,4,1,84,14,36,.389,2,9,.222,12,27,.444,.417,5,5,1.000,2,12,14,1,4,0,7,5,35
17409,LAC,2021,Malik Fitts,23,3,0,11,1,3,.333,1,2,.500,0,1,.000,.500,0,0,,0,3,3,0,0,0,0,3,3
17410,LAC,2020,Lou Williams,33,65,8,1864,391,936,.418,111,315,.352,280,621,.451,.477,292,339,.861,31,170,201,365,43,12,182,80,1185
17411,LAC,2020,Kawhi Leonard,28,57,57,1848,532,1133,.470,123,325,.378,409,808,.506,.524,356,402,.886,54,348,402,280,103,33,149,113,1543
17412,LAC,2020,Montrezl Harrell,26,63,2,1749,471,812,.580,0,18,.000,471,794,.593,.580,231,351,.658,163,282,445,107,39,72,108,146,1173
17413,LAC,2020,Landry Shamet,22,53,30,1452,158,391,.404,111,296,.375,47,95,.495,.546,65,76,.855,6,94,100,99,20,10,42,142,492
17414,LAC,2020,Paul George,29,48,48,1419,343,782,.439,157,381,.412,186,401,.464,.539,190,217,.876,24,248,272,185,68,20,125,113,1033
17415,LAC,2020,Patrick Beverley,31,51,50,1342,147,341,.431,80,206,.388,67,135,.496,.548,31,47,.660,57,209,266,183,54,25,66,156,405
17416,LAC,2020,Ivica Zubac,22,72,70,1326,236,385,.613,0,2,.000,236,383,.616,.613,124,166,.747,197,346,543,82,16,66,61,168,596
17417,LAC,2020,JaMychal Green,29,63,1,1307,151,352,.429,92,238,.387,59,114,.518,.560,36,48,.750,77,311,388,49,29,24,54,174,430
17418,LAC,2020,Maurice Harkless,26,50,38,1141,112,217,.516,27,73,.370,85,144,.590,.578,24,42,.571,47,153,200,48,49,30,46,120,275
17419,LAC,2020,Rodney McGruder,28,56,4,871,72,181,.398,24,89,.270,48,92,.522,.464,19,34,.559,29,122,151,36,26,8,24,74,187
17420,LAC,2020,Patrick Patterson,30,59,18,776,95,233,.408,67,172,.390,28,61,.459,.552,35,43,.814,35,116,151,41,7,3,21,54,292
17421,LAC,2020,Marcus Morris,30,19,19,549,74,174,.425,26,84,.310,48,90,.533,.500,18,22,.818,11,67,78,27,13,13,24,52,192
17422,LAC,2020,Jerome Robinson,22,42,1,476,46,136,.338,19,67,.284,27,69,.391,.408,11,19,.579,5,55,60,46,13,8,26,55,122
17423,LAC,2020,Terance Mann,23,41,6,362,37,79,.468,7,20,.350,30,59,.508,.513,18,27,.667,10,45,55,53,11,5,18,46,99
17424,LAC,2020,Reggie Jackson,29,17,6,362,58,128,.453,26,63,.413,32,65,.492,.555,19,21,.905,6,45,51,54,5,4,28,38,161
17425,LAC,2020,Derrick Walton,24,23,1,222,17,36,.472,9,21,.429,8,15,.533,.597,7,9,.778,2,13,15,22,4,0,4,19,50
17426,LAC,2020,Amir Coffey,22,18,1,159,23,54,.426,6,19,.316,17,35,.486,.481,6,11,.545,4,12,16,14,5,2,8,20,58
17427,LAC,2020,Mfiondu Kabengele,22,12,0,64,14,32,.438,9,20,.450,5,12,.417,.578,5,5,1.000,1,10,11,2,2,2,2,9,42
17428,LAC,2020,Joakim Noah,34,5,0,50,4,8,.500,0,0,,4,8,.500,.500,6,8,.750,5,11,16,7,1,1,6,9,14
17429,LAC,2020,Johnathan Motley,24,13,0,41,11,15,.733,1,1,1.000,10,14,.714,.767,5,7,.714,3,7,10,8,3,0,5,6,28
17430,LAC,2019,Shai Gilgeous-Alexander,20,82,73,2174,341,716,.476,51,139,.367,290,577,.503,.512,156,195,.800,57,175,232,270,96,45,141,175,889
17431,LAC,2019,Montrezl Harrell,25,82,5,2158,546,888,.615,3,17,.176,543,871,.623,.617,266,414,.643,184,351,535,162,71,110,132,255,1361
17432,LAC,2019,Patrick Beverley,30,78,49,2137,194,477,.407,112,282,.397,82,195,.421,.524,96,123,.780,76,312,388,300,67,43,85,265,596
17433,LAC,2019,Danilo Gallinari,30,68,68,2059,409,884,.463,161,372,.433,248,512,.484,.554,367,406,.904,54,363,417,178,49,23,99,129,1346
17434,LAC,2019,Lou Williams,32,75,1,1993,484,1138,.425,105,291,.361,379,847,.447,.471,425,485,.876,40,182,222,402,57,11,181,80,1498
17435,LAC,2019,Tobias Harris,26,55,55,1903,424,855,.496,112,258,.434,312,597,.523,.561,192,219,.877,37,395,432,150,40,24,109,123,1152
17436,LAC,2019,Avery Bradley,28,49,49,1463,161,420,.383,58,172,.337,103,248,.415,.452,20,25,.800,35,96,131,96,27,16,61,133,400
17437,LAC,2019,Marcin Gortat,34,47,43,751,99,186,.532,0,0,,99,186,.532,.532,35,48,.729,67,194,261,65,6,24,50,92,233
17438,LAC,2019,Mike Scott,30,52,0,748,92,230,.400,52,133,.391,40,97,.412,.513,12,18,.667,24,150,174,44,17,8,27,88,248
17439,LAC,2019,Landry Shamet,21,25,23,694,87,210,.414,68,151,.450,19,59,.322,.576,31,39,.795,7,49,56,58,13,2,19,49,273
17440,LAC,2019,Tyrone Wallace,24,62,0,628,92,217,.424,4,19,.211,88,198,.444,.433,30,57,.526,20,81,101,42,21,7,36,83,218
17441,LAC,2019,Ivica Zubac,21,26,25,524,100,186,.538,0,0,,100,186,.538,.538,44,60,.733,61,139,200,38,10,24,37,64,244
17442,LAC,2019,Garrett Temple,32,26,6,510,42,106,.396,16,54,.296,26,52,.500,.472,23,31,.742,10,54,64,37,26,5,16,70,123
17443,LAC,2019,JaMychal Green,28,24,2,471,79,164,.482,33,80,.413,46,84,.548,.582,17,21,.810,32,125,157,14,12,8,23,70,208
17444,LAC,2019,Boban Marjanović,30,36,9,376,85,140,.607,0,2,.000,85,138,.616,.607,72,95,.758,55,97,152,22,11,17,37,57,242
17445,LAC,2019,Jerome Robinson,21,33,0,320,44,110,.400,18,57,.316,26,53,.491,.482,6,9,.667,3,38,41,19,11,3,13,46,112
17446,LAC,2019,Sindarius Thornwell,24,64,1,313,17,49,.347,3,15,.200,14,34,.412,.378,25,34,.735,5,39,44,18,14,7,20,41,62
17447,LAC,2019,Wilson Chandler,31,15,1,226,23,66,.348,13,40,.325,10,26,.385,.447,5,7,.714,4,43,47,10,3,3,7,29,64
17448,LAC,2019,Johnathan Motley,23,22,0,156,39,73,.534,0,3,.000,39,70,.557,.534,24,40,.600,18,33,51,11,5,3,16,27,102
17449,LAC,2019,Miloš Teodosić,31,15,0,150,17,40,.425,10,27,.370,7,13,.538,.550,4,7,.571,3,13,16,32,3,1,21,27,48
17450,LAC,2019,Luc Mbah a Moute,32,4,0,61,8,18,.444,2,6,.333,6,12,.500,.500,2,5,.400,2,5,7,2,1,1,2,8,20
17451,LAC,2019,Ángel Delgado,24,2,0,15,1,5,.200,0,0,,1,5,.200,.200,1,2,.500,2,2,4,0,1,0,0,2,3
17452,LAC,2018,Lou Williams,31,79,19,2589,582,1337,.435,186,518,.359,396,819,.484,.505,432,491,.880,40,158,198,417,85,19,234,106,1782
17453,LAC,2018,DeAndre Jordan,29,77,77,2424,373,578,.645,0,0,,373,578,.645,.645,181,312,.580,329,842,1171,117,39,71,137,203,927
17454,LAC,2018,Austin Rivers,25,61,59,2057,341,805,.424,136,360,.378,205,445,.461,.508,102,159,.642,27,118,145,242,74,16,109,152,920
17455,LAC,2018,Wesley Johnson,30,74,40,1486,150,368,.408,60,177,.339,90,191,.471,.489,43,58,.741,29,187,216,61,76,62,55,146,403
17456,LAC,2018,Montrezl Harrell,24,76,3,1293,348,548,.635,1,7,.143,347,541,.641,.636,139,222,.626,103,203,306,74,36,52,68,143,836
17457,LAC,2018,Sindarius Thornwell,23,73,16,1156,100,233,.429,23,61,.377,77,172,.448,.479,59,88,.670,33,107,140,68,48,25,53,125,282
17458,LAC,2018,Blake Griffin,28,33,33,1139,255,578,.441,64,187,.342,191,391,.488,.497,172,219,.785,46,216,262,179,30,9,99,78,746
17459,LAC,2018,Miloš Teodosić,30,45,36,1134,151,360,.419,88,232,.379,63,128,.492,.542,39,46,.848,16,110,126,209,23,5,97,103,429
17460,LAC,2018,Tobias Harris,25,32,32,1105,242,512,.473,70,169,.414,172,343,.501,.541,64,80,.800,22,171,193,98,37,20,54,73,618
17461,LAC,2018,Sam Dekker,23,73,1,883,128,259,.494,10,60,.167,118,199,.593,.514,37,56,.661,44,130,174,38,24,9,33,71,303
17462,LAC,2018,Tyrone Wallace,23,30,19,851,110,247,.445,10,40,.250,100,207,.483,.466,61,78,.782,21,84,105,71,27,13,46,83,291
17463,LAC,2018,Jawun Evans,21,48,4,778,89,253,.352,15,54,.278,74,199,.372,.381,38,49,.776,9,75,84,100,36,6,44,97,231
17464,LAC,2018,C.J. Williams,27,38,18,707,87,197,.442,22,78,.282,65,119,.546,.497,13,16,.813,12,44,56,43,31,13,20,63,209
17465,LAC,2018,Danilo Gallinari,29,21,21,671,102,256,.398,36,111,.324,66,145,.455,.469,81,87,.931,9,92,101,41,12,10,26,30,321
17466,LAC,2018,Willie Reed,27,39,5,419,80,120,.667,1,2,.500,79,118,.669,.671,32,55,.582,35,85,120,9,9,22,19,53,193
17467,LAC,2018,Patrick Beverley,29,11,11,334,48,119,.403,24,60,.400,24,59,.407,.504,14,17,.824,16,29,45,32,19,5,25,34,134
17468,LAC,2018,Jamil Wilson,27,15,10,274,38,81,.469,27,63,.429,11,18,.611,.636,2,4,.500,3,29,32,10,5,8,8,34,105
17469,LAC,2018,Boban Marjanović,29,20,0,166,38,69,.551,0,0,,38,69,.551,.551,41,52,.788,33,54,87,8,6,5,14,23,117
17470,LAC,2018,Avery Bradley,27,6,6,165,26,55,.473,1,9,.111,25,46,.543,.482,2,2,1.000,3,19,22,11,5,1,8,12,55
17471,LAC,2018,Sean Kilpatrick,28,4,0,38,7,18,.389,3,7,.429,4,11,.364,.472,2,2,1.000,0,2,2,3,0,0,1,2,19
17472,LAC,2018,Brice Johnson,23,9,0,38,7,11,.636,0,1,.000,7,10,.700,.636,2,2,1.000,2,11,13,1,6,2,4,7,16
17473,LAC,2017,DeAndre Jordan,28,81,81,2570,412,577,.714,0,2,.000,412,575,.717,.714,205,425,.482,298,816,1114,96,51,134,115,212,1029
17474,LAC,2017,JJ Redick,32,78,78,2198,396,890,.445,201,468,.429,195,422,.462,.558,180,202,.891,11,160,171,110,54,13,98,125,1173
17475,LAC,2017,Jamal Crawford,36,82,1,2157,359,870,.413,116,322,.360,243,548,.443,.479,174,203,.857,17,112,129,214,61,14,134,115,1008
17476,LAC,2017,Blake Griffin,27,61,61,2076,479,971,.493,38,113,.336,441,858,.514,.513,320,421,.760,112,385,497,300,57,22,142,157,1316
17477,LAC,2017,Austin Rivers,24,74,29,2054,323,731,.442,111,299,.371,212,432,.491,.518,132,191,.691,20,141,161,204,48,10,115,187,889
17478,LAC,2017,Chris Paul,31,61,61,1921,374,785,.476,124,302,.411,250,483,.518,.555,232,260,.892,40,264,304,563,119,8,147,146,1104
17479,LAC,2017,Luc Mbah a Moute,30,80,76,1787,191,378,.505,43,110,.391,148,268,.552,.562,59,87,.678,44,126,170,39,81,35,46,122,484
17480,LAC,2017,Raymond Felton,32,80,11,1700,221,514,.430,46,144,.319,175,370,.473,.475,50,64,.781,33,185,218,191,66,22,83,125,538
17481,LAC,2017,Marreese Speights,29,82,2,1286,244,548,.445,103,277,.372,141,271,.520,.539,120,137,.876,88,285,373,65,23,41,69,229,711
17482,LAC,2017,Wesley Johnson,29,68,3,810,73,200,.365,29,118,.246,44,82,.537,.438,11,17,.647,26,155,181,23,29,30,18,83,186
17483,LAC,2017,Brandon Bass,31,52,0,577,107,186,.575,1,3,.333,106,183,.579,.578,77,88,.875,43,86,129,21,14,11,29,45,292
17484,LAC,2017,Alan Anderson,34,30,0,308,30,80,.375,14,44,.318,16,36,.444,.463,12,16,.750,3,21,24,11,3,0,7,35,86
17485,LAC,2017,Paul Pierce,39,25,7,277,28,70,.400,15,43,.349,13,27,.481,.507,10,13,.769,1,47,48,10,4,5,16,40,81
17486,LAC,2017,Diamond Stone,19,7,0,24,3,13,.231,0,0,,3,13,.231,.231,4,4,1.000,1,5,6,0,0,1,2,5,10
17487,LAC,2017,Brice Johnson,22,3,0,9,2,7,.286,0,0,,2,7,.286,.286,0,0,,1,2,3,1,2,1,1,0,4
17488,LAC,2016,DeAndre Jordan,27,77,77,2598,357,508,.703,0,1,.000,357,507,.704,.703,266,619,.430,267,792,1059,90,51,177,107,207,980
17489,LAC,2016,Chris Paul,30,74,74,2420,515,1114,.462,122,329,.371,393,785,.501,.517,294,328,.896,39,271,310,738,152,13,194,185,1446
17490,LAC,2016,Jamal Crawford,35,79,5,2126,379,939,.404,117,344,.340,262,595,.440,.466,245,271,.904,20,125,145,183,52,12,113,122,1120
17491,LAC,2016,JJ Redick,31,75,75,2097,422,880,.480,200,421,.475,222,459,.484,.593,182,205,.888,10,129,139,106,42,5,78,135,1226
17492,LAC,2016,Wesley Johnson,28,80,9,1666,208,515,.404,103,309,.333,105,206,.510,.504,30,46,.652,37,211,248,49,89,56,54,173,549
17493,LAC,2016,Austin Rivers,23,67,7,1464,226,516,.438,62,185,.335,164,331,.495,.498,79,116,.681,22,108,130,99,48,9,61,137,593
17494,LAC,2016,Luc Mbah a Moute,29,75,61,1274,94,207,.454,13,40,.325,81,167,.485,.486,30,57,.526,60,111,171,30,44,19,34,100,231
17495,LAC,2016,Paul Pierce,38,68,38,1231,144,397,.363,75,242,.310,69,155,.445,.457,54,66,.818,12,174,186,71,33,17,58,129,417
17496,LAC,2016,Blake Griffin,26,35,35,1170,301,603,.499,6,18,.333,295,585,.504,.504,141,194,.727,51,243,294,170,28,17,83,95,749
17497,LAC,2016,Pablo Prigioni,38,59,3,823,55,147,.374,28,95,.295,27,52,.519,.469,7,8,.875,38,76,114,130,53,1,49,82,145
17498,LAC,2016,Cole Aldrich,27,60,5,800,134,225,.596,0,0,,134,225,.596,.596,60,84,.714,86,202,288,50,47,68,64,139,328
17499,LAC,2016,Jeff Green,29,27,10,709,114,267,.427,25,77,.325,89,190,.468,.474,40,65,.615,19,72,91,40,18,21,24,62,293
17500,LAC,2016,Lance Stephenson,25,43,10,680,82,166,.494,19,47,.404,63,119,.529,.551,21,30,.700,19,89,108,60,24,3,48,79,204
17501,LAC,2016,Josh Smith,30,32,1,459,69,180,.383,18,58,.310,51,122,.418,.433,25,42,.595,33,92,125,42,18,34,41,62,181
17502,LAC,2016,C.J. Wilcox,25,23,0,167,26,66,.394,9,23,.391,17,43,.395,.462,9,12,.750,1,11,12,10,10,2,2,15,70
17503,LAC,2016,Jeff Ayres,28,17,0,107,12,23,.522,0,1,.000,12,22,.545,.522,6,6,1.000,4,18,22,5,0,3,6,18,30
17504,LAC,2016,Branden Dawson,22,6,0,29,2,5,.400,0,0,,2,5,.400,.400,1,1,1.000,2,2,4,0,0,1,0,2,5
17505,LAC,2016,Alex Stepheson,28,4,0,12,1,1,1.000,0,0,,1,1,1.000,1.000,0,2,.000,1,1,2,0,0,2,0,4,2
17506,LAC,2015,Chris Paul,29,82,82,2857,568,1170,.485,139,349,.398,429,821,.523,.545,289,321,.900,52,324,376,838,156,15,190,203,1564
17507,LAC,2015,DeAndre Jordan,26,82,82,2820,379,534,.710,1,4,.250,378,530,.713,.711,187,471,.397,397,829,1226,61,81,183,109,245,946
17508,LAC,2015,JJ Redick,30,78,78,2409,447,938,.477,200,458,.437,247,480,.515,.583,183,203,.901,22,145,167,137,39,8,95,134,1277
17509,LAC,2015,Blake Griffin,25,67,67,2356,574,1144,.502,10,25,.400,564,1119,.504,.506,311,427,.728,126,382,508,354,63,35,152,196,1469
17510,LAC,2015,Matt Barnes,34,76,74,2271,277,624,.444,136,376,.362,141,248,.569,.553,74,95,.779,51,251,302,114,67,50,87,240,764
17511,LAC,2015,Jamal Crawford,34,64,4,1703,332,839,.396,119,364,.327,213,475,.448,.467,227,252,.901,18,106,124,158,59,14,92,108,1010
17512,LAC,2015,Spencer Hawes,26,73,15,1274,163,415,.393,55,176,.313,108,239,.452,.459,44,68,.647,30,228,258,88,24,53,61,173,425
17513,LAC,2015,Glen Davis,29,74,0,904,117,255,.459,0,4,.000,117,251,.466,.459,60,95,.632,43,126,169,39,41,21,39,132,294
17514,LAC,2015,Austin Rivers,22,41,2,791,117,274,.427,25,81,.309,92,193,.477,.473,32,55,.582,15,69,84,68,30,7,35,81,291
17515,LAC,2015,Hedo Türkoğlu,35,62,2,705,83,188,.441,60,139,.432,23,49,.469,.601,6,11,.545,5,94,99,37,19,7,29,66,232
17516,LAC,2015,Jordan Farmar,28,36,0,529,61,158,.386,35,97,.361,26,61,.426,.497,10,11,.909,8,34,42,67,20,5,32,52,167
17517,LAC,2015,Reggie Bullock,23,25,2,263,23,54,.426,15,39,.385,8,15,.533,.565,4,5,.800,0,40,40,6,9,2,6,17,65
17518,LAC,2015,Ekpe Udoh,27,33,0,128,11,24,.458,0,0,,11,24,.458,.458,7,9,.778,7,19,26,8,8,7,7,20,29
17519,LAC,2015,Nate Robinson,30,9,0,126,17,51,.333,7,20,.350,10,31,.323,.402,5,6,.833,3,8,11,20,6,0,8,8,46
17520,LAC,2015,Dahntay Jones,34,33,0,123,6,21,.286,0,4,.000,6,17,.353,.286,9,11,.818,1,10,11,2,3,0,1,23,21
17521,LAC,2015,Jordan Hamilton,24,14,2,122,14,35,.400,10,21,.476,4,14,.286,.543,0,0,,2,14,16,7,2,0,4,14,38
17522,LAC,2015,Chris Douglas-Roberts,28,12,0,103,5,21,.238,1,7,.143,4,14,.286,.262,8,8,1.000,1,11,12,4,1,0,0,14,19
17523,LAC,2015,C.J. Wilcox,24,21,0,101,16,38,.421,7,19,.368,9,19,.474,.513,2,2,1.000,1,6,7,8,3,1,10,7,41
17524,LAC,2015,Jared Cunningham,23,19,0,89,12,33,.364,4,13,.308,8,20,.400,.424,7,13,.538,1,8,9,10,3,0,7,12,35
17525,LAC,2015,Lester Hudson,30,5,0,56,6,14,.429,3,6,.500,3,8,.375,.536,3,4,.750,1,7,8,5,6,1,3,4,18
17526,LAC,2014,DeAndre Jordan,25,82,82,2870,348,515,.676,0,0,,348,515,.676,.676,160,374,.428,331,783,1114,74,80,203,123,264,856
17527,LAC,2014,Blake Griffin,24,80,80,2863,718,1359,.528,12,44,.273,706,1315,.537,.533,482,674,.715,192,565,757,309,92,51,224,265,1930
17528,LAC,2014,Chris Paul,28,62,62,2171,406,870,.467,78,212,.368,328,658,.498,.511,295,345,.855,38,230,268,663,154,4,145,157,1185
17529,LAC,2014,Jamal Crawford,33,69,24,2094,421,1011,.416,161,446,.361,260,565,.460,.496,279,322,.866,34,124,158,223,59,12,135,120,1282
17530,LAC,2014,Darren Collison,26,80,35,2069,324,694,.467,71,189,.376,253,505,.501,.518,192,224,.857,47,141,188,297,93,15,132,150,911
17531,LAC,2014,Matt Barnes,33,63,40,1735,231,527,.438,97,283,.343,134,244,.549,.530,66,90,.733,60,232,292,125,56,28,85,185,625
17532,LAC,2014,Jared Dudley,28,74,43,1729,196,447,.438,81,225,.360,115,222,.518,.529,38,58,.655,36,124,160,104,41,10,56,146,511
17533,LAC,2014,JJ Redick,29,35,34,987,181,398,.455,73,185,.395,108,213,.507,.546,97,106,.915,9,65,74,78,28,3,42,65,532
17534,LAC,2014,Willie Green,32,55,9,869,102,271,.376,41,121,.339,61,150,.407,.452,28,34,.824,12,66,78,50,22,11,34,96,273
17535,LAC,2014,Ryan Hollins,29,61,0,482,53,72,.736,0,0,,53,72,.736,.736,35,56,.625,31,59,90,8,9,31,29,87,141
17536,LAC,2014,Reggie Bullock,22,43,0,395,43,121,.355,22,73,.301,21,48,.438,.446,7,9,.778,11,43,54,12,9,1,13,26,115
17537,LAC,2014,Hedo Türkoğlu,34,38,0,392,42,109,.385,22,50,.440,20,59,.339,.486,9,18,.500,11,78,89,33,19,10,16,50,115
17538,LAC,2014,Glen Davis,28,23,1,308,39,81,.481,0,1,.000,39,80,.488,.481,18,23,.783,21,48,69,7,12,7,17,48,96
17539,LAC,2014,Antawn Jamison,37,22,0,248,29,92,.315,8,41,.195,21,51,.412,.359,18,25,.720,9,46,55,7,9,3,7,29,84
17540,LAC,2014,Danny Granger,30,12,0,194,36,84,.429,12,34,.353,24,50,.480,.500,12,14,.857,7,21,28,8,3,4,10,21,96
17541,LAC,2014,Byron Mullens,24,27,0,167,26,64,.406,13,39,.333,13,25,.520,.508,2,6,.333,7,25,32,6,6,3,13,33,67
17542,LAC,2014,Stephen Jackson,35,9,0,107,6,26,.231,1,14,.071,5,12,.417,.250,2,4,.500,2,8,10,5,6,1,6,11,15
17543,LAC,2014,Darius Morris,23,10,0,54,4,13,.308,0,7,.000,4,6,.667,.308,1,2,.500,0,5,5,5,2,0,2,9,9
17544,LAC,2014,Sasha Vujačić,29,2,0,10,2,5,.400,1,2,.500,1,3,.333,.500,0,0,,0,3,3,0,1,0,3,1,5
17545,LAC,2014,Maalik Wayns,22,2,0,9,1,2,.500,0,0,,1,2,.500,.500,0,0,,0,2,2,2,2,0,0,4,2
17546,LAC,2013,Blake Griffin,23,80,80,2598,577,1072,.538,5,28,.179,572,1044,.548,.541,281,426,.660,186,476,662,299,97,50,185,231,1440
17547,LAC,2013,Chris Paul,27,70,70,2335,412,856,.481,76,232,.328,336,624,.538,.526,286,323,.885,53,209,262,678,169,10,159,143,1186
17548,LAC,2013,Jamal Crawford,32,76,0,2230,445,1016,.438,149,396,.376,296,620,.477,.511,216,248,.871,22,106,128,193,79,13,146,71,1255
17549,LAC,2013,Matt Barnes,32,80,4,2058,312,675,.462,111,325,.342,201,350,.574,.544,87,117,.744,111,255,366,123,82,63,90,233,822
17550,LAC,2013,DeAndre Jordan,24,82,82,2010,314,488,.643,0,0,,314,488,.643,.643,96,249,.386,210,384,594,28,48,112,100,192,724
17551,LAC,2013,Caron Butler,32,78,78,1879,305,720,.424,128,330,.388,177,390,.454,.513,75,90,.833,41,182,223,78,51,11,72,139,813
17552,LAC,2013,Lamar Odom,33,82,2,1616,146,366,.399,18,90,.200,128,276,.464,.423,20,42,.476,117,363,480,142,69,58,86,214,330
17553,LAC,2013,Eric Bledsoe,23,76,12,1553,253,568,.445,31,78,.397,222,490,.453,.473,106,134,.791,78,147,225,233,109,55,137,112,643
17554,LAC,2013,Willie Green,31,72,60,1188,178,386,.461,71,166,.428,107,220,.486,.553,23,32,.719,17,80,97,55,29,12,31,96,450
17555,LAC,2013,Ronny Turiaf,30,65,0,701,49,97,.505,0,0,,49,97,.505,.505,23,63,.365,45,107,152,35,19,35,29,80,121
17556,LAC,2013,Ryan Hollins,28,60,0,663,70,114,.614,0,0,,70,114,.614,.614,66,88,.750,50,89,139,11,6,34,44,133,206
17557,LAC,2013,Grant Hill,40,29,0,437,38,98,.388,3,11,.273,35,87,.402,.403,14,24,.583,6,43,49,26,11,7,25,39,93
17558,LAC,2013,Chauncey Billups,36,22,22,418,53,132,.402,33,90,.367,20,42,.476,.527,45,48,.938,2,30,32,49,12,1,26,25,184
17559,LAC,2013,Maalik Wayns,21,6,0,37,7,16,.438,2,6,.333,5,10,.500,.500,4,4,1.000,0,2,2,7,3,0,2,8,20
17560,LAC,2013,DaJuan Summers,25,2,0,7,1,4,.250,0,0,,1,4,.250,.250,0,0,,0,2,2,1,0,0,0,0,2
17561,LAC,2012,Blake Griffin,22,66,66,2392,561,1022,.549,2,16,.125,559,1006,.556,.550,244,468,.521,218,499,717,210,54,48,150,216,1368
17562,LAC,2012,Chris Paul,26,60,60,2181,425,890,.478,79,213,.371,346,677,.511,.522,260,302,.861,42,171,213,543,152,4,124,138,1189
17563,LAC,2012,Caron Butler,31,63,63,1871,287,705,.407,92,257,.358,195,448,.435,.472,87,107,.813,44,186,230,78,52,9,77,123,753
17564,LAC,2012,DeAndre Jordan,23,66,66,1798,206,326,.632,0,1,.000,206,325,.634,.632,74,141,.525,202,344,546,17,30,134,74,189,486
17565,LAC,2012,Randy Foye,28,65,48,1682,256,644,.398,127,329,.386,129,315,.410,.496,73,85,.859,25,113,138,146,46,24,73,130,712
17566,LAC,2012,Mo Williams,29,52,1,1472,260,611,.426,93,239,.389,167,372,.449,.502,72,80,.900,23,76,99,160,51,7,86,103,685
17567,LAC,2012,Kenyon Martin,34,42,0,940,97,220,.441,3,13,.231,94,207,.454,.448,20,54,.370,49,132,181,18,44,43,32,103,217
17568,LAC,2012,Reggie Evans,31,56,0,771,34,72,.472,0,0,,34,72,.472,.472,36,71,.507,100,171,271,17,31,6,44,118,104
17569,LAC,2012,Chauncey Billups,35,20,20,607,83,228,.364,48,125,.384,35,103,.340,.469,85,95,.895,4,46,50,80,9,3,38,40,299
17570,LAC,2012,Nick Young,26,22,3,518,76,193,.394,30,85,.353,46,108,.426,.472,32,39,.821,11,25,36,10,14,6,24,51,214
17571,LAC,2012,Eric Bledsoe,22,40,1,464,49,126,.389,6,30,.200,43,96,.448,.413,28,44,.636,22,43,65,66,31,14,47,58,132
17572,LAC,2012,Ryan Gomes,29,32,2,425,31,95,.326,4,29,.138,27,66,.409,.347,8,11,.727,14,47,61,12,16,0,15,34,74
17573,LAC,2012,Bobby Simmons,31,28,0,418,28,90,.311,20,60,.333,8,30,.267,.422,4,7,.571,17,38,55,11,15,3,10,41,80
17574,LAC,2012,Brian Cook,31,16,0,121,11,49,.224,5,27,.185,6,22,.273,.276,4,4,1.000,4,19,23,2,2,4,4,26,31
17575,LAC,2012,Trey Thompkins,21,24,0,119,24,61,.393,4,13,.308,20,48,.417,.426,5,7,.714,4,20,24,3,3,3,6,10,57
17576,LAC,2012,Solomon Jones,27,10,0,96,1,8,.125,0,0,,1,8,.125,.125,4,5,.800,11,6,17,2,4,5,5,12,6
17577,LAC,2012,Courtney Fortson,23,4,0,46,5,12,.417,1,4,.250,4,8,.500,.458,6,9,.667,4,4,8,5,0,0,5,3,17
17578,LAC,2012,Travis Leslie,21,10,0,45,5,14,.357,0,0,,5,14,.357,.357,4,9,.444,6,3,9,5,2,2,2,4,14
17579,LAC,2011,Blake Griffin,21,82,82,3112,696,1376,.506,7,24,.292,689,1352,.510,.508,446,695,.642,270,719,989,312,63,45,223,252,1845
17580,LAC,2011,Eric Gordon,22,56,56,2112,427,949,.450,106,291,.364,321,658,.488,.506,287,348,.825,45,119,164,244,71,18,151,115,1247
17581,LAC,2011,Ryan Gomes,28,76,62,2095,207,505,.410,72,211,.341,135,294,.459,.481,61,85,.718,61,193,254,118,62,12,55,159,547
17582,LAC,2011,DeAndre Jordan,22,80,66,2047,234,341,.686,0,1,.000,234,340,.688,.686,98,217,.452,207,368,575,42,41,142,101,255,566
17583,LAC,2011,Eric Bledsoe,21,81,25,1841,206,486,.424,32,116,.276,174,370,.470,.457,99,133,.744,68,155,223,289,92,26,194,130,543
17584,LAC,2011,Randy Foye,27,63,24,1551,206,531,.388,71,217,.327,135,314,.430,.455,133,149,.893,13,90,103,170,47,21,95,122,616
17585,LAC,2011,Al-Farouq Aminu,20,81,14,1452,160,406,.394,45,143,.315,115,263,.437,.450,92,119,.773,75,192,267,60,59,25,103,121,457
17586,LAC,2011,Baron Davis,31,43,35,1269,214,515,.416,45,152,.296,169,363,.466,.459,79,104,.760,29,91,120,299,62,22,107,114,552
17587,LAC,2011,Chris Kaman,28,32,15,838,177,376,.471,0,0,,177,376,.471,.471,43,57,.754,51,174,225,46,16,48,58,75,397
17588,LAC,2011,Rasual Butler,31,41,2,744,73,226,.323,42,129,.326,31,97,.320,.416,18,27,.667,10,66,76,27,8,15,22,34,206
17589,LAC,2011,Mo Williams,28,22,22,723,113,268,.422,43,108,.398,70,160,.438,.502,66,75,.880,6,50,56,123,20,0,66,59,335
17590,LAC,2011,Craig Smith,27,48,0,586,104,188,.553,0,5,.000,104,183,.568,.553,50,68,.735,43,74,117,31,16,7,33,84,258
17591,LAC,2011,Ike Diogu,27,36,0,470,83,148,.561,0,0,,83,148,.561,.561,41,62,.661,41,74,115,2,3,3,22,72,207
17592,LAC,2011,Brian Cook,30,40,0,447,72,170,.424,34,79,.430,38,91,.418,.524,15,24,.625,19,77,96,15,12,11,25,75,193
17593,LAC,2011,Jamario Moon,30,19,7,278,25,59,.424,11,28,.393,14,31,.452,.517,5,6,.833,9,38,47,7,3,6,5,26,66
17594,LAC,2011,Jarron Collins,32,23,0,157,5,15,.333,0,0,,5,15,.333,.333,7,10,.700,7,10,17,1,4,1,5,24,17
17595,LAC,2011,Willie Warren,21,19,0,134,13,35,.371,5,15,.333,8,20,.400,.443,6,8,.750,1,11,12,27,6,0,8,16,37
17596,LAC,2010,Rasual Butler,30,82,64,2702,356,870,.409,145,432,.336,211,438,.482,.493,122,145,.841,39,201,240,116,36,68,79,121,979
17597,LAC,2010,Chris Kaman,27,76,76,2608,589,1202,.490,0,6,.000,589,1196,.492,.490,230,307,.749,184,520,704,120,37,94,223,213,1408
17598,LAC,2010,Baron Davis,30,75,73,2523,412,1015,.406,82,296,.277,330,719,.459,.446,239,291,.821,52,214,266,598,126,43,211,210,1145
17599,LAC,2010,Eric Gordon,21,62,60,2229,352,784,.449,119,321,.371,233,463,.503,.525,222,299,.742,25,135,160,186,69,14,144,96,1045
17600,LAC,2010,Marcus Camby,35,51,51,1596,166,356,.466,2,6,.333,164,350,.469,.469,60,91,.659,166,450,616,151,69,99,64,105,394
17601,LAC,2010,Al Thornton,26,51,30,1405,220,460,.478,5,14,.357,215,446,.482,.484,103,139,.741,85,107,192,61,25,22,66,144,548
17602,LAC,2010,Craig Smith,26,75,2,1232,226,397,.569,1,5,.200,225,392,.574,.571,132,208,.635,97,190,287,84,33,25,88,194,585
17603,LAC,2010,DeAndre Jordan,21,70,12,1137,144,238,.605,0,2,.000,144,236,.610,.605,48,128,.375,122,230,352,21,16,62,75,152,336
17604,LAC,2010,Steve Blake,29,29,10,762,74,167,.443,38,87,.437,36,80,.450,.557,12,16,.750,6,63,69,177,21,4,63,39,198
17605,LAC,2010,Drew Gooden,28,24,22,725,131,266,.492,0,2,.000,131,264,.496,.492,93,101,.921,84,142,226,21,15,8,52,65,355
17606,LAC,2010,Sebastian Telfair,24,39,1,582,67,166,.404,11,47,.234,56,119,.471,.437,24,31,.774,5,36,41,114,22,5,44,65,169
17607,LAC,2010,Ricky Davis,30,36,2,499,62,143,.434,16,42,.381,46,101,.455,.490,18,31,.581,10,47,57,39,11,3,29,39,158
17608,LAC,2010,Travis Outlaw,25,23,6,499,72,180,.400,28,74,.378,44,106,.415,.478,28,35,.800,20,63,83,26,11,9,20,30,200
17609,LAC,2010,Mardy Collins,25,43,0,470,47,128,.367,4,17,.235,43,111,.387,.383,13,21,.619,13,37,50,44,23,1,32,45,111
17610,LAC,2010,Steve Novak,26,54,0,362,42,108,.389,22,71,.310,20,37,.541,.491,7,9,.778,1,32,33,6,7,2,2,21,113
17611,LAC,2010,Bobby Brown,25,23,0,191,28,85,.329,9,32,.281,19,53,.358,.382,5,7,.714,8,12,20,42,6,0,22,14,70
17612,LAC,2010,Brian Skinner,33,16,1,123,10,25,.400,0,0,,10,25,.400,.400,6,8,.750,9,18,27,0,3,4,7,20,26
17613,LAC,2010,Kareem Rush,29,7,0,58,4,11,.364,1,3,.333,3,8,.375,.409,0,0,,1,5,6,4,2,3,3,8,9
17614,LAC,2010,JamesOn Curry,24,1,0,0,0,0,,0,0,,0,0,,,0,0,,0,0,0,0,0,0,0,0,0
17615,LAC,2009,Eric Gordon,20,78,65,2677,411,901,.456,131,337,.389,280,564,.496,.529,299,350,.854,45,156,201,215,78,35,164,172,1252
17616,LAC,2009,Al Thornton,25,71,67,2654,469,1051,.446,20,79,.253,449,972,.462,.456,236,313,.754,122,246,368,103,59,62,130,227,1194
17617,LAC,2009,Baron Davis,29,65,60,2248,355,959,.370,99,328,.302,256,631,.406,.422,159,210,.757,46,192,238,501,108,35,193,193,968
17618,LAC,2009,Marcus Camby,34,62,55,1925,254,496,.512,1,4,.250,253,492,.514,.513,132,182,.725,161,529,690,127,51,132,93,129,641
17619,LAC,2009,Fred Jones,29,52,21,1495,129,317,.407,54,147,.367,75,170,.441,.492,66,81,.815,23,103,126,188,53,11,66,112,378
17620,LAC,2009,Zach Randolph,27,39,34,1369,333,684,.487,25,73,.342,308,611,.504,.505,124,177,.701,117,250,367,88,30,13,91,105,815
17621,LAC,2009,Steve Novak,25,71,3,1161,176,396,.444,119,286,.416,57,110,.518,.595,21,23,.913,19,106,125,40,20,5,23,71,492
17622,LAC,2009,Chris Kaman,26,31,24,921,161,305,.528,0,0,,161,305,.528,.528,51,75,.680,75,172,247,46,17,45,84,93,373
17623,LAC,2009,Brian Skinner,32,51,21,843,92,205,.449,0,2,.000,92,203,.453,.449,30,47,.638,72,131,203,27,17,52,43,94,214
17624,LAC,2009,Mardy Collins,24,39,14,815,97,224,.433,13,28,.464,84,196,.429,.462,24,37,.649,29,70,99,101,29,10,53,73,231
17625,LAC,2009,Ricky Davis,29,36,9,785,83,245,.339,35,111,.315,48,134,.358,.410,31,36,.861,9,51,60,82,19,5,39,63,232
17626,LAC,2009,DeAndre Jordan,20,53,13,771,93,147,.633,0,0,,93,147,.633,.633,42,109,.385,72,165,237,11,11,59,41,96,228
17627,LAC,2009,Mike Taylor,23,51,5,771,110,267,.412,13,40,.325,97,227,.427,.436,56,81,.691,22,65,87,106,36,0,73,84,289
17628,LAC,2009,Cuttino Mobley,33,11,11,365,63,146,.432,12,35,.343,51,111,.459,.473,13,18,.722,9,20,29,12,15,2,18,21,151
17629,LAC,2009,Paul Davis,24,27,1,320,40,98,.408,0,1,.000,40,97,.412,.408,27,34,.794,28,39,67,12,10,3,13,44,107
17630,LAC,2009,Jason Hart,30,28,2,312,25,84,.298,0,4,.000,25,80,.313,.298,15,19,.789,12,30,42,43,12,4,19,35,65
17631,LAC,2009,Tim Thomas,31,10,5,220,34,90,.378,6,20,.300,28,70,.400,.411,21,34,.618,14,32,46,10,3,1,14,26,95
17632,LAC,2009,Alex Acker,26,18,0,179,26,65,.400,7,16,.438,19,49,.388,.454,4,8,.500,8,14,22,11,3,3,7,9,63
17633,LAC,2009,Cheikh Samb,24,10,0,51,4,16,.250,0,2,.000,4,14,.286,.250,3,5,.600,7,6,13,0,1,5,1,3,11
17634,LAC,2008,Cuttino Mobley,32,77,38,2702,377,870,.433,67,192,.349,310,678,.457,.472,163,199,.819,50,225,275,202,78,34,123,152,984
17635,LAC,2008,Corey Maggette,28,70,65,2502,458,1000,.458,78,203,.384,380,797,.477,.497,553,681,.812,78,316,394,189,71,7,195,210,1547
17636,LAC,2008,Al Thornton,24,79,31,2158,374,871,.429,43,130,.331,331,741,.447,.454,214,288,.743,98,260,358,98,46,43,128,195,1005
17637,LAC,2008,Chris Kaman,25,56,55,2083,338,700,.483,0,4,.000,338,696,.486,.483,202,265,.762,173,538,711,107,33,155,164,179,878
17638,LAC,2008,Tim Thomas,30,63,51,1940,291,705,.413,83,271,.306,208,434,.479,.472,115,153,.752,62,261,323,171,40,29,98,192,780
17639,LAC,2008,Brevin Knight,32,74,39,1674,138,342,.404,0,6,.000,138,336,.411,.404,62,71,.873,15,127,142,328,100,11,71,160,338
17640,LAC,2008,Quinton Ross,26,76,44,1505,131,335,.391,9,21,.429,122,314,.389,.404,40,60,.667,54,118,172,88,43,33,29,132,311
17641,LAC,2008,Josh Powell,25,64,25,1228,145,315,.460,0,3,.000,145,312,.465,.460,63,87,.724,115,216,331,47,14,23,65,130,353
17642,LAC,2008,Dan Dickau,29,67,8,1040,124,296,.419,36,108,.333,88,188,.468,.480,68,82,.829,13,84,97,172,32,3,55,108,352
17643,LAC,2008,Sam Cassell,38,38,33,975,183,402,.455,14,54,.259,169,348,.486,.473,106,119,.891,12,93,105,179,28,3,78,69,486
17644,LAC,2008,Smush Parker,26,19,2,409,47,130,.362,12,54,.222,35,76,.461,.408,16,24,.667,2,30,32,69,19,3,36,47,122
17645,LAC,2008,Ruben Patterson,32,20,5,327,39,86,.453,0,2,.000,39,84,.464,.453,24,43,.558,24,40,64,17,21,7,27,37,102
17646,LAC,2008,Aaron Williams,36,30,5,297,27,55,.491,0,0,,27,55,.491,.491,14,18,.778,15,46,61,9,12,15,13,44,68
17647,LAC,2008,Elton Brand,28,8,6,274,52,114,.456,0,0,,52,114,.456,.456,37,47,.787,21,43,64,16,3,15,17,21,141
17648,LAC,2008,Nick Fazekas,22,22,0,260,44,77,.571,0,2,.000,44,75,.587,.571,15,22,.682,33,53,86,11,8,11,13,25,103
17649,LAC,2008,Paul Davis,23,22,1,194,24,65,.369,0,0,,24,65,.369,.369,6,10,.600,25,22,47,10,6,6,9,33,54
17650,LAC,2008,Richie Frahm,30,10,2,163,20,54,.370,7,25,.280,13,29,.448,.435,0,2,.000,4,10,14,8,2,0,6,7,47
17651,LAC,2008,Marcus Williams,21,10,0,34,5,19,.263,0,0,,5,19,.263,.263,0,0,,4,8,12,3,1,0,0,3,10
17652,LAC,2008,Andre Barrett,25,4,0,25,2,5,.400,1,3,.333,1,2,.500,.500,1,2,.500,0,1,1,7,0,0,1,1,6
17653,LAC,2008,Guillermo Díaz,22,6,0,18,1,4,.250,0,1,.000,1,3,.333,.250,3,5,.600,2,0,2,1,0,0,0,0,5
17654,LAC,2007,Elton Brand,27,80,80,3077,645,1211,.533,1,1,1.000,644,1210,.532,.533,351,461,.761,268,476,744,235,77,179,202,238,1642
17655,LAC,2007,Cuttino Mobley,31,78,73,2841,388,882,.440,101,246,.411,287,636,.451,.497,200,239,.837,52,215,267,198,92,24,145,186,1077
17656,LAC,2007,Corey Maggette,27,75,31,2291,367,808,.454,13,65,.200,354,743,.476,.462,519,633,.820,90,352,442,208,65,14,201,244,1266
17657,LAC,2007,Chris Kaman,24,75,66,2176,294,652,.451,0,1,.000,294,651,.452,.451,166,224,.741,160,428,588,79,41,116,147,251,754
17658,LAC,2007,Tim Thomas,29,76,24,2054,299,723,.414,136,356,.382,163,367,.444,.508,102,144,.708,63,315,378,171,55,28,106,228,836
17659,LAC,2007,Quinton Ross,25,81,43,1700,177,379,.467,2,10,.200,175,369,.474,.470,68,87,.782,60,130,190,86,70,32,33,179,424
17660,LAC,2007,Shaun Livingston,21,54,31,1611,208,449,.463,5,16,.313,203,433,.469,.469,82,116,.707,56,128,184,274,59,29,108,135,503
17661,LAC,2007,Sam Cassell,37,58,30,1407,261,625,.418,32,109,.294,229,516,.444,.443,160,182,.879,27,140,167,270,28,8,101,126,714
17662,LAC,2007,Jason Hart,28,23,22,746,85,194,.438,4,23,.174,81,171,.474,.448,32,36,.889,12,71,83,93,41,1,34,60,206
17663,LAC,2007,Daniel Ewing,23,61,3,712,65,161,.404,14,44,.318,51,117,.436,.447,35,45,.778,9,64,73,90,32,4,50,62,179
17664,LAC,2007,James Singleton,25,53,0,376,30,82,.366,3,14,.214,27,68,.397,.384,22,29,.759,36,70,106,17,15,17,17,45,85
17665,LAC,2007,Aaron Williams,35,38,7,374,29,53,.547,0,1,.000,29,52,.558,.547,18,22,.818,27,58,85,7,7,14,18,56,76
17666,LAC,2007,Paul Davis,22,31,0,180,22,52,.423,0,0,,22,52,.423,.423,7,10,.700,21,23,44,7,6,5,8,28,51
17667,LAC,2007,Doug Christie,36,7,0,82,5,17,.294,1,6,.167,4,11,.364,.324,2,3,.667,3,8,11,8,3,1,5,11,13
17668,LAC,2007,Yaroslav Korolev,19,10,0,41,4,16,.250,1,5,.200,3,11,.273,.281,3,6,.500,1,2,3,4,3,0,1,0,12
17669,LAC,2007,Will Conroy,24,4,0,35,0,3,.000,0,0,,0,3,.000,.000,0,4,.000,2,3,5,8,0,0,2,6,0
17670,LAC,2007,Luke Jackson,25,3,0,16,1,8,.125,1,4,.250,0,4,.000,.188,0,0,,0,1,1,4,0,0,1,3,3
17671,LAC,2007,Alvin Williams,32,2,0,10,0,2,.000,0,1,.000,0,1,.000,.000,2,4,.500,1,0,1,3,2,0,3,0,2
17672,LAC,2007,Von Wafer,21,1,0,1,0,1,.000,0,1,.000,0,0,,.000,0,0,,0,0,0,0,0,0,0,0,0
17673,LAC,2006,Elton Brand,26,79,79,3099,756,1435,.527,1,3,.333,755,1432,.527,.527,440,568,.775,236,554,790,208,81,201,173,227,1953
17674,LAC,2006,Cuttino Mobley,30,79,74,2979,429,1008,.426,83,245,.339,346,763,.453,.467,229,273,.839,50,291,341,238,93,36,145,208,1170
17675,LAC,2006,Sam Cassell,36,78,75,2653,493,1112,.443,70,190,.368,423,922,.459,.475,289,335,.863,40,247,287,491,74,11,175,225,1345
17676,LAC,2006,Chris Kaman,23,78,78,2560,369,706,.523,0,2,.000,369,704,.524,.523,194,252,.770,187,563,750,79,45,108,176,269,932
17677,LAC,2006,Shaun Livingston,20,61,14,1525,149,349,.427,1,8,.125,148,341,.434,.428,53,77,.688,41,142,183,273,46,32,111,160,352
17678,LAC,2006,Quinton Ross,24,67,45,1515,130,308,.422,0,7,.000,130,301,.432,.422,57,75,.760,38,132,170,79,51,16,47,155,317
17679,LAC,2006,Daniel Ewing,22,66,5,971,97,255,.380,22,78,.282,75,177,.424,.424,36,46,.783,23,62,85,84,37,6,57,86,252
17680,LAC,2006,Corey Maggette,26,32,13,943,167,375,.445,24,71,.338,143,304,.470,.477,212,256,.828,28,141,169,66,19,4,78,95,570
17681,LAC,2006,Vladimir Radmanović,25,30,11,885,108,259,.417,66,158,.418,42,101,.416,.544,38,52,.731,25,146,171,64,29,14,40,80,320
17682,LAC,2006,James Singleton,24,59,10,753,77,151,.510,10,20,.500,67,131,.511,.543,39,50,.780,63,134,197,29,19,21,28,95,203
17683,LAC,2006,Chris Wilcox,23,48,1,657,90,168,.536,0,2,.000,90,166,.542,.536,38,59,.644,46,127,173,18,15,21,32,103,218
17684,LAC,2006,Željko Rebrača,33,29,2,412,52,96,.542,0,0,,52,96,.542,.542,31,41,.756,13,51,64,9,5,19,24,59,135
17685,LAC,2006,Walter McCarty,31,36,1,353,33,99,.333,10,45,.222,23,54,.426,.384,12,21,.571,15,53,68,23,8,5,19,52,88
17686,LAC,2006,Boniface N'Dong,28,23,1,152,22,53,.415,0,1,.000,22,52,.423,.415,6,9,.667,15,22,37,7,2,5,6,23,50
17687,LAC,2006,Yaroslav Korolev,18,24,0,127,9,30,.300,2,7,.286,7,23,.304,.333,7,10,.700,5,8,13,9,3,0,6,11,27
17688,LAC,2006,Howard Eisley,33,13,0,112,4,17,.235,1,4,.250,3,13,.231,.265,0,0,,1,13,14,25,3,0,3,11,9
17689,LAC,2006,Vin Baker,34,8,1,85,7,15,.467,0,0,,7,15,.467,.467,13,18,.722,2,17,19,4,4,4,9,13,27
17690,LAC,2006,Anthony Goldwire,34,3,0,22,1,7,.143,0,2,.000,1,5,.200,.143,0,0,,0,1,1,2,0,0,1,0,2
17691,LAC,2005,Elton Brand,25,81,81,3001,629,1251,.503,0,3,.000,629,1248,.504,.503,364,484,.752,296,474,770,208,62,169,183,240,1622
17692,LAC,2005,Bobby Simmons,24,75,74,2799,474,1017,.466,50,115,.435,424,902,.470,.491,231,273,.846,128,318,446,205,106,16,135,227,1229
17693,LAC,2005,Corey Maggette,25,66,60,2436,425,986,.431,51,168,.304,374,818,.457,.457,563,657,.857,70,324,394,225,70,8,195,191,1464
17694,LAC,2005,Rick Brunson,32,80,39,1945,166,442,.376,48,130,.369,118,312,.378,.430,57,74,.770,23,164,187,410,82,7,125,106,437
17695,LAC,2005,Quinton Ross,23,78,19,1659,161,373,.432,1,4,.250,160,369,.434,.433,74,110,.673,59,151,210,109,51,22,54,165,397
17696,LAC,2005,Marko Jarić,26,50,41,1656,189,457,.414,56,151,.371,133,306,.435,.475,59,82,.720,20,141,161,303,84,17,98,107,493
17697,LAC,2005,Chris Kaman,22,63,50,1632,246,495,.497,0,1,.000,246,494,.498,.497,80,121,.661,135,288,423,73,26,68,115,182,572
17698,LAC,2005,Mikki Moore,29,74,4,1178,144,287,.502,1,5,.200,143,282,.507,.503,107,136,.787,97,149,246,47,19,32,63,173,396
17699,LAC,2005,Chris Wilcox,22,54,25,1005,169,329,.514,0,0,,169,329,.514,.514,88,144,.611,63,165,228,38,26,24,77,129,426
17700,LAC,2005,Željko Rebrača,32,58,2,928,133,234,.568,0,0,,133,234,.568,.568,73,85,.859,49,135,184,26,13,40,49,130,339
17701,LAC,2005,Shaun Livingston,19,30,15,814,89,215,.414,0,2,.000,89,213,.418,.414,44,59,.746,22,67,89,151,32,11,75,82,222
17702,LAC,2005,Lionel Chalmers,24,36,0,433,42,125,.336,12,49,.245,30,76,.395,.384,15,24,.625,4,27,31,51,13,0,24,30,111
17703,LAC,2005,Kerry Kittles,30,11,0,243,28,73,.384,7,21,.333,21,52,.404,.432,6,10,.600,1,31,32,20,8,3,7,12,69
17704,LAC,2005,Darrick Martin,33,11,0,190,16,50,.320,5,18,.278,11,32,.344,.370,5,8,.625,3,7,10,28,6,0,6,19,42
17705,LAC,2005,Mamadou N'Diaye,29,11,0,72,8,20,.400,0,1,.000,8,19,.421,.400,4,7,.571,9,9,18,1,1,5,0,20,20
17706,LAC,2005,Kenny Anderson,34,4,0,26,4,11,.364,0,0,,4,11,.364,.364,0,0,,1,4,5,5,0,0,3,6,8
17707,LAC,2005,Kirk Penney,24,4,0,12,1,3,.333,0,1,.000,1,2,.500,.333,0,0,,0,1,1,1,0,0,2,0,2
17708,LAC,2005,Maurice Baker,25,1,0,1,0,0,,0,0,,0,0,,,0,0,,0,0,0,0,0,0,0,0,0
17709,LAC,2004,Elton Brand,24,69,68,2670,484,982,.493,0,1,.000,484,981,.493,.493,411,532,.773,269,445,714,227,64,154,193,229,1379
17710,LAC,2004,Corey Maggette,24,73,72,2628,453,1013,.447,76,231,.329,377,782,.482,.485,526,620,.848,96,334,430,224,65,16,207,217,1508
17711,LAC,2004,Quentin Richardson,23,65,64,2338,425,1068,.398,120,341,.352,305,727,.420,.454,151,204,.740,146,268,414,139,67,19,141,130,1121
17712,LAC,2004,Chris Kaman,21,82,61,1843,200,435,.460,0,2,.000,200,433,.462,.460,99,142,.697,126,335,461,85,23,73,155,211,499
17713,LAC,2004,Marko Jarić,25,58,50,1760,185,477,.388,51,150,.340,134,327,.410,.441,74,101,.733,44,131,175,281,93,20,115,132,495
17714,LAC,2004,Bobby Simmons,23,56,8,1376,147,373,.394,2,12,.167,145,361,.402,.397,141,169,.834,115,147,262,96,51,17,73,169,437
17715,LAC,2004,Chris Wilcox,21,65,17,1340,227,436,.521,0,1,.000,227,435,.522,.521,105,150,.700,125,180,305,51,29,20,80,183,559
17716,LAC,2004,Eddie House,25,60,10,1188,161,449,.359,51,136,.375,110,313,.351,.415,36,45,.800,28,110,138,148,65,4,63,92,409
17717,LAC,2004,Keyon Dooling,23,58,24,1137,137,352,.389,8,46,.174,129,306,.422,.401,78,94,.830,17,62,79,130,45,6,65,108,360
17718,LAC,2004,Doug Overton,34,55,11,1011,96,237,.405,3,23,.130,93,214,.435,.411,21,29,.724,16,69,85,134,25,2,56,85,216
17719,LAC,2004,Predrag Drobnjak,28,61,14,949,149,379,.393,11,36,.306,138,343,.402,.408,73,86,.849,54,142,196,39,22,24,48,85,382
17720,LAC,2004,Matt Barnes,23,38,9,724,63,138,.457,2,13,.154,61,125,.488,.464,43,61,.705,53,98,151,48,27,3,44,76,171
17721,LAC,2004,Melvin Ely,25,42,2,510,66,153,.431,0,1,.000,66,152,.434,.431,25,42,.595,48,53,101,22,9,17,20,68,157
17722,LAC,2004,Glen Rice,36,18,0,262,22,76,.289,5,28,.179,17,48,.354,.322,17,17,1.000,9,32,41,24,6,0,13,22,66
17723,LAC,2004,Randy Livingston,28,4,0,48,2,10,.200,0,3,.000,2,7,.286,.200,4,6,.667,2,5,7,4,2,0,4,7,8
17724,LAC,2004,Olden Polynice,39,2,0,12,0,0,,0,0,,0,0,,,0,0,,1,1,2,1,1,0,4,2,0
17725,LAC,2004,Wang Zhizhi,26,2,0,9,0,1,.000,0,0,,0,1,.000,.000,4,4,1.000,0,4,4,0,0,1,0,0,4
17726,LAC,2003,Andre Miller,26,80,80,2913,377,928,.406,23,108,.213,354,820,.432,.419,311,391,.795,84,232,316,537,99,11,206,203,1088
17727,LAC,2003,Elton Brand,23,62,61,2454,451,899,.502,0,1,.000,451,898,.502,.502,244,356,.685,283,420,703,157,71,158,161,204,1146
17728,LAC,2003,Corey Maggette,23,64,57,2006,343,773,.444,62,177,.350,281,596,.471,.484,325,405,.802,77,245,322,123,55,16,147,194,1073
17729,LAC,2003,Lamar Odom,23,49,47,1679,268,611,.439,42,129,.326,226,482,.469,.473,136,175,.777,59,267,326,178,42,41,140,181,714
17730,LAC,2003,Marko Jarić,24,66,12,1379,179,446,.401,53,166,.319,126,280,.450,.461,79,105,.752,35,125,160,193,97,11,103,125,490
17731,LAC,2003,Michael Olowokandi,27,36,36,1369,186,436,.427,0,0,,186,436,.427,.427,69,105,.657,57,271,328,47,18,79,98,110,441
17732,LAC,2003,Quentin Richardson,22,59,13,1368,203,546,.372,61,198,.308,142,348,.408,.428,85,124,.685,98,183,281,52,35,10,64,92,552
17733,LAC,2003,Eric Piatkowski,32,62,26,1360,210,446,.471,80,201,.398,130,245,.531,.561,101,122,.828,44,112,156,70,33,9,56,92,601
17734,LAC,2003,Sean Rooks,33,70,38,1344,125,297,.421,0,1,.000,125,296,.422,.421,47,58,.810,53,163,216,69,34,44,66,174,297
17735,LAC,2003,Keyon Dooling,22,55,1,969,128,329,.389,50,139,.360,78,190,.411,.465,44,57,.772,9,63,72,89,24,6,60,93,350
17736,LAC,2003,Melvin Ely,24,52,7,802,92,186,.495,0,0,,92,186,.495,.495,52,74,.703,64,110,174,15,10,32,50,95,236
17737,LAC,2003,Cherokee Parks,30,30,18,648,82,163,.503,1,2,.500,81,161,.503,.506,23,38,.605,46,86,132,21,16,20,18,52,188
17738,LAC,2003,Tremaine Fowlkes,26,37,10,573,56,128,.438,2,9,.222,54,119,.454,.445,50,59,.847,41,62,103,23,25,2,20,63,164
17739,LAC,2003,Chris Wilcox,20,46,3,479,73,140,.521,0,0,,73,140,.521,.521,25,50,.500,32,72,104,21,7,12,26,65,171
17740,LAC,2003,Wang Zhizhi,25,41,1,412,62,162,.383,16,47,.340,46,115,.400,.432,42,58,.724,26,51,77,10,8,10,31,41,182
17741,LAC,2002,Jeff McInnis,27,81,80,3030,463,1121,.413,75,234,.321,388,887,.437,.446,183,219,.836,45,168,213,500,63,6,147,202,1184
17742,LAC,2002,Elton Brand,22,80,80,3020,532,1010,.527,0,0,,532,1010,.527,.527,389,524,.742,396,529,925,191,80,163,173,254,1453
17743,LAC,2002,Michael Olowokandi,26,80,79,2568,384,886,.433,0,0,,384,886,.433,.433,117,188,.622,164,547,711,90,55,145,175,217,885
17744,LAC,2002,Darius Miles,20,82,6,2227,309,642,.481,3,19,.158,306,623,.491,.484,158,255,.620,109,344,453,184,71,103,160,184,779
17745,LAC,2002,Quentin Richardson,21,81,0,2152,400,926,.432,133,349,.381,267,577,.463,.504,143,187,.765,113,221,334,128,78,21,102,142,1076
17746,LAC,2002,Eric Piatkowski,31,71,64,1718,207,471,.439,111,238,.466,96,233,.412,.557,101,113,.894,43,141,184,112,41,12,64,110,626
17747,LAC,2002,Corey Maggette,22,63,52,1615,235,530,.443,46,139,.331,189,391,.483,.487,201,251,.801,54,177,231,112,41,19,116,155,717
17748,LAC,2002,Lamar Odom,22,29,25,999,151,360,.419,16,84,.190,135,276,.489,.442,61,93,.656,31,145,176,171,23,36,97,91,379
17749,LAC,2002,Earl Boykins,25,68,2,761,110,275,.400,13,42,.310,97,233,.416,.424,47,61,.770,27,27,54,145,20,2,44,44,280
17750,LAC,2002,Sean Rooks,32,61,2,728,81,194,.418,0,0,,81,194,.418,.418,21,29,.724,32,92,124,25,12,21,20,114,183
17751,LAC,2002,Tremaine Fowlkes,25,22,17,343,25,64,.391,0,0,,25,64,.391,.391,24,31,.774,32,32,64,17,11,1,13,39,74
17752,LAC,2002,Harold Jamison,25,25,2,176,22,43,.512,0,0,,22,43,.512,.512,10,15,.667,24,15,39,6,5,1,6,23,54
17753,LAC,2002,Keyon Dooling,21,14,0,155,22,57,.386,4,14,.286,18,43,.419,.421,10,12,.833,0,3,3,12,4,3,10,20,58
17754,LAC,2002,Obinna Ekezie,26,29,1,152,13,39,.333,0,0,,13,39,.333,.333,28,40,.700,12,22,34,3,2,6,10,16,54
17755,LAC,2002,Doug Overton,32,18,0,130,14,44,.318,7,27,.259,7,17,.412,.398,4,7,.571,1,11,12,13,3,1,12,10,39
17756,LAC,2002,Eldridge Recasner,34,5,0,31,2,6,.333,0,1,.000,2,5,.400,.333,1,1,1.000,0,0,0,5,1,0,1,3,5
17757,LAC,2001,Lamar Odom,21,76,74,2836,481,1046,.460,80,253,.316,401,793,.506,.498,262,386,.679,110,482,592,392,74,122,264,236,1304
17758,LAC,2001,Jeff McInnis,26,81,81,2831,432,933,.463,52,144,.361,380,789,.482,.491,130,161,.807,41,179,220,447,75,7,113,199,1046
17759,LAC,2001,Eric Piatkowski,30,81,40,2144,291,672,.433,120,297,.404,171,375,.456,.522,158,181,.873,54,187,241,96,46,19,76,123,860
17760,LAC,2001,Darius Miles,19,81,21,2133,318,630,.505,1,19,.053,317,611,.519,.506,124,238,.521,127,350,477,99,51,125,147,191,761
17761,LAC,2001,Michael Olowokandi,25,82,82,2127,308,708,.435,0,0,,308,708,.435,.435,85,156,.545,168,357,525,46,30,108,169,250,701
17762,LAC,2001,Sean Rooks,31,82,0,1553,169,395,.428,1,2,.500,168,393,.427,.429,107,143,.748,91,212,303,77,34,64,73,197,446
17763,LAC,2001,Corey Maggette,21,69,9,1359,225,487,.462,17,56,.304,208,431,.483,.479,223,288,.774,88,203,291,82,35,9,106,140,690
17764,LAC,2001,Quentin Richardson,20,76,28,1358,232,525,.442,50,151,.331,182,374,.487,.490,99,158,.627,105,152,257,62,42,7,64,98,613
17765,LAC,2001,Keyon Dooling,20,76,1,1237,148,362,.409,28,80,.350,120,282,.426,.448,125,179,.698,8,81,89,177,41,11,94,107,449
17766,LAC,2001,Cherokee Parks,28,52,31,876,116,236,.492,0,6,.000,116,230,.504,.492,19,27,.704,58,131,189,39,19,25,31,102,251
17767,LAC,2001,Brian Skinner,24,39,23,584,64,161,.398,0,0,,64,161,.398,.398,32,59,.542,55,113,168,18,14,11,32,61,160
17768,LAC,2001,Derek Strong,32,28,8,491,45,117,.385,0,1,.000,45,116,.388,.385,28,37,.757,34,74,108,7,14,1,22,30,118
17769,LAC,2001,Tyrone Nesby,25,14,12,333,40,123,.325,10,46,.217,30,77,.390,.366,18,23,.783,16,26,42,11,10,4,10,28,108
17770,LAC,2001,Earl Boykins,24,10,0,149,25,63,.397,1,8,.125,24,55,.436,.405,14,17,.824,4,7,11,32,5,0,9,9,65
17771,LAC,2001,Zendon Hamilton,25,3,0,19,2,9,.222,0,0,,2,9,.222,.222,5,8,.625,3,5,8,0,0,0,2,4,9
17772,LAC,2000,Lamar Odom,20,76,70,2767,449,1024,.438,59,164,.360,390,860,.453,.467,302,420,.719,159,436,595,317,91,95,258,291,1259
17773,LAC,2000,Michael Olowokandi,24,80,77,2493,330,756,.437,0,0,,330,756,.437,.437,123,189,.651,194,462,656,38,35,140,177,304,783
17774,LAC,2000,Tyrone Nesby,24,73,39,2317,364,915,.398,94,281,.335,270,634,.426,.449,151,191,.791,82,193,275,121,75,31,102,205,973
17775,LAC,2000,Maurice Taylor,23,62,60,2227,458,988,.464,1,8,.125,457,980,.466,.464,143,201,.711,96,304,400,101,51,48,169,217,1060
17776,LAC,2000,Derek Anderson,25,64,58,2201,377,860,.438,55,178,.309,322,682,.472,.470,271,309,.877,80,178,258,220,90,11,167,149,1080
17777,LAC,2000,Eric Piatkowski,29,75,23,1712,238,573,.415,93,243,.383,145,330,.439,.497,85,100,.850,74,148,222,81,44,13,57,140,654
17778,LAC,2000,Troy Hudson,23,62,38,1592,204,541,.377,60,193,.311,144,348,.414,.433,77,95,.811,28,120,148,242,43,0,108,65,545
17779,LAC,2000,Keith Closs,23,57,6,820,96,197,.487,0,3,.000,96,194,.495,.487,46,78,.590,65,114,179,25,13,73,34,80,238
17780,LAC,2000,Brian Skinner,23,33,9,775,68,134,.507,0,0,,68,134,.507,.507,43,65,.662,63,138,201,11,16,44,37,75,179
17781,LAC,2000,Eric Murdock,31,40,15,693,79,205,.385,16,42,.381,63,163,.387,.424,51,80,.638,15,62,77,108,47,5,58,67,225
17782,LAC,2000,Charles Jones,24,56,0,662,66,201,.328,39,118,.331,27,83,.325,.425,17,23,.739,17,45,62,94,30,5,28,46,188
17783,LAC,2000,Jeff McInnis,25,25,10,597,80,186,.430,7,21,.333,73,165,.442,.449,13,17,.765,18,54,72,89,15,2,27,55,180
17784,LAC,2000,Anthony Avent,30,49,3,377,29,96,.302,0,0,,29,96,.302,.302,23,32,.719,23,51,74,11,16,15,24,62,81
17785,LAC,2000,Pete Chilcutt,31,24,2,347,31,63,.492,5,16,.313,26,47,.553,.532,6,6,1.000,27,52,79,16,10,6,11,39,73
17786,LAC,2000,Etdrick Bohannon,26,11,0,113,7,13,.538,0,0,,7,13,.538,.538,12,20,.600,12,18,30,5,2,6,8,24,26
17787,LAC,2000,Marty Conlon,32,3,0,9,1,2,.500,0,0,,1,2,.500,.500,0,0,,1,1,2,0,0,0,0,1,2
17788,LAC,2000,Mario Bennett,26,1,0,3,0,3,.000,0,0,,0,3,.000,.000,0,0,,1,1,2,0,0,0,0,1,0
17789,LAC,1999,Maurice Taylor,22,46,45,1505,311,675,.461,1,6,.167,310,669,.463,.461,150,206,.728,100,142,242,67,16,29,120,179,773
17790,LAC,1999,Lamond Murray,25,50,13,1317,226,578,.391,34,103,.330,192,475,.404,.420,126,157,.803,59,136,195,61,58,20,99,107,612
17791,LAC,1999,Tyrone Nesby,23,50,36,1288,182,405,.449,35,96,.365,147,309,.476,.493,104,133,.782,57,118,175,82,77,20,53,143,503
17792,LAC,1999,Michael Olowokandi,23,45,36,1279,172,399,.431,0,0,,172,399,.431,.431,57,118,.483,120,237,357,25,27,55,85,137,401
17793,LAC,1999,Eric Piatkowski,28,49,38,1242,180,417,.432,65,165,.394,115,252,.456,.510,88,102,.863,39,101,140,53,44,6,53,86,513
17794,LAC,1999,Lorenzen Wright,23,48,15,1135,119,260,.458,0,1,.000,119,259,.459,.458,81,117,.692,142,219,361,33,26,36,48,162,319
17795,LAC,1999,Rodney Rogers,27,47,7,968,131,297,.441,18,63,.286,113,234,.483,.471,68,101,.673,65,114,179,77,47,22,66,140,348
17796,LAC,1999,Darrick Martin,27,37,25,941,102,278,.367,31,106,.292,71,172,.413,.423,61,76,.803,5,43,48,144,43,4,67,82,296
17797,LAC,1999,Sherman Douglas,32,30,19,842,96,219,.438,0,11,.000,96,208,.462,.438,55,87,.632,16,42,58,124,27,3,61,54,247
17798,LAC,1999,Troy Hudson,22,25,6,524,60,150,.400,15,47,.319,45,103,.437,.450,34,38,.895,15,40,55,92,11,2,38,28,169
17799,LAC,1999,Charles Smith,23,23,10,317,35,97,.361,7,33,.212,28,64,.438,.397,7,16,.438,7,17,24,13,17,14,20,35,84
17800,LAC,1999,James Robinson,28,14,0,280,39,98,.398,8,30,.267,31,68,.456,.439,20,27,.741,10,17,27,18,14,3,16,29,106
17801,LAC,1999,Brian Skinner,22,21,0,258,33,71,.465,0,0,,33,71,.465,.465,20,33,.606,20,33,53,1,10,13,19,20,86
17802,LAC,1999,Pooh Richardson,32,11,0,130,12,36,.333,0,6,.000,12,30,.400,.333,4,4,1.000,1,12,13,30,4,0,9,5,28
17803,LAC,1999,Keith Closs,22,15,0,87,12,23,.522,0,1,.000,12,22,.545,.522,8,10,.800,5,20,25,0,3,9,6,14,32
17804,LAC,1999,Stojko Vranković,35,2,0,12,1,4,.250,0,0,,1,4,.250,.250,0,0,,4,2,6,0,0,0,0,2,2
17805,LAC,1998,Lamond Murray,24,79,65,2579,473,984,.481,54,153,.353,419,831,.504,.508,220,294,.748,172,312,484,142,118,54,171,193,1220
17806,LAC,1998,Rodney Rogers,26,76,70,2499,426,935,.456,72,212,.340,354,723,.490,.494,225,328,.686,155,269,424,202,93,38,193,242,1149
17807,LAC,1998,Darrick Martin,26,82,63,2299,275,730,.377,107,293,.365,168,437,.384,.450,184,217,.848,19,145,164,331,82,10,154,198,841
17808,LAC,1998,Lorenzen Wright,22,69,38,2067,241,542,.445,0,2,.000,241,540,.446,.445,141,214,.659,180,426,606,55,55,87,81,237,623
17809,LAC,1998,Eric Piatkowski,27,67,35,1740,257,568,.452,106,259,.409,151,309,.489,.546,140,170,.824,70,166,236,85,51,12,80,137,760
17810,LAC,1998,Maurice Taylor,21,71,3,1513,321,675,.476,0,1,.000,321,674,.476,.476,173,244,.709,118,178,296,53,34,40,107,222,815
17811,LAC,1998,Brent Barry,26,41,36,1341,190,444,.428,78,195,.400,112,249,.450,.516,103,122,.844,27,116,143,132,50,23,95,88,561
17812,LAC,1998,Pooh Richardson,31,69,17,1252,124,333,.372,11,57,.193,113,276,.409,.389,30,43,.698,17,79,96,226,44,3,54,71,289
17813,LAC,1998,James Robinson,27,70,13,1231,195,501,.389,74,225,.329,121,276,.438,.463,77,107,.720,37,74,111,135,37,10,97,101,541
17814,LAC,1998,Stojko Vranković,34,65,38,996,79,186,.425,0,0,,79,186,.425,.425,37,65,.569,71,192,263,36,11,66,46,130,195
17815,LAC,1998,Isaac Austin,28,26,25,895,154,339,.454,0,5,.000,154,334,.461,.454,88,135,.652,80,147,227,88,18,22,89,69,396
17816,LAC,1998,Keith Closs,21,58,1,740,93,207,.449,0,0,,93,207,.449,.449,46,77,.597,63,105,168,19,12,81,38,73,232
17817,LAC,1998,Loy Vaught,29,10,6,265,36,84,.429,0,2,.000,36,82,.439,.429,3,8,.375,16,49,65,7,4,2,13,33,75
17818,LAC,1998,Charles Smith,22,23,0,260,45,107,.421,14,44,.318,31,63,.492,.486,5,9,.556,8,11,19,19,10,5,21,21,109
17819,LAC,1998,James Collins,24,23,0,103,21,55,.382,9,20,.450,12,35,.343,.464,8,14,.571,7,7,14,3,6,3,8,12,59
17820,LAC,1997,Loy Vaught,28,82,82,2838,542,1084,.500,2,12,.167,540,1072,.504,.501,134,191,.702,222,595,817,110,85,25,137,241,1220
17821,LAC,1997,Rodney Rogers,25,81,62,2480,408,884,.462,65,180,.361,343,704,.487,.498,191,288,.663,137,274,411,222,88,61,221,272,1072
17822,LAC,1997,Malik Sealy,26,80,79,2456,373,942,.396,79,222,.356,294,720,.408,.438,254,290,.876,59,179,238,165,124,45,154,185,1079
17823,LAC,1997,Bo Outlaw,25,82,25,2195,254,417,.609,0,8,.000,254,409,.621,.609,117,232,.504,174,280,454,157,94,142,107,227,625
17824,LAC,1997,Lorenzen Wright,21,77,51,1936,236,491,.481,1,4,.250,235,487,.483,.482,88,150,.587,206,265,471,49,48,60,79,211,561
17825,LAC,1997,Darrick Martin,25,82,64,1820,292,718,.407,91,234,.389,201,484,.415,.470,218,250,.872,26,87,113,339,57,2,127,165,893
17826,LAC,1997,Lamond Murray,23,74,1,1295,181,435,.416,31,91,.341,150,344,.436,.452,156,211,.739,85,148,233,57,53,29,86,113,549
17827,LAC,1997,Brent Barry,25,59,0,1094,155,379,.409,56,173,.324,99,206,.481,.483,76,93,.817,30,80,110,154,51,15,76,88,442
17828,LAC,1997,Pooh Richardson,30,59,18,1065,131,344,.381,42,128,.328,89,216,.412,.442,26,43,.605,25,73,98,169,54,5,62,82,330
17829,LAC,1997,Terry Dehere,25,73,3,1053,148,383,.386,52,160,.325,96,223,.430,.454,122,148,.824,15,80,95,158,27,3,96,142,470
17830,LAC,1997,Eric Piatkowski,26,65,0,747,134,298,.450,51,120,.425,83,178,.466,.535,69,84,.821,49,56,105,52,33,10,46,85,388
17831,LAC,1997,Kevin Duckworth,32,26,22,384,45,103,.437,3,4,.750,42,99,.424,.451,11,16,.688,23,37,60,16,9,11,33,63,104
17832,LAC,1997,Stanley Roberts,26,18,2,378,63,148,.426,0,0,,63,148,.426,.426,45,64,.703,24,67,91,9,8,23,23,57,171
17833,LAC,1997,Dwayne Schintzius,28,15,0,116,13,36,.361,1,2,.500,12,34,.353,.375,7,8,.875,9,13,22,4,1,9,7,22,34
17834,LAC,1997,Rich Manning,26,10,1,73,14,34,.412,0,1,.000,14,33,.424,.412,3,6,.500,8,8,16,1,1,1,2,11,31
17835,LAC,1996,Loy Vaught,27,80,78,2966,571,1087,.525,7,19,.368,564,1068,.528,.529,149,205,.727,204,604,808,112,87,40,158,241,1298
17836,LAC,1996,Bison Dele,26,65,65,2157,416,766,.543,1,6,.167,415,760,.546,.544,196,267,.734,149,343,492,122,70,55,190,226,1029
17837,LAC,1996,Terry Dehere,24,82,10,2018,315,686,.459,139,316,.440,176,370,.476,.560,247,327,.755,41,102,143,350,54,16,191,239,1016
17838,LAC,1996,Pooh Richardson,29,63,61,2013,281,664,.423,94,245,.384,187,419,.446,.494,78,105,.743,35,123,158,340,77,13,95,134,734
17839,LAC,1996,Rodney Rogers,24,67,51,1950,306,641,.477,49,153,.320,257,488,.527,.516,113,180,.628,113,173,286,167,75,35,144,216,774
17840,LAC,1996,Brent Barry,24,79,44,1898,283,597,.474,123,296,.416,160,301,.532,.577,111,137,.810,38,130,168,230,95,22,120,196,800
17841,LAC,1996,Lamond Murray,22,77,32,1816,257,575,.447,37,116,.319,220,459,.479,.479,99,132,.750,89,157,246,84,61,25,108,151,650
17842,LAC,1996,Malik Sealy,25,62,48,1601,272,655,.415,21,100,.210,251,555,.452,.431,147,184,.799,76,164,240,116,84,28,113,150,712
17843,LAC,1996,Bo Outlaw,24,80,3,985,107,186,.575,0,3,.000,107,183,.585,.575,72,162,.444,87,113,200,50,44,91,45,127,286
17844,LAC,1996,Stanley Roberts,25,51,7,795,141,304,.464,0,0,,141,304,.464,.464,74,133,.556,42,120,162,41,15,39,48,153,356
17845,LAC,1996,Eric Piatkowski,25,65,1,784,98,242,.405,38,114,.333,60,128,.469,.483,67,82,.817,40,63,103,48,24,10,45,83,301
17846,LAC,1996,Antonio Harvey,25,37,9,411,44,129,.341,0,0,,44,129,.341,.341,18,40,.450,42,64,106,6,13,26,26,38,106
17847,LAC,1996,Keith Tower,25,34,1,305,32,72,.444,0,1,.000,32,71,.451,.444,18,26,.692,22,29,51,5,4,11,16,50,82
17848,LAC,1996,Logan Vander Velden,24,15,0,31,3,14,.214,0,5,.000,3,9,.333,.214,3,4,.750,1,5,6,1,0,0,0,4,9
17849,LAC,1995,Loy Vaught,26,80,79,2966,609,1185,.514,7,33,.212,602,1152,.523,.517,176,248,.710,261,511,772,139,104,29,166,243,1401
17850,LAC,1995,Pooh Richardson,28,80,77,2864,353,897,.394,87,244,.357,266,653,.407,.442,81,125,.648,38,223,261,632,129,12,171,218,874
17851,LAC,1995,Lamond Murray,21,81,61,2556,439,1093,.402,65,218,.298,374,875,.427,.431,199,264,.754,132,222,354,133,72,55,163,180,1142
17852,LAC,1995,Tony Massenburg,27,80,50,2127,282,601,.469,0,3,.000,282,598,.472,.469,177,235,.753,160,295,455,67,48,58,118,253,741
17853,LAC,1995,Terry Dehere,23,80,28,1774,279,685,.407,48,163,.294,231,522,.443,.442,229,292,.784,35,117,152,225,45,7,157,200,835
17854,LAC,1995,Bo Outlaw,23,81,31,1655,170,325,.523,0,5,.000,170,320,.531,.523,82,186,.441,121,192,313,84,90,151,78,227,422
17855,LAC,1995,Malik Sealy,24,60,41,1604,291,669,.435,22,73,.301,269,596,.451,.451,174,223,.780,77,137,214,107,72,25,83,173,778
17856,LAC,1995,Eric Piatkowski,24,81,11,1208,201,456,.441,74,198,.374,127,258,.492,.522,90,115,.783,63,70,133,77,37,15,63,150,566
17857,LAC,1995,Harold Ellis,24,69,7,656,91,189,.481,1,13,.077,90,176,.511,.484,69,117,.590,56,32,88,40,67,12,49,102,252
17858,LAC,1995,Randy Woods,24,62,3,495,37,117,.316,22,74,.297,15,43,.349,.410,28,38,.737,10,34,44,134,41,0,55,87,124
17859,LAC,1995,Gary Grant,29,33,2,470,78,166,.470,4,16,.250,74,150,.493,.482,45,55,.818,8,27,35,93,29,3,44,66,205
17860,LAC,1995,Eric Riley,24,40,4,434,65,145,.448,0,1,.000,65,144,.451,.448,47,64,.734,45,67,112,11,17,35,31,78,177
17861,LAC,1995,Matt Fish,25,26,8,370,49,103,.476,0,1,.000,49,102,.480,.476,25,37,.676,32,52,84,17,16,7,28,70,123
17862,LAC,1995,Elmore Spencer,25,19,8,368,52,118,.441,0,1,.000,52,117,.444,.441,28,50,.560,11,54,65,25,14,23,48,62,132
17863,LAC,1995,Michael Smith,29,29,0,319,63,134,.470,1,8,.125,62,126,.492,.474,26,30,.867,13,43,56,20,6,2,18,41,153
17864,LAC,1995,Bob Martin,25,1,0,14,1,5,.200,0,0,,1,5,.200,.200,0,0,,2,0,2,1,0,1,0,2,2
17865,LAC,1994,Ron Harper,30,75,75,2856,569,1335,.426,71,236,.301,498,1099,.453,.453,299,418,.715,129,331,460,344,144,54,242,167,1508
17866,LAC,1994,Mark Jackson,28,79,79,2711,331,732,.452,36,127,.283,295,605,.488,.477,167,211,.791,107,241,348,678,120,6,232,115,865
17867,LAC,1994,Loy Vaught,25,75,56,2118,373,695,.537,0,5,.000,373,690,.541,.537,131,182,.720,218,438,656,74,76,22,96,221,877
17868,LAC,1994,Elmore Spencer,24,76,63,1930,288,540,.533,0,2,.000,288,538,.535,.533,97,162,.599,96,319,415,75,30,127,168,208,673
17869,LAC,1994,Danny Manning,27,42,41,1595,409,829,.493,2,14,.143,407,815,.499,.495,174,258,.674,82,214,296,176,53,57,147,167,994
17870,LAC,1994,Gary Grant,28,78,8,1533,253,563,.449,17,62,.274,236,501,.471,.464,65,76,.855,42,100,142,291,119,12,136,139,588
17871,LAC,1994,Dominique Wilkins,34,25,25,948,268,592,.453,24,97,.247,244,495,.493,.473,167,200,.835,63,113,176,55,29,8,52,39,727
17872,LAC,1994,Harold Ellis,23,49,16,923,159,292,.545,0,4,.000,159,288,.552,.545,106,149,.711,94,59,153,31,73,2,43,97,424
17873,LAC,1994,Bo Outlaw,22,37,14,871,98,167,.587,0,2,.000,98,165,.594,.587,61,103,.592,81,131,212,36,36,37,31,94,257
17874,LAC,1994,Mark Aguirre,34,39,0,859,163,348,.468,37,93,.398,126,255,.494,.522,50,72,.694,28,88,116,104,21,8,70,98,413
17875,LAC,1994,Terry Dehere,22,64,6,759,129,342,.377,23,57,.404,106,285,.372,.411,61,81,.753,25,43,68,78,28,3,61,69,342
17876,LAC,1994,John Williams,27,34,6,725,81,188,.431,5,20,.250,76,168,.452,.444,24,36,.667,37,90,127,97,25,10,35,85,191
17877,LAC,1994,Tom Tolbert,28,49,6,640,74,177,.418,6,16,.375,68,161,.422,.435,33,45,.733,36,72,108,30,13,15,39,61,187
17878,LAC,1994,Bob Martin,24,53,1,535,40,88,.455,0,0,,40,88,.455,.455,31,51,.608,36,81,117,17,8,33,29,106,111
17879,LAC,1994,Randy Woods,23,40,0,352,49,133,.368,27,78,.346,22,55,.400,.470,20,35,.571,13,16,29,71,24,2,34,40,145
17880,LAC,1994,Stanley Roberts,23,14,14,350,43,100,.430,0,0,,43,100,.430,.430,18,44,.409,27,66,93,11,6,25,24,54,104
17881,LAC,1994,Henry James,28,12,0,75,16,42,.381,4,18,.222,12,24,.500,.429,5,5,1.000,6,8,14,1,2,0,2,9,41
17882,LAC,1993,Mark Jackson,27,82,81,3117,459,945,.486,22,82,.268,437,863,.506,.497,241,300,.803,129,259,388,724,136,12,220,158,1181
17883,LAC,1993,Ron Harper,29,80,77,2970,542,1203,.451,52,186,.280,490,1017,.482,.472,307,399,.769,117,308,425,360,177,73,222,212,1443
17884,LAC,1993,Danny Manning,26,79,77,2761,702,1379,.509,8,30,.267,694,1349,.514,.512,388,484,.802,198,322,520,207,108,101,230,323,1800
17885,LAC,1993,Ken Norman,28,76,71,2477,498,975,.511,10,38,.263,488,937,.521,.516,131,220,.595,209,362,571,165,59,58,125,156,1137
17886,LAC,1993,Stanley Roberts,22,77,76,1816,375,711,.527,0,0,,375,711,.527,.527,120,246,.488,181,297,478,59,34,141,121,332,870
17887,LAC,1993,Loy Vaught,24,79,4,1653,313,616,.508,1,4,.250,312,612,.510,.509,116,155,.748,164,328,492,54,55,39,83,172,743
17888,LAC,1993,John Williams,26,74,8,1638,205,477,.430,12,53,.226,193,424,.455,.442,70,129,.543,88,228,316,142,83,23,79,188,492
17889,LAC,1993,Gary Grant,27,74,8,1624,210,476,.441,11,42,.262,199,434,.459,.453,55,74,.743,27,112,139,353,106,9,129,168,486
17890,LAC,1993,Kiki Vandeweghe,34,41,3,494,92,203,.453,12,37,.324,80,166,.482,.483,58,66,.879,12,36,48,25,13,7,20,45,254
17891,LAC,1993,Lester Conner,33,31,0,422,28,62,.452,0,0,,28,62,.452,.452,18,19,.947,16,33,49,65,34,4,21,39,74
17892,LAC,1993,Jaren Jackson,25,34,0,350,53,128,.414,2,5,.400,51,123,.415,.422,23,27,.852,19,20,39,35,19,5,17,45,131
17893,LAC,1993,Elmore Spencer,23,44,4,280,44,82,.537,0,0,,44,82,.537,.537,16,32,.500,17,45,62,8,8,18,26,54,104
17894,LAC,1993,Randy Woods,22,41,1,174,23,66,.348,3,14,.214,20,52,.385,.371,19,26,.731,6,8,14,40,14,1,16,26,68
17895,LAC,1993,Duane Washington,28,4,0,28,0,5,.000,0,0,,0,5,.000,.000,0,0,,0,2,2,5,1,0,2,2,0
17896,LAC,1993,Alex Stivrins,30,1,0,1,0,1,.000,0,0,,0,1,.000,.000,0,0,,0,0,0,0,0,0,0,0,0
17897,LAC,1992,Ron Harper,28,82,82,3144,569,1292,.440,64,211,.303,505,1081,.467,.465,293,398,.736,120,327,447,417,152,72,252,199,1495
17898,LAC,1992,Danny Manning,25,82,82,2904,650,1199,.542,0,5,.000,650,1194,.544,.542,279,385,.725,229,335,564,285,135,122,210,293,1579
17899,LAC,1992,Gary Grant,26,78,53,2049,275,595,.462,15,51,.294,260,544,.478,.475,44,54,.815,34,150,184,538,138,14,187,181,609
17900,LAC,1992,Ken Norman,27,77,24,2009,402,821,.490,4,28,.143,398,793,.502,.492,121,226,.535,158,290,448,125,53,66,100,145,929
17901,LAC,1992,Olden Polynice,27,76,65,1834,244,470,.519,0,1,.000,244,469,.520,.519,125,201,.622,195,341,536,46,45,20,83,165,613
17902,LAC,1992,Loy Vaught,23,79,38,1687,271,551,.492,4,5,.800,267,546,.489,.495,55,69,.797,160,352,512,71,37,31,66,165,601
17903,LAC,1992,Doc Rivers,30,59,25,1657,226,533,.424,26,92,.283,200,441,.454,.448,163,196,.832,23,124,147,233,111,19,92,166,641
17904,LAC,1992,James Edwards,36,72,11,1437,250,538,.465,0,1,.000,250,537,.466,.465,198,271,.731,55,147,202,53,24,33,72,236,698
17905,LAC,1992,Charles Smith,26,49,25,1310,251,539,.466,0,6,.000,251,533,.471,.466,212,270,.785,95,206,301,56,41,98,69,159,714
17906,LAC,1992,Danny Young,29,44,5,889,84,215,.391,20,60,.333,64,155,.413,.437,47,53,.887,16,50,66,152,40,4,42,47,235
17907,LAC,1992,Bo Kimble,25,34,0,277,44,111,.396,4,13,.308,40,98,.408,.414,20,31,.645,13,19,32,17,10,6,15,37,112
17908,LAC,1992,Tony Brown,31,22,0,254,39,89,.438,7,22,.318,32,67,.478,.478,18,29,.621,9,19,28,16,12,1,14,31,103
17909,LAC,1992,David Rivers,27,15,0,122,10,30,.333,0,1,.000,10,29,.345,.333,10,11,.909,10,9,19,21,7,1,17,14,30
17910,LAC,1992,LeRon Ellis,22,29,0,103,17,50,.340,0,0,,17,50,.340,.340,9,19,.474,12,12,24,1,6,9,11,11,43
17911,LAC,1992,Elliot Perry,22,10,0,66,6,15,.400,0,2,.000,6,13,.462,.400,1,2,.500,2,5,7,14,9,1,13,10,13
17912,LAC,1992,Lanard Copeland,26,10,0,48,7,23,.304,0,2,.000,7,21,.333,.304,2,2,1.000,1,6,7,5,2,0,4,5,16
17913,LAC,1992,Tharon Mayes,23,3,0,40,2,5,.400,1,2,.500,1,3,.333,.500,4,6,.667,0,1,1,3,2,1,3,9,9
17914,LAC,1991,Charles Smith,25,74,74,2703,548,1168,.469,0,7,.000,548,1161,.472,.469,384,484,.793,216,392,608,134,81,145,165,267,1480
17915,LAC,1991,Ken Norman,26,70,45,2309,520,1037,.501,6,32,.188,514,1005,.511,.504,173,275,.629,177,320,497,159,63,63,139,192,1219
17916,LAC,1991,Danny Manning,24,73,47,2197,470,905,.519,0,3,.000,470,902,.521,.519,219,306,.716,169,257,426,196,117,62,188,281,1159
17917,LAC,1991,Gary Grant,25,68,65,2105,265,587,.451,9,39,.231,256,548,.467,.459,51,74,.689,69,140,209,587,103,12,210,192,590
17918,LAC,1991,Winston Garland,26,69,26,1702,221,519,.426,4,26,.154,217,493,.440,.430,118,157,.752,46,152,198,317,97,10,116,189,564
17919,LAC,1991,Ron Harper,27,39,34,1383,285,729,.391,48,148,.324,237,581,.408,.424,145,217,.668,58,130,188,209,66,35,129,111,763
17920,LAC,1991,Benoit Benjamin,26,39,38,1337,229,465,.492,0,0,,229,465,.492,.492,123,169,.728,95,374,469,74,26,91,138,110,581
17921,LAC,1991,Jeff Martin,24,74,26,1334,214,507,.422,27,88,.307,187,419,.446,.449,68,100,.680,53,78,131,65,37,31,49,104,523
17922,LAC,1991,Loy Vaught,22,73,0,1178,175,359,.487,0,2,.000,175,357,.490,.487,49,74,.662,124,225,349,40,20,23,49,135,399
17923,LAC,1991,Olden Polynice,26,31,30,1132,151,261,.579,0,1,.000,151,260,.581,.579,79,138,.572,106,177,283,26,17,13,35,98,381
17924,LAC,1991,Bo Kimble,24,62,22,1004,159,418,.380,19,65,.292,140,353,.397,.403,92,119,.773,42,77,119,76,30,8,77,158,429
17925,LAC,1991,Tom Garrick,24,67,0,949,100,236,.424,0,22,.000,100,214,.467,.424,60,79,.759,40,87,127,223,62,2,66,101,260
17926,LAC,1991,Ken Bannister,30,47,3,339,43,81,.531,0,1,.000,43,80,.538,.531,25,65,.385,34,62,96,9,5,7,25,73,111
17927,LAC,1991,Mike Smrek,28,10,0,70,3,16,.188,0,0,,3,16,.188,.188,4,8,.500,4,15,19,3,1,3,1,18,10
17928,LAC,1991,Greg Butler,24,9,0,37,5,19,.263,0,0,,5,19,.263,.263,4,6,.667,8,8,16,1,0,0,4,9,14
17929,LAC,1991,Cedric Ball,22,7,0,26,3,8,.375,0,0,,3,8,.375,.375,2,2,1.000,5,6,11,0,0,2,2,5,8
17930,LAC,1990,Charles Smith,24,78,76,2732,595,1145,.520,1,12,.083,594,1133,.524,.520,454,572,.794,177,347,524,114,86,119,162,294,1645
17931,LAC,1990,Ken Norman,25,70,64,2334,484,949,.510,7,16,.438,477,933,.511,.514,153,242,.632,143,327,470,160,78,59,190,196,1128
17932,LAC,1990,Benoit Benjamin,25,71,58,2313,362,688,.526,0,1,.000,362,687,.527,.526,235,321,.732,156,501,657,159,59,187,187,217,959
17933,LAC,1990,Danny Manning,23,71,42,2269,440,826,.533,0,5,.000,440,821,.536,.533,274,370,.741,142,280,422,187,91,39,188,261,1154
17934,LAC,1990,Tom Garrick,23,73,22,1721,208,421,.494,4,21,.190,204,400,.510,.499,88,114,.772,34,128,162,289,90,7,117,151,508
17935,LAC,1990,Gary Grant,24,44,44,1529,241,517,.466,5,21,.238,236,496,.476,.471,88,113,.779,59,136,195,442,108,5,206,120,575
17936,LAC,1990,Jeff Martin,23,69,23,1351,170,414,.411,2,15,.133,168,399,.421,.413,91,129,.705,78,81,159,44,41,16,47,97,433
17937,LAC,1990,Joe Wolf,25,77,19,1325,155,392,.395,5,25,.200,150,367,.409,.402,55,71,.775,63,169,232,62,30,24,77,129,370
17938,LAC,1990,Ron Harper,26,28,28,1105,240,499,.481,13,46,.283,227,453,.501,.494,151,190,.795,55,103,158,133,67,32,82,80,644
17939,LAC,1990,Winston Garland,25,28,15,871,122,285,.428,11,26,.423,111,259,.429,.447,49,59,.831,20,83,103,146,30,5,77,75,304
17940,LAC,1990,David Rivers,25,52,11,724,80,197,.406,0,5,.000,80,192,.417,.406,59,78,.756,30,55,85,155,31,0,88,53,219
17941,LAC,1990,Ken Bannister,29,52,1,589,77,161,.478,0,1,.000,77,160,.481,.478,52,110,.473,39,73,112,18,17,7,44,92,206
17942,LAC,1990,Michael Young,29,45,2,459,92,194,.474,8,26,.308,84,168,.500,.495,27,38,.711,36,50,86,24,25,3,15,47,219
17943,LAC,1990,Reggie Williams,25,5,5,133,21,57,.368,0,5,.000,21,52,.404,.368,18,21,.857,8,7,15,10,9,1,9,7,60
17944,LAC,1990,Carlton McKinney,25,7,0,104,8,32,.250,0,1,.000,8,31,.258,.250,2,4,.500,4,8,12,7,6,1,7,15,18
17945,LAC,1990,Steve Harris,26,15,0,93,14,40,.350,0,0,,14,40,.350,.350,3,4,.750,5,5,10,1,7,1,5,9,31
17946,LAC,1990,Jim Les,26,6,0,86,5,14,.357,0,1,.000,5,13,.385,.357,11,13,.846,3,4,7,20,3,0,7,6,21
17947,LAC,1990,Andre Turner,25,3,0,31,2,13,.154,0,1,.000,2,12,.167,.154,0,0,,3,2,5,3,1,0,4,1,4
17948,LAC,1990,Jay Edwards,21,4,0,26,3,7,.429,0,2,.000,3,5,.600,.429,1,3,.333,1,1,2,4,1,0,1,4,7
17949,LAC,1990,Torgeir Bryn,25,3,0,10,0,2,.000,0,0,,0,2,.000,.000,4,6,.667,0,2,2,0,2,1,1,5,4
17950,LAC,1989,Ken Norman,24,80,79,3020,638,1271,.502,4,21,.190,634,1250,.507,.504,170,270,.630,245,422,667,277,106,66,206,223,1450
17951,LAC,1989,Benoit Benjamin,24,79,62,2585,491,907,.541,0,2,.000,491,905,.543,.541,317,426,.744,164,532,696,157,57,221,237,221,1299
17952,LAC,1989,Charles Smith,23,71,56,2161,435,878,.495,0,3,.000,435,875,.497,.495,285,393,.725,173,292,465,103,68,89,146,273,1155
17953,LAC,1989,Gary Grant,23,71,48,1924,361,830,.435,5,22,.227,356,808,.441,.438,119,162,.735,80,158,238,506,144,9,258,170,846
17954,LAC,1989,Quintin Dailey,28,69,51,1722,448,964,.465,1,9,.111,447,955,.468,.465,217,286,.759,69,135,204,154,90,6,122,152,1114
17955,LAC,1989,Tom Garrick,22,71,20,1499,176,359,.490,0,13,.000,176,346,.509,.490,102,127,.803,37,119,156,243,78,9,116,141,454
17956,LAC,1989,Joe Wolf,24,66,15,1450,170,402,.423,2,14,.143,168,388,.433,.425,44,64,.688,83,188,271,113,32,16,94,152,386
17957,LAC,1989,Norm Nixon,33,53,30,1318,153,370,.414,8,29,.276,145,341,.425,.424,48,65,.738,13,65,78,339,46,0,118,69,362
17958,LAC,1989,Reggie Williams,24,63,17,1303,260,594,.438,30,104,.288,230,490,.469,.463,92,122,.754,70,109,179,103,81,29,114,181,642
17959,LAC,1989,Danny Manning,22,26,18,950,177,358,.494,1,5,.200,176,353,.499,.496,79,103,.767,70,101,171,81,44,25,93,89,434
17960,LAC,1989,Greg Kite,27,58,12,729,49,121,.405,0,0,,49,121,.405,.405,14,31,.452,66,124,190,29,23,46,46,118,112
17961,LAC,1989,Eric White,23,37,0,434,62,119,.521,0,0,,62,119,.521,.521,34,42,.810,34,36,70,17,10,1,26,39,158
17962,LAC,1989,Grant Gondrezick,26,27,0,244,38,95,.400,3,11,.273,35,84,.417,.416,26,40,.650,15,21,36,34,13,1,17,36,105
17963,LAC,1989,Ken Bannister,28,9,2,130,22,36,.611,0,1,.000,22,35,.629,.611,30,53,.566,6,27,33,3,7,2,8,17,74
17964,LAC,1989,Kevin Williams,27,9,0,114,14,32,.438,0,0,,14,32,.438,.438,6,8,.750,9,11,20,17,5,3,10,17,34
17965,LAC,1989,Rob Lock,22,20,0,110,9,32,.281,0,0,,9,32,.281,.281,12,15,.800,14,18,32,4,3,4,13,15,30
17966,LAC,1989,Ennis Whatley,26,8,0,90,12,33,.364,0,0,,12,33,.364,.364,10,11,.909,2,14,16,22,7,1,11,15,34
17967,LAC,1989,Dave Popson,24,10,0,68,11,25,.440,0,0,,11,25,.440,.440,1,2,.500,5,11,16,6,1,2,6,9,23
17968,LAC,1989,Rob Rose,24,2,0,3,0,1,.000,0,0,,0,1,.000,.000,0,0,,1,1,2,0,0,0,0,0,0
17969,LAC,1989,Barry Sumpter,23,1,0,1,0,1,.000,0,0,,0,1,.000,.000,0,0,,0,0,0,0,0,0,0,0,0
17970,LAC,1988,Michael Cage,26,72,70,2660,360,766,.470,0,1,.000,360,765,.471,.470,326,474,.688,371,567,938,110,91,58,160,194,1046
17971,LAC,1988,Mike Woodson,29,80,77,2534,562,1263,.445,18,78,.231,544,1185,.459,.452,296,341,.868,64,126,190,273,109,26,186,210,1438
17972,LAC,1988,Benoit Benjamin,23,66,59,2171,340,693,.491,0,8,.000,340,685,.496,.491,180,255,.706,112,418,530,172,50,225,223,203,860
17973,LAC,1988,Larry Drew,29,74,51,2024,328,720,.456,26,90,.289,302,630,.479,.474,83,108,.769,21,98,119,383,65,0,152,114,765
17974,LAC,1988,Darnell Valentine,28,79,31,1636,223,533,.418,15,33,.455,208,500,.416,.432,101,136,.743,37,119,156,382,122,8,148,135,562
17975,LAC,1988,Ken Norman,23,66,28,1435,241,500,.482,0,10,.000,241,490,.492,.482,87,170,.512,100,163,263,78,44,34,103,123,569
17976,LAC,1988,Quintin Dailey,27,67,7,1282,328,755,.434,2,12,.167,326,743,.439,.436,243,313,.776,62,92,154,109,69,4,123,128,901
17977,LAC,1988,Joe Wolf,23,42,26,1137,136,334,.407,3,15,.200,133,319,.417,.412,45,54,.833,51,136,187,98,38,16,76,139,320
17978,LAC,1988,Earl Cureton,30,69,11,1128,133,310,.429,0,3,.000,133,307,.433,.429,33,63,.524,97,174,271,63,32,36,58,135,299
17979,LAC,1988,Greg Kite,26,40,19,977,83,182,.456,0,1,.000,83,181,.459,.456,39,73,.534,75,165,240,45,16,50,64,137,205
17980,LAC,1988,Reggie Williams,23,35,14,857,152,427,.356,13,58,.224,139,369,.377,.371,48,66,.727,55,63,118,58,29,21,63,108,365
17981,LAC,1988,Norris Coleman,26,29,11,431,66,191,.346,1,2,.500,65,189,.344,.348,20,36,.556,36,45,81,13,11,6,16,51,153
17982,LAC,1988,Eric White,22,17,4,352,66,124,.532,1,1,1.000,65,123,.528,.536,45,57,.789,31,31,62,9,7,3,21,32,178
17983,LAC,1988,Claude Gregory,29,23,2,313,61,134,.455,0,1,.000,61,133,.459,.455,12,36,.333,37,58,95,16,9,13,22,37,134
17984,LAC,1988,Steve Burtt,25,19,0,312,62,138,.449,0,4,.000,62,134,.463,.449,47,69,.681,6,21,27,38,10,5,40,56,171
17985,LAC,1988,Martin Nessley,22,35,0,295,18,49,.367,0,0,,18,49,.367,.367,7,14,.500,20,53,73,16,7,11,21,78,43
17986,LAC,1988,Kenny Fields,25,7,0,154,16,36,.444,0,0,,16,36,.444,.444,20,26,.769,13,16,29,10,5,2,19,17,52
17987,LAC,1988,Lancaster Gordon,25,8,0,65,11,31,.355,0,0,,11,31,.355,.355,6,6,1.000,2,2,4,7,1,2,4,8,28
17988,LAC,1988,Michael Phelps,26,2,0,23,3,7,.429,0,0,,3,7,.429,.429,3,4,.750,0,2,2,3,5,0,2,1,9
17989,LAC,1988,Tod Murphy,24,1,0,19,1,1,1.000,0,0,,1,1,1.000,1.000,3,4,.750,1,1,2,2,1,0,0,2,5
17990,LAC,1987,Michael Cage,25,80,76,2922,457,878,.521,0,3,.000,457,875,.522,.521,341,467,.730,354,568,922,131,99,67,171,221,1255
17991,LAC,1987,Benoit Benjamin,22,72,61,2230,320,713,.449,0,2,.000,320,711,.450,.449,188,263,.715,134,452,586,135,60,187,184,251,828
17992,LAC,1987,Mike Woodson,28,74,66,2126,494,1130,.437,34,123,.276,460,1007,.457,.452,240,290,.828,68,94,162,196,100,16,168,201,1262
17993,LAC,1987,Darnell Valentine,27,65,52,1759,275,671,.410,13,56,.232,262,615,.426,.420,163,200,.815,38,112,150,447,116,10,167,148,726
17994,LAC,1987,Larry Drew,28,60,22,1566,295,683,.432,12,72,.167,283,611,.463,.441,139,166,.837,26,77,103,326,60,2,151,107,741
17995,LAC,1987,Rory White,27,68,35,1545,265,552,.480,0,3,.000,265,549,.483,.480,94,144,.653,90,104,194,79,47,19,73,159,624
17996,LAC,1987,Cedric Maxwell,31,35,31,1132,150,289,.519,0,0,,150,289,.519,.519,177,228,.776,103,148,251,122,26,9,88,102,477
17997,LAC,1987,Lancaster Gordon,24,70,4,1130,221,545,.406,14,48,.292,207,497,.416,.418,70,95,.737,64,62,126,139,61,13,102,106,526
17998,LAC,1987,Tim Kempton,23,66,6,936,97,206,.471,0,1,.000,97,205,.473,.471,95,137,.693,70,124,194,53,38,12,49,162,289
17999,LAC,1987,Quintin Dailey,26,49,5,924,200,491,.407,1,10,.100,199,481,.414,.408,119,155,.768,34,49,83,79,43,8,71,113,520
18000,LAC,1987,Earl Cureton,29,35,11,868,114,234,.487,0,1,.000,114,233,.489,.487,43,79,.544,99,126,225,52,18,30,35,86,271
18001,LAC,1987,Kenny Fields,24,44,17,861,153,344,.445,3,12,.250,150,332,.452,.449,72,89,.809,63,83,146,60,31,11,52,120,381
18002,LAC,1987,Kurt Nimphius,28,38,6,811,119,252,.472,0,3,.000,119,249,.478,.472,57,88,.648,58,75,133,18,16,41,47,118,295
18003,LAC,1987,Geoff Huston,29,19,8,428,55,121,.455,1,2,.500,54,119,.454,.459,18,34,.529,6,11,17,101,14,0,45,28,129
18004,LAC,1987,Marques Johnson,30,10,10,302,68,155,.439,0,6,.000,68,149,.456,.439,30,42,.714,9,24,33,28,12,5,17,24,166
18005,LAC,1987,Steffond Johnson,24,29,0,234,27,64,.422,0,3,.000,27,61,.443,.422,20,38,.526,15,28,43,5,9,2,18,55,74
18006,LAC,1987,Dwayne Polee,23,1,0,6,1,4,.250,0,3,.000,1,1,1.000,.250,0,0,,0,0,0,0,1,0,1,3,2
18007,LAC,1986,Marques Johnson,29,75,75,2605,613,1201,.510,1,15,.067,612,1186,.516,.511,298,392,.760,156,260,416,283,107,50,183,214,1525
18008,LAC,1986,Cedric Maxwell,30,76,72,2458,314,661,.475,0,3,.000,314,658,.477,.475,447,562,.795,241,383,624,215,61,29,206,252,1075
18009,LAC,1986,Norm Nixon,30,67,62,2138,403,921,.438,42,121,.347,361,800,.451,.460,131,162,.809,45,135,180,576,84,3,190,143,979
18010,LAC,1986,Benoit Benjamin,21,79,37,2088,324,661,.490,1,3,.333,323,658,.491,.491,229,307,.746,161,439,600,79,64,206,145,286,878
18011,LAC,1986,Kurt Nimphius,27,67,62,1946,314,622,.505,0,2,.000,314,620,.506,.505,177,233,.760,129,264,393,48,30,93,107,229,805
18012,LAC,1986,Rory White,26,75,30,1761,355,684,.519,1,9,.111,354,675,.524,.520,164,222,.739,82,99,181,74,74,8,95,161,875
18013,LAC,1986,Michael Cage,24,78,12,1566,204,426,.479,0,3,.000,204,423,.482,.479,113,174,.649,168,249,417,81,62,34,106,176,521
18014,LAC,1986,Franklin Edwards,26,73,19,1491,262,577,.454,1,9,.111,261,568,.460,.455,132,151,.874,24,62,86,259,89,4,137,87,657
18015,LAC,1986,Junior Bridgeman,32,58,14,1161,199,451,.441,6,18,.333,193,433,.446,.448,106,119,.891,29,94,123,108,31,8,68,81,510
18016,LAC,1986,Lancaster Gordon,23,60,1,704,130,345,.377,7,28,.250,123,317,.388,.387,45,56,.804,24,44,68,60,33,10,62,91,312
18017,LAC,1986,Darnell Valentine,26,34,2,483,69,182,.379,3,11,.273,66,171,.386,.387,59,75,.787,12,41,53,107,23,1,57,45,200
18018,LAC,1986,James Donaldson,28,14,14,441,43,84,.512,0,0,,43,84,.512,.512,57,70,.814,28,103,131,12,5,29,38,33,143
18019,LAC,1986,Derek Smith,24,11,9,339,100,181,.552,1,2,.500,99,179,.553,.555,58,84,.690,20,21,41,31,9,13,33,35,259
18020,LAC,1986,Jamaal Wilkes,32,13,1,195,26,65,.400,1,3,.333,25,62,.403,.408,22,27,.815,13,16,29,15,7,2,16,19,75
18021,LAC,1986,Jeff Cross,24,21,0,128,6,24,.250,0,0,,6,24,.250,.250,14,25,.560,9,21,30,1,2,3,6,38,26
18022,LAC,1986,Jay Murphy,23,14,0,100,16,45,.356,0,2,.000,16,43,.372,.356,9,14,.643,7,8,15,3,4,3,5,12,41
18023,LAC,1986,Jim Thomas,25,6,0,69,6,15,.400,0,0,,6,15,.400,.400,1,2,.500,3,5,8,12,5,1,9,12,13
18024,LAC,1986,Wallace Bryant,26,8,0,64,4,18,.222,0,0,,4,18,.222,.222,5,8,.625,8,12,20,4,2,3,2,12,13
18025,LAC,1986,Ozell Jones,25,3,0,18,0,2,.000,0,0,,0,2,.000,.000,0,0,,0,2,2,0,2,1,3,5,0
18026,LAC,1985,Norm Nixon,29,81,81,2894,596,1281,.465,33,99,.333,563,1182,.476,.478,170,218,.780,55,163,218,711,95,4,273,175,1395
18027,LAC,1985,Derek Smith,23,80,80,2762,682,1271,.537,3,19,.158,679,1252,.542,.538,400,504,.794,174,253,427,216,77,52,230,317,1767
18028,LAC,1985,Marques Johnson,28,72,68,2448,494,1094,.452,3,13,.231,491,1081,.454,.453,190,260,.731,188,240,428,248,72,30,176,193,1181
18029,LAC,1985,James Donaldson,27,82,58,2392,351,551,.637,0,0,,351,551,.637,.637,227,303,.749,168,500,668,48,28,130,206,217,929
18030,LAC,1985,Junior Bridgeman,31,80,15,2042,460,990,.465,14,39,.359,446,951,.469,.472,181,206,.879,55,175,230,171,47,18,116,128,1115
18031,LAC,1985,Bill Walton,32,67,37,1647,269,516,.521,0,2,.000,269,514,.523,.521,138,203,.680,168,432,600,156,50,140,174,184,676
18032,LAC,1985,Michael Cage,23,75,41,1610,216,398,.543,0,0,,216,398,.543,.543,101,137,.737,126,266,392,51,41,32,81,164,533
18033,LAC,1985,Rory White,25,80,14,1106,144,279,.516,0,0,,144,279,.516,.516,90,130,.692,94,101,195,34,35,20,87,115,378
18034,LAC,1985,Harvey Catchings,33,70,14,1049,72,149,.483,0,1,.000,72,148,.486,.483,59,89,.663,89,173,262,14,15,57,55,162,203
18035,LAC,1985,Bryan Warrick,25,58,1,713,85,173,.491,1,4,.250,84,169,.497,.494,44,57,.772,10,48,58,153,23,6,70,85,215
18036,LAC,1985,Lancaster Gordon,22,63,1,682,110,287,.383,2,9,.222,108,278,.388,.387,37,49,.755,26,35,61,88,33,6,69,61,259
18037,LAC,1985,Franklin Edwards,25,16,0,198,36,66,.545,0,0,,36,66,.545,.545,19,24,.792,3,11,14,38,17,0,17,10,91
18038,LAC,1985,Jay Murphy,22,23,0,149,8,50,.160,0,1,.000,8,49,.163,.160,12,21,.571,6,35,41,4,1,2,8,21,28
18039,LAC,1985,Dale Wilkinson,24,10,0,38,4,14,.286,0,1,.000,4,13,.308,.286,6,7,.857,1,2,3,2,0,0,4,8,14
18040,SDC,1984,Norm Nixon,28,82,82,3053,587,1270,.462,11,46,.239,576,1224,.471,.467,206,271,.760,56,147,203,914,94,4,257,180,1391
18041,SDC,1984,Terry Cummings,22,81,80,2907,737,1491,.494,0,3,.000,737,1488,.495,.494,380,528,.720,323,454,777,139,92,57,218,298,1854
18042,SDC,1984,James Donaldson,26,82,67,2525,360,604,.596,0,0,,360,604,.596,.596,249,327,.761,165,484,649,90,40,139,171,214,969
18043,SDC,1984,Greg Kelser,26,80,21,1783,313,603,.519,2,6,.333,311,597,.521,.521,250,356,.702,188,203,391,91,68,31,195,249,878
18044,SDC,1984,Craig Hodges,23,76,28,1571,258,573,.450,10,46,.217,248,527,.471,.459,66,88,.750,22,64,86,116,58,1,85,166,592
18045,SDC,1984,Bill Walton,31,55,46,1476,288,518,.556,0,2,.000,288,516,.558,.556,92,154,.597,132,345,477,183,45,88,177,153,668
18046,SDC,1984,Michael Brooks,25,47,30,1405,213,445,.479,0,5,.000,213,440,.484,.479,104,151,.689,142,200,342,88,50,14,78,125,530
18047,SDC,1984,Derek Smith,22,61,20,1297,238,436,.546,1,6,.167,237,430,.551,.547,123,163,.755,54,116,170,82,33,22,78,165,600
18048,SDC,1984,Ricky Pierce,24,69,35,1280,268,570,.470,0,9,.000,268,561,.478,.470,149,173,.861,59,76,135,60,27,13,81,143,685
18049,SDC,1984,Jerome Whitehead,27,70,1,921,144,294,.490,0,0,,144,294,.490,.490,88,107,.822,94,151,245,19,17,12,59,159,376
18050,SDC,1984,Billy McKinney,28,80,0,843,136,305,.446,0,2,.000,136,303,.449,.446,39,46,.848,7,47,54,161,27,0,48,84,311
18051,SDC,1984,Hank McDowell,24,57,0,611,85,197,.431,0,3,.000,85,194,.438,.431,38,56,.679,63,92,155,37,14,2,49,77,208
18052,SDC,1984,Rory White,24,6,0,19,4,9,.444,0,0,,4,9,.444,.444,0,0,,2,2,4,0,0,0,1,3,8
18053,SDC,1984,Hutch Jones,24,4,0,18,0,3,.000,0,0,,0,3,.000,.000,1,4,.250,0,0,0,0,1,0,2,0,1
18054,SDC,1984,Linton Townes,24,2,0,17,3,7,.429,0,0,,3,7,.429,.429,0,0,,0,1,1,1,1,2,1,3,6
18055,SDC,1984,Kevin Loder,24,1,0,4,0,0,,0,0,,0,0,,,0,0,,0,0,0,0,0,0,0,1,0
18056,SDC,1983,Tom Chambers,23,79,79,2665,519,1099,.472,0,8,.000,519,1091,.476,.472,353,488,.723,218,301,519,192,79,57,234,333,1391
18057,SDC,1983,Terry Cummings,21,70,69,2531,684,1309,.523,0,1,.000,684,1308,.523,.523,292,412,.709,303,441,744,177,129,62,204,294,1660
18058,SDC,1983,Michael Brooks,24,82,26,2457,402,830,.484,5,15,.333,397,815,.487,.487,193,277,.697,239,282,521,262,112,39,177,297,1002
18059,SDC,1983,Craig Hodges,22,76,48,2022,318,704,.452,20,90,.222,298,614,.485,.466,94,130,.723,53,69,122,275,82,4,161,192,750
18060,SDC,1983,Lionel Hollins,29,56,54,1844,313,717,.437,3,21,.143,310,696,.445,.439,129,179,.721,30,98,128,373,111,14,198,155,758
18061,SDC,1983,Al Wood,24,76,47,1822,343,740,.464,15,50,.300,328,690,.475,.474,124,161,.770,96,140,236,134,55,36,111,188,825
18062,SDC,1983,Richard Anderson,22,78,5,1274,174,431,.404,7,19,.368,167,412,.405,.412,48,69,.696,111,161,272,120,57,26,93,170,403
18063,SDC,1983,Randy Smith,34,65,16,1264,244,499,.489,3,16,.188,241,483,.499,.492,101,117,.863,35,53,88,192,54,0,89,122,592
18064,SDC,1983,Bill Walton,30,33,32,1099,200,379,.528,0,0,,200,379,.528,.528,65,117,.556,75,248,323,120,34,119,105,113,465
18065,SDC,1983,Jerome Whitehead,26,46,23,905,164,306,.536,0,0,,164,306,.536,.536,72,87,.828,105,156,261,42,21,15,65,139,400
18066,SDC,1983,Lowes Moore,25,37,3,642,81,190,.426,6,23,.261,75,167,.449,.442,42,56,.750,15,40,55,73,22,1,46,72,210
18067,SDC,1983,Jim Brogan,24,58,0,466,91,213,.427,3,13,.231,88,200,.440,.434,34,43,.791,33,29,62,66,26,9,43,79,219
18068,SDC,1983,Bob Gross,29,27,3,373,35,82,.427,1,3,.333,34,79,.430,.433,12,19,.632,32,34,66,34,22,7,24,69,83
18069,SDC,1983,Joe Cooper,25,13,4,275,31,59,.525,0,0,,31,59,.525,.525,11,20,.550,36,35,71,15,8,19,23,39,73
18070,SDC,1983,Hutch Jones,23,9,0,85,17,37,.459,0,0,,17,37,.459,.459,6,6,1.000,10,7,17,4,3,0,6,14,40
18071,SDC,1983,Swen Nater,33,7,0,51,6,20,.300,0,0,,6,20,.300,.300,4,4,1.000,2,11,13,1,1,0,3,1,16
18072,SDC,1983,Robert Smith,27,5,0,43,2,13,.154,0,1,.000,2,12,.167,.154,7,8,.875,1,2,3,6,4,0,3,7,11
18073,SDC,1983,John Douglas,26,3,1,12,1,6,.167,1,2,.500,0,4,.000,.250,2,2,1.000,0,1,1,1,0,0,0,0,5
18074,SDC,1982,Michael Brooks,23,82,73,2750,537,1066,.504,0,7,.000,537,1059,.507,.504,202,267,.757,207,417,624,236,113,39,197,285,1276
18075,SDC,1982,Tom Chambers,22,81,58,2682,554,1056,.525,0,2,.000,554,1054,.526,.525,284,458,.620,211,350,561,146,58,46,220,341,1392
18076,SDC,1982,Jerome Whitehead,25,72,63,2214,406,726,.559,0,0,,406,726,.559,.559,184,241,.763,231,433,664,102,48,44,141,290,996
18077,SDC,1982,Joe Bryant,27,75,49,1988,341,701,.486,8,30,.267,333,671,.496,.492,194,247,.785,79,195,274,189,78,29,183,250,884
18078,SDC,1982,Phil Smith,29,48,39,1446,253,575,.440,5,24,.208,248,551,.450,.444,123,168,.732,34,83,117,233,45,19,116,151,634
18079,SDC,1982,Brian Taylor,30,41,40,1274,165,328,.503,23,63,.365,142,265,.536,.538,90,110,.818,26,70,96,229,47,9,82,113,443
18080,SDC,1982,John Douglas,25,64,9,1031,181,389,.465,18,59,.305,163,330,.494,.488,67,102,.657,27,63,90,146,48,9,92,147,447
18081,SDC,1982,Jim Brogan,23,63,19,1027,165,364,.453,9,32,.281,156,332,.470,.466,61,84,.726,61,59,120,156,49,13,83,123,400
18082,SDC,1982,Michael Wiley,24,61,1,1013,203,359,.565,0,5,.000,203,354,.573,.565,98,141,.695,67,115,182,52,40,16,71,127,504
18083,SDC,1982,Jim Smith,23,72,3,858,86,169,.509,0,0,,86,169,.509,.509,39,85,.459,72,110,182,46,22,51,47,185,211
18084,SDC,1982,Charlie Criss,33,28,20,840,138,288,.479,8,21,.381,130,267,.487,.493,76,86,.884,7,37,44,112,21,4,52,56,360
18085,SDC,1982,Freeman Williams,25,37,10,808,234,513,.456,24,74,.324,210,439,.478,.480,118,140,.843,21,29,50,67,23,0,89,85,610
18086,SDC,1982,Al Wood,23,29,5,692,143,276,.518,3,18,.167,140,258,.543,.524,73,91,.802,29,61,90,47,22,8,60,74,362
18087,SDC,1982,Swen Nater,32,21,7,575,101,175,.577,1,1,1.000,100,174,.575,.580,59,79,.747,46,146,192,30,6,9,48,64,262
18088,SDC,1982,Armond Hill,28,19,14,480,34,89,.382,0,2,.000,34,87,.391,.382,22,32,.688,6,21,27,81,16,3,52,51,90
18089,SDC,1982,Ron Davis,27,7,0,67,10,25,.400,0,0,,10,25,.400,.400,3,6,.500,7,6,13,4,0,0,5,8,23
18090,SDC,1982,Rock Lee,26,2,0,10,1,2,.500,0,0,,1,2,.500,.500,0,4,.000,0,1,1,2,0,0,0,3,2
18091,SDC,1981,Swen Nater,31,82,,2809,517,935,.553,0,0,,517,935,.553,.553,244,307,.795,295,722,1017,199,49,46,211,295,1278
18092,SDC,1981,Michael Brooks,22,82,,2479,488,1018,.479,0,6,.000,488,1012,.482,.479,226,320,.706,210,232,442,208,99,31,163,234,1202
18093,SDC,1981,Phil Smith,28,76,,2378,519,1057,.491,4,18,.222,515,1039,.496,.493,237,313,.757,49,107,156,372,84,18,176,231,1279
18094,SDC,1981,Joe Bryant,26,82,,2359,379,791,.479,2,15,.133,377,776,.486,.480,193,244,.791,146,294,440,189,72,34,176,264,953
18095,SDC,1981,Brian Taylor,29,80,,2312,310,591,.525,44,115,.383,266,476,.559,.562,146,185,.789,58,93,151,440,118,23,111,212,810
18096,SDC,1981,Freeman Williams,24,82,,1976,642,1381,.465,48,141,.340,594,1240,.479,.482,253,297,.852,75,54,129,164,91,5,166,157,1585
18097,SDC,1981,Gar Heard,32,78,,1631,149,396,.376,0,7,.000,149,389,.383,.376,79,101,.782,120,228,348,122,104,72,81,196,377
18098,SDC,1981,Henry Bibby,31,73,,1112,118,306,.386,32,95,.337,86,211,.408,.438,67,98,.684,25,49,74,200,47,2,76,85,335
18099,SDC,1981,Sidney Wicks,31,49,,1083,125,286,.437,0,1,.000,125,285,.439,.437,76,150,.507,79,144,223,111,40,40,94,168,326
18100,SDC,1981,Ron Davis,26,64,,817,139,314,.443,2,8,.250,137,306,.448,.446,94,158,.595,47,72,119,47,36,11,61,98,374
18101,SDC,1981,Jerome Whitehead,24,38,,562,66,139,.475,0,1,.000,66,138,.478,.475,23,45,.511,48,135,183,24,15,8,45,100,155
18102,SDC,1981,Wally Rank,22,25,,153,21,57,.368,0,0,,21,57,.368,.368,13,28,.464,17,13,30,17,7,1,26,33,55
18103,SDC,1981,Stan Pietkiewicz,24,6,,30,2,5,.400,0,0,,2,5,.400,.400,0,0,,0,1,1,2,0,0,5,2,4
18104,SDC,1981,Tony Price,24,5,,29,2,7,.286,0,0,,2,7,.286,.286,0,0,,0,0,0,3,2,1,2,3,4
18105,SDC,1980,Swen Nater,30,81,,2860,443,799,.554,0,2,.000,443,797,.556,.554,196,273,.718,352,864,1216,233,45,37,257,259,1082
18106,SDC,1980,Brian Taylor,28,78,,2754,418,895,.467,90,239,.377,328,656,.500,.517,130,162,.802,76,112,188,335,147,25,141,246,1056
18107,SDC,1980,World B. Free,26,68,,2585,737,1556,.474,9,25,.360,728,1531,.476,.477,572,760,.753,129,109,238,283,81,32,228,195,2055
18108,SDC,1980,Joe Bryant,25,81,,2328,294,682,.431,5,34,.147,289,648,.446,.435,161,217,.742,171,345,516,144,102,39,170,258,754
18109,SDC,1980,Sidney Wicks,30,71,,2146,210,496,.423,0,1,.000,210,495,.424,.423,83,152,.546,138,271,409,213,76,52,167,241,503
18110,SDC,1980,Freeman Williams,23,82,,2118,645,1343,.480,42,128,.328,603,1215,.496,.496,194,238,.815,103,89,192,166,72,9,171,145,1526
18111,SDC,1980,Bingo Smith,33,70,,1988,352,819,.430,22,76,.289,330,743,.444,.443,93,107,.869,92,153,245,93,59,15,72,188,819
18112,SDC,1980,Nick Weatherspoon,29,57,,1124,164,378,.434,0,0,,164,378,.434,.434,63,91,.692,83,125,208,54,34,17,86,136,391
18113,SDC,1980,Stan Pietkiewicz,23,50,,577,91,179,.508,9,36,.250,82,143,.573,.534,37,46,.804,26,19,45,94,25,4,51,52,228
18114,SDC,1980,Bill Walton,27,14,,337,81,161,.503,0,0,,81,161,.503,.503,32,54,.593,28,98,126,34,8,38,37,37,194
18115,SDC,1980,Marvin Barnes,27,20,,287,24,60,.400,0,0,,24,60,.400,.400,16,32,.500,34,43,77,18,5,12,18,52,64
18116,SDC,1980,Steve Malovic,23,28,,277,23,42,.548,0,0,,23,42,.548,.548,7,9,.778,27,31,58,12,5,1,14,35,53
18117,SDC,1980,Jerome Whitehead,23,18,,225,27,45,.600,0,0,,27,45,.600,.600,5,18,.278,29,41,70,6,1,6,8,32,59
18118,SDC,1980,Bob Carrington,26,10,,134,15,37,.405,0,2,.000,15,35,.429,.405,6,8,.750,6,7,13,3,4,1,5,18,36
18119,SDC,1980,John Olive,24,1,,15,0,2,.000,0,0,,0,2,.000,.000,0,0,,0,1,1,0,0,0,2,2,0
18120,PHO,2024,Kevin Durant,35,75,75,2791,751,1436,.523,168,407,.413,583,1029,.567,.581,362,423,.856,41,454,495,378,69,91,244,133,2032
18121,PHO,2024,Grayson Allen,28,75,74,2513,340,682,.499,205,445,.461,135,237,.570,.649,129,147,.878,48,247,295,227,69,45,95,157,1014
18122,PHO,2024,Devin Booker,27,68,68,2447,642,1305,.492,152,418,.364,490,887,.552,.550,405,457,.886,56,252,308,472,61,28,178,206,1841
18123,PHO,2024,Jusuf Nurkić,29,76,76,2078,320,627,.510,22,90,.244,298,537,.555,.528,167,261,.640,224,613,837,301,81,80,175,254,829
18124,PHO,2024,Eric Gordon,35,68,24,1893,274,618,.443,150,397,.378,124,221,.561,.565,51,64,.797,16,106,122,139,66,30,73,79,749
18125,PHO,2024,Bradley Beal,30,53,53,1767,377,735,.513,101,235,.430,276,500,.552,.582,109,134,.813,54,178,232,265,52,27,131,127,964
18126,PHO,2024,Drew Eubanks,26,75,6,1169,152,253,.601,3,3,1.000,149,250,.596,.607,72,93,.774,103,219,322,63,27,61,61,115,379
18127,PHO,2024,Josh Okogie,25,60,11,960,86,206,.417,29,94,.309,57,112,.509,.488,76,102,.745,74,80,154,64,48,24,36,68,277
18128,PHO,2024,Royce O'Neale,30,30,8,752,88,214,.411,59,157,.376,29,57,.509,.549,9,13,.692,22,134,156,82,27,15,22,54,244
18129,PHO,2024,Keita Bates-Diop,28,39,8,597,64,150,.427,20,64,.313,44,86,.512,.493,26,36,.722,30,71,101,34,22,20,13,33,174
18130,PHO,2024,Jordan Goodwin,25,40,0,558,75,193,.389,23,80,.288,52,113,.460,.448,25,29,.862,40,77,117,78,23,9,29,43,198
18131,PHO,2024,Bol Bol,24,43,0,469,93,151,.616,22,52,.423,71,99,.717,.689,15,19,.789,32,105,137,17,10,25,19,42,223
18132,PHO,2024,Nassir Little,23,45,2,458,57,124,.460,21,70,.300,36,54,.667,.544,17,20,.850,14,61,75,21,10,10,14,39,152
18133,PHO,2024,Chimezie Metu,26,37,5,448,66,130,.508,15,51,.294,51,79,.646,.565,38,43,.884,24,86,110,19,19,9,27,39,185
18134,PHO,2024,Yuta Watanabe,29,29,0,382,35,97,.361,24,75,.320,11,22,.500,.485,10,15,.667,11,34,45,10,9,7,16,34,104
18135,PHO,2024,Saben Lee,24,24,0,185,20,55,.364,2,16,.125,18,39,.462,.382,29,39,.744,9,22,31,30,7,3,8,13,71
18136,PHO,2024,Udoka Azubuike,24,16,0,113,16,23,.696,0,0,,16,23,.696,.696,3,13,.231,11,21,32,3,1,6,4,17,35
18137,PHO,2024,Thaddeus Young,35,10,0,89,11,21,.524,0,1,.000,11,20,.550,.524,1,3,.333,17,11,28,7,5,2,4,11,23
18138,PHO,2024,David Roddy,22,17,0,63,10,23,.435,1,8,.125,9,15,.600,.457,1,1,1.000,2,9,11,4,2,0,3,4,22
18139,PHO,2024,Isaiah Thomas,34,6,0,19,3,10,.300,2,4,.500,1,6,.167,.400,0,0,,0,0,0,3,0,0,0,0,8
18140,PHO,2024,Ish Wainright,29,4,0,16,1,6,.167,1,4,.250,0,2,.000,.250,0,0,,3,2,5,1,2,0,1,4,3
18141,PHO,2024,Théo Maledon,22,4,0,13,1,4,.250,0,0,,1,4,.250,.250,3,3,1.000,0,1,1,0,0,0,3,3,5
18142,PHO,2023,Mikal Bridges,26,56,56,2040,354,764,.463,101,261,.387,253,503,.503,.529,156,174,.897,56,187,243,201,65,45,78,115,965
18143,PHO,2023,Deandre Ayton,24,67,67,2035,522,887,.589,7,24,.292,515,863,.597,.592,152,200,.760,172,495,667,115,37,53,120,190,1203
18144,PHO,2023,Torrey Craig,32,79,60,1948,228,500,.456,100,253,.395,128,247,.518,.556,32,45,.711,145,281,426,117,50,62,73,179,588
18145,PHO,2023,Chris Paul,37,59,59,1889,294,668,.440,98,261,.375,196,407,.482,.513,133,160,.831,27,224,251,524,91,22,114,126,819
18146,PHO,2023,Devin Booker,26,53,53,1835,527,1067,.494,111,316,.351,416,751,.554,.546,306,358,.855,46,194,240,293,51,18,145,159,1471
18147,PHO,2023,Damion Lee,30,74,5,1506,200,452,.442,110,247,.445,90,205,.439,.564,94,104,.904,39,186,225,99,30,7,78,118,604
18148,PHO,2023,Josh Okogie,24,72,26,1350,162,414,.391,66,197,.335,96,217,.442,.471,139,192,.724,109,142,251,105,56,34,63,114,529
18149,PHO,2023,Jock Landale,27,69,4,979,178,337,.528,21,84,.250,157,253,.621,.559,79,105,.752,119,161,280,68,16,30,59,126,456
18150,PHO,2023,Cameron Payne,28,48,15,968,188,453,.415,68,185,.368,120,268,.448,.490,49,64,.766,12,94,106,214,33,8,81,88,493
18151,PHO,2023,Ish Wainright,28,60,2,915,84,227,.370,57,173,.329,27,54,.500,.496,26,31,.839,45,94,139,53,38,22,22,117,251
18152,PHO,2023,Bismack Biyombo,30,61,14,874,119,206,.578,0,0,,119,206,.578,.578,25,70,.357,89,171,260,56,18,88,51,114,263
18153,PHO,2023,Landry Shamet,25,40,9,807,113,300,.377,75,199,.377,38,101,.376,.502,45,51,.882,11,56,67,93,26,5,36,61,346
18154,PHO,2023,Dario Šarić,28,37,12,533,76,178,.427,27,69,.391,49,109,.450,.503,36,44,.818,39,103,142,57,13,5,36,69,215
18155,PHO,2023,Cameron Johnson,26,17,16,429,82,173,.474,45,99,.455,37,74,.500,.604,27,33,.818,14,51,65,26,15,6,10,29,236
18156,PHO,2023,Duane Washington Jr.,22,31,3,394,94,256,.367,40,111,.360,54,145,.372,.445,16,24,.667,2,34,36,63,6,4,34,23,244
18157,PHO,2023,Terrence Ross,31,21,0,386,71,166,.428,34,98,.347,37,68,.544,.530,12,14,.857,12,57,69,41,10,2,6,44,188
18158,PHO,2023,Saben Lee,23,23,1,363,46,117,.393,11,29,.379,35,88,.398,.440,42,57,.737,13,32,45,65,18,1,21,31,145
18159,PHO,2023,Kevin Durant,34,8,8,269,73,128,.570,22,41,.537,51,87,.586,.656,40,48,.833,3,48,51,28,2,10,20,7,208
18160,PHO,2023,T.J. Warren,29,16,0,197,30,70,.429,6,19,.316,24,51,.471,.471,1,2,.500,13,36,49,11,7,5,3,20,67
18161,PHO,2023,Darius Bazley,22,7,0,61,12,25,.480,2,8,.250,10,17,.588,.520,2,5,.400,5,11,16,6,3,5,5,9,28
18162,PHO,2022,Mikal Bridges,25,82,82,2854,458,858,.534,115,312,.369,343,546,.628,.601,131,157,.834,74,273,347,185,96,36,68,150,1162
18163,PHO,2022,Devin Booker,25,68,68,2345,662,1421,.466,183,478,.383,479,943,.508,.530,315,363,.868,45,297,342,329,77,26,162,180,1822
18164,PHO,2022,Chris Paul,36,65,65,2139,363,736,.493,63,199,.317,300,537,.559,.536,169,202,.837,22,261,283,702,121,20,153,134,958
18165,PHO,2022,Jae Crowder,31,67,67,1886,217,544,.399,127,365,.348,90,179,.503,.516,71,90,.789,30,324,354,124,95,30,55,173,632
18166,PHO,2022,Cameron Johnson,25,66,16,1730,279,607,.460,166,391,.425,113,216,.523,.596,98,114,.860,42,231,273,99,57,16,47,113,822
18167,PHO,2022,Deandre Ayton,23,58,58,1713,442,697,.634,7,19,.368,435,678,.642,.639,106,142,.746,149,444,593,84,40,40,91,142,997
18168,PHO,2022,Landry Shamet,24,69,14,1437,191,485,.394,123,334,.368,68,151,.450,.521,68,81,.840,16,110,126,108,28,9,41,92,573
18169,PHO,2022,Cameron Payne,27,58,12,1278,240,587,.409,71,211,.336,169,376,.449,.469,75,89,.843,24,151,175,282,40,17,103,119,626
18170,PHO,2022,JaVale McGee,34,74,17,1172,288,458,.629,2,9,.222,286,449,.637,.631,102,146,.699,163,333,496,42,22,81,98,181,680
18171,PHO,2022,Torrey Craig,31,27,2,562,72,160,.450,31,96,.323,41,64,.641,.547,12,17,.706,27,88,115,33,22,17,28,56,187
18172,PHO,2022,Elfrid Payton,27,50,1,549,67,175,.383,4,18,.222,63,157,.401,.394,12,32,.375,21,67,88,99,25,6,47,38,150
18173,PHO,2022,Bismack Biyombo,29,36,3,506,86,145,.593,0,0,,86,145,.593,.593,38,71,.535,63,104,167,23,12,26,25,70,210
18174,PHO,2022,Jalen Smith,21,29,4,382,63,137,.460,9,39,.231,54,98,.551,.493,40,52,.769,55,84,139,6,6,18,22,52,175
18175,PHO,2022,Ish Wainright,27,45,0,359,41,104,.394,19,59,.322,22,45,.489,.486,7,12,.583,27,27,54,15,20,6,13,49,108
18176,PHO,2022,Aaron Holiday,25,22,1,358,51,124,.411,16,36,.444,35,88,.398,.476,31,33,.939,15,40,55,75,18,0,28,32,149
18177,PHO,2022,Frank Kaminsky,28,9,0,181,36,66,.545,5,15,.333,31,51,.608,.583,18,20,.900,11,30,41,13,8,7,5,14,95
18178,PHO,2022,Abdel Nader,28,14,0,145,12,35,.343,4,14,.286,8,21,.381,.400,6,10,.600,4,23,27,7,8,4,11,20,34
18179,PHO,2022,Gabriel Lundberg,27,4,0,44,5,19,.263,3,8,.375,2,11,.182,.342,0,0,,2,5,7,11,3,0,3,7,13
18180,PHO,2022,Justin Jackson,26,6,0,35,5,14,.357,3,9,.333,2,5,.400,.464,0,0,,1,6,7,2,0,0,1,3,13
18181,PHO,2022,Chandler Hutchison,25,6,0,22,1,2,.500,0,0,,1,2,.500,.500,2,2,1.000,0,5,5,2,0,0,4,1,4
18182,PHO,2022,Emanuel Terry,25,3,0,18,0,5,.000,0,0,,0,5,.000,.000,0,0,,8,7,15,2,1,0,5,4,0
18183,PHO,2022,M.J. Walker,23,2,0,8,0,4,.000,0,2,.000,0,2,.000,.000,0,0,,0,1,1,1,2,0,0,1,0
18184,PHO,2022,Paris Bass,26,2,0,7,2,6,.333,0,2,.000,2,4,.500,.333,2,2,1.000,2,2,4,0,1,0,2,2,6
18185,PHO,2021,Mikal Bridges,24,72,72,2348,363,669,.543,134,315,.425,229,354,.647,.643,110,131,.840,76,233,309,152,76,63,57,116,970
18186,PHO,2021,Devin Booker,24,67,67,2270,623,1287,.484,126,371,.340,497,916,.543,.533,340,392,.867,34,247,281,289,53,16,207,181,1712
18187,PHO,2021,Chris Paul,35,70,70,2199,439,879,.499,102,258,.395,337,621,.543,.557,169,181,.934,25,287,312,622,99,19,156,166,1149
18188,PHO,2021,Deandre Ayton,22,69,69,2115,430,687,.626,4,20,.200,426,667,.639,.629,133,173,.769,228,499,727,99,41,81,103,196,997
18189,PHO,2021,Jae Crowder,30,60,42,1648,199,492,.404,148,380,.389,51,112,.455,.555,57,75,.760,32,250,282,127,48,27,55,125,603
18190,PHO,2021,Cameron Johnson,24,60,11,1437,203,483,.420,117,335,.349,86,148,.581,.541,50,59,.847,33,166,199,86,37,16,40,85,573
18191,PHO,2021,Cameron Payne,26,60,1,1079,191,395,.484,73,166,.440,118,229,.515,.576,50,56,.893,16,128,144,217,36,16,60,97,505
18192,PHO,2021,Dario Šarić,26,50,4,871,153,342,.447,47,135,.348,106,207,.512,.516,84,99,.848,46,144,190,65,30,4,57,95,437
18193,PHO,2021,Jevon Carter,25,60,1,717,94,223,.422,56,151,.371,38,72,.528,.547,4,7,.571,16,76,92,71,29,9,16,56,248
18194,PHO,2021,Frank Kaminsky,27,47,13,715,121,257,.471,31,85,.365,90,172,.523,.531,37,60,.617,36,152,188,79,14,17,22,70,310
18195,PHO,2021,Torrey Craig,30,32,8,602,91,181,.503,31,84,.369,60,97,.619,.588,16,20,.800,44,110,154,33,19,19,20,59,229
18196,PHO,2021,Langston Galloway,29,40,0,438,66,147,.449,36,85,.424,30,62,.484,.571,22,23,.957,7,35,42,26,8,0,13,25,190
18197,PHO,2021,E'Twaun Moore,31,27,1,389,55,121,.455,11,35,.314,44,86,.512,.500,12,14,.857,14,31,45,40,15,5,23,32,133
18198,PHO,2021,Abdel Nader,27,24,0,355,57,116,.491,18,43,.419,39,73,.534,.569,28,37,.757,7,55,62,19,10,9,19,34,160
18199,PHO,2021,Jalen Smith,20,27,1,156,22,50,.440,4,17,.235,18,33,.545,.480,5,7,.714,7,30,37,4,1,5,7,16,53
18200,PHO,2021,Damian Jones,25,14,0,94,8,16,.500,0,1,.000,8,15,.533,.500,6,11,.545,7,11,18,4,1,5,6,19,22
18201,PHO,2021,Ty-Shon Alexander,22,15,0,47,3,12,.250,2,9,.222,1,3,.333,.333,1,2,.500,2,8,10,6,0,1,3,2,9
18202,PHO,2020,Devin Booker,23,70,70,2512,627,1283,.489,141,398,.354,486,885,.549,.544,468,509,.919,29,268,297,456,49,18,264,213,1863
18203,PHO,2020,Mikal Bridges,23,73,32,2042,247,484,.510,70,194,.361,177,290,.610,.583,103,122,.844,66,226,292,129,102,46,73,163,667
18204,PHO,2020,Ricky Rubio,29,65,65,2016,287,692,.415,78,216,.361,209,476,.439,.471,195,226,.863,46,258,304,570,94,11,173,167,847
18205,PHO,2020,Kelly Oubre Jr.,24,56,55,1933,373,826,.452,108,307,.352,265,519,.511,.517,192,246,.780,67,294,361,85,71,40,83,192,1046
18206,PHO,2020,Dario Šarić,25,66,51,1632,256,538,.476,84,235,.357,172,303,.568,.554,108,128,.844,100,306,406,123,37,16,88,156,704
18207,PHO,2020,Cameron Johnson,23,57,9,1255,176,405,.435,106,272,.390,70,133,.526,.565,46,57,.807,49,138,187,69,36,20,32,88,504
18208,PHO,2020,Deandre Ayton,21,38,32,1236,310,568,.546,3,13,.231,307,555,.553,.548,67,89,.753,147,289,436,72,26,58,80,117,690
18209,PHO,2020,Jevon Carter,24,58,2,945,101,243,.416,62,146,.425,39,97,.402,.543,23,27,.852,30,88,118,84,47,17,32,86,287
18210,PHO,2020,Aron Baynes,33,42,28,934,183,381,.480,59,168,.351,124,213,.582,.558,56,75,.747,71,166,237,67,10,23,50,141,481
18211,PHO,2020,Frank Kaminsky,26,39,13,777,138,307,.450,41,124,.331,97,183,.530,.516,61,90,.678,35,141,176,75,14,10,37,75,378
18212,PHO,2020,Elie Okobo,22,55,3,719,72,181,.398,25,71,.352,47,110,.427,.467,50,71,.704,16,74,90,115,24,4,38,54,219
18213,PHO,2020,Tyler Johnson,27,31,3,515,65,171,.380,24,83,.289,41,88,.466,.450,24,32,.750,10,42,52,50,12,8,24,43,178
18214,PHO,2020,Cheick Diallo,23,47,2,479,92,142,.648,1,3,.333,91,139,.655,.651,34,39,.872,30,101,131,22,11,12,32,55,219
18215,PHO,2020,Ty Jerome,22,31,0,328,38,113,.336,14,50,.280,24,63,.381,.398,12,16,.750,7,39,46,44,15,3,18,29,102
18216,PHO,2020,Cameron Payne,25,8,0,183,33,68,.485,15,29,.517,18,39,.462,.596,6,7,.857,4,27,31,24,8,2,11,20,87
18217,PHO,2020,Jonah Bolden,24,3,0,33,2,8,.250,0,3,.000,2,5,.400,.250,2,2,1.000,3,5,8,0,2,2,0,6,6
18218,PHO,2020,Jalen Lecque,19,5,0,32,4,10,.400,0,4,.000,4,6,.667,.400,2,2,1.000,0,2,2,2,0,0,2,3,10
18219,PHO,2020,Tariq Owens,24,3,0,15,1,5,.200,0,2,.000,1,3,.333,.200,2,2,1.000,2,1,3,0,1,0,0,1,4
18220,PHO,2020,Jared Harper,22,3,0,8,1,4,.250,0,2,.000,1,2,.500,.250,0,0,,0,0,0,0,0,0,0,0,2
18221,PHO,2019,Mikal Bridges,22,82,56,2417,242,563,.430,105,313,.335,137,250,.548,.523,95,118,.805,56,208,264,173,129,38,70,201,684
18222,PHO,2019,Devin Booker,22,64,64,2242,586,1255,.467,135,414,.326,451,841,.536,.521,393,454,.866,39,226,265,433,56,13,264,200,1700
18223,PHO,2019,Deandre Ayton,20,71,70,2183,509,870,.585,0,4,.000,509,866,.588,.585,141,189,.746,223,506,729,125,61,67,126,209,1159
18224,PHO,2019,Josh Jackson,21,79,29,1988,347,841,.413,73,225,.324,274,616,.445,.456,143,213,.671,66,281,347,183,74,56,173,209,910
18225,PHO,2019,T.J. Warren,25,43,36,1360,297,611,.486,77,180,.428,220,431,.510,.549,101,124,.815,31,143,174,64,51,29,52,119,772
18226,PHO,2019,Jamal Crawford,38,64,0,1211,174,438,.397,67,202,.332,107,236,.453,.474,93,110,.845,8,77,85,229,33,12,99,75,508
18227,PHO,2019,Richaun Holmes,25,70,4,1184,222,365,.608,0,0,,222,365,.608,.608,128,175,.731,115,216,331,60,42,79,52,194,572
18228,PHO,2019,Kelly Oubre Jr.,23,40,12,1180,243,537,.453,67,206,.325,176,331,.532,.515,121,159,.761,47,149,196,64,57,39,73,110,674
18229,PHO,2019,De'Anthony Melton,20,50,31,984,100,256,.391,29,95,.305,71,161,.441,.447,21,28,.750,25,109,134,159,68,23,75,113,250
18230,PHO,2019,Elie Okobo,21,53,16,958,114,290,.393,39,132,.295,75,158,.475,.460,37,47,.787,12,86,98,127,32,7,69,109,304
18231,PHO,2019,Trevor Ariza,33,26,26,884,86,227,.379,50,139,.360,36,88,.409,.489,36,43,.837,16,129,145,87,38,8,39,44,258
18232,PHO,2019,Dragan Bender,21,46,27,826,88,197,.447,22,101,.218,66,96,.688,.503,32,54,.593,34,149,183,56,18,22,37,90,230
18233,PHO,2019,Troy Daniels,27,51,1,760,113,275,.411,74,194,.381,39,81,.481,.545,18,23,.783,13,60,73,26,26,5,27,79,318
18234,PHO,2019,Isaiah Canaan,27,19,15,503,51,129,.395,25,72,.347,26,57,.456,.492,15,20,.750,5,44,49,62,12,0,29,46,142
18235,PHO,2019,Tyler Johnson,26,13,12,406,46,125,.368,18,56,.321,28,69,.406,.440,34,39,.872,15,37,52,54,14,6,14,25,144
18236,PHO,2019,Ryan Anderson,30,15,8,278,19,60,.317,7,34,.206,12,26,.462,.375,11,14,.786,14,31,45,17,3,1,12,23,56
18237,PHO,2019,Ray Spalding,21,13,3,147,25,47,.532,0,3,.000,25,44,.568,.532,4,12,.333,15,33,48,5,9,8,9,23,54
18238,PHO,2019,Quincy Acy,28,10,0,123,4,18,.222,2,15,.133,2,3,.667,.278,7,10,.700,3,22,25,8,1,4,4,24,17
18239,PHO,2019,Tyson Chandler,36,7,0,89,8,12,.667,0,0,,8,12,.667,.667,10,18,.556,7,32,39,6,2,1,7,21,26
18240,PHO,2019,Jimmer Fredette,29,6,0,65,8,29,.276,0,13,.000,8,16,.500,.276,6,6,1.000,1,6,7,8,3,0,5,5,22
18241,PHO,2019,Jawun Evans,22,7,0,64,3,13,.231,0,2,.000,3,11,.273,.231,0,0,,1,11,12,10,3,0,6,8,6
18242,PHO,2019,Emanuel Terry,22,2,0,20,4,6,.667,0,0,,4,6,.667,.667,1,2,.500,2,4,6,1,3,0,2,4,9
18243,PHO,2019,George King,25,1,0,6,0,0,,0,0,,0,0,,,0,0,,0,1,1,0,0,0,0,0,0
18244,PHO,2019,Eric Moreland,27,1,0,5,0,0,,0,0,,0,0,,,0,0,,0,3,3,0,0,0,0,1,0
18245,PHO,2018,T.J. Warren,24,65,65,2142,529,1063,.498,20,90,.222,509,973,.523,.507,193,255,.757,125,208,333,85,65,41,85,149,1271
18246,PHO,2018,Dragan Bender,20,82,37,2069,187,484,.386,118,322,.366,69,162,.426,.508,39,51,.765,40,321,361,130,22,53,112,166,531
18247,PHO,2018,Josh Jackson,20,77,35,1959,389,932,.417,57,217,.263,332,715,.464,.448,177,279,.634,95,256,351,119,80,35,146,218,1012
18248,PHO,2018,Devin Booker,21,54,54,1865,455,1054,.432,147,384,.383,308,670,.460,.501,289,329,.878,26,218,244,253,47,14,194,168,1346
18249,PHO,2018,Tyler Ulis,22,71,43,1658,214,551,.388,42,146,.288,172,405,.425,.426,84,101,.832,24,104,128,311,70,7,127,120,554
18250,PHO,2018,Troy Daniels,26,79,15,1622,232,575,.403,183,458,.400,49,117,.419,.563,56,64,.875,12,115,127,48,26,5,56,137,703
18251,PHO,2018,Marquese Chriss,20,72,49,1527,202,477,.423,56,190,.295,146,287,.509,.482,96,158,.608,76,319,395,83,51,70,107,205,556
18252,PHO,2018,Alex Len,24,69,13,1395,214,378,.566,1,3,.333,213,375,.568,.567,158,231,.684,175,343,518,82,27,61,78,158,587
18253,PHO,2018,Tyson Chandler,35,46,46,1151,121,187,.647,0,0,,121,187,.647,.647,58,93,.624,134,284,418,53,16,27,59,106,300
18254,PHO,2018,Jared Dudley,32,48,0,686,48,122,.393,29,80,.363,19,42,.452,.512,27,35,.771,8,86,94,78,24,11,28,85,152
18255,PHO,2018,Mike James,27,32,10,669,121,312,.388,26,97,.268,95,215,.442,.429,64,84,.762,12,77,89,120,27,7,48,45,332
18256,PHO,2018,Elfrid Payton,23,19,19,551,91,209,.435,5,25,.200,86,184,.467,.447,37,54,.685,17,83,100,118,19,6,54,50,224
18257,PHO,2018,Greg Monroe,27,20,14,465,97,155,.626,0,0,,97,155,.626,.626,31,46,.674,50,110,160,50,16,6,40,40,225
18258,PHO,2018,Isaiah Canaan,26,19,1,418,52,136,.382,22,66,.333,30,70,.429,.463,46,51,.902,6,38,44,76,16,1,29,36,172
18259,PHO,2018,Danuel House Jr.,24,23,3,403,56,129,.434,15,58,.259,41,71,.577,.492,25,31,.806,13,63,76,25,7,6,11,23,152
18260,PHO,2018,Shaquille Harrison,24,23,2,384,59,124,.476,6,26,.231,53,98,.541,.500,28,38,.737,9,52,61,55,26,7,22,42,152
18261,PHO,2018,Davon Reed,22,21,1,242,22,76,.289,11,38,.289,11,38,.289,.362,8,12,.667,2,37,39,13,10,2,10,17,63
18262,PHO,2018,Alec Peters,22,20,0,225,28,74,.378,18,58,.310,10,16,.625,.500,8,10,.800,8,29,37,12,2,2,4,13,82
18263,PHO,2018,Josh Gray,24,5,0,86,11,41,.268,3,13,.231,8,28,.286,.305,7,11,.636,2,8,10,12,8,2,7,8,32
18264,PHO,2018,Eric Bledsoe,28,3,3,83,16,40,.400,4,13,.308,12,27,.444,.450,11,14,.786,3,4,7,9,4,2,10,6,47
18265,PHO,2018,Alan Williams,25,5,0,70,7,18,.389,0,0,,7,18,.389,.389,6,9,.667,3,19,22,8,5,1,7,13,20
18266,PHO,2018,Derrick Jones Jr.,20,6,0,33,2,4,.500,0,2,.000,2,2,1.000,.500,5,6,.833,2,2,4,3,1,4,1,2,9
18267,PHO,2017,Devin Booker,20,78,78,2730,606,1431,.423,147,405,.363,459,1026,.447,.475,367,441,.832,46,203,249,268,72,21,241,242,1726
18268,PHO,2017,Eric Bledsoe,27,66,66,2176,449,1034,.434,104,310,.335,345,724,.477,.485,388,458,.847,52,268,320,418,91,31,224,164,1390
18269,PHO,2017,T.J. Warren,23,66,59,2048,403,814,.495,26,98,.265,377,716,.527,.511,119,154,.773,125,214,339,75,76,39,57,175,951
18270,PHO,2017,Marquese Chriss,19,82,75,1743,284,632,.449,72,224,.321,212,408,.520,.506,113,181,.624,96,252,348,60,67,70,108,263,753
18271,PHO,2017,P.J. Tucker,31,57,17,1627,147,354,.415,46,136,.338,101,218,.463,.480,61,77,.792,94,248,342,73,85,14,52,143,401
18272,PHO,2017,Alex Len,23,77,34,1560,230,463,.497,3,12,.250,227,451,.503,.500,150,208,.721,156,354,510,44,38,98,102,242,613
18273,PHO,2017,Jared Dudley,31,64,7,1362,157,346,.454,77,203,.379,80,143,.559,.565,43,65,.662,31,194,225,121,42,16,73,154,434
18274,PHO,2017,Tyson Chandler,34,47,46,1298,153,228,.671,0,0,,153,228,.671,.671,91,124,.734,153,386,539,30,33,24,65,126,397
18275,PHO,2017,Brandon Knight,25,54,5,1140,209,525,.398,45,139,.324,164,386,.425,.441,132,154,.857,25,93,118,130,27,5,88,87,595
18276,PHO,2017,Tyler Ulis,21,61,15,1123,184,437,.421,21,79,.266,163,358,.455,.445,55,71,.775,20,75,95,226,48,5,77,73,444
18277,PHO,2017,Leandro Barbosa,34,67,0,963,172,392,.439,35,98,.357,137,294,.466,.483,40,45,.889,15,89,104,81,31,8,48,82,419
18278,PHO,2017,Alan Williams,24,47,0,708,138,267,.517,0,1,.000,138,266,.519,.517,70,112,.625,94,198,292,23,27,32,37,125,346
18279,PHO,2017,Dragan Bender,19,43,0,574,57,161,.354,28,101,.277,29,60,.483,.441,4,11,.364,23,80,103,23,10,22,32,74,146
18280,PHO,2017,Derrick Jones Jr.,19,32,8,545,68,121,.562,3,11,.273,65,110,.591,.574,29,41,.707,39,40,79,12,14,13,13,63,168
18281,PHO,2017,Ronnie Price,33,14,0,134,4,24,.167,3,17,.176,1,7,.143,.229,3,4,.750,3,8,11,18,11,1,3,14,14
18282,PHO,2017,Jarell Eddie,25,5,0,62,6,19,.316,4,16,.250,2,3,.667,.421,8,9,.889,1,6,7,0,1,0,1,1,24
18283,PHO,2017,Elijah Millsap,29,2,0,23,1,7,.143,0,2,.000,1,5,.200,.143,1,2,.500,3,3,6,1,0,0,2,2,3
18284,PHO,2017,John Jenkins,25,4,0,13,2,5,.400,1,2,.500,1,3,.333,.500,2,2,1.000,0,1,1,1,0,0,0,0,7
18285,PHO,2016,P.J. Tucker,30,82,80,2540,239,582,.411,68,206,.330,171,376,.455,.469,106,142,.746,165,347,512,177,106,20,111,202,652
18286,PHO,2016,Devin Booker,19,76,51,2108,367,867,.423,99,289,.343,268,578,.464,.480,215,256,.840,27,160,187,200,44,20,160,225,1048
18287,PHO,2016,Brandon Knight,24,52,50,1870,371,895,.415,120,351,.342,251,544,.461,.482,156,183,.852,36,166,202,263,61,20,177,124,1018
18288,PHO,2016,Alex Len,22,78,46,1821,264,624,.423,1,7,.143,263,617,.426,.424,174,239,.728,178,416,594,97,38,62,145,230,703
18289,PHO,2016,Mirza Teletović,30,79,1,1686,332,777,.427,181,460,.393,151,317,.476,.544,120,155,.774,55,247,302,89,32,21,84,159,965
18290,PHO,2016,Tyson Chandler,33,66,60,1618,183,314,.583,0,1,.000,183,313,.585,.583,106,171,.620,175,401,576,64,36,44,93,145,472
18291,PHO,2016,Jon Leuer,26,67,27,1255,224,466,.481,42,110,.382,182,356,.511,.526,77,101,.762,76,297,373,72,38,30,75,125,567
18292,PHO,2016,Ronnie Price,32,62,18,1211,116,302,.384,68,196,.347,48,106,.453,.497,31,41,.756,25,74,99,147,74,13,70,161,331
18293,PHO,2016,Archie Goodwin,21,57,13,1114,176,422,.417,23,99,.232,153,323,.474,.444,130,193,.674,27,115,142,118,27,13,100,84,505
18294,PHO,2016,T.J. Warren,22,47,4,1070,221,441,.501,28,70,.400,193,371,.520,.533,45,64,.703,57,90,147,44,37,16,32,94,515
18295,PHO,2016,Eric Bledsoe,26,31,31,1059,223,492,.453,48,129,.372,175,363,.482,.502,138,172,.802,18,107,125,190,63,19,110,75,632
18296,PHO,2016,Markieff Morris,26,37,24,917,171,431,.397,22,76,.289,149,355,.420,.422,66,92,.717,43,151,194,87,33,17,90,104,430
18297,PHO,2016,Sonny Weems,29,36,0,421,35,89,.393,13,32,.406,22,57,.386,.466,7,13,.538,6,35,41,47,10,1,37,40,90
18298,PHO,2016,John Jenkins,24,22,2,287,42,90,.467,13,32,.406,29,58,.500,.539,12,15,.800,4,31,35,26,5,1,16,11,109
18299,PHO,2016,Chase Budinger,27,17,0,200,23,45,.511,4,17,.235,19,28,.679,.556,5,8,.625,12,17,29,15,3,1,13,16,55
18300,PHO,2016,Phil Pressey,24,9,0,113,9,23,.391,0,5,.000,9,18,.500,.391,4,7,.571,3,5,8,29,7,3,14,14,22
18301,PHO,2016,Jordan McRae,24,7,0,82,11,26,.423,3,11,.273,8,15,.533,.481,12,15,.800,2,6,8,10,3,0,6,7,37
18302,PHO,2016,Kris Humphries,30,4,3,74,10,36,.278,3,10,.300,7,26,.269,.319,6,8,.750,11,21,32,7,3,2,4,8,29
18303,PHO,2016,Alan Williams,23,10,0,68,10,24,.417,0,0,,10,24,.417,.417,9,14,.643,14,24,38,5,4,5,6,15,29
18304,PHO,2016,Lorenzo Brown,25,8,0,61,8,25,.320,1,8,.125,7,17,.412,.340,3,4,.750,0,7,7,11,3,1,9,4,20
18305,PHO,2016,Cory Jefferson,25,8,0,50,9,22,.409,0,1,.000,9,21,.429,.409,4,6,.667,6,10,16,0,0,1,0,8,22
18306,PHO,2016,Orlando Johnson,26,2,0,47,5,17,.294,1,5,.200,4,12,.333,.324,5,6,.833,3,6,9,0,2,3,1,5,16
18307,PHO,2016,Bryce Cotton,23,3,0,33,2,8,.250,0,3,.000,2,5,.400,.250,0,0,,0,0,0,3,3,0,5,2,4
18308,PHO,2015,Eric Bledsoe,25,81,81,2800,468,1046,.447,88,272,.324,380,774,.491,.489,353,441,.800,72,351,423,493,127,45,274,189,1377
18309,PHO,2015,Markieff Morris,25,82,82,2581,512,1100,.465,57,179,.318,455,921,.494,.491,177,232,.763,110,396,506,192,101,39,170,245,1258
18310,PHO,2015,P.J. Tucker,29,78,63,2383,261,596,.438,87,252,.345,174,344,.506,.511,104,143,.727,114,388,502,122,107,23,96,179,713
18311,PHO,2015,Marcus Morris,25,81,35,2045,331,763,.434,112,313,.358,219,450,.487,.507,71,113,.628,73,312,385,133,63,16,73,188,845
18312,PHO,2015,Goran Dragić,28,52,52,1735,340,679,.501,66,186,.355,274,493,.556,.549,97,130,.746,51,134,185,211,50,9,114,120,843
18313,PHO,2015,Alex Len,21,69,44,1518,179,353,.507,1,3,.333,178,350,.509,.508,73,104,.702,142,312,454,32,34,105,74,213,432
18314,PHO,2015,Gerald Green,29,74,4,1446,324,778,.416,137,387,.354,187,391,.478,.504,99,120,.825,33,153,186,91,42,12,104,145,884
18315,PHO,2015,Isaiah Thomas,25,46,1,1181,218,512,.426,81,207,.391,137,305,.449,.505,184,211,.872,26,83,109,171,45,5,89,105,701
18316,PHO,2015,Miles Plumlee,26,54,28,1005,107,195,.549,0,0,,107,195,.549,.549,19,38,.500,95,179,274,27,35,55,45,99,233
18317,PHO,2015,Brandan Wright,27,40,7,858,120,207,.580,0,3,.000,120,204,.588,.580,40,60,.667,70,124,194,23,32,47,16,54,280
18318,PHO,2015,T.J. Warren,21,40,1,614,113,214,.528,5,21,.238,108,193,.560,.540,14,19,.737,41,44,85,25,18,9,27,51,245
18319,PHO,2015,Archie Goodwin,20,41,2,535,79,201,.393,12,41,.293,67,160,.419,.423,61,83,.735,27,47,74,44,18,9,48,55,231
18320,PHO,2015,Brandon Knight,23,11,9,347,51,143,.357,21,67,.313,30,76,.395,.430,24,29,.828,2,21,23,49,6,1,23,21,147
18321,PHO,2015,Anthony Tolliver,29,24,0,272,26,74,.351,24,62,.387,2,12,.167,.514,4,6,.667,6,38,44,10,4,1,11,20,80
18322,PHO,2015,Earl Barron,33,16,1,143,12,39,.308,2,4,.500,10,35,.286,.333,6,12,.500,14,14,28,5,4,2,5,26,32
18323,PHO,2015,Shavlik Randolph,31,16,0,101,6,25,.240,0,4,.000,6,21,.286,.240,5,10,.500,12,14,26,3,4,2,2,13,17
18324,PHO,2015,Marcus Thornton,27,9,0,81,13,40,.325,2,19,.105,11,21,.524,.350,4,5,.800,4,9,13,2,6,0,5,3,32
18325,PHO,2015,Reggie Bullock,23,11,0,75,1,16,.063,0,7,.000,1,9,.111,.063,2,4,.500,1,9,10,2,1,2,2,2,4
18326,PHO,2015,Tyler Ennis,20,8,0,58,9,21,.429,2,6,.333,7,15,.467,.476,2,2,1.000,1,6,7,14,0,2,8,3,22
18327,PHO,2015,A.J. Price,28,5,0,44,3,14,.214,0,7,.000,3,7,.429,.214,0,0,,0,3,3,6,0,0,1,5,6
18328,PHO,2015,Jerel McNeal,27,6,0,36,3,11,.273,1,2,.500,2,9,.222,.318,2,2,1.000,0,3,3,2,3,1,5,5,9
18329,PHO,2015,Zoran Dragić,25,6,0,13,2,8,.250,0,5,.000,2,3,.667,.250,2,3,.667,2,1,3,1,0,0,0,1,6
18330,PHO,2015,Seth Curry,24,2,0,8,0,3,.000,0,1,.000,0,2,.000,.000,0,0,,0,2,2,1,0,0,0,2,0
18331,PHO,2014,Goran Dragić,27,76,75,2668,552,1093,.505,122,299,.408,430,794,.542,.561,316,416,.760,69,176,245,447,104,22,213,206,1542
18332,PHO,2014,P.J. Tucker,28,81,81,2490,265,615,.431,74,191,.387,191,424,.450,.491,156,201,.776,161,368,529,141,110,23,102,204,760
18333,PHO,2014,Gerald Green,28,82,48,2330,448,1006,.445,204,510,.400,244,496,.492,.547,195,230,.848,48,227,275,122,70,42,145,220,1295
18334,PHO,2014,Channing Frye,30,82,82,2312,336,778,.432,160,432,.370,176,346,.509,.535,78,95,.821,73,343,416,98,60,63,89,245,910
18335,PHO,2014,Markieff Morris,24,81,0,2153,411,845,.486,34,108,.315,377,737,.512,.507,259,327,.792,139,346,485,144,68,51,147,232,1115
18336,PHO,2014,Miles Plumlee,25,80,79,1964,286,553,.517,0,0,,286,553,.517,.517,74,132,.561,198,428,626,43,50,90,111,185,646
18337,PHO,2014,Marcus Morris,24,82,1,1800,288,651,.442,99,260,.381,189,391,.483,.518,121,159,.761,84,235,319,88,72,18,95,157,796
18338,PHO,2014,Eric Bledsoe,24,43,40,1416,265,556,.477,50,140,.357,215,416,.517,.522,183,237,.772,27,175,202,235,69,14,143,99,763
18339,PHO,2014,Ish Smith,25,70,1,1006,119,281,.423,1,23,.043,118,258,.457,.425,22,39,.564,31,98,129,179,49,13,65,66,261
18340,PHO,2014,Archie Goodwin,19,52,0,533,76,167,.455,5,36,.139,71,131,.542,.470,37,55,.673,25,62,87,20,20,11,44,45,194
18341,PHO,2014,Leandro Barbosa,31,20,0,368,56,131,.427,7,25,.280,49,106,.462,.454,31,39,.795,5,32,37,32,7,4,19,30,150
18342,PHO,2014,Alex Len,20,42,3,362,33,78,.423,0,0,,33,78,.423,.423,20,31,.645,39,60,99,4,4,18,26,68,86
18343,PHO,2014,Dionte Christmas,27,31,0,198,22,62,.355,9,31,.290,13,31,.419,.427,18,24,.750,13,25,38,8,2,3,6,19,71
18344,PHO,2014,Shavlik Randolph,30,14,0,95,7,14,.500,0,0,,7,14,.500,.500,6,11,.545,7,18,25,1,3,1,5,15,20
18345,PHO,2014,Viacheslav Kravtsov,26,20,0,59,8,15,.533,0,0,,8,15,.533,.533,4,8,.500,9,8,17,1,0,1,6,7,20
18346,PHO,2013,Goran Dragić,26,77,77,2581,401,906,.443,88,276,.319,313,630,.497,.491,244,326,.748,60,178,238,569,124,26,212,214,1134
18347,PHO,2013,Luis Scola,32,82,67,2184,432,915,.472,3,16,.188,429,899,.477,.474,181,230,.787,158,383,541,182,67,35,126,257,1048
18348,PHO,2013,Jared Dudley,27,79,50,2170,313,669,.468,106,271,.391,207,398,.520,.547,129,162,.796,79,166,245,203,75,8,101,128,861
18349,PHO,2013,P.J. Tucker,27,79,45,1910,210,444,.473,22,70,.314,188,374,.503,.498,64,86,.744,132,218,350,109,62,19,67,145,506
18350,PHO,2013,Marcin Gortat,28,61,61,1876,295,566,.521,0,3,.000,295,563,.524,.521,90,138,.652,128,388,516,75,40,98,99,127,680
18351,PHO,2013,Markieff Morris,23,82,32,1837,266,653,.407,45,134,.336,221,519,.426,.442,93,127,.732,131,265,396,108,77,64,104,209,670
18352,PHO,2013,Michael Beasley,24,75,20,1554,310,766,.405,45,144,.313,265,622,.426,.434,94,126,.746,52,230,282,111,31,34,144,107,759
18353,PHO,2013,Shannon Brown,27,59,22,1402,240,571,.420,39,141,.277,201,430,.467,.454,98,125,.784,44,105,149,108,59,15,74,92,617
18354,PHO,2013,Jermaine O'Neal,34,55,4,1029,179,371,.482,0,0,,179,371,.482,.482,96,115,.835,82,211,293,42,19,78,73,126,454
18355,PHO,2013,Wesley Johnson,25,50,21,953,161,396,.407,50,155,.323,111,241,.461,.470,27,35,.771,21,102,123,34,22,18,48,56,399
18356,PHO,2013,Sebastian Telfair,27,46,2,795,94,247,.381,43,113,.381,51,134,.381,.468,44,57,.772,12,56,68,114,28,10,53,84,275
18357,PHO,2013,Kendall Marshall,21,48,3,702,56,151,.371,23,73,.315,33,78,.423,.447,8,14,.571,4,38,42,143,22,4,57,48,143
18358,PHO,2013,Marcus Morris,23,23,6,370,51,126,.405,12,39,.308,39,87,.448,.452,17,42,.405,17,41,58,15,18,4,24,40,131
18359,PHO,2013,Hamed Haddadi,27,17,0,235,28,61,.459,0,0,,28,61,.459,.459,13,25,.520,33,54,87,8,5,21,27,45,69
18360,PHO,2013,Diante Garrett,24,19,0,149,16,49,.327,3,15,.200,13,34,.382,.357,5,10,.500,5,10,15,31,10,0,16,5,40
18361,PHO,2013,Luke Zeller,25,16,0,58,9,26,.346,1,5,.200,8,21,.381,.365,0,0,,1,9,10,3,0,0,0,5,19
18362,PHO,2012,Marcin Gortat,27,66,66,2114,427,769,.555,0,2,.000,427,767,.557,.555,163,251,.649,185,474,659,59,48,99,90,142,1017
18363,PHO,2012,Jared Dudley,26,65,60,2020,312,643,.485,80,209,.383,232,434,.535,.547,119,164,.726,95,206,301,112,49,19,72,107,823
18364,PHO,2012,Steve Nash,37,62,62,1961,295,555,.532,55,141,.390,240,414,.580,.581,127,142,.894,26,160,186,664,38,8,229,53,772
18365,PHO,2012,Channing Frye,28,64,59,1669,255,613,.416,91,263,.346,164,350,.469,.490,73,82,.890,71,308,379,88,42,70,63,176,674
18366,PHO,2012,Shannon Brown,26,59,19,1400,251,598,.420,68,188,.362,183,410,.446,.477,80,99,.808,38,119,157,69,44,15,64,66,650
18367,PHO,2012,Grant Hill,39,49,46,1378,201,451,.446,14,53,.264,187,398,.470,.461,83,109,.761,29,142,171,107,41,29,65,88,499
18368,PHO,2012,Markieff Morris,22,63,7,1227,174,436,.399,43,124,.347,131,312,.420,.448,76,106,.717,69,210,279,65,41,42,70,179,467
18369,PHO,2012,Robin Lopez,23,64,0,895,124,269,.461,0,0,,124,269,.461,.461,100,140,.714,90,119,209,20,18,60,43,128,348
18370,PHO,2012,Sebastian Telfair,26,60,1,895,141,342,.412,33,105,.314,108,237,.456,.461,53,67,.791,20,71,91,138,41,12,68,120,368
18371,PHO,2012,Michael Redd,32,51,2,770,144,360,.400,42,132,.318,102,228,.447,.458,88,111,.793,14,63,77,33,13,0,37,29,418
18372,PHO,2012,Ronnie Price,28,36,8,517,49,130,.377,13,44,.295,36,86,.419,.427,20,25,.800,18,38,56,67,34,3,46,72,131
18373,PHO,2012,Hakim Warrick,29,35,0,503,74,180,.411,1,10,.100,73,170,.429,.414,76,99,.768,31,61,92,30,8,3,36,35,225
18374,PHO,2012,Josh Childress,28,34,0,491,48,99,.485,4,24,.167,44,75,.587,.505,0,2,.000,31,64,95,34,14,6,9,38,100
18375,PHO,2011,Channing Frye,27,77,64,2541,358,829,.432,171,439,.390,187,390,.479,.535,89,107,.832,65,448,513,96,46,79,73,272,976
18376,PHO,2011,Steve Nash,36,75,75,2497,399,811,.492,81,205,.395,318,606,.525,.542,227,249,.912,40,220,260,855,48,4,265,87,1106
18377,PHO,2011,Grant Hill,38,80,80,2409,399,825,.484,45,114,.395,354,711,.498,.511,213,257,.829,77,261,338,200,64,35,134,184,1056
18378,PHO,2011,Jared Dudley,25,82,15,2140,300,629,.477,105,253,.415,195,376,.519,.560,162,218,.743,111,207,318,108,87,20,77,139,867
18379,PHO,2011,Marcin Gortat,26,55,12,1636,294,522,.563,1,4,.250,293,518,.566,.564,128,175,.731,110,403,513,53,29,70,64,136,717
18380,PHO,2011,Hakim Warrick,28,80,6,1416,228,446,.511,1,11,.091,227,435,.522,.512,212,294,.721,88,208,296,69,32,9,79,100,669
18381,PHO,2011,Vince Carter,34,51,41,1387,264,625,.422,89,243,.366,175,382,.458,.494,72,98,.735,43,142,185,82,47,17,54,123,689
18382,PHO,2011,Robin Lopez,22,67,56,991,179,357,.501,0,0,,179,357,.501,.501,74,100,.740,82,134,216,8,18,45,48,143,432
18383,PHO,2011,Josh Childress,27,54,3,894,121,214,.565,1,16,.063,120,198,.606,.568,29,59,.492,69,86,155,42,33,23,44,68,272
18384,PHO,2011,Goran Dragić,24,48,2,856,133,316,.421,28,101,.277,105,215,.488,.465,59,97,.608,24,62,86,149,36,6,96,90,353
18385,PHO,2011,Jason Richardson,30,25,25,796,183,389,.470,62,148,.419,121,241,.502,.550,55,72,.764,33,78,111,36,27,3,30,46,483
18386,PHO,2011,Mickaël Piétrus,28,38,4,689,98,250,.392,51,149,.342,47,101,.465,.494,36,51,.706,9,67,76,23,19,18,25,66,283
18387,PHO,2011,Hedo Türkoğlu,31,25,16,630,85,193,.440,41,97,.423,44,96,.458,.547,26,36,.722,20,80,100,58,18,14,31,77,237
18388,PHO,2011,Aaron Brooks,26,25,5,473,86,200,.430,22,67,.328,64,133,.481,.485,46,57,.807,9,18,27,104,13,1,44,46,240
18389,PHO,2011,Zabian Dowdell,26,24,0,292,51,125,.408,3,10,.300,48,115,.417,.420,16,17,.941,5,15,20,51,20,2,29,30,121
18390,PHO,2011,Earl Barron,29,12,6,183,12,51,.235,0,0,,12,51,.235,.235,12,20,.600,16,24,40,4,6,4,11,32,36
18391,PHO,2011,Garret Siler,24,21,0,101,17,31,.548,0,0,,17,31,.548,.548,11,22,.500,16,12,28,3,1,4,10,20,45
18392,PHO,2011,Earl Clark,23,9,0,72,12,31,.387,0,0,,12,31,.387,.387,5,10,.500,4,13,17,4,1,3,2,6,29
18393,PHO,2011,Gani Lawal,22,1,0,2,0,0,,0,0,,0,0,,,0,0,,0,0,0,0,0,0,0,1,0
18394,PHO,2010,Amar'e Stoudemire,27,82,82,2838,704,1264,.557,1,6,.167,703,1258,.559,.557,487,632,.771,230,502,732,82,52,83,213,281,1896
18395,PHO,2010,Steve Nash,35,81,81,2660,499,985,.507,124,291,.426,375,694,.540,.570,211,225,.938,34,234,268,892,42,12,295,108,1333
18396,PHO,2010,Jason Richardson,29,79,76,2485,473,998,.474,157,400,.393,316,598,.528,.553,136,184,.739,81,323,404,143,66,33,92,169,1239
18397,PHO,2010,Grant Hill,37,81,81,2430,336,703,.478,35,80,.438,301,623,.483,.503,205,251,.817,74,371,445,193,60,36,108,165,912
18398,PHO,2010,Channing Frye,26,81,41,2190,317,703,.451,172,392,.439,145,311,.466,.573,98,121,.810,66,361,427,113,64,74,73,263,904
18399,PHO,2010,Jared Dudley,24,82,1,1991,225,490,.459,120,262,.458,105,228,.461,.582,104,138,.754,99,182,281,115,81,16,68,162,674
18400,PHO,2010,Goran Dragić,23,80,2,1442,222,491,.452,74,188,.394,148,303,.488,.527,117,159,.736,38,133,171,241,48,8,126,131,635
18401,PHO,2010,Lou Amundson,27,79,0,1168,152,276,.551,0,1,.000,152,275,.553,.551,67,123,.545,128,218,346,31,24,73,57,169,371
18402,PHO,2010,Robin Lopez,21,51,31,986,171,291,.588,0,0,,171,291,.588,.588,88,125,.704,104,144,248,7,10,53,41,117,430
18403,PHO,2010,Leandro Barbosa,27,44,5,786,155,365,.425,44,136,.324,111,229,.485,.485,64,73,.877,11,58,69,64,23,12,46,71,418
18404,PHO,2010,Earl Clark,22,51,0,383,56,151,.371,2,5,.400,54,146,.370,.377,26,36,.722,18,44,62,21,7,13,23,25,140
18405,PHO,2010,Jarron Collins,31,34,10,261,12,31,.387,0,0,,12,31,.387,.387,10,25,.400,22,40,62,6,2,3,10,42,34
18406,PHO,2010,Alando Tucker,25,11,0,71,13,30,.433,1,7,.143,12,23,.522,.450,16,21,.762,5,2,7,3,0,0,4,5,43
18407,PHO,2010,Taylor Griffin,23,8,0,32,4,10,.400,0,2,.000,4,8,.500,.400,2,4,.500,0,2,2,1,0,2,1,4,10
18408,PHO,2010,Dwayne Jones,26,2,0,7,0,0,,0,0,,0,0,,,0,0,,0,2,2,0,0,0,0,1,0
18409,PHO,2009,Steve Nash,34,74,74,2484,428,851,.503,108,246,.439,320,605,.529,.566,196,210,.933,19,204,223,717,55,10,248,108,1160
18410,PHO,2009,Grant Hill,36,82,68,2445,390,745,.523,24,76,.316,366,669,.547,.540,181,224,.808,64,341,405,186,90,54,126,182,985
18411,PHO,2009,Shaquille O'Neal,36,75,75,2252,512,841,.609,0,1,.000,512,840,.610,.609,309,519,.595,187,446,633,126,49,108,168,253,1333
18412,PHO,2009,Matt Barnes,28,77,40,2082,285,674,.423,117,341,.343,168,333,.505,.510,101,136,.743,79,342,421,212,52,26,130,209,788
18413,PHO,2009,Amar'e Stoudemire,26,53,53,1948,404,749,.539,3,7,.429,401,742,.540,.541,323,387,.835,116,314,430,104,49,57,150,163,1134
18414,PHO,2009,Jason Richardson,28,58,57,1919,368,754,.488,102,266,.383,266,488,.545,.556,112,144,.778,64,197,261,110,62,25,71,103,950
18415,PHO,2009,Leandro Barbosa,26,70,11,1705,366,759,.482,90,240,.375,276,519,.532,.542,171,194,.881,34,147,181,162,82,7,93,115,993
18416,PHO,2009,Lou Amundson,26,76,0,1044,134,250,.536,0,1,.000,134,249,.538,.536,53,120,.442,128,142,270,28,32,65,56,154,321
18417,PHO,2009,Goran Dragić,22,55,1,728,88,224,.393,20,54,.370,68,170,.400,.438,50,65,.769,33,70,103,111,29,3,73,87,246
18418,PHO,2009,Jared Dudley,23,48,0,728,91,189,.481,26,66,.394,65,123,.528,.550,56,81,.691,57,89,146,37,39,6,33,65,264
18419,PHO,2009,Raja Bell,32,22,22,712,76,177,.429,44,94,.468,32,83,.386,.554,16,21,.762,8,56,64,29,13,2,18,57,212
18420,PHO,2009,Robin Lopez,20,60,7,614,71,137,.518,0,1,.000,71,136,.522,.518,47,68,.691,52,66,118,8,11,41,28,97,189
18421,PHO,2009,Boris Diaw,26,22,0,538,80,141,.567,5,14,.357,75,127,.591,.585,18,26,.692,24,60,84,46,11,9,37,39,183
18422,PHO,2009,Alando Tucker,24,30,1,282,52,121,.430,8,23,.348,44,98,.449,.463,26,33,.788,19,12,31,12,5,1,14,14,138
18423,PHO,2009,Sean Singletary,23,13,1,122,12,37,.324,4,10,.400,8,27,.296,.378,6,6,1.000,5,11,16,12,6,0,5,14,34
18424,PHO,2009,Stromile Swift,29,13,0,121,15,41,.366,1,1,1.000,14,40,.350,.378,8,15,.533,11,22,33,2,4,6,9,25,39
18425,PHO,2009,Dee Brown,24,2,0,28,1,5,.200,1,4,.250,0,1,.000,.300,2,2,1.000,0,1,1,3,0,0,3,6,5
18426,PHO,2009,Courtney Sims,25,1,0,2,0,0,,0,0,,0,0,,,0,0,,0,0,0,0,0,0,1,0,0
18427,PHO,2008,Steve Nash,33,81,81,2780,485,962,.504,179,381,.470,306,581,.527,.597,222,245,.906,28,254,282,898,53,5,295,113,1371
18428,PHO,2008,Amar'e Stoudemire,25,79,79,2677,714,1211,.590,5,31,.161,709,1180,.601,.592,556,691,.805,178,541,719,118,64,163,174,294,1989
18429,PHO,2008,Raja Bell,31,75,75,2646,317,753,.421,176,439,.401,141,314,.449,.538,79,91,.868,47,227,274,168,54,27,65,220,889
18430,PHO,2008,Leandro Barbosa,25,82,12,2421,472,1021,.462,164,422,.389,308,599,.514,.543,175,213,.822,40,191,231,216,75,18,117,195,1283
18431,PHO,2008,Boris Diaw,25,82,19,2308,308,646,.477,13,41,.317,295,605,.488,.487,96,129,.744,97,281,378,317,61,39,155,166,725
18432,PHO,2008,Grant Hill,35,70,68,2222,358,712,.503,33,104,.317,325,608,.535,.526,170,196,.867,74,279,353,203,65,56,96,153,919
18433,PHO,2008,Shawn Marion,29,47,47,1713,304,578,.526,58,167,.347,246,411,.599,.576,77,108,.713,86,378,464,98,95,70,49,117,743
18434,PHO,2008,Brian Skinner,31,66,0,844,92,198,.465,2,3,.667,90,195,.462,.470,33,63,.524,63,175,238,15,21,77,39,112,219
18435,PHO,2008,Shaquille O'Neal,35,28,28,803,140,229,.611,0,0,,140,229,.611,.611,82,160,.513,67,229,296,48,13,34,83,94,362
18436,PHO,2008,Gordan Giriček,30,22,0,442,79,159,.497,19,50,.380,60,109,.550,.557,16,17,.941,9,42,51,35,8,2,23,49,193
18437,PHO,2008,Marcus Banks,26,24,1,310,44,109,.404,25,65,.385,19,44,.432,.518,12,16,.750,3,17,20,25,8,8,16,38,125
18438,PHO,2008,D.J. Strawberry,22,33,0,270,29,92,.315,6,25,.240,23,67,.343,.348,9,19,.474,9,19,28,30,12,6,11,36,73
18439,PHO,2008,Sean Marks,32,19,0,130,23,43,.535,1,4,.250,22,39,.564,.547,12,19,.632,9,27,36,4,3,10,8,23,59
18440,PHO,2008,Eric Piatkowski,37,16,0,113,12,33,.364,11,26,.423,1,7,.143,.530,4,4,1.000,1,11,12,10,0,1,6,11,39
18441,PHO,2008,Linton Johnson,27,6,0,53,7,14,.500,1,2,.500,6,12,.500,.536,0,0,,5,8,13,3,0,1,2,10,15
18442,PHO,2008,Alando Tucker,23,6,0,48,8,22,.364,1,4,.250,7,18,.389,.386,5,6,.833,4,4,8,0,0,1,0,2,22
18443,PHO,2007,Shawn Marion,28,80,80,3010,561,1071,.524,80,252,.317,481,819,.587,.561,201,248,.810,172,613,785,134,156,122,114,216,1403
18444,PHO,2007,Raja Bell,30,78,78,2917,410,950,.432,205,496,.413,205,454,.452,.539,118,152,.776,48,203,251,196,50,22,83,233,1143
18445,PHO,2007,Amar'e Stoudemire,24,82,78,2689,607,1055,.575,0,3,.000,607,1052,.577,.575,457,585,.781,222,564,786,84,78,110,232,295,1671
18446,PHO,2007,Steve Nash,32,76,76,2682,517,971,.532,156,343,.455,361,628,.575,.613,222,247,.899,30,239,269,884,57,6,287,117,1412
18447,PHO,2007,Leandro Barbosa,24,80,18,2613,529,1111,.476,190,438,.434,339,673,.504,.562,196,232,.845,22,192,214,317,96,15,146,210,1444
18448,PHO,2007,Boris Diaw,24,73,59,2268,306,569,.538,15,45,.333,291,524,.555,.551,82,120,.683,91,226,317,352,28,38,154,177,709
18449,PHO,2007,James Jones,26,76,7,1376,162,440,.368,90,238,.378,72,202,.356,.470,71,81,.877,33,143,176,45,28,42,28,115,485
18450,PHO,2007,Kurt Thomas,34,67,13,1208,126,259,.486,0,1,.000,126,258,.488,.486,56,71,.789,86,293,379,24,24,29,35,156,308
18451,PHO,2007,Marcus Banks,25,45,1,503,84,196,.429,5,29,.172,79,167,.473,.441,48,60,.800,10,28,38,60,23,3,40,70,221
18452,PHO,2007,Jalen Rose,34,29,0,246,38,86,.442,21,47,.447,17,39,.436,.564,11,12,.917,3,20,23,16,5,2,9,22,108
18453,PHO,2007,Pat Burke,33,23,0,164,23,65,.354,6,22,.273,17,43,.395,.400,8,13,.615,12,35,47,5,3,2,7,19,60
18454,PHO,2007,Jumaine Jones,27,18,0,138,14,51,.275,10,32,.313,4,19,.211,.373,2,2,1.000,6,17,23,1,5,1,7,19,40
18455,PHO,2007,Eric Piatkowski,36,11,0,73,9,25,.360,7,18,.389,2,7,.286,.500,2,2,1.000,2,7,9,4,0,1,5,6,27
18456,PHO,2007,Sean Marks,31,3,0,17,2,6,.333,0,1,.000,2,5,.400,.333,2,2,1.000,0,3,3,0,0,1,0,4,6
18457,PHO,2006,Shawn Marion,27,81,81,3263,716,1365,.525,96,290,.331,620,1075,.577,.560,241,298,.809,249,710,959,143,160,137,125,223,1769
18458,PHO,2006,Raja Bell,29,79,79,2959,425,930,.457,197,446,.442,228,484,.471,.563,115,146,.788,44,209,253,207,76,22,89,248,1162
18459,PHO,2006,Boris Diaw,23,81,70,2874,449,853,.526,8,30,.267,441,823,.536,.531,174,238,.731,159,399,558,503,58,85,189,260,1080
18460,PHO,2006,Steve Nash,31,79,79,2796,541,1056,.512,150,342,.439,391,714,.548,.583,257,279,.921,47,286,333,826,61,12,276,120,1489
18461,PHO,2006,James Jones,25,75,24,1772,243,581,.418,110,285,.386,133,296,.449,.513,103,121,.851,44,209,253,57,38,49,35,142,699
18462,PHO,2006,Leandro Barbosa,23,57,11,1592,273,567,.481,87,196,.444,186,371,.501,.558,111,147,.755,31,119,150,158,48,6,89,145,744
18463,PHO,2006,Eddie House,27,81,0,1421,320,759,.422,123,316,.389,197,443,.445,.503,33,41,.805,15,117,132,148,42,12,76,96,796
18464,PHO,2006,Kurt Thomas,33,53,50,1411,190,391,.486,0,0,,190,391,.486,.486,75,92,.815,102,313,415,57,23,54,57,193,455
18465,PHO,2006,Tim Thomas,28,26,10,634,107,246,.435,45,105,.429,62,141,.440,.526,28,42,.667,22,105,127,18,16,6,32,77,287
18466,PHO,2006,Jim Jackson,35,27,1,420,38,129,.295,14,63,.222,24,66,.364,.349,9,13,.692,11,53,64,31,10,6,30,46,99
18467,PHO,2006,Pat Burke,32,42,0,346,63,127,.496,2,7,.286,61,120,.508,.504,13,21,.619,21,52,73,16,6,13,33,62,141
18468,PHO,2006,Brian Grant,33,21,2,248,27,65,.415,0,0,,27,65,.415,.415,7,8,.875,11,46,57,7,5,3,7,45,61
18469,PHO,2006,Nikoloz Tskitishvili,22,12,0,86,12,33,.364,1,3,.333,11,30,.367,.379,8,12,.667,9,11,20,3,1,2,4,8,33
18470,PHO,2006,Amar'e Stoudemire,23,3,3,50,9,27,.333,0,1,.000,9,26,.346,.333,8,9,.889,6,10,16,2,1,3,1,4,26
18471,PHO,2006,Dijon Thompson,22,10,0,43,11,25,.440,4,11,.364,7,14,.500,.520,2,2,1.000,4,7,11,1,3,1,2,6,28
18472,PHO,2006,Andre Barrett,23,2,0,21,3,7,.429,0,1,.000,3,6,.500,.429,3,3,1.000,1,2,3,2,0,0,1,1,9
18473,PHO,2006,Sharrod Ford,24,3,0,13,2,3,.667,0,0,,2,3,.667,.667,0,0,,1,2,3,0,0,1,2,7,4
18474,PHO,2006,Josh Davis,25,1,0,5,1,3,.333,0,1,.000,1,2,.500,.333,2,3,.667,1,0,1,0,1,0,0,0,4
18475,PHO,2005,Joe Johnson,23,82,82,3240,544,1179,.461,177,370,.478,367,809,.454,.536,135,180,.750,120,302,422,291,79,24,148,167,1400
18476,PHO,2005,Shawn Marion,26,81,81,3146,613,1289,.476,114,341,.334,499,948,.526,.520,229,275,.833,235,680,915,154,163,119,125,199,1569
18477,PHO,2005,Amar'e Stoudemire,22,80,80,2889,747,1336,.559,3,16,.188,744,1320,.564,.560,583,795,.733,219,494,713,131,77,130,189,278,2080
18478,PHO,2005,Quentin Richardson,24,79,78,2839,407,1045,.389,226,631,.358,181,414,.437,.498,136,184,.739,91,388,479,158,96,27,102,197,1176
18479,PHO,2005,Steve Nash,30,75,75,2573,430,857,.502,94,218,.431,336,639,.526,.557,211,238,.887,57,192,249,861,74,6,245,136,1165
18480,PHO,2005,Leandro Barbosa,22,63,6,1087,168,354,.475,51,139,.367,117,215,.544,.547,55,69,.797,32,98,130,126,30,7,87,127,442
18481,PHO,2005,Steven Hunter,23,76,3,1046,135,220,.614,0,1,.000,135,219,.616,.614,78,163,.479,98,129,227,13,4,102,44,131,348
18482,PHO,2005,Jim Jackson,34,40,3,997,130,299,.435,68,148,.459,62,151,.411,.548,24,25,.960,23,131,154,97,12,4,59,86,352
18483,PHO,2005,Casey Jacobsen,23,40,0,768,65,157,.414,34,89,.382,31,68,.456,.522,48,62,.774,17,50,67,37,11,1,27,56,212
18484,PHO,2005,Jake Voskuhl,27,38,1,360,27,59,.458,0,0,,27,59,.458,.458,26,38,.684,30,62,92,17,4,11,20,60,80
18485,PHO,2005,Walter McCarty,30,28,0,353,33,85,.388,25,65,.385,8,20,.400,.535,7,14,.500,8,53,61,11,10,6,19,59,98
18486,PHO,2005,Bo Outlaw,33,39,0,214,12,34,.353,0,0,,12,34,.353,.353,5,9,.556,16,37,53,13,6,12,8,29,29
18487,PHO,2005,Maciej Lampe,19,16,0,119,17,49,.347,2,3,.667,15,46,.326,.367,8,12,.667,9,23,32,1,1,2,10,20,44
18488,PHO,2005,Jackson Vroman,23,10,1,57,6,16,.375,0,0,,6,16,.375,.375,4,7,.571,5,8,13,7,3,2,7,11,16
18489,PHO,2005,Smush Parker,23,5,0,34,7,15,.467,1,4,.250,6,11,.545,.500,0,0,,2,1,3,4,2,0,9,3,15
18490,PHO,2005,Paul Shirley,27,9,0,30,5,11,.455,0,0,,5,11,.455,.455,2,4,.500,1,1,2,3,0,0,1,3,12
18491,PHO,2005,Yuta Tabuse,24,4,0,17,1,6,.167,1,1,1.000,0,5,.000,.250,4,4,1.000,2,2,4,3,0,0,1,1,7
18492,PHO,2005,Žarko Čabarkapa,23,3,0,11,4,7,.571,0,0,,4,7,.571,.571,1,1,1.000,2,1,3,0,0,0,0,0,9
18493,PHO,2004,Joe Johnson,22,82,77,3331,555,1291,.430,83,272,.305,472,1019,.463,.462,174,232,.750,80,305,385,362,93,26,199,177,1367
18494,PHO,2004,Shawn Marion,25,79,79,3217,590,1341,.440,90,265,.340,500,1076,.465,.474,228,268,.851,212,525,737,214,167,104,156,203,1498
18495,PHO,2004,Amar'e Stoudemire,21,55,53,2025,411,865,.475,1,5,.200,410,860,.477,.476,310,435,.713,157,339,496,78,64,89,177,188,1133
18496,PHO,2004,Casey Jacobsen,22,78,13,1828,150,360,.417,75,180,.417,75,180,.417,.521,91,111,.820,42,159,201,98,48,9,68,144,466
18497,PHO,2004,Jake Voskuhl,26,66,43,1606,152,300,.507,0,0,,152,300,.507,.507,134,181,.740,123,220,343,57,42,25,77,258,438
18498,PHO,2004,Leandro Barbosa,21,70,46,1500,210,470,.447,83,210,.395,127,260,.488,.535,47,61,.770,23,100,123,165,93,7,120,184,550
18499,PHO,2004,Stephon Marbury,26,34,34,1415,262,606,.432,37,118,.314,225,488,.461,.463,147,185,.795,19,98,117,281,64,5,97,74,708
18500,PHO,2004,Anfernee Hardaway,32,34,10,876,120,271,.443,14,35,.400,106,236,.449,.469,42,49,.857,27,71,98,97,28,8,42,65,296
18501,PHO,2004,Jahidi White,27,61,17,861,99,189,.524,0,0,,99,189,.524,.524,63,126,.500,97,164,261,7,25,50,65,176,261
18502,PHO,2004,Howard Eisley,31,34,0,727,86,249,.345,24,78,.308,62,171,.363,.394,44,53,.830,13,50,63,117,26,2,48,52,240
18503,PHO,2004,Žarko Čabarkapa,22,49,4,570,81,197,.411,6,32,.188,75,165,.455,.426,35,53,.660,26,73,99,40,10,13,54,75,203
18504,PHO,2004,Antonio McDyess,29,24,14,506,61,126,.484,0,0,,61,126,.484,.484,16,31,.516,39,99,138,16,25,13,30,71,138
18505,PHO,2004,Donnell Harvey,23,36,7,438,53,112,.473,0,0,,53,112,.473,.473,35,44,.795,19,73,92,13,14,16,23,85,141
18506,PHO,2004,Tom Gugliotta,34,30,3,304,31,99,.313,0,1,.000,31,98,.316,.313,6,8,.750,15,41,56,21,14,4,20,34,68
18507,PHO,2004,Scott Williams,35,16,10,267,53,101,.525,2,2,1.000,51,99,.515,.535,9,13,.692,23,49,72,6,15,7,6,45,117
18508,PHO,2004,Maciej Lampe,18,21,0,224,43,88,.489,0,4,.000,43,84,.512,.489,10,13,.769,9,35,44,9,3,3,15,28,96
18509,PHO,2004,Brevin Knight,28,3,0,19,1,3,.333,0,0,,1,3,.333,.333,0,0,,0,3,3,4,3,1,3,1,2
18510,PHO,2004,Cezary Trybański,24,4,0,10,0,2,.000,0,0,,0,2,.000,.000,0,0,,0,1,1,0,0,1,2,1,0
18511,PHO,2004,Robert Archibald,23,1,0,6,0,1,.000,0,0,,0,1,.000,.000,1,2,.500,0,1,1,1,0,0,1,1,1
18512,PHO,2003,Shawn Marion,24,81,81,3373,662,1466,.452,141,364,.387,521,1102,.473,.500,251,295,.851,199,574,773,198,185,95,157,208,1716
18513,PHO,2003,Stephon Marbury,25,81,81,3240,671,1530,.439,89,296,.301,582,1234,.472,.468,375,467,.803,53,210,263,654,108,20,263,200,1806
18514,PHO,2003,Amar'e Stoudemire,20,82,71,2570,392,830,.472,2,10,.200,390,820,.476,.473,320,484,.661,250,471,721,78,62,87,189,269,1106
18515,PHO,2003,Joe Johnson,21,82,34,2255,316,796,.397,75,205,.366,241,591,.408,.444,96,124,.774,57,207,264,210,62,19,108,143,803
18516,PHO,2003,Bo Outlaw,31,80,20,1800,153,278,.550,0,2,.000,153,276,.554,.550,72,116,.621,134,234,368,112,50,71,76,194,378
18517,PHO,2003,Anfernee Hardaway,31,58,51,1777,256,573,.447,26,73,.356,230,500,.460,.469,77,97,.794,66,192,258,235,66,26,145,150,615
18518,PHO,2003,Casey Jacobsen,21,72,0,1147,122,327,.373,52,165,.315,70,162,.432,.453,72,105,.686,29,54,83,73,35,6,55,90,368
18519,PHO,2003,Jake Voskuhl,25,65,1,947,92,163,.564,0,0,,92,163,.564,.564,64,96,.667,97,128,225,36,18,29,48,172,248
18520,PHO,2003,Scott Williams,34,69,33,872,120,292,.411,0,2,.000,120,290,.414,.411,33,42,.786,72,121,193,22,27,21,32,159,273
18521,PHO,2003,Jake Tsakalidis,23,33,27,543,61,135,.452,0,0,,61,135,.452,.452,39,58,.672,45,77,122,13,6,17,26,80,161
18522,PHO,2003,Dan Langhi,25,60,0,541,81,202,.401,9,31,.290,72,171,.421,.423,12,20,.600,19,68,87,21,15,6,16,58,183
18523,PHO,2003,Tom Gugliotta,33,27,11,447,60,132,.455,0,1,.000,60,131,.458,.455,9,9,1.000,25,75,100,31,14,5,31,35,129
18524,PHO,2003,Randy Brown,34,32,0,262,16,43,.372,0,0,,16,43,.372,.372,9,12,.750,3,23,26,35,17,2,17,36,41
18525,PHO,2003,Alton Ford,21,11,0,31,3,9,.333,0,0,,3,9,.333,.333,1,3,.333,0,6,6,1,0,0,2,7,7
18526,PHO,2002,Stephon Marbury,24,82,80,3187,625,1413,.442,71,248,.286,554,1165,.476,.467,353,452,.781,75,191,266,666,77,13,284,186,1674
18527,PHO,2002,Shawn Marion,23,81,81,3109,654,1395,.469,48,122,.393,606,1273,.476,.486,191,226,.845,211,592,803,162,149,86,144,214,1547
18528,PHO,2002,Anfernee Hardaway,30,80,55,2462,389,931,.418,23,83,.277,366,848,.432,.430,158,195,.810,98,252,350,324,122,32,189,184,959
18529,PHO,2002,Bo Outlaw,30,73,36,1768,153,278,.550,1,2,.500,152,276,.551,.552,35,84,.417,132,203,335,122,61,83,85,182,342
18530,PHO,2002,Jake Tsakalidis,22,67,47,1582,190,400,.475,0,1,.000,190,399,.476,.475,111,159,.698,130,244,374,23,23,69,78,193,491
18531,PHO,2002,Rodney Rogers,30,50,7,1254,249,534,.466,49,140,.350,200,394,.508,.512,82,99,.828,95,146,241,72,50,17,66,148,629
18532,PHO,2002,Dan Majerle,36,65,1,1180,99,289,.343,79,235,.336,20,54,.370,.479,23,39,.590,28,148,176,90,48,15,35,104,300
18533,PHO,2002,Tom Gugliotta,32,44,40,1129,127,301,.422,3,9,.333,124,292,.425,.427,28,37,.757,59,162,221,77,39,30,61,116,285
18534,PHO,2002,Joe Johnson,20,29,27,913,121,288,.420,14,42,.333,107,246,.435,.444,21,27,.778,35,83,118,105,26,11,43,55,277
18535,PHO,2002,Jake Voskuhl,24,59,34,900,107,193,.554,0,0,,107,193,.554,.554,82,109,.752,103,147,250,18,11,23,48,139,296
18536,PHO,2002,Tony Delk,28,41,1,877,166,416,.399,47,147,.320,119,269,.442,.456,56,67,.836,38,86,124,81,31,4,40,60,435
18537,PHO,2002,John Wallace,27,46,0,490,93,214,.435,5,13,.385,88,201,.438,.446,40,46,.870,27,58,85,29,11,9,29,60,231
18538,PHO,2002,Alton Ford,20,53,0,452,61,118,.517,0,0,,61,118,.517,.517,42,57,.737,32,75,107,7,6,7,32,99,164
18539,PHO,2002,Milt Palacio,23,28,1,272,30,79,.380,1,7,.143,29,72,.403,.386,18,23,.783,3,20,23,29,9,1,16,23,79
18540,PHO,2002,Joe Crispin,22,15,0,129,23,56,.411,15,35,.429,8,21,.381,.545,8,8,1.000,2,8,10,24,4,0,9,8,69
18541,PHO,2002,Jud Buechler,33,6,0,54,2,6,.333,2,6,.333,0,0,,.500,0,0,,2,6,8,3,1,0,1,7,6
18542,PHO,2002,Charlie Bell,22,5,0,42,3,11,.273,0,6,.000,3,5,.600,.273,2,2,1.000,2,2,4,2,0,0,5,3,8
18543,PHO,2002,Daniel Santiago,25,3,0,24,4,8,.500,0,0,,4,8,.500,.500,0,0,,0,7,7,2,0,1,2,4,8
18544,PHO,2002,Vinny Del Negro,35,2,0,6,1,4,.250,0,0,,1,4,.250,.250,0,0,,0,0,0,2,0,0,0,0,2
18545,PHO,2001,Jason Kidd,27,77,76,3065,451,1097,.411,69,232,.297,382,865,.442,.443,328,403,.814,91,403,494,753,166,23,286,171,1299
18546,PHO,2001,Shawn Marion,22,79,79,2857,557,1160,.480,21,82,.256,536,1078,.497,.489,234,289,.810,220,628,848,160,132,108,129,211,1369
18547,PHO,2001,Clifford Robinson,34,82,82,2751,501,1186,.422,90,249,.361,411,937,.439,.460,253,357,.709,105,229,334,237,87,82,186,258,1345
18548,PHO,2001,Tony Delk,27,82,11,2288,383,923,.415,54,168,.321,329,755,.436,.444,185,235,.787,76,185,261,160,75,17,101,171,1005
18549,PHO,2001,Rodney Rogers,29,82,3,2183,377,876,.430,56,189,.296,321,687,.467,.462,188,247,.761,94,265,359,180,97,47,157,269,998
18550,PHO,2001,Mario Elie,37,68,67,1506,104,246,.423,36,100,.360,68,146,.466,.496,55,69,.797,38,117,155,131,58,12,60,112,299
18551,PHO,2001,Tom Gugliotta,31,57,2,1159,149,380,.392,3,12,.250,146,368,.397,.396,61,77,.792,76,179,255,55,47,21,51,110,362
18552,PHO,2001,Jake Tsakalidis,21,57,39,947,101,215,.470,0,0,,101,215,.470,.470,54,91,.593,83,159,242,19,10,55,66,137,256
18553,PHO,2001,Chris Dudley,35,53,33,613,29,73,.397,0,0,,29,73,.397,.397,14,36,.389,64,119,183,18,14,29,26,111,72
18554,PHO,2001,Daniel Santiago,24,54,2,581,64,134,.478,0,0,,64,134,.478,.478,42,61,.689,35,67,102,11,17,21,47,101,170
18555,PHO,2001,Vinny Del Negro,34,36,0,526,76,144,.528,0,4,.000,76,140,.543,.528,25,28,.893,8,43,51,64,20,3,19,42,177
18556,PHO,2001,Elliot Perry,31,43,6,460,60,129,.465,1,4,.250,59,125,.472,.469,16,22,.727,8,34,42,74,19,1,32,28,137
18557,PHO,2001,Corie Blount,32,30,6,387,23,47,.489,0,0,,23,47,.489,.489,8,15,.533,35,50,85,8,13,5,18,75,54
18558,PHO,2001,Paul McPherson,22,33,0,308,47,96,.490,0,6,.000,47,90,.522,.490,18,24,.750,20,28,48,16,12,3,23,48,112
18559,PHO,2001,Anfernee Hardaway,29,4,4,112,15,36,.417,2,8,.250,13,28,.464,.444,7,11,.636,5,13,18,15,6,1,3,6,39
18560,PHO,2001,Rubén Garcés,27,10,0,62,7,15,.467,0,0,,7,15,.467,.467,2,8,.250,12,10,22,4,2,1,5,14,16
18561,PHO,2000,Clifford Robinson,33,80,67,2839,530,1142,.464,120,324,.370,410,818,.501,.517,298,381,.782,105,254,359,224,90,61,166,239,1478
18562,PHO,2000,Jason Kidd,26,67,67,2616,350,855,.409,56,166,.337,294,689,.427,.442,203,245,.829,96,387,483,678,134,28,226,148,959
18563,PHO,2000,Rodney Rogers,28,82,7,2286,428,881,.486,115,262,.439,313,619,.506,.551,159,249,.639,138,309,447,170,94,47,163,290,1130
18564,PHO,2000,Anfernee Hardaway,28,60,60,2253,378,798,.474,33,102,.324,345,696,.496,.494,226,286,.790,91,256,347,315,94,38,153,164,1015
18565,PHO,2000,Tom Gugliotta,30,54,54,1767,310,645,.481,1,8,.125,309,637,.485,.481,117,151,.775,141,284,425,124,80,31,106,152,738
18566,PHO,2000,Luc Longley,31,72,68,1417,186,399,.466,0,0,,186,399,.466,.466,80,97,.825,100,223,323,77,22,42,136,221,452
18567,PHO,2000,Shawn Marion,21,51,38,1260,222,471,.471,4,22,.182,218,449,.486,.476,72,85,.847,105,227,332,69,38,53,51,113,520
18568,PHO,2000,Oliver Miller,29,51,9,1088,137,233,.588,0,0,,137,233,.588,.588,49,73,.671,87,174,261,68,42,80,74,132,323
18569,PHO,2000,Randy Livingston,24,79,15,1081,155,373,.416,19,55,.345,136,318,.428,.441,52,62,.839,25,105,130,170,49,13,92,129,381
18570,PHO,2000,Rex Chapman,32,53,19,957,124,320,.388,41,123,.333,83,197,.421,.452,59,78,.756,10,70,80,62,22,1,38,70,348
18571,PHO,2000,Todd Day,30,58,1,941,130,330,.394,64,165,.388,66,165,.400,.491,72,108,.667,31,98,129,65,44,22,50,127,396
18572,PHO,2000,Toby Bailey,24,46,2,449,58,140,.414,2,10,.200,56,130,.431,.421,45,65,.692,26,46,72,30,13,4,24,55,163
18573,PHO,2000,Corie Blount,31,38,1,446,44,89,.494,0,2,.000,44,87,.506,.494,19,33,.576,52,61,113,10,15,7,28,78,107
18574,PHO,2000,Don MacLean,30,16,0,143,18,49,.367,2,6,.333,16,43,.372,.388,4,6,.667,6,17,23,8,2,1,8,24,42
18575,PHO,2000,Mark West,39,22,2,127,5,12,.417,0,0,,5,12,.417,.417,5,8,.625,6,25,31,2,2,4,6,23,15
18576,PHO,2000,Kevin Johnson,33,6,0,113,16,28,.571,1,1,1.000,15,27,.556,.589,7,7,1.000,0,16,16,24,2,0,7,6,40
18577,PHO,2000,Ben Davis,27,5,0,22,2,6,.333,0,0,,2,6,.333,.333,0,0,,3,6,9,2,1,1,3,2,4
18578,PHO,1999,Jason Kidd,25,50,50,2060,310,698,.444,45,123,.366,265,575,.461,.476,181,239,.757,87,252,339,539,114,19,150,108,846
18579,PHO,1999,Clifford Robinson,32,50,35,1740,299,629,.475,58,139,.417,241,490,.492,.521,163,234,.697,69,158,227,128,75,59,88,153,819
18580,PHO,1999,Tom Gugliotta,29,43,43,1563,277,573,.483,2,7,.286,275,566,.486,.485,173,218,.794,131,250,381,121,59,21,88,110,729
18581,PHO,1999,George McCloud,31,48,16,1245,142,324,.438,69,166,.416,73,158,.462,.545,75,87,.862,34,128,162,79,45,14,49,128,428
18582,PHO,1999,Danny Manning,32,50,5,1184,187,386,.484,1,9,.111,186,377,.493,.486,78,112,.696,62,157,219,113,36,38,69,129,453
18583,PHO,1999,Rex Chapman,31,38,35,1183,165,459,.359,53,151,.351,112,308,.364,.417,76,91,.835,12,92,104,109,34,9,54,46,459
18584,PHO,1999,Luc Longley,30,39,39,933,140,290,.483,0,0,,140,290,.483,.483,59,76,.776,59,162,221,45,23,21,53,119,339
18585,PHO,1999,Pat Garrity,22,39,9,538,85,170,.500,7,18,.389,78,152,.513,.521,40,56,.714,26,49,75,18,8,3,20,62,217
18586,PHO,1999,Chris Morris,33,44,2,535,64,149,.430,16,56,.286,48,93,.516,.483,40,46,.870,54,67,121,23,16,11,21,54,184
18587,PHO,1999,Joe Kleine,37,31,5,374,30,74,.405,0,2,.000,30,72,.417,.405,8,12,.667,27,40,67,12,8,1,10,46,68
18588,PHO,1999,Toby Bailey,23,27,10,249,34,86,.395,1,5,.200,33,81,.407,.401,9,13,.692,24,30,54,13,9,2,11,24,78
18589,PHO,1999,Gerald Brown,23,33,0,236,33,89,.371,3,10,.300,30,79,.380,.388,11,14,.786,5,17,22,31,5,1,22,21,80
18590,PHO,1999,Shawn Respert,26,12,1,99,13,36,.361,4,13,.308,9,23,.391,.417,7,10,.700,2,11,13,8,5,0,5,10,37
18591,PHO,1999,Marko Milič,21,11,0,53,8,20,.400,0,1,.000,8,19,.421,.400,0,0,,3,2,5,2,3,1,6,7,16
18592,PHO,1999,Alvin Sims,24,4,0,25,4,10,.400,1,1,1.000,3,9,.333,.450,2,5,.400,3,1,4,5,2,0,6,2,11
18593,PHO,1999,Randy Livingston,23,1,0,22,5,8,.625,0,0,,5,8,.625,.625,2,2,1.000,0,2,2,3,2,0,1,1,12
18594,PHO,1999,Jimmy Oliver,29,2,0,11,1,3,.333,1,1,1.000,0,2,.000,.500,0,0,,0,0,0,0,0,0,0,2,3
18595,PHO,1998,Jason Kidd,24,82,82,3118,357,859,.416,73,233,.313,284,626,.454,.458,167,209,.799,108,402,510,745,162,26,261,142,954
18596,PHO,1998,Antonio McDyess,23,81,81,2441,497,927,.536,0,2,.000,497,925,.537,.536,231,329,.702,206,407,613,106,100,135,142,292,1225
18597,PHO,1998,Clifford Robinson,31,80,64,2359,429,895,.479,27,84,.321,402,811,.496,.494,248,360,.689,152,258,410,170,92,90,140,249,1133
18598,PHO,1998,Rex Chapman,30,68,67,2263,408,956,.427,120,311,.386,288,645,.447,.490,146,187,.781,30,143,173,203,71,14,116,102,1082
18599,PHO,1998,Danny Manning,31,70,11,1794,390,756,.516,0,7,.000,390,749,.521,.516,167,226,.739,110,282,392,139,71,46,100,201,947
18600,PHO,1998,Steve Nash,23,76,9,1664,268,584,.459,81,195,.415,187,389,.481,.528,74,86,.860,32,128,160,262,63,4,98,145,691
18601,PHO,1998,Hot Rod Williams,35,71,30,1333,95,202,.470,0,0,,95,202,.470,.470,65,93,.699,107,205,312,49,33,60,29,138,255
18602,PHO,1998,Kevin Johnson,31,50,12,1290,155,347,.447,4,26,.154,151,321,.470,.452,162,186,.871,35,129,164,245,27,8,101,57,476
18603,PHO,1998,George McCloud,30,63,13,1213,173,427,.405,71,208,.341,102,219,.466,.488,39,51,.765,45,173,218,84,54,13,63,132,456
18604,PHO,1998,Mark Bryant,32,70,22,1110,109,225,.484,0,1,.000,109,224,.487,.484,73,95,.768,92,152,244,46,36,15,58,180,291
18605,PHO,1998,Cedric Ceballos,28,35,16,626,129,258,.500,15,50,.300,114,208,.548,.529,60,84,.714,51,98,149,35,22,8,39,59,333
18606,PHO,1998,Dennis Scott,29,29,3,493,71,162,.438,31,69,.449,40,93,.430,.534,8,12,.667,8,42,50,24,10,7,12,31,181
18607,PHO,1998,Marko Milič,20,33,0,163,39,64,.609,3,6,.500,36,58,.621,.633,11,17,.647,10,15,25,12,10,0,21,17,92
18608,PHO,1998,Brooks Thompson,27,13,0,46,10,27,.370,5,16,.313,5,11,.455,.463,1,3,.333,1,4,5,3,4,0,5,6,26
18609,PHO,1998,Horacio Llamas,24,8,0,42,8,21,.381,1,3,.333,7,18,.389,.405,7,10,.700,4,14,18,1,1,3,9,14,24
18610,PHO,1997,Kevin Johnson,30,70,70,2658,441,890,.496,89,202,.441,352,688,.512,.546,439,515,.852,54,199,253,653,102,12,217,141,1410
18611,PHO,1997,Wesley Person,25,80,42,2326,409,903,.453,171,414,.413,238,489,.487,.548,91,114,.798,68,224,292,123,86,20,76,102,1080
18612,PHO,1997,Hot Rod Williams,34,68,66,2137,204,416,.490,0,2,.000,204,414,.493,.490,133,198,.672,178,384,562,100,67,88,66,176,541
18613,PHO,1997,Danny Manning,30,77,17,2134,426,795,.536,7,36,.194,419,759,.552,.540,181,251,.721,137,332,469,173,81,74,161,268,1040
18614,PHO,1997,Rex Chapman,29,65,33,1833,332,749,.443,110,314,.350,222,435,.510,.517,124,149,.832,25,156,181,182,52,7,96,108,898
18615,PHO,1997,Jason Kidd,23,33,23,1173,138,326,.423,40,100,.400,98,226,.434,.485,66,96,.688,34,125,159,296,79,12,76,72,382
18616,PHO,1997,Cedric Ceballos,27,42,32,1147,248,534,.464,21,81,.259,227,453,.501,.484,126,171,.737,91,186,277,49,28,17,68,94,643
18617,PHO,1997,Mark Bryant,31,41,18,1018,152,275,.553,0,0,,152,275,.553,.553,76,108,.704,67,145,212,47,22,5,46,136,380
18618,PHO,1997,Michael Finley,23,27,18,796,141,297,.475,14,55,.255,127,242,.525,.498,56,69,.812,34,86,120,68,18,4,44,42,352
18619,PHO,1997,Wayman Tisdale,32,53,15,778,158,371,.426,0,0,,158,371,.426,.426,30,48,.625,35,85,120,20,8,21,36,111,346
18620,PHO,1997,Robert Horry,26,32,15,719,82,195,.421,24,78,.308,58,117,.496,.482,32,50,.640,40,79,119,54,28,26,46,81,220
18621,PHO,1997,Steve Nash,22,65,2,684,74,175,.423,23,55,.418,51,120,.425,.489,42,51,.824,16,47,63,138,20,0,63,92,213
18622,PHO,1997,A.C. Green,33,27,19,548,61,128,.477,0,3,.000,61,125,.488,.477,31,48,.646,33,105,138,17,18,1,20,34,153
18623,PHO,1997,Sam Cassell,27,22,9,539,100,241,.415,19,62,.306,81,179,.453,.454,106,124,.855,12,38,50,99,23,6,60,66,325
18624,PHO,1997,Loren Meyer,24,35,17,449,74,166,.446,3,5,.600,71,161,.441,.455,37,52,.712,39,57,96,12,5,12,35,73,188
18625,PHO,1997,Joe Kleine,35,23,10,365,32,80,.400,1,1,1.000,31,79,.392,.406,13,18,.722,21,59,80,12,9,6,20,47,78
18626,PHO,1997,Horacio Llamas,23,20,2,101,15,28,.536,0,0,,15,28,.536,.536,4,8,.500,4,14,18,4,10,5,11,25,34
18627,PHO,1997,Ben Davis,24,20,0,98,10,26,.385,0,0,,10,26,.385,.385,9,20,.450,12,15,27,0,4,1,3,16,29
18628,PHO,1997,Rumeal Robinson,30,12,0,87,16,34,.471,3,10,.300,13,24,.542,.515,1,4,.250,1,6,7,8,1,0,5,8,36
18629,PHO,1997,Mike Brown,33,6,1,83,5,12,.417,0,0,,5,12,.417,.417,6,10,.600,9,16,25,5,1,1,2,9,16
18630,PHO,1997,Chucky Brown,28,10,0,83,13,26,.500,0,0,,13,26,.500,.500,8,11,.727,3,13,16,4,0,2,4,14,34
18631,PHO,1997,Tony Dumas,24,6,1,51,6,19,.316,1,4,.250,5,15,.333,.342,1,2,.500,0,2,2,3,0,1,1,9,14
18632,PHO,1997,Dexter Boney,26,8,0,48,6,19,.316,1,6,.167,5,13,.385,.342,6,8,.750,3,3,6,0,2,1,1,3,19
18633,PHO,1996,Michael Finley,22,82,72,3212,465,976,.476,61,186,.328,404,790,.511,.508,242,323,.749,139,235,374,289,85,31,133,199,1233
18634,PHO,1996,Charles Barkley,32,71,71,2632,580,1160,.500,49,175,.280,531,985,.539,.521,440,566,.777,243,578,821,262,114,56,218,208,1649
18635,PHO,1996,Wesley Person,24,82,47,2609,390,877,.445,117,313,.374,273,564,.484,.511,148,192,.771,56,265,321,138,55,22,89,148,1045
18636,PHO,1996,A.C. Green,32,82,36,2113,215,444,.484,14,52,.269,201,392,.513,.500,168,237,.709,166,388,554,72,45,23,79,141,612
18637,PHO,1996,Kevin Johnson,29,56,55,2007,342,674,.507,21,57,.368,321,617,.520,.523,342,398,.859,42,179,221,517,82,13,170,144,1047
18638,PHO,1996,Elliot Perry,26,81,26,1668,261,549,.475,24,59,.407,237,490,.484,.497,151,194,.778,34,102,136,353,87,5,146,140,697
18639,PHO,1996,Hot Rod Williams,33,62,58,1652,180,397,.453,0,1,.000,180,396,.455,.453,95,130,.731,129,243,372,62,46,90,62,170,455
18640,PHO,1996,Wayman Tisdale,31,63,6,1152,279,564,.495,0,0,,279,564,.495,.495,114,149,.765,55,159,214,58,15,36,63,188,672
18641,PHO,1996,Danny Manning,29,33,4,816,178,388,.459,3,14,.214,175,374,.468,.463,82,109,.752,30,113,143,65,38,24,77,121,441
18642,PHO,1996,Joe Kleine,34,56,9,663,71,169,.420,2,7,.286,69,162,.426,.426,20,25,.800,36,96,132,44,13,6,37,113,164
18643,PHO,1996,Chris Carr,21,60,10,590,90,217,.415,11,42,.262,79,175,.451,.440,49,60,.817,27,75,102,43,10,5,40,77,240
18644,PHO,1996,Tony Smith,27,34,2,528,70,173,.405,25,77,.325,45,96,.469,.477,24,37,.649,24,32,56,86,21,5,40,60,189
18645,PHO,1996,Mario Bennett,22,19,14,230,29,64,.453,0,1,.000,29,63,.460,.453,27,42,.643,21,28,49,6,11,11,11,46,85
18646,PHO,1996,David Wood,31,4,0,34,1,6,.167,0,0,,1,6,.167,.167,2,2,1.000,2,3,5,2,1,0,2,9,4
18647,PHO,1996,Stefano Rusconi,27,7,0,30,3,9,.333,0,0,,3,9,.333,.333,2,5,.400,3,3,6,3,0,2,3,10,8
18648,PHO,1996,John Coker,24,5,0,11,4,5,.800,0,0,,4,5,.800,.800,0,0,,2,0,2,1,0,1,0,1,8
18649,PHO,1996,Terrence Rencher,22,2,0,8,1,1,1.000,0,0,,1,1,1.000,1.000,1,3,.333,0,2,2,0,0,1,2,1,3
18650,PHO,1995,Dan Majerle,29,82,46,3091,438,1031,.425,199,548,.363,239,483,.495,.521,206,282,.730,104,271,375,340,96,38,105,155,1281
18651,PHO,1995,A.C. Green,31,82,52,2687,311,617,.504,43,127,.339,268,490,.547,.539,251,343,.732,194,475,669,127,55,31,114,146,916
18652,PHO,1995,Charles Barkley,31,68,66,2382,554,1141,.486,74,219,.338,480,922,.521,.518,379,507,.748,203,553,756,276,110,45,150,201,1561
18653,PHO,1995,Elliot Perry,25,82,51,1977,306,588,.520,25,60,.417,281,528,.532,.542,158,195,.810,51,100,151,394,156,4,163,142,795
18654,PHO,1995,Wesley Person,23,78,56,1800,309,638,.484,116,266,.436,193,372,.519,.575,80,101,.792,67,134,201,105,48,24,79,149,814
18655,PHO,1995,Danny Manning,28,46,19,1510,340,622,.547,6,21,.286,334,601,.556,.551,136,202,.673,97,179,276,154,41,57,121,176,822
18656,PHO,1995,Danny Ainge,35,74,1,1374,194,422,.460,78,214,.364,116,208,.558,.552,105,130,.808,25,84,109,210,46,7,79,155,571
18657,PHO,1995,Kevin Johnson,28,47,35,1352,246,523,.470,4,26,.154,242,497,.487,.474,234,289,.810,32,83,115,360,47,18,105,88,730
18658,PHO,1995,Wayman Tisdale,30,65,13,1276,278,574,.484,0,0,,278,574,.484,.484,94,122,.770,83,164,247,45,29,27,64,190,650
18659,PHO,1995,Joe Kleine,33,75,42,968,119,265,.449,0,2,.000,119,263,.452,.449,42,49,.857,82,177,259,39,14,18,35,174,280
18660,PHO,1995,Danny Schayes,35,69,27,823,126,248,.508,1,1,1.000,125,247,.506,.510,50,69,.725,57,151,208,89,20,37,64,170,303
18661,PHO,1995,Trevor Ruffin,24,49,1,319,84,197,.426,38,99,.384,46,98,.469,.523,27,38,.711,8,15,23,48,14,2,47,52,233
18662,PHO,1995,Richard Dumas,25,15,1,167,37,73,.507,0,1,.000,37,72,.514,.507,8,16,.500,18,11,29,7,10,2,9,22,82
18663,PHO,1995,Antonio Lang,22,12,0,53,4,10,.400,0,0,,4,10,.400,.400,3,4,.750,3,1,4,1,0,2,5,11,11
18664,PHO,1995,Aaron Swinson,24,9,0,51,10,18,.556,0,0,,10,18,.556,.556,4,5,.800,3,5,8,3,1,0,5,8,24
18665,PHO,1994,Dan Majerle,28,80,76,3207,476,1138,.418,192,503,.382,284,635,.447,.503,176,238,.739,120,229,349,275,129,43,137,153,1320
18666,PHO,1994,A.C. Green,30,82,55,2825,465,926,.502,8,35,.229,457,891,.513,.506,266,362,.735,275,478,753,137,70,38,100,142,1204
18667,PHO,1994,Kevin Johnson,27,67,67,2449,477,980,.487,6,27,.222,471,953,.494,.490,380,464,.819,55,112,167,637,125,10,235,127,1340
18668,PHO,1994,Charles Barkley,30,65,65,2298,518,1046,.495,48,178,.270,470,868,.541,.518,318,452,.704,198,529,727,296,101,37,206,160,1402
18669,PHO,1994,Oliver Miller,23,69,30,1786,277,455,.609,2,9,.222,275,446,.617,.611,80,137,.584,140,336,476,244,83,156,164,230,636
18670,PHO,1994,Cedric Ceballos,24,53,43,1602,425,795,.535,0,9,.000,425,786,.541,.535,160,221,.724,153,191,344,91,59,23,93,124,1010
18671,PHO,1994,Danny Ainge,34,68,1,1555,224,537,.417,80,244,.328,144,293,.491,.492,78,94,.830,28,103,131,180,57,8,81,140,606
18672,PHO,1994,Mark West,33,82,50,1236,162,286,.566,0,0,,162,286,.566,.566,58,116,.500,112,183,295,33,31,109,74,214,382
18673,PHO,1994,Frank Johnson,35,70,5,875,134,299,.448,2,12,.167,132,287,.460,.452,54,69,.783,29,53,82,148,41,1,65,120,324
18674,PHO,1994,Joe Kleine,32,74,4,848,125,256,.488,5,11,.455,120,245,.490,.498,30,39,.769,50,143,193,45,14,19,35,118,285
18675,PHO,1994,Elliot Perry,24,27,9,432,42,113,.372,0,3,.000,42,110,.382,.372,21,28,.750,12,27,39,125,25,1,43,36,105
18676,PHO,1994,Jerrod Mustaf,24,33,2,196,30,84,.357,0,0,,30,84,.357,.357,13,22,.591,20,35,55,8,4,5,10,29,73
18677,PHO,1994,Joe Courtney,24,33,1,168,40,78,.513,0,0,,40,78,.513,.513,23,32,.719,14,13,27,9,3,6,10,23,103
18678,PHO,1994,Duane Cooper,24,23,2,136,18,41,.439,1,7,.143,17,34,.500,.451,11,15,.733,2,7,9,28,3,0,20,12,48
18679,PHO,1994,Malcolm Mackey,23,22,0,69,14,37,.378,0,2,.000,14,35,.400,.378,4,8,.500,12,12,24,1,0,3,2,9,32
18680,PHO,1994,Skeeter Henry,26,4,0,15,1,5,.200,0,2,.000,1,3,.333,.200,2,4,.500,0,2,2,4,0,0,1,1,4
18681,PHO,1994,Negele Knight,26,1,0,8,1,4,.250,0,0,,1,4,.250,.250,0,0,,0,0,0,0,0,1,0,1,2
18682,PHO,1993,Dan Majerle,27,82,82,3199,509,1096,.464,167,438,.381,342,658,.520,.541,203,261,.778,120,263,383,311,138,33,133,180,1388
18683,PHO,1993,Charles Barkley,29,76,76,2859,716,1376,.520,67,220,.305,649,1156,.561,.545,445,582,.765,237,691,928,385,119,74,233,196,1944
18684,PHO,1993,Danny Ainge,33,80,0,2163,337,730,.462,150,372,.403,187,358,.522,.564,123,145,.848,49,165,214,260,69,8,113,175,947
18685,PHO,1993,Tom Chambers,33,73,0,1723,320,716,.447,11,28,.393,309,688,.449,.455,241,288,.837,96,249,345,101,43,23,92,212,892
18686,PHO,1993,Kevin Johnson,26,49,47,1643,282,565,.499,1,8,.125,281,557,.504,.500,226,276,.819,30,74,104,384,85,19,151,100,791
18687,PHO,1993,Cedric Ceballos,23,74,46,1607,381,662,.576,0,2,.000,381,660,.577,.576,187,258,.725,172,236,408,77,54,28,106,103,949
18688,PHO,1993,Mark West,32,82,82,1558,175,285,.614,0,0,,175,285,.614,.614,86,166,.518,153,305,458,29,16,103,93,243,436
18689,PHO,1993,Richard Dumas,23,48,32,1320,302,576,.524,1,3,.333,301,573,.525,.525,152,215,.707,100,123,223,60,85,39,92,127,757
18690,PHO,1993,Frank Johnson,34,77,0,1122,136,312,.436,1,12,.083,135,300,.450,.438,59,76,.776,41,72,113,186,60,8,80,112,332
18691,PHO,1993,Oliver Miller,22,56,1,1069,121,255,.475,0,3,.000,121,252,.480,.475,71,100,.710,70,205,275,118,38,100,108,145,313
18692,PHO,1993,Negele Knight,25,52,35,888,124,317,.391,0,7,.000,124,310,.400,.391,67,86,.779,28,36,64,145,23,4,73,66,315
18693,PHO,1993,Jerrod Mustaf,23,32,9,336,57,130,.438,0,1,.000,57,129,.442,.438,33,53,.623,29,54,83,10,14,11,22,40,147
18694,PHO,1993,Tim Kempton,29,30,0,167,19,48,.396,0,0,,19,48,.396,.396,18,31,.581,12,27,39,19,4,4,16,30,56
18695,PHO,1993,Kurt Rambis,34,5,0,41,4,7,.571,0,0,,4,7,.571,.571,1,2,.500,2,4,6,1,3,0,6,3,9
18696,PHO,1993,Alex Stivrins,30,10,0,35,11,18,.611,0,1,.000,11,17,.647,.611,0,0,,2,6,8,1,1,1,5,7,22
18697,PHO,1992,Jeff Hornacek,28,81,81,3078,635,1240,.512,83,189,.439,552,1051,.525,.546,279,315,.886,106,301,407,411,158,31,170,218,1632
18698,PHO,1992,Kevin Johnson,25,78,78,2899,539,1125,.479,10,46,.217,529,1079,.490,.484,448,555,.807,61,231,292,836,116,23,272,180,1536
18699,PHO,1992,Dan Majerle,26,82,15,2853,551,1153,.478,87,228,.382,464,925,.502,.516,229,303,.756,148,335,483,274,131,43,102,158,1418
18700,PHO,1992,Tim Perry,26,80,69,2483,413,789,.523,3,8,.375,410,781,.525,.525,153,215,.712,204,347,551,134,44,116,141,237,982
18701,PHO,1992,Andrew Lang,25,81,71,1965,248,475,.522,0,1,.000,248,474,.523,.522,126,164,.768,170,376,546,43,48,201,87,306,622
18702,PHO,1992,Tom Chambers,32,69,66,1948,426,989,.431,18,49,.367,408,940,.434,.440,258,311,.830,86,315,401,142,57,37,103,196,1128
18703,PHO,1992,Mark West,31,82,11,1436,196,310,.632,0,0,,196,310,.632,.632,109,171,.637,134,238,372,22,14,81,82,239,501
18704,PHO,1992,Cedric Ceballos,22,64,4,725,176,365,.482,1,6,.167,175,359,.487,.484,109,148,.736,60,92,152,50,16,11,71,52,462
18705,PHO,1992,Negele Knight,24,42,1,631,103,217,.475,4,13,.308,99,204,.485,.484,33,48,.688,16,30,46,112,24,3,58,58,243
18706,PHO,1992,Jerrod Mustaf,22,52,3,545,92,193,.477,0,0,,92,193,.477,.477,49,71,.690,45,100,145,45,21,16,51,59,233
18707,PHO,1992,Ed Nealy,31,52,4,505,62,121,.512,20,50,.400,42,71,.592,.595,16,24,.667,25,86,111,37,16,2,17,45,160
18708,PHO,1992,Kurt Rambis,33,28,5,381,38,82,.463,0,0,,38,82,.463,.463,14,18,.778,23,83,106,37,12,14,25,46,90
18709,PHO,1992,Steve Burtt,29,31,2,356,74,160,.463,1,6,.167,73,154,.474,.466,38,54,.704,10,24,34,59,16,4,33,58,187
18710,PHO,1991,Kevin Johnson,24,77,76,2772,591,1145,.516,9,44,.205,582,1101,.529,.520,519,616,.843,54,217,271,781,163,11,269,174,1710
18711,PHO,1991,Jeff Hornacek,27,80,77,2733,544,1051,.518,61,146,.418,483,905,.534,.547,201,224,.897,74,247,321,409,111,16,130,185,1350
18712,PHO,1991,Tom Chambers,31,76,75,2475,556,1271,.437,20,73,.274,536,1198,.447,.445,379,459,.826,104,386,490,194,65,52,177,235,1511
18713,PHO,1991,Dan Majerle,25,77,7,2281,397,821,.484,30,86,.349,367,735,.499,.502,227,298,.762,168,250,418,216,106,40,114,162,1051
18714,PHO,1991,Xavier McDaniel,27,66,64,2105,451,896,.503,0,5,.000,451,891,.506,.503,144,198,.727,137,339,476,149,50,42,144,214,1046
18715,PHO,1991,Mark West,30,82,64,1957,247,382,.647,0,0,,247,382,.647,.647,135,206,.655,171,393,564,37,32,161,86,266,629
18716,PHO,1991,Andrew Lang,24,63,18,1152,109,189,.577,0,1,.000,109,188,.580,.577,93,130,.715,113,190,303,27,17,127,45,168,311
18717,PHO,1991,Kurt Rambis,32,62,17,900,83,167,.497,0,2,.000,83,165,.503,.497,60,85,.706,77,189,266,64,25,11,45,107,226
18718,PHO,1991,Negele Knight,23,64,6,792,131,308,.425,6,25,.240,125,283,.442,.435,71,118,.602,20,51,71,191,20,7,76,83,339
18719,PHO,1991,Cedric Ceballos,21,63,0,730,204,419,.487,1,6,.167,203,413,.492,.488,110,166,.663,77,73,150,35,22,5,69,70,519
18720,PHO,1991,Tim Perry,25,46,2,587,75,144,.521,0,5,.000,75,139,.540,.521,43,70,.614,53,73,126,27,23,43,32,60,193
18721,PHO,1991,Ed Nealy,30,55,0,573,45,97,.464,5,16,.313,40,81,.494,.490,28,38,.737,44,107,151,36,24,4,19,46,123
18722,PHO,1991,Eddie Johnson,31,15,0,312,88,186,.473,6,21,.286,82,165,.497,.489,21,29,.724,16,30,46,17,9,2,24,37,203
18723,PHO,1991,Kenny Battle,26,16,4,263,38,86,.442,0,2,.000,38,84,.452,.442,20,29,.690,21,32,53,15,19,6,17,25,96
18724,PHO,1991,Joe Barry Carroll,32,11,0,96,13,36,.361,0,0,,13,36,.361,.361,11,12,.917,3,21,24,11,1,8,12,18,37
18725,PHO,1991,Ian Lockhart,23,1,0,2,1,1,1.000,0,0,,1,1,1.000,1.000,2,2,1.000,0,0,0,0,0,0,0,0,4
18726,PHO,1990,Tom Chambers,30,81,81,3046,810,1617,.501,24,86,.279,786,1531,.513,.508,557,647,.861,121,450,571,190,88,47,218,260,2201
18727,PHO,1990,Kevin Johnson,23,74,74,2782,578,1159,.499,8,41,.195,570,1118,.510,.502,501,598,.838,42,228,270,846,95,14,263,143,1665
18728,PHO,1990,Mark West,29,82,79,2399,331,530,.625,0,0,,331,530,.625,.625,199,288,.691,212,516,728,45,36,184,126,277,861
18729,PHO,1990,Jeff Hornacek,26,67,60,2278,483,901,.536,40,98,.408,443,803,.552,.558,173,202,.856,86,227,313,337,117,14,125,144,1179
18730,PHO,1990,Dan Majerle,24,73,23,2244,296,698,.424,19,80,.238,277,618,.448,.438,198,260,.762,144,286,430,188,100,32,82,177,809
18731,PHO,1990,Eddie Johnson,30,64,4,1811,411,907,.453,70,184,.380,341,723,.472,.492,188,205,.917,69,177,246,107,32,10,108,174,1080
18732,PHO,1990,Kurt Rambis,31,58,45,1456,132,257,.514,0,2,.000,132,255,.518,.514,52,72,.722,108,297,405,107,68,27,75,163,316
18733,PHO,1990,Andrew Lang,23,74,0,1011,97,174,.557,0,0,,97,174,.557,.557,64,98,.653,83,188,271,21,22,133,41,171,258
18734,PHO,1990,Kenny Battle,25,59,8,729,93,170,.547,1,4,.250,92,166,.554,.550,55,82,.671,44,80,124,38,35,11,32,94,242
18735,PHO,1990,Greg Grant,23,67,3,678,83,216,.384,3,16,.188,80,200,.400,.391,39,59,.661,16,43,59,168,36,1,77,58,208
18736,PHO,1990,Tim Perry,24,60,18,612,100,195,.513,1,1,1.000,99,194,.510,.515,53,90,.589,79,73,152,17,21,22,47,76,254
18737,PHO,1990,Mike McGee,30,14,7,280,42,87,.483,8,23,.348,34,64,.531,.529,10,21,.476,11,25,36,16,8,1,14,28,102
18738,PHO,1990,Armen Gilliam,25,16,7,267,52,121,.430,0,0,,52,121,.430,.430,39,56,.696,26,44,70,8,6,5,17,28,143
18739,PHO,1990,Mike Morrison,22,36,1,153,23,68,.338,2,7,.286,21,61,.344,.353,24,30,.800,7,13,20,11,2,0,23,20,72
18740,PHO,1990,Tim Legler,23,11,0,83,11,29,.379,0,1,.000,11,28,.393,.379,6,6,1.000,4,4,8,6,2,0,4,12,28
18741,PHO,1990,Micheal Williams,23,6,0,26,2,10,.200,0,0,,2,10,.200,.200,1,2,.500,1,0,1,4,0,0,5,0,5
18742,PHO,1989,Kevin Johnson,22,81,81,3179,570,1128,.505,2,22,.091,568,1106,.514,.506,508,576,.882,46,294,340,991,135,24,322,226,1650
18743,PHO,1989,Tom Chambers,29,81,81,3002,774,1643,.471,28,86,.326,746,1557,.479,.480,509,598,.851,143,541,684,231,87,55,231,271,2085
18744,PHO,1989,Jeff Hornacek,25,78,73,2487,440,889,.495,27,81,.333,413,808,.511,.510,147,178,.826,75,191,266,465,129,8,111,188,1054
18745,PHO,1989,Armen Gilliam,24,74,60,2120,468,930,.503,0,0,,468,930,.503,.503,240,323,.743,165,376,541,52,54,27,140,176,1176
18746,PHO,1989,Eddie Johnson,29,70,7,2043,608,1224,.497,71,172,.413,537,1052,.510,.526,217,250,.868,91,215,306,162,47,7,122,198,1504
18747,PHO,1989,Mark West,28,82,32,2019,243,372,.653,0,0,,243,372,.653,.653,108,202,.535,167,384,551,39,35,187,103,273,594
18748,PHO,1989,Tyrone Corbin,26,77,30,1655,245,454,.540,0,2,.000,245,452,.542,.540,141,179,.788,176,222,398,118,82,13,92,222,631
18749,PHO,1989,Dan Majerle,23,54,5,1354,181,432,.419,27,82,.329,154,350,.440,.450,78,127,.614,62,147,209,130,63,14,48,139,467
18750,PHO,1989,Tim Perry,23,62,15,614,108,201,.537,1,4,.250,107,197,.543,.540,40,65,.615,61,71,132,18,19,32,37,47,257
18751,PHO,1989,Andrew Lang,22,62,25,526,60,117,.513,0,0,,60,117,.513,.513,39,60,.650,54,93,147,9,17,48,28,112,159
18752,PHO,1989,T.R. Dunn,33,34,1,321,12,35,.343,0,0,,12,35,.343,.343,9,12,.750,30,30,60,25,12,1,6,35,33
18753,PHO,1989,Ed Nealy,28,30,0,164,8,29,.276,0,2,.000,8,27,.296,.276,3,7,.429,18,37,55,8,4,0,6,22,19
18754,PHO,1989,Steve Kerr,23,26,0,157,20,46,.435,8,17,.471,12,29,.414,.522,6,9,.667,3,14,17,24,7,0,6,12,54
18755,PHO,1989,Craig Hodges,28,10,0,92,16,36,.444,4,12,.333,12,24,.500,.500,3,4,.750,2,3,5,8,2,0,5,8,39
18756,PHO,1989,Kenny Gattison,24,2,0,9,0,1,.000,0,0,,0,1,.000,.000,1,2,.500,0,1,1,0,0,0,0,2,1
18757,PHO,1989,Mark Davis,25,2,0,7,1,5,.200,0,1,.000,1,4,.250,.200,2,2,1.000,1,0,1,0,0,0,0,1,4
18758,PHO,1989,Winston Crite,23,2,0,6,0,3,.000,0,0,,0,3,.000,.000,0,0,,1,0,1,0,0,0,1,1,0
18759,PHO,1988,Jeff Hornacek,24,82,49,2243,306,605,.506,17,58,.293,289,547,.528,.520,152,185,.822,71,191,262,540,107,10,156,151,781
18760,PHO,1988,Eddie Johnson,28,73,59,2177,533,1110,.480,24,94,.255,509,1016,.501,.491,204,240,.850,121,197,318,180,33,9,139,190,1294
18761,PHO,1988,Walter Davis,33,68,48,1951,488,1031,.473,36,96,.375,452,935,.483,.491,205,231,.887,32,127,159,278,86,3,126,131,1217
18762,PHO,1988,Armen Gilliam,23,55,53,1807,342,720,.475,0,0,,342,720,.475,.475,131,193,.679,134,300,434,72,58,29,123,143,815
18763,PHO,1988,Alvan Adams,33,82,25,1646,251,506,.496,1,2,.500,250,504,.496,.497,108,128,.844,118,247,365,183,82,41,140,245,611
18764,PHO,1988,Jay Humphries,25,50,33,1557,264,484,.545,3,16,.188,261,468,.558,.549,103,139,.741,44,107,151,354,61,4,108,154,634
18765,PHO,1988,Larry Nance,28,40,34,1477,327,616,.531,2,5,.400,325,611,.532,.532,187,249,.751,119,275,394,123,45,96,106,152,843
18766,PHO,1988,James Edwards,32,43,42,1377,254,542,.469,0,1,.000,254,541,.470,.469,165,260,.635,97,238,335,73,14,32,108,159,673
18767,PHO,1988,Mark West,27,29,29,915,134,257,.521,0,1,.000,134,256,.523,.521,75,132,.568,82,160,242,24,22,68,82,107,343
18768,PHO,1988,Kevin Johnson,21,28,25,874,132,285,.463,3,15,.200,129,270,.478,.468,85,99,.859,26,93,119,244,43,7,64,59,352
18769,PHO,1988,James Bailey,30,65,0,869,109,241,.452,0,4,.000,109,237,.460,.452,70,89,.787,73,137,210,42,17,28,70,180,288
18770,PHO,1988,Tyrone Corbin,25,30,1,591,99,203,.488,1,3,.333,98,200,.490,.490,33,40,.825,48,82,130,59,30,3,38,53,232
18771,PHO,1988,Bernard Thompson,25,37,7,566,74,159,.465,0,2,.000,74,157,.471,.465,43,60,.717,40,36,76,51,21,1,21,75,191
18772,PHO,1988,Mike Sanders,27,35,5,466,82,171,.480,0,1,.000,82,170,.482,.480,39,53,.736,28,34,62,30,18,4,27,73,203
18773,PHO,1988,Craig Hodges,27,23,0,462,87,178,.489,31,57,.544,56,121,.463,.576,27,32,.844,7,25,32,44,16,2,28,38,232
18774,PHO,1988,Jeff Cook,31,33,0,359,14,59,.237,0,1,.000,14,58,.241,.237,23,28,.821,37,69,106,14,9,8,14,64,51
18775,PHO,1988,Winston Crite,22,29,0,258,34,68,.500,0,0,,34,68,.500,.500,19,25,.760,27,37,64,15,5,8,25,42,87
18776,PHO,1988,Bill Martin,25,10,0,101,16,51,.314,0,1,.000,16,50,.320,.314,8,13,.615,9,18,27,6,5,0,9,16,40
18777,PHO,1988,Ron Moore,26,5,0,34,5,16,.313,0,0,,5,16,.313,.313,4,4,1.000,0,6,6,0,3,0,1,13,14
18778,PHO,1987,Walter Davis,32,79,79,2646,779,1515,.514,21,81,.259,758,1434,.529,.521,288,334,.862,90,154,244,364,96,5,226,184,1867
18779,PHO,1987,Jay Humphries,24,82,82,2579,359,753,.477,5,27,.185,354,726,.488,.480,200,260,.769,62,198,260,632,112,9,195,239,923
18780,PHO,1987,Larry Nance,27,69,67,2569,585,1062,.551,1,5,.200,584,1057,.553,.551,381,493,.773,188,411,599,233,86,148,149,223,1552
18781,PHO,1987,Ed Pinckney,23,80,65,2250,290,497,.584,0,2,.000,290,495,.586,.584,257,348,.739,179,401,580,116,86,54,135,196,837
18782,PHO,1987,Alvan Adams,32,68,40,1690,311,618,.503,0,1,.000,311,617,.504,.503,134,170,.788,91,247,338,223,62,37,139,207,756
18783,PHO,1987,Mike Sanders,26,82,4,1655,357,722,.494,2,17,.118,355,705,.504,.496,143,183,.781,101,170,271,126,61,23,105,210,859
18784,PHO,1987,Jeff Hornacek,23,80,3,1561,159,350,.454,12,43,.279,147,307,.479,.471,94,121,.777,41,143,184,361,70,5,153,130,424
18785,PHO,1987,Kenny Gattison,22,77,14,1104,148,311,.476,0,3,.000,148,308,.481,.476,108,171,.632,87,183,270,36,24,33,88,178,404
18786,PHO,1987,William Bedford,23,50,18,979,142,358,.397,0,1,.000,142,357,.398,.397,50,86,.581,79,167,246,57,18,37,85,125,334
18787,PHO,1987,Grant Gondrezick,24,64,1,836,135,300,.450,4,17,.235,131,283,.463,.457,75,107,.701,47,63,110,81,25,4,56,91,349
18788,PHO,1987,Rafael Addison,22,62,12,711,146,331,.441,16,50,.320,130,281,.463,.465,51,64,.797,41,65,106,45,27,7,54,75,359
18789,PHO,1987,Nick Vanos,23,57,14,640,65,158,.411,0,2,.000,65,156,.417,.411,38,59,.644,67,113,180,43,19,23,48,94,168
18790,PHO,1987,Bernard Thompson,24,24,2,331,42,105,.400,0,3,.000,42,102,.412,.400,27,33,.818,20,11,31,18,11,5,16,53,111
18791,PHO,1987,James Edwards,31,14,9,304,57,110,.518,0,0,,57,110,.518,.518,54,70,.771,20,40,60,19,6,7,15,42,168
18792,PHO,1986,Jay Humphries,23,82,82,2733,352,735,.479,4,29,.138,348,706,.493,.482,197,257,.767,56,204,260,526,132,9,190,222,905
18793,PHO,1986,Larry Nance,26,73,69,2484,582,1001,.581,0,8,.000,582,993,.586,.581,310,444,.698,169,449,618,240,70,130,210,247,1474
18794,PHO,1986,Walter Davis,31,70,62,2239,624,1287,.485,18,76,.237,606,1211,.500,.492,257,305,.843,54,149,203,361,99,3,219,153,1523
18795,PHO,1986,Alvan Adams,31,78,45,2005,341,679,.502,0,2,.000,341,677,.504,.502,159,203,.783,148,329,477,324,103,46,206,272,841
18796,PHO,1986,Mike Sanders,25,82,5,1644,347,676,.513,3,15,.200,344,661,.520,.516,208,257,.809,104,169,273,150,76,31,143,236,905
18797,PHO,1986,Ed Pinckney,22,80,24,1602,255,457,.558,0,2,.000,255,455,.560,.558,171,254,.673,95,213,308,90,71,37,148,190,681
18798,PHO,1986,James Edwards,30,52,51,1314,318,587,.542,0,0,,318,587,.542,.542,212,302,.702,79,222,301,74,23,29,128,200,848
18799,PHO,1986,Bernard Thompson,23,61,20,1281,195,399,.489,0,2,.000,195,397,.491,.489,127,157,.809,58,83,141,132,51,10,90,151,517
18800,PHO,1986,Charles Pittman,27,69,17,1132,127,218,.583,0,0,,127,218,.583,.583,99,141,.702,99,147,246,58,37,23,107,140,353
18801,PHO,1986,Georgi Glouchkov,26,49,16,772,84,209,.402,1,1,1.000,83,208,.399,.404,70,122,.574,31,132,163,32,26,25,76,124,239
18802,PHO,1986,Charles Jones,24,43,18,742,75,164,.457,0,1,.000,75,163,.460,.457,50,98,.510,65,128,193,52,32,25,57,87,200
18803,PHO,1986,Rod Foster,25,48,0,704,85,218,.390,9,32,.281,76,186,.409,.411,23,32,.719,9,49,58,121,22,1,61,77,202
18804,PHO,1986,Rick Robey,30,46,1,629,72,191,.377,0,3,.000,72,188,.383,.377,33,48,.688,40,108,148,58,19,5,66,92,177
18805,PHO,1986,Sedric Toney,23,10,0,206,26,59,.441,3,10,.300,23,49,.469,.466,20,30,.667,3,20,23,26,5,0,19,18,75
18806,PHO,1986,Nick Vanos,22,11,0,202,23,72,.319,0,0,,23,72,.319,.319,8,23,.348,21,39,60,16,2,5,20,34,54
18807,PHO,1986,Michael Holton,24,4,0,65,4,20,.200,0,2,.000,4,18,.222,.200,4,6,.667,1,2,3,7,2,0,4,7,12
18808,PHO,1986,Devin Durrant,25,4,0,51,8,21,.381,0,0,,8,21,.381,.381,1,4,.250,2,6,8,5,3,0,4,10,17
18809,PHO,1985,Larry Nance,25,61,55,2202,515,877,.587,1,2,.500,514,875,.587,.588,180,254,.709,195,341,536,159,88,104,136,185,1211
18810,PHO,1985,Alvan Adams,30,82,69,2136,476,915,.520,0,0,,476,915,.520,.520,250,283,.883,153,347,500,308,115,48,197,254,1202
18811,PHO,1985,Jay Humphries,22,80,39,2062,279,626,.446,4,20,.200,275,606,.454,.449,141,170,.829,32,132,164,350,107,8,167,209,703
18812,PHO,1985,Kyle Macy,27,65,52,2018,282,582,.485,23,85,.271,259,497,.521,.504,127,140,.907,33,146,179,380,85,3,111,128,714
18813,PHO,1985,James Edwards,29,70,58,1787,384,766,.501,0,3,.000,384,763,.503,.501,276,370,.746,95,292,387,153,26,52,162,237,1044
18814,PHO,1985,Michael Holton,23,74,59,1761,257,576,.446,14,45,.311,243,531,.458,.458,96,118,.814,30,102,132,198,59,6,123,141,624
18815,PHO,1985,Maurice Lucas,32,63,22,1670,346,727,.476,0,4,.000,346,723,.479,.476,150,200,.750,138,419,557,145,39,17,151,183,842
18816,PHO,1985,Charles Jones,23,78,14,1565,236,454,.520,0,4,.000,236,450,.524,.520,182,281,.648,139,255,394,128,45,61,143,149,654
18817,PHO,1985,Rod Foster,24,79,1,1318,286,636,.450,41,126,.325,245,510,.480,.482,83,110,.755,27,53,80,186,61,0,117,171,696
18818,PHO,1985,Alvin Scott,29,77,18,1238,111,259,.429,1,5,.200,110,254,.433,.431,53,74,.716,46,115,161,127,39,25,60,125,276
18819,PHO,1985,Charles Pittman,26,68,3,1001,107,227,.471,0,2,.000,107,225,.476,.471,109,146,.747,90,137,227,69,20,21,100,144,323
18820,PHO,1985,Walter Davis,30,23,9,570,139,309,.450,3,10,.300,136,299,.455,.455,64,73,.877,6,29,35,98,18,0,50,42,345
18821,PHO,1985,Mike Sanders,24,21,11,418,85,175,.486,0,0,,85,175,.486,.486,45,59,.763,38,51,89,29,23,4,34,59,215
18822,PHO,1985,Rick Robey,29,4,0,48,2,9,.222,0,0,,2,9,.222,.222,1,2,.500,3,5,8,5,2,0,8,7,5
18823,PHO,1985,Michael Young,24,2,0,11,2,6,.333,0,1,.000,2,5,.400,.333,0,0,,1,1,2,0,0,0,0,0,4
18824,PHO,1984,Larry Nance,24,82,82,2899,601,1044,.576,0,7,.000,601,1037,.580,.576,249,352,.707,227,451,678,214,86,174,177,274,1451
18825,PHO,1984,Walter Davis,29,78,70,2546,652,1274,.512,20,87,.230,632,1187,.532,.520,233,270,.863,38,164,202,429,107,12,213,202,1557
18826,PHO,1984,Kyle Macy,26,82,45,2402,357,713,.501,23,70,.329,334,643,.519,.517,95,114,.833,49,137,186,353,123,6,116,181,832
18827,PHO,1984,Maurice Lucas,31,75,69,2309,451,908,.497,0,5,.000,451,903,.499,.497,293,383,.765,208,517,725,203,55,39,177,235,1195
18828,PHO,1984,James Edwards,28,72,67,1897,438,817,.536,0,1,.000,438,816,.537,.536,183,254,.720,108,240,348,184,23,30,140,254,1059
18829,PHO,1984,Alvan Adams,29,70,13,1452,269,582,.462,0,4,.000,269,578,.465,.462,132,160,.825,118,201,319,219,73,31,117,195,670
18830,PHO,1984,Rod Foster,23,80,34,1424,260,580,.448,22,84,.262,238,496,.480,.467,122,155,.787,39,81,120,172,54,9,108,193,664
18831,PHO,1984,Charles Pittman,25,69,8,989,126,209,.603,0,2,.000,126,207,.609,.603,69,101,.683,76,138,214,70,16,22,81,129,321
18832,PHO,1984,Paul Westphal,33,59,2,865,144,313,.460,7,26,.269,137,287,.477,.471,117,142,.824,8,35,43,148,41,6,77,69,412
18833,PHO,1984,Rick Robey,28,61,4,856,140,257,.545,1,1,1.000,139,256,.543,.547,61,88,.693,80,118,198,65,20,14,77,120,342
18834,PHO,1984,Alvin Scott,28,65,5,735,55,124,.444,1,2,.500,54,122,.443,.448,56,72,.778,29,71,100,48,19,20,42,85,167
18835,PHO,1984,Mike Sanders,23,50,0,586,97,203,.478,0,0,,97,203,.478,.478,29,42,.690,40,63,103,44,23,12,44,101,223
18836,PHO,1984,Johnny High,26,29,9,512,18,52,.346,0,2,.000,18,50,.360,.346,10,29,.345,16,50,66,51,40,11,38,84,46
18837,PHO,1984,Rory White,24,22,2,308,69,144,.479,0,0,,69,144,.479,.479,24,42,.571,30,32,62,14,13,2,18,25,162
18838,PHO,1983,Larry Nance,23,82,82,2914,588,1069,.550,1,3,.333,587,1066,.551,.551,193,287,.672,239,471,710,197,99,217,190,254,1370
18839,PHO,1983,Maurice Lucas,30,77,71,2586,495,1045,.474,1,3,.333,494,1042,.474,.474,278,356,.781,201,598,799,219,56,43,221,274,1269
18840,PHO,1983,Dennis Johnson,28,77,74,2551,398,861,.462,5,31,.161,393,830,.473,.465,292,369,.791,92,243,335,388,97,39,204,204,1093
18841,PHO,1983,Walter Davis,28,80,79,2491,665,1289,.516,7,23,.304,658,1266,.520,.519,184,225,.818,63,134,197,397,117,12,188,186,1521
18842,PHO,1983,Alvan Adams,28,80,75,2447,477,981,.486,1,3,.333,476,978,.487,.487,180,217,.829,161,387,548,376,114,74,242,287,1135
18843,PHO,1983,Kyle Macy,25,82,9,1836,328,634,.517,23,76,.303,305,558,.547,.535,129,148,.872,41,124,165,278,64,8,90,130,808
18844,PHO,1983,Johnny High,25,82,2,1155,100,217,.461,1,5,.200,99,212,.467,.463,63,136,.463,45,105,150,153,85,34,106,205,264
18845,PHO,1983,Alvin Scott,27,81,9,1139,124,259,.479,0,2,.000,124,257,.482,.479,81,110,.736,60,164,224,97,48,31,64,133,329
18846,PHO,1983,Rory White,23,65,0,626,127,234,.543,0,1,.000,127,233,.545,.543,70,109,.642,47,58,105,30,16,2,51,54,324
18847,PHO,1983,Jeff Cook,26,45,2,551,61,142,.430,0,2,.000,61,140,.436,.430,41,54,.759,44,85,129,58,12,13,56,89,163
18848,PHO,1983,David Thirdkill,22,49,2,521,74,170,.435,1,7,.143,73,163,.448,.438,45,78,.577,28,44,72,36,19,4,48,93,194
18849,PHO,1983,Joel Kramer,27,54,4,458,44,104,.423,0,1,.000,44,103,.427,.423,14,16,.875,41,47,88,37,15,6,22,63,102
18850,PHO,1983,James Edwards,27,16,1,285,55,113,.487,0,0,,55,113,.487,.487,31,47,.660,19,40,59,27,5,5,19,49,141
18851,PHO,1983,Charles Pittman,24,28,0,170,19,40,.475,0,1,.000,19,39,.487,.475,25,37,.676,13,18,31,7,2,7,22,41,63
18852,PHO,1982,Dennis Johnson,27,80,77,2937,577,1228,.470,8,42,.190,569,1186,.480,.473,399,495,.806,142,268,410,369,105,55,233,253,1561
18853,PHO,1982,Kyle Macy,24,82,72,2845,486,945,.514,39,100,.390,447,845,.529,.535,152,169,.899,78,183,261,384,143,9,125,185,1163
18854,PHO,1982,Truck Robinson,30,74,72,2745,579,1128,.513,1,1,1.000,578,1127,.513,.514,255,371,.687,202,519,721,179,42,28,202,215,1414
18855,PHO,1982,Alvan Adams,27,79,75,2393,507,1027,.494,0,1,.000,507,1026,.494,.494,182,233,.781,138,448,586,356,114,78,196,269,1196
18856,PHO,1982,Rich Kelley,28,81,39,1892,236,505,.467,0,1,.000,236,504,.468,.467,167,223,.749,168,329,497,293,64,71,244,292,639
18857,PHO,1982,Alvin Scott,26,81,38,1740,189,380,.497,0,2,.000,189,378,.500,.497,108,148,.730,97,197,294,149,59,70,98,169,486
18858,PHO,1982,Jeff Cook,25,76,22,1298,151,358,.422,0,2,.000,151,356,.424,.422,89,134,.664,112,189,301,100,37,23,80,174,391
18859,PHO,1982,Larry Nance,22,80,0,1186,227,436,.521,0,1,.000,227,435,.522,.521,75,117,.641,95,161,256,82,42,71,104,169,529
18860,PHO,1982,Walter Davis,27,55,12,1182,350,669,.523,3,16,.188,347,653,.531,.525,91,111,.820,21,82,103,162,46,3,112,104,794
18861,PHO,1982,Dudley Bradley,24,64,3,937,125,281,.445,1,4,.250,124,277,.448,.447,74,100,.740,30,57,87,80,78,10,71,115,325
18862,PHO,1982,Joel Kramer,26,56,0,549,55,133,.414,0,0,,55,133,.414,.414,33,42,.786,36,72,108,51,19,11,26,62,143
18863,PHO,1982,Craig Dykema,22,32,0,103,17,37,.459,2,4,.500,15,33,.455,.486,7,9,.778,3,9,12,15,2,0,7,19,43
18864,PHO,1982,John McCullough,25,8,0,23,9,13,.692,0,0,,9,13,.692,.692,3,5,.600,1,3,4,3,2,0,3,3,21
18865,PHO,1981,Truck Robinson,29,82,82,3088,647,1280,.505,0,0,,647,1280,.505,.505,249,396,.629,216,573,789,206,68,38,250,220,1543
18866,PHO,1981,Dennis Johnson,26,79,,2615,532,1220,.436,11,51,.216,521,1169,.446,.441,411,501,.820,160,203,363,291,136,61,208,244,1486
18867,PHO,1981,Jeff Cook,24,79,,2192,286,616,.464,0,5,.000,286,611,.468,.464,100,155,.645,170,297,467,201,82,54,146,236,672
18868,PHO,1981,Walter Davis,26,78,,2182,593,1101,.539,7,17,.412,586,1084,.541,.542,209,250,.836,63,137,200,302,97,12,222,192,1402
18869,PHO,1981,Alvan Adams,26,75,,2054,458,870,.526,0,0,,458,870,.526,.526,199,259,.768,157,389,546,344,106,69,226,226,1115
18870,PHO,1981,Johnny High,23,81,,1750,246,576,.427,2,24,.083,244,552,.442,.429,183,264,.693,89,139,228,202,129,26,188,251,677
18871,PHO,1981,Rich Kelley,27,81,,1686,196,387,.506,0,2,.000,196,385,.509,.506,175,231,.758,131,310,441,282,79,63,209,210,567
18872,PHO,1981,Kyle Macy,23,82,,1469,272,532,.511,12,51,.235,260,481,.541,.523,107,119,.899,44,88,132,160,76,5,95,120,663
18873,PHO,1981,Alvin Scott,25,82,,1423,173,348,.497,1,6,.167,172,342,.503,.499,97,127,.764,101,167,268,114,60,70,77,124,444
18874,PHO,1981,Joel Kramer,25,82,,1065,136,258,.527,0,1,.000,136,257,.529,.527,63,91,.692,77,155,232,88,35,17,67,132,335
18875,PHO,1981,Mike Niles,25,44,,231,48,138,.348,2,4,.500,46,134,.343,.355,17,37,.459,26,32,58,15,8,1,25,41,115
18876,PHO,1980,Truck Robinson,28,82,82,2710,545,1064,.512,0,0,,545,1064,.512,.512,325,487,.667,213,557,770,142,58,59,251,262,1415
18877,PHO,1980,Paul Westphal,29,82,82,2665,692,1317,.525,26,93,.280,666,1224,.544,.535,382,443,.862,46,141,187,416,119,35,207,162,1792
18878,PHO,1980,Don Buse,29,81,,2499,261,589,.443,19,79,.241,242,510,.475,.459,85,128,.664,70,163,233,320,132,10,91,111,626
18879,PHO,1980,Walter Davis,25,75,,2309,657,1166,.563,0,4,.000,657,1162,.565,.563,299,365,.819,75,197,272,337,114,19,242,202,1613
18880,PHO,1980,Alvan Adams,25,75,,2168,465,875,.531,0,2,.000,465,873,.533,.531,188,236,.797,158,451,609,322,108,55,218,237,1118
18881,PHO,1980,Mike Bratz,24,82,,1589,269,687,.392,21,86,.244,248,601,.413,.407,141,162,.870,50,117,167,223,93,9,135,165,700
18882,PHO,1980,Gar Heard,31,82,,1403,171,410,.417,0,2,.000,171,408,.419,.417,64,86,.744,118,262,380,97,84,49,88,177,406
18883,PHO,1980,Alvin Scott,24,79,,1303,127,301,.422,1,3,.333,126,298,.423,.424,95,122,.779,89,139,228,98,47,53,92,101,350
18884,PHO,1980,Johnny High,22,82,,1121,144,323,.446,1,7,.143,143,316,.453,.447,120,178,.674,69,104,173,119,71,15,123,172,409
18885,PHO,1980,Jeff Cook,23,66,,904,129,275,.469,0,3,.000,129,272,.474,.469,104,129,.806,90,151,241,84,28,18,71,102,362
18886,PHO,1980,Joel Kramer,24,54,,711,67,143,.469,0,1,.000,67,142,.472,.469,56,70,.800,49,102,151,75,26,5,51,104,190
18887,PHO,1980,Rich Kelley,26,23,,373,43,85,.506,0,0,,43,85,.506,.506,47,60,.783,44,74,118,50,28,17,46,58,133
18888,POR,2024,Jerami Grant,29,54,54,1830,383,850,.451,111,276,.402,272,574,.474,.516,255,312,.817,37,154,191,152,45,34,116,117,1132
18889,POR,2024,Deandre Ayton,25,55,55,1784,427,749,.570,1,10,.100,426,739,.576,.571,65,79,.823,176,433,609,90,56,42,99,109,920
18890,POR,2024,Scoot Henderson,19,62,32,1765,307,797,.385,87,268,.325,220,529,.416,.440,167,204,.819,53,141,194,336,48,13,212,195,868
18891,POR,2024,Toumani Camara,23,70,49,1739,197,438,.450,58,172,.337,139,266,.523,.516,75,99,.758,139,204,343,87,66,33,84,174,527
18892,POR,2024,Jabari Walker,21,72,23,1700,234,509,.460,41,139,.295,193,370,.522,.500,129,171,.754,151,357,508,71,42,22,66,173,638
18893,POR,2024,Anfernee Simons,24,46,46,1582,360,837,.430,156,405,.385,204,432,.472,.523,163,178,.916,22,145,167,255,23,5,126,98,1039
18894,POR,2024,Matisse Thybulle,26,65,19,1487,126,317,.397,80,231,.346,46,86,.535,.524,22,29,.759,30,106,136,90,113,49,40,93,354
18895,POR,2024,Kris Murray,23,62,29,1348,145,366,.396,49,183,.268,96,183,.525,.463,37,56,.661,85,139,224,80,53,21,55,92,376
18896,POR,2024,Duop Reath,27,68,20,1214,230,499,.461,88,245,.359,142,254,.559,.549,69,93,.742,93,157,250,67,33,38,52,161,617
18897,POR,2024,Malcolm Brogdon,31,39,25,1121,218,496,.440,82,199,.412,136,297,.458,.522,95,116,.819,28,120,148,214,27,8,60,58,613
18898,POR,2024,Shaedon Sharpe,20,32,25,1059,176,434,.406,60,180,.333,116,254,.457,.475,98,119,.824,42,118,160,94,28,12,72,88,510
18899,POR,2024,Dalano Banton,24,30,8,876,183,449,.408,57,183,.311,126,266,.474,.471,78,100,.780,29,114,143,108,28,17,67,44,501
18900,POR,2024,Rayan Rupert,19,39,12,633,54,161,.335,28,78,.359,26,83,.313,.422,19,25,.760,24,68,92,62,12,3,31,56,155
18901,POR,2024,Justin Minaya,24,34,1,381,22,74,.297,12,49,.245,10,25,.400,.378,5,9,.556,30,26,56,21,9,10,9,35,61
18902,POR,2024,Skylar Mays,26,21,5,356,53,138,.384,14,49,.286,39,89,.438,.435,13,17,.765,9,28,37,75,14,3,18,20,133
18903,POR,2024,Ashton Hagans,24,19,1,316,29,71,.408,8,25,.320,21,46,.457,.465,14,17,.824,14,31,45,54,11,9,30,40,80
18904,POR,2024,Ibou Badji,21,22,1,226,14,22,.636,0,0,,14,22,.636,.636,6,12,.500,20,31,51,13,3,20,15,46,34
18905,POR,2024,Moses Brown,24,22,5,200,33,65,.508,0,0,,33,65,.508,.508,9,31,.290,37,49,86,7,5,7,11,27,75
18906,POR,2024,Robert Williams,26,6,0,119,17,26,.654,0,0,,17,26,.654,.654,7,9,.778,11,27,38,5,7,7,7,17,41
18907,POR,2024,Jamaree Bouyea,24,6,0,57,5,21,.238,0,8,.000,5,13,.385,.238,0,0,,2,8,10,8,0,0,8,3,10
18908,POR,2024,Ish Wainright,29,7,0,46,6,18,.333,6,16,.375,0,2,.000,.500,2,2,1.000,0,9,9,0,2,1,1,4,20
18909,POR,2024,Taze Moore,25,4,0,40,8,19,.421,1,7,.143,7,12,.583,.447,1,2,.500,4,4,8,5,2,0,3,4,18
18910,POR,2023,Jerami Grant,28,63,63,2246,434,913,.475,144,359,.401,290,554,.523,.554,278,342,.813,53,230,283,150,51,53,116,152,1290
18911,POR,2023,Anfernee Simons,23,62,62,2171,467,1045,.447,212,562,.377,255,483,.528,.548,160,179,.894,18,143,161,253,42,14,128,142,1306
18912,POR,2023,Damian Lillard,32,58,58,2107,556,1202,.463,244,658,.371,312,544,.574,.564,510,558,.914,44,233,277,425,50,18,191,109,1866
18913,POR,2023,Shaedon Sharpe,19,80,15,1779,306,648,.472,102,283,.360,204,365,.559,.551,75,105,.714,63,173,236,94,38,24,83,136,789
18914,POR,2023,Josh Hart,27,51,51,1704,183,363,.504,34,112,.304,149,251,.594,.551,87,119,.731,95,322,417,200,54,9,79,133,487
18915,POR,2023,Drew Eubanks,25,78,28,1584,214,334,.641,7,18,.389,207,316,.655,.651,83,125,.664,132,286,418,103,40,102,67,169,518
18916,POR,2023,Jusuf Nurkić,28,52,52,1391,262,505,.519,43,119,.361,219,386,.567,.561,127,192,.661,114,357,471,149,43,44,119,185,694
18917,POR,2023,Trendon Watford,22,62,12,1182,181,323,.560,25,64,.391,156,259,.602,.599,72,100,.720,42,196,238,130,32,12,71,118,459
18918,POR,2023,Nassir Little,22,54,4,976,134,303,.442,58,158,.367,76,145,.524,.538,33,46,.717,27,114,141,50,20,20,36,66,359
18919,POR,2023,Justise Winslow,26,29,11,776,81,198,.409,14,45,.311,67,153,.438,.444,20,28,.714,49,96,145,98,30,11,43,89,196
18920,POR,2023,Jabari Walker,20,56,0,619,83,198,.419,16,56,.286,67,142,.472,.460,34,45,.756,48,83,131,34,10,13,29,69,216
18921,POR,2023,Matisse Thybulle,25,22,22,609,60,137,.438,33,85,.388,27,52,.519,.558,10,16,.625,20,57,77,30,38,18,16,48,163
18922,POR,2023,Cam Reddish,23,20,12,552,78,176,.443,28,88,.318,50,88,.568,.523,35,42,.833,11,46,57,37,24,6,32,40,219
18923,POR,2023,Keon Johnson,20,40,0,416,67,178,.376,28,81,.346,39,97,.402,.455,27,41,.659,11,33,44,59,19,6,43,43,189
18924,POR,2023,Kevin Knox,23,21,4,359,68,153,.444,22,70,.314,46,83,.554,.516,20,27,.741,14,55,69,18,10,0,18,21,178
18925,POR,2023,Gary Payton II,30,15,1,255,24,41,.585,9,17,.529,15,24,.625,.695,4,4,1.000,10,29,39,22,16,1,12,29,61
18926,POR,2023,John Butler,20,19,1,221,17,53,.321,8,35,.229,9,18,.500,.396,3,4,.750,3,14,17,11,7,9,1,22,45
18927,POR,2023,Skylar Mays,25,6,6,189,34,68,.500,12,26,.462,22,42,.524,.588,12,13,.923,2,17,19,50,6,1,10,11,92
18928,POR,2023,Ryan Arcidiacono,28,9,4,146,8,32,.250,7,20,.350,1,12,.083,.359,0,0,,0,11,11,21,3,0,6,14,23
18929,POR,2023,Jeenathan Williams,23,5,4,127,24,39,.615,3,8,.375,21,31,.677,.654,2,3,.667,10,5,15,10,3,2,4,13,53
18930,POR,2023,Shaquille Harrison,29,5,0,120,15,36,.417,3,10,.300,12,26,.462,.458,11,15,.733,1,21,22,30,11,2,6,12,44
18931,POR,2023,Greg Brown III,21,16,0,93,11,28,.393,1,7,.143,10,21,.476,.411,5,12,.417,2,17,19,3,4,5,6,13,28
18932,POR,2023,Justin Minaya,23,4,0,89,7,23,.304,3,12,.250,4,11,.364,.370,0,1,.000,3,12,15,4,2,5,4,9,17
18933,POR,2023,Chance Comanche,26,1,0,21,3,5,.600,0,0,,3,5,.600,.600,1,4,.250,2,1,3,0,0,1,0,0,7
18934,POR,2022,Anfernee Simons,22,57,30,1681,353,797,.443,179,442,.405,174,355,.490,.555,103,116,.888,26,125,151,221,30,6,115,110,988
18935,POR,2022,Jusuf Nurkić,27,56,56,1579,321,600,.535,15,56,.268,306,544,.563,.548,185,268,.690,167,452,619,157,62,34,143,189,842
18936,POR,2022,Robert Covington,31,48,40,1431,128,336,.381,79,230,.343,49,106,.462,.499,30,36,.833,41,233,274,68,74,63,58,132,365
18937,POR,2022,Norman Powell,28,40,39,1333,247,542,.456,93,229,.406,154,313,.492,.542,159,198,.803,17,114,131,82,40,17,62,92,746
18938,POR,2022,Ben McLemore,28,64,6,1285,216,539,.401,151,417,.362,65,122,.533,.541,72,88,.818,12,91,103,59,38,10,55,103,655
18939,POR,2022,CJ McCollum,30,36,36,1267,290,665,.436,111,289,.384,179,376,.476,.520,48,68,.706,34,119,153,163,36,21,70,77,739
18940,POR,2022,CJ Elleby,21,58,28,1174,121,308,.393,37,126,.294,84,182,.462,.453,60,84,.714,66,161,227,87,35,19,56,116,339
18941,POR,2022,Nassir Little,21,42,23,1088,145,315,.460,51,154,.331,94,161,.584,.541,69,94,.734,58,178,236,54,25,36,40,82,410
18942,POR,2022,Damian Lillard,31,29,29,1056,222,552,.402,92,284,.324,130,268,.485,.486,159,181,.878,13,107,120,212,17,11,83,37,695
18943,POR,2022,Trendon Watford,21,48,10,869,142,267,.532,9,38,.237,133,229,.581,.549,71,94,.755,57,142,199,81,25,28,44,116,364
18944,POR,2022,Larry Nance Jr.,29,37,11,858,102,198,.515,19,62,.306,83,136,.610,.563,32,49,.653,58,151,209,73,38,13,27,67,255
18945,POR,2022,Drew Eubanks,24,22,22,650,137,212,.646,4,15,.267,133,197,.675,.656,40,51,.784,66,120,186,35,18,10,35,61,318
18946,POR,2022,Greg Brown III,20,48,6,640,81,190,.426,19,61,.311,62,129,.481,.476,44,65,.677,38,97,135,35,26,24,36,90,225
18947,POR,2022,Brandon Williams,22,24,16,640,105,282,.372,31,106,.292,74,176,.420,.427,68,97,.701,19,55,74,94,24,10,58,52,309
18948,POR,2022,Dennis Smith Jr.,24,37,4,638,79,189,.418,6,27,.222,73,162,.451,.434,42,64,.656,20,68,88,132,45,12,51,52,206
18949,POR,2022,Keon Johnson,19,22,12,562,79,221,.357,31,89,.348,48,132,.364,.428,25,30,.833,18,42,60,63,21,10,39,48,214
18950,POR,2022,Tony Snell,30,38,10,546,36,97,.371,24,75,.320,12,22,.545,.495,3,3,1.000,11,61,72,20,8,7,11,44,99
18951,POR,2022,Josh Hart,26,13,13,417,92,183,.503,31,83,.373,61,100,.610,.587,44,57,.772,9,61,70,56,16,2,33,32,259
18952,POR,2022,Cody Zeller,29,27,0,355,51,90,.567,0,4,.000,51,86,.593,.567,38,49,.776,50,75,125,22,8,6,19,56,140
18953,POR,2022,Keljin Blevins,26,31,1,349,34,111,.306,21,72,.292,13,39,.333,.401,6,11,.545,16,29,45,19,13,1,17,29,95
18954,POR,2022,Kris Dunn,27,14,3,336,44,102,.431,1,11,.091,43,91,.473,.436,17,18,.944,9,40,49,79,23,3,32,38,106
18955,POR,2022,Elijah Hughes,23,22,3,322,32,108,.296,15,67,.224,17,41,.415,.366,4,6,.667,4,37,41,16,10,7,10,32,83
18956,POR,2022,Justise Winslow,25,11,10,295,47,116,.405,10,37,.270,37,79,.468,.448,14,25,.560,20,49,69,32,14,7,12,21,118
18957,POR,2022,Reggie Perry,21,9,1,177,39,78,.500,3,16,.188,36,62,.581,.519,9,15,.600,15,31,46,12,9,6,11,30,90
18958,POR,2022,Didi Louzada,22,7,1,122,12,30,.400,9,20,.450,3,10,.300,.550,2,2,1.000,3,12,15,4,2,2,5,13,35
18959,POR,2022,Cameron McGriff,24,3,0,46,5,14,.357,2,6,.333,3,8,.375,.429,2,2,1.000,6,9,15,3,0,1,0,7,14
18960,POR,2022,Jarron Cumberland,24,3,0,12,1,2,.500,0,1,.000,1,1,1.000,.500,0,0,,1,2,3,1,0,0,0,2,2
18961,POR,2021,Damian Lillard,30,67,67,2398,602,1334,.451,275,704,.391,327,630,.519,.554,449,484,.928,32,251,283,505,62,17,203,102,1928
18962,POR,2021,Robert Covington,30,70,70,2243,204,509,.401,135,356,.379,69,153,.451,.533,50,62,.806,61,405,466,117,101,84,64,195,593
18963,POR,2021,Enes Freedom,28,72,35,1758,339,561,.604,1,4,.250,338,557,.607,.605,127,164,.774,284,511,795,84,33,48,78,168,806
18964,POR,2021,Carmelo Anthony,36,69,3,1690,327,777,.421,133,325,.409,194,452,.429,.506,137,154,.890,32,182,214,104,46,38,61,144,924
18965,POR,2021,CJ McCollum,29,47,47,1600,405,884,.458,169,420,.402,236,464,.509,.554,108,133,.812,30,155,185,223,44,21,65,87,1087
18966,POR,2021,Derrick Jones Jr.,23,58,43,1318,147,304,.484,43,136,.316,104,168,.619,.554,59,91,.648,77,128,205,47,37,54,32,127,396
18967,POR,2021,Gary Trent Jr.,22,41,23,1262,217,524,.414,121,305,.397,96,219,.438,.530,58,75,.773,21,70,91,58,37,6,31,63,613
18968,POR,2021,Anfernee Simons,21,64,0,1104,168,401,.419,120,282,.426,48,119,.403,.569,46,57,.807,14,126,140,89,18,8,43,96,502
18969,POR,2021,Norman Powell,27,27,27,928,156,352,.443,53,147,.361,103,205,.502,.518,95,108,.880,23,66,89,52,35,10,42,62,460
18970,POR,2021,Jusuf Nurkić,26,37,37,880,171,333,.514,12,30,.400,159,303,.525,.532,70,113,.619,86,246,332,125,38,39,73,103,424
18971,POR,2021,Rodney Hood,28,38,5,726,73,201,.363,25,84,.298,48,117,.410,.425,9,12,.750,18,55,73,47,20,4,31,59,180
18972,POR,2021,Nassir Little,20,48,2,640,78,167,.467,28,80,.350,50,87,.575,.551,36,45,.800,32,96,128,23,5,13,18,51,220
18973,POR,2021,Harry Giles,22,38,0,348,42,97,.433,8,23,.348,34,74,.459,.474,16,27,.593,31,102,133,29,8,13,20,54,108
18974,POR,2021,CJ Elleby,20,30,0,192,25,66,.379,7,34,.206,18,32,.563,.432,11,15,.733,11,21,32,10,6,3,5,27,68
18975,POR,2021,Rondae Hollis-Jefferson,26,11,1,107,9,18,.500,0,1,.000,9,17,.529,.500,9,16,.563,11,15,26,13,2,4,2,15,27
18976,POR,2021,Keljin Blevins,25,17,0,75,5,20,.250,2,8,.250,3,12,.250,.300,0,0,,3,7,10,4,2,0,5,8,12
18977,POR,2021,T.J. Leaf,23,7,0,35,5,10,.500,0,0,,5,10,.500,.500,2,2,1.000,0,5,5,1,2,1,2,1,12
18978,POR,2020,CJ McCollum,28,70,70,2556,611,1356,.451,194,512,.379,417,844,.494,.522,140,185,.757,46,251,297,310,54,42,127,183,1556
18979,POR,2020,Damian Lillard,29,66,66,2474,624,1349,.463,270,674,.401,354,675,.524,.563,460,518,.888,33,251,284,530,70,22,194,114,1978
18980,POR,2020,Hassan Whiteside,30,67,61,2008,436,702,.621,4,7,.571,432,695,.622,.624,164,239,.686,258,647,905,78,26,196,120,196,1040
18981,POR,2020,Carmelo Anthony,35,58,58,1902,336,782,.430,87,226,.385,249,556,.448,.485,136,161,.845,71,297,368,85,49,27,100,171,895
18982,POR,2020,Anfernee Simons,20,70,4,1449,214,536,.399,75,226,.332,139,310,.448,.469,76,92,.826,25,127,152,97,26,10,61,135,579
18983,POR,2020,Gary Trent Jr.,21,61,8,1332,196,441,.444,112,268,.418,84,173,.486,.571,37,45,.822,25,75,100,61,48,16,21,90,541
18984,POR,2020,Kent Bazemore,30,43,21,1111,113,326,.347,56,171,.327,57,155,.368,.433,58,72,.806,13,159,172,61,45,31,60,121,340
18985,POR,2020,Mario Hezonja,24,53,4,871,92,218,.422,24,78,.308,68,140,.486,.477,48,59,.814,30,154,184,50,36,9,42,107,256
18986,POR,2020,Trevor Ariza,34,21,21,702,78,159,.491,34,85,.400,44,74,.595,.597,41,47,.872,13,87,100,41,34,8,28,48,231
18987,POR,2020,Rodney Hood,27,21,21,619,87,172,.506,35,71,.493,52,101,.515,.608,21,27,.778,10,62,72,32,17,4,19,46,230
18988,POR,2020,Nassir Little,19,48,5,573,65,151,.430,14,59,.237,51,92,.554,.477,28,44,.636,31,77,108,22,13,14,15,72,172
18989,POR,2020,Skal Labissière,23,33,1,567,81,147,.551,3,13,.231,78,134,.582,.561,25,33,.758,65,104,169,42,7,31,30,89,190
18990,POR,2020,Anthony Tolliver,34,33,9,554,43,117,.368,30,89,.337,13,28,.464,.496,13,19,.684,27,83,110,29,8,9,21,54,129
18991,POR,2020,Zach Collins,22,11,11,290,32,68,.471,7,19,.368,25,49,.510,.522,6,8,.750,25,44,69,16,5,5,14,36,77
18992,POR,2020,Caleb Swanigan,22,20,1,265,26,43,.605,0,2,.000,26,41,.634,.605,8,15,.533,25,68,93,29,2,5,31,54,60
18993,POR,2020,Jusuf Nurkić,25,8,8,253,54,109,.495,2,10,.200,52,99,.525,.505,31,35,.886,23,59,82,32,11,16,19,39,141
18994,POR,2020,Wenyen Gabriel,22,19,1,174,15,31,.484,5,12,.417,10,19,.526,.565,9,12,.750,17,25,42,5,8,5,11,32,44
18995,POR,2020,Jaylen Hoard,20,13,0,103,15,32,.469,0,3,.000,15,29,.517,.469,8,13,.615,14,18,32,4,5,0,4,12,38
18996,POR,2020,Moses Brown,20,9,0,33,4,10,.400,0,0,,4,10,.400,.400,3,8,.375,3,11,14,1,1,1,3,7,11
18997,POR,2019,Damian Lillard,28,80,80,2838,681,1533,.444,237,643,.369,444,890,.499,.522,468,513,.912,68,303,371,551,88,34,212,148,2067
18998,POR,2019,CJ McCollum,27,70,70,2375,571,1243,.459,167,445,.375,404,798,.506,.527,159,192,.828,62,220,282,207,55,28,106,172,1468
18999,POR,2019,Al-Farouq Aminu,28,81,81,2292,257,593,.433,96,280,.343,161,313,.514,.514,150,173,.867,112,498,610,104,68,33,72,143,760
19000,POR,2019,Jusuf Nurkić,24,72,72,1974,420,826,.508,3,29,.103,417,797,.523,.510,282,365,.773,243,505,748,233,71,103,168,250,1125
19001,POR,2019,Evan Turner,30,73,2,1605,204,443,.460,11,52,.212,193,391,.494,.473,75,106,.708,37,291,328,283,33,18,114,110,494
19002,POR,2019,Maurice Harkless,25,60,53,1415,189,388,.487,33,120,.275,156,268,.582,.530,49,73,.671,77,192,269,74,67,53,45,163,460
19003,POR,2019,Seth Curry,28,74,2,1399,212,465,.456,113,251,.450,99,214,.463,.577,44,52,.846,27,93,120,66,36,12,61,97,581
19004,POR,2019,Zach Collins,21,77,0,1356,189,400,.473,40,121,.331,149,279,.534,.523,94,126,.746,109,215,324,71,25,66,77,174,512
19005,POR,2019,Jake Layman,24,71,33,1327,216,424,.509,59,181,.326,157,243,.646,.579,50,71,.704,56,161,217,53,31,30,46,116,541
19006,POR,2019,Meyers Leonard,26,61,2,878,132,242,.545,50,111,.450,82,131,.626,.649,43,51,.843,49,184,233,75,13,9,43,105,357
19007,POR,2019,Nik Stauskas,25,44,0,673,96,229,.419,43,125,.344,53,104,.510,.513,32,36,.889,10,70,80,62,14,4,40,31,267
19008,POR,2019,Rodney Hood,26,27,4,659,98,217,.452,29,84,.345,69,133,.519,.518,33,41,.805,7,38,45,34,21,7,19,45,258
19009,POR,2019,Enes Freedom,26,23,8,512,124,215,.577,3,12,.250,121,203,.596,.584,50,68,.735,86,112,198,32,14,9,39,61,301
19010,POR,2019,Caleb Swanigan,21,18,0,145,14,44,.318,1,5,.200,13,39,.333,.330,6,7,.857,13,39,52,7,4,0,16,22,35
19011,POR,2019,Anfernee Simons,19,20,1,141,28,63,.444,10,29,.345,18,34,.529,.524,9,16,.563,3,10,13,13,1,0,11,9,75
19012,POR,2019,Gary Trent Jr.,20,15,1,111,16,50,.320,5,21,.238,11,29,.379,.370,3,7,.429,1,10,11,5,1,2,4,4,40
19013,POR,2019,Wade Baldwin,22,16,0,94,10,33,.303,2,9,.222,8,24,.333,.333,8,11,.727,2,13,15,12,1,2,14,11,30
19014,POR,2019,Skal Labissière,22,9,1,63,13,19,.684,2,2,1.000,11,17,.647,.737,3,6,.500,5,14,19,5,3,3,4,8,31
19015,POR,2018,CJ McCollum,26,81,81,2923,667,1505,.443,189,476,.397,478,1029,.465,.506,209,250,.836,53,268,321,272,77,35,151,168,1732
19016,POR,2018,Damian Lillard,27,73,73,2670,621,1415,.439,227,629,.361,394,786,.501,.519,493,538,.916,62,263,325,481,77,27,206,117,1962
19017,POR,2018,Jusuf Nurkić,23,79,79,2088,480,951,.505,0,7,.000,480,944,.508,.505,172,273,.630,189,519,708,143,64,111,183,247,1132
19018,POR,2018,Al-Farouq Aminu,27,69,67,2072,230,582,.395,125,339,.369,105,243,.432,.503,59,80,.738,97,428,525,84,79,40,79,136,644
19019,POR,2018,Evan Turner,29,79,40,2034,258,577,.447,42,132,.318,216,445,.485,.484,91,107,.850,30,214,244,173,47,29,99,163,649
19020,POR,2018,Shabazz Napier,26,74,9,1535,223,531,.420,82,218,.376,141,313,.450,.497,116,138,.841,26,144,170,150,81,14,90,84,644
19021,POR,2018,Pat Connaughton,25,82,5,1488,165,390,.423,74,210,.352,91,180,.506,.518,37,44,.841,36,125,161,91,23,22,43,120,441
19022,POR,2018,Ed Davis,28,78,0,1471,170,292,.582,0,1,.000,170,291,.584,.582,74,111,.667,183,392,575,40,32,52,66,188,414
19023,POR,2018,Maurice Harkless,24,59,37,1264,147,297,.495,49,118,.415,98,179,.547,.577,42,59,.712,46,116,162,53,48,43,40,103,385
19024,POR,2018,Zach Collins,20,66,1,1045,115,289,.398,35,113,.310,80,176,.455,.458,27,42,.643,45,176,221,52,17,31,58,133,292
19025,POR,2018,Noah Vonleh,22,33,12,476,47,96,.490,2,6,.333,45,90,.500,.500,23,31,.742,35,132,167,13,6,11,15,42,119
19026,POR,2018,Meyers Leonard,25,33,2,254,46,78,.590,11,26,.423,35,52,.673,.660,9,11,.818,12,58,70,17,7,0,10,36,112
19027,POR,2018,Caleb Swanigan,20,27,3,189,24,60,.400,1,8,.125,23,52,.442,.408,12,18,.667,15,39,54,14,5,3,18,37,61
19028,POR,2018,Jake Layman,23,35,1,160,14,47,.298,4,20,.200,10,27,.370,.340,2,3,.667,4,12,16,11,6,4,5,13,34
19029,POR,2018,Wade Baldwin,21,7,0,80,14,21,.667,4,5,.800,10,16,.625,.762,6,10,.600,1,7,8,5,2,1,4,12,38
19030,POR,2018,Georgios Papagiannis,20,1,0,4,1,1,1.000,0,0,,1,1,1.000,1.000,0,0,,1,0,1,0,2,0,0,0,2
19031,POR,2017,CJ McCollum,25,80,80,2796,692,1441,.480,185,439,.421,507,1002,.506,.544,268,294,.912,60,229,289,285,72,42,172,202,1837
19032,POR,2017,Damian Lillard,26,75,75,2694,661,1488,.444,214,579,.370,447,909,.492,.516,488,545,.895,46,322,368,440,68,20,197,152,2024
19033,POR,2017,Allen Crabbe,24,79,7,2254,303,647,.468,134,302,.444,169,345,.490,.572,105,124,.847,19,207,226,94,54,20,62,171,845
19034,POR,2017,Maurice Harkless,23,77,69,2223,314,624,.503,68,194,.351,246,430,.572,.558,77,124,.621,125,216,341,88,85,70,86,214,773
19035,POR,2017,Al-Farouq Aminu,26,61,25,1773,183,466,.393,70,212,.330,113,254,.445,.468,96,136,.706,77,374,451,99,60,44,94,102,532
19036,POR,2017,Evan Turner,28,65,12,1658,235,552,.426,31,118,.263,204,434,.470,.454,85,103,.825,36,211,247,205,53,24,100,121,586
19037,POR,2017,Mason Plumlee,26,54,54,1516,235,442,.532,0,5,.000,235,437,.538,.532,127,224,.567,120,312,432,214,50,63,88,149,597
19038,POR,2017,Noah Vonleh,21,74,41,1265,130,270,.481,7,20,.350,123,250,.492,.494,60,94,.638,131,256,387,31,30,27,64,154,327
19039,POR,2017,Meyers Leonard,24,74,12,1222,146,378,.386,74,213,.347,72,165,.436,.484,35,40,.875,27,210,237,71,13,28,35,172,401
19040,POR,2017,Ed Davis,27,46,12,789,75,142,.528,0,0,,75,142,.528,.528,50,81,.617,96,148,244,26,15,22,37,137,200
19041,POR,2017,Jusuf Nurkić,22,20,19,584,120,236,.508,0,1,.000,120,235,.511,.508,64,97,.660,65,142,207,63,25,38,62,73,304
19042,POR,2017,Shabazz Napier,25,53,2,512,73,183,.399,34,92,.370,39,91,.429,.492,38,49,.776,8,53,61,67,32,2,41,38,218
19043,POR,2017,Pat Connaughton,24,39,1,316,37,72,.514,17,33,.515,20,39,.513,.632,7,9,.778,10,42,52,28,6,2,17,23,98
19044,POR,2017,Jake Layman,22,35,1,249,26,89,.292,13,51,.255,13,38,.342,.365,13,17,.765,6,18,24,11,9,3,11,22,78
19045,POR,2017,Tim Quarterman,22,16,0,80,13,29,.448,5,13,.385,8,16,.500,.534,0,3,.000,4,10,14,11,2,3,11,6,31
19046,POR,2016,CJ McCollum,24,80,80,2780,641,1431,.448,197,472,.417,444,959,.463,.517,187,226,.827,47,212,259,341,97,23,196,187,1666
19047,POR,2016,Damian Lillard,25,75,75,2676,618,1474,.419,229,610,.375,389,864,.450,.497,414,464,.892,45,257,302,512,65,28,242,165,1879
19048,POR,2016,Al-Farouq Aminu,25,82,82,2341,299,719,.416,126,349,.361,173,370,.468,.503,115,156,.737,98,401,499,138,72,53,120,171,839
19049,POR,2016,Allen Crabbe,23,81,8,2105,311,678,.459,112,285,.393,199,393,.506,.541,98,113,.867,27,189,216,99,63,16,64,192,832
19050,POR,2016,Mason Plumlee,25,82,82,2084,267,517,.516,0,4,.000,267,513,.520,.516,215,335,.642,201,427,628,226,68,85,154,253,749
19051,POR,2016,Ed Davis,26,81,0,1684,206,337,.611,0,0,,206,337,.611,.611,114,204,.559,224,375,599,88,57,72,64,202,526
19052,POR,2016,Maurice Harkless,22,78,14,1457,195,411,.474,39,140,.279,156,271,.576,.522,69,111,.622,101,179,280,67,49,35,62,124,498
19053,POR,2016,Gerald Henderson,28,72,0,1431,232,529,.439,48,136,.353,184,393,.468,.484,112,146,.767,30,181,211,75,39,19,68,87,624
19054,POR,2016,Meyers Leonard,23,61,10,1333,195,435,.448,86,228,.377,109,207,.527,.547,35,46,.761,51,263,314,92,8,18,77,183,511
19055,POR,2016,Noah Vonleh,20,78,56,1174,117,278,.421,11,46,.239,106,232,.457,.441,38,51,.745,91,214,305,30,27,26,50,152,283
19056,POR,2016,Tim Frazier,25,35,1,272,20,60,.333,3,17,.176,17,43,.395,.358,8,15,.533,11,28,39,42,10,1,27,31,51
19057,POR,2016,Pat Connaughton,23,34,0,143,13,49,.265,5,21,.238,8,28,.286,.316,5,5,1.000,11,21,32,10,2,0,10,6,36
19058,POR,2016,Brian Roberts,30,21,0,137,23,50,.460,6,15,.400,17,35,.486,.520,8,10,.800,2,10,12,16,3,1,7,12,60
19059,POR,2016,Chris Kaman,33,16,2,112,20,43,.465,1,4,.250,19,39,.487,.477,3,3,1.000,7,17,24,11,1,1,8,15,44
19060,POR,2016,Luis Montero,22,12,0,42,5,19,.263,1,9,.111,4,10,.400,.289,3,4,.750,0,4,4,1,0,0,4,1,14
19061,POR,2016,Cliff Alexander,20,8,0,36,5,10,.500,0,0,,5,10,.500,.500,0,0,,2,4,6,0,1,2,1,1,10
19062,POR,2015,Damian Lillard,24,82,82,2925,590,1360,.434,196,572,.343,394,788,.500,.506,344,398,.864,49,329,378,507,97,21,222,164,1720
19063,POR,2015,LaMarcus Aldridge,29,71,71,2512,659,1415,.466,37,105,.352,622,1310,.475,.479,306,362,.845,177,549,726,124,48,68,122,125,1661
19064,POR,2015,Nicolas Batum,26,71,71,2380,240,600,.400,100,309,.324,140,291,.481,.483,84,98,.857,62,354,416,341,78,40,132,106,664
19065,POR,2015,Wesley Matthews,28,60,60,2024,337,752,.448,173,445,.389,164,307,.534,.563,109,145,.752,38,184,222,139,77,10,81,132,956
19066,POR,2015,Robin Lopez,26,59,59,1638,234,437,.535,0,1,.000,234,436,.537,.535,98,127,.772,190,204,394,55,16,84,73,122,566
19067,POR,2015,Steve Blake,34,81,0,1529,122,327,.373,77,219,.352,45,108,.417,.491,29,41,.707,16,121,137,288,41,5,104,118,350
19068,POR,2015,Chris Kaman,32,74,13,1398,283,549,.515,0,0,,283,549,.515,.515,72,102,.706,149,335,484,65,18,54,108,140,638
19069,POR,2015,CJ McCollum,23,62,3,973,159,365,.436,55,139,.396,104,226,.460,.511,51,73,.699,14,77,91,64,43,8,48,81,424
19070,POR,2015,Meyers Leonard,22,55,7,847,125,245,.510,47,112,.420,78,133,.586,.606,30,32,.938,46,204,250,32,10,14,39,113,327
19071,POR,2015,Arron Afflalo,29,25,19,752,94,227,.414,36,90,.400,58,137,.423,.493,40,47,.851,6,61,67,28,9,2,33,59,264
19072,POR,2015,Allen Crabbe,22,51,9,683,63,153,.412,30,85,.353,33,68,.485,.510,12,16,.750,7,66,73,39,19,15,15,74,168
19073,POR,2015,Joel Freeland,27,48,8,617,74,151,.490,0,0,,74,151,.490,.490,21,25,.840,62,129,191,16,9,23,23,93,169
19074,POR,2015,Dorell Wright,29,48,2,592,72,190,.379,41,108,.380,31,82,.378,.487,34,42,.810,14,97,111,41,20,11,18,55,219
19075,POR,2015,Thomas Robinson,23,32,4,391,47,91,.516,0,0,,47,91,.516,.516,21,48,.438,33,100,133,9,16,11,33,54,115
19076,POR,2015,Will Barton,24,30,0,300,38,100,.380,4,18,.222,34,82,.415,.400,10,15,.667,3,31,34,27,14,4,17,20,90
19077,POR,2015,Alonzo Gee,27,15,2,151,21,49,.429,3,11,.273,18,38,.474,.459,6,12,.500,8,16,24,6,7,1,8,16,51
19078,POR,2015,Victor Claver,26,10,0,76,9,20,.450,6,11,.545,3,9,.333,.600,0,0,,3,17,20,1,1,1,4,12,24
19079,POR,2015,Tim Frazier,24,5,0,68,8,18,.444,2,6,.333,6,12,.500,.500,5,6,.833,2,7,9,17,2,0,7,10,23
19080,POR,2014,Nicolas Batum,25,82,82,2956,381,819,.465,145,402,.361,236,417,.566,.554,163,203,.803,116,495,611,420,75,57,208,156,1070
19081,POR,2014,Damian Lillard,23,82,82,2937,553,1304,.424,218,554,.394,335,750,.447,.508,371,426,.871,35,253,288,457,64,22,193,197,1695
19082,POR,2014,Wesley Matthews,27,82,82,2780,445,1009,.441,201,511,.393,244,498,.490,.541,252,301,.837,51,238,289,197,76,14,110,176,1343
19083,POR,2014,Robin Lopez,25,82,82,2603,355,644,.551,0,1,.000,355,643,.552,.551,198,242,.818,326,374,700,73,25,139,84,196,908
19084,POR,2014,LaMarcus Aldridge,28,69,69,2498,652,1423,.458,3,15,.200,649,1408,.461,.459,296,360,.822,166,599,765,178,63,68,123,147,1603
19085,POR,2014,Mo Williams,31,74,0,1834,280,672,.417,83,225,.369,197,447,.441,.478,78,89,.876,42,111,153,321,55,10,149,197,721
19086,POR,2014,Dorell Wright,28,68,13,984,111,297,.374,69,202,.342,42,95,.442,.490,52,69,.754,29,162,191,64,23,16,39,62,343
19087,POR,2014,Thomas Robinson,22,70,0,873,141,293,.481,0,1,.000,141,292,.483,.481,57,101,.564,105,202,307,34,23,20,57,131,339
19088,POR,2014,Joel Freeland,26,52,0,727,77,162,.475,0,2,.000,77,160,.481,.475,20,29,.690,88,120,208,36,10,22,32,95,174
19089,POR,2014,CJ McCollum,22,38,0,476,74,178,.416,30,80,.375,44,98,.449,.500,23,34,.676,7,41,48,27,14,2,35,53,201
19090,POR,2014,Will Barton,23,41,0,387,65,156,.417,10,33,.303,55,123,.447,.449,26,32,.813,16,58,74,33,9,7,18,31,166
19091,POR,2014,Meyers Leonard,21,40,0,355,41,91,.451,0,6,.000,41,85,.482,.451,16,21,.762,26,85,111,18,7,5,15,76,98
19092,POR,2014,Victor Claver,25,21,0,184,17,42,.405,3,18,.167,14,24,.583,.440,10,11,.909,9,30,39,12,3,3,11,16,47
19093,POR,2014,Earl Watson,34,24,0,161,3,11,.273,2,7,.286,1,4,.250,.364,4,4,1.000,5,10,15,28,5,1,17,33,12
19094,POR,2014,Allen Crabbe,21,15,0,100,12,33,.364,6,14,.429,6,19,.316,.455,3,4,.750,1,8,9,6,2,1,3,10,33
19095,POR,2013,Damian Lillard,22,82,82,3167,553,1288,.429,185,503,.368,368,785,.469,.501,271,321,.844,42,215,257,531,74,19,243,172,1562
19096,POR,2013,Nicolas Batum,24,73,73,2807,352,833,.423,165,444,.372,187,389,.481,.522,178,210,.848,97,315,412,360,91,83,190,139,1047
19097,POR,2013,LaMarcus Aldridge,27,74,74,2790,638,1318,.484,2,14,.143,636,1304,.488,.485,282,348,.810,175,495,670,192,62,91,143,187,1560
19098,POR,2013,Wesley Matthews,26,69,69,2403,352,808,.436,169,425,.398,183,383,.478,.540,149,187,.797,35,156,191,174,90,18,109,172,1022
19099,POR,2013,J.J. Hickson,24,80,80,2323,418,744,.562,0,2,.000,418,742,.563,.562,182,268,.679,266,562,828,88,48,51,145,160,1018
19100,POR,2013,Meyers Leonard,20,69,9,1206,151,277,.545,3,7,.429,148,270,.548,.551,72,89,.809,80,175,255,33,11,38,49,168,377
19101,POR,2013,Will Barton,22,73,5,894,118,309,.382,9,65,.138,109,244,.447,.396,50,65,.769,36,109,145,58,34,9,60,56,295
19102,POR,2013,Victor Claver,24,49,16,812,74,189,.392,25,87,.287,49,102,.480,.458,14,30,.467,31,88,119,43,26,12,43,75,187
19103,POR,2013,Luke Babbitt,23,62,0,730,86,234,.368,62,178,.348,24,56,.429,.500,10,13,.769,15,122,137,29,14,5,22,82,244
19104,POR,2013,Eric Maynor,25,27,0,572,70,166,.422,19,50,.380,51,116,.440,.479,28,41,.683,4,24,28,109,12,1,48,36,187
19105,POR,2013,Sasha Pavlović,29,39,1,528,42,119,.353,18,60,.300,24,59,.407,.429,1,6,.167,7,49,56,32,24,5,14,59,103
19106,POR,2013,Ronnie Price,29,39,0,510,39,120,.325,10,39,.256,29,81,.358,.367,17,24,.708,13,31,44,73,26,3,34,61,105
19107,POR,2013,Joel Freeland,25,51,1,477,58,142,.408,0,0,,58,142,.408,.408,18,27,.667,40,79,119,13,13,11,19,67,134
19108,POR,2013,Jared Jeffries,31,38,0,350,16,54,.296,0,2,.000,16,52,.308,.296,12,23,.522,26,34,60,14,6,6,17,58,44
19109,POR,2013,Nolan Smith,24,40,0,288,42,114,.368,6,28,.214,36,86,.419,.395,20,28,.714,7,20,27,35,7,1,29,26,110
19110,POR,2012,Wesley Matthews,25,66,53,2228,314,763,.412,129,337,.383,185,426,.434,.496,147,171,.860,56,168,224,113,96,15,73,148,904
19111,POR,2012,LaMarcus Aldridge,26,55,55,1994,483,943,.512,2,11,.182,481,932,.516,.513,223,274,.814,150,292,442,134,51,45,111,153,1191
19112,POR,2012,Raymond Felton,27,60,56,1906,261,642,.407,62,203,.305,199,439,.453,.455,100,124,.806,27,122,149,390,78,10,170,122,684
19113,POR,2012,Nicolas Batum,23,59,34,1791,289,641,.451,107,274,.391,182,367,.496,.534,133,159,.836,81,190,271,84,57,60,90,105,818
19114,POR,2012,Jamal Crawford,31,60,6,1613,283,737,.384,80,260,.308,203,477,.426,.438,191,206,.927,16,102,118,191,55,14,111,74,837
19115,POR,2012,Gerald Wallace,29,42,42,1503,203,430,.472,26,98,.265,177,332,.533,.502,125,161,.776,63,214,277,115,62,25,84,107,557
19116,POR,2012,Marcus Camby,37,40,40,894,67,161,.416,0,0,,67,161,.416,.416,18,38,.474,105,249,354,75,33,56,47,88,152
19117,POR,2012,Kurt Thomas,39,53,3,803,73,157,.465,0,0,,73,157,.465,.465,14,20,.700,39,149,188,46,24,31,31,123,160
19118,POR,2012,J.J. Hickson,23,19,10,600,119,219,.543,0,1,.000,119,218,.546,.543,49,76,.645,66,92,158,23,12,18,31,41,287
19119,POR,2012,Nolan Smith,23,44,4,541,67,180,.372,13,45,.289,54,135,.400,.408,20,28,.714,17,39,56,62,18,3,42,55,167
19120,POR,2012,Luke Babbitt,22,40,4,537,71,173,.410,43,100,.430,28,73,.384,.535,17,20,.850,16,79,95,16,10,4,27,46,202
19121,POR,2012,Craig Smith,28,47,0,464,59,117,.504,0,1,.000,59,116,.509,.504,38,53,.717,33,77,110,19,16,5,24,55,156
19122,POR,2012,Joel Przybilla,32,27,19,449,22,48,.458,0,0,,22,48,.458,.458,11,18,.611,29,109,138,6,4,16,22,66,55
19123,POR,2012,Jonny Flynn,22,18,1,281,34,90,.378,8,25,.320,26,65,.400,.422,18,25,.720,7,24,31,68,3,1,27,15,94
19124,POR,2012,Elliot Williams,22,24,0,149,37,74,.500,8,27,.296,29,47,.617,.554,6,18,.333,7,12,19,6,6,3,5,18,88
19125,POR,2012,Hasheem Thabeet,24,15,3,116,8,18,.444,0,0,,8,18,.444,.444,13,20,.650,15,20,35,0,1,8,8,15,29
19126,POR,2012,Chris Johnson,26,20,0,93,11,23,.478,0,0,,11,23,.478,.478,10,12,.833,8,10,18,1,1,8,7,20,32
19127,POR,2012,Armon Johnson,22,1,0,5,1,1,1.000,0,0,,1,1,1.000,1.000,0,0,,0,1,1,0,1,0,1,0,2
19128,POR,2011,LaMarcus Aldridge,25,81,81,3211,707,1415,.500,4,23,.174,703,1392,.505,.501,351,444,.791,278,431,709,170,82,94,153,220,1769
19129,POR,2011,Wesley Matthews,24,82,69,2758,440,979,.449,154,378,.407,286,601,.476,.528,266,315,.844,48,210,258,164,102,9,138,195,1300
19130,POR,2011,Andre Miller,34,81,81,2650,388,844,.460,4,37,.108,384,807,.476,.462,249,292,.853,97,205,302,566,114,12,197,171,1029
19131,POR,2011,Nicolas Batum,22,80,67,2522,367,807,.455,118,342,.345,249,465,.535,.528,138,164,.841,109,252,361,123,68,49,83,194,990
19132,POR,2011,Rudy Fernández,25,78,3,1821,213,575,.370,116,361,.321,97,214,.453,.471,126,146,.863,37,135,172,193,87,14,88,134,668
19133,POR,2011,Marcus Camby,36,59,51,1540,117,294,.398,0,1,.000,117,293,.399,.398,43,70,.614,182,424,606,121,40,92,62,140,277
19134,POR,2011,Brandon Roy,26,47,23,1310,209,523,.400,38,114,.333,171,409,.418,.436,117,138,.848,28,93,121,129,37,12,55,76,573
19135,POR,2011,Dante Cunningham,23,56,9,1108,126,291,.433,0,4,.000,126,287,.439,.433,32,45,.711,73,116,189,30,39,32,33,139,284
19136,POR,2011,Gerald Wallace,28,23,15,821,134,269,.498,27,80,.338,107,189,.566,.548,69,90,.767,39,136,175,57,46,15,52,63,364
19137,POR,2011,Patty Mills,22,64,0,783,135,328,.412,47,133,.353,88,195,.451,.483,36,47,.766,19,32,51,109,27,1,62,63,353
19138,POR,2011,Joel Przybilla,31,31,9,445,21,34,.618,0,0,,21,34,.618,.618,13,23,.565,28,93,121,13,5,14,22,63,55
19139,POR,2011,Armon Johnson,21,38,0,277,46,101,.455,5,12,.417,41,89,.461,.480,13,22,.591,11,25,36,45,5,1,38,31,110
19140,POR,2011,Sean Marks,35,29,0,208,19,44,.432,2,2,1.000,17,42,.405,.455,5,8,.625,16,24,40,4,3,5,11,44,45
19141,POR,2011,Luke Babbitt,21,24,0,137,15,55,.273,3,16,.188,12,39,.308,.300,3,9,.333,6,24,30,6,2,2,8,15,36
19142,POR,2011,Chris Johnson,25,10,1,106,7,18,.389,0,0,,7,18,.389,.389,13,18,.722,11,16,27,2,3,6,8,18,27
19143,POR,2011,Fabricio Oberto,35,5,0,45,3,5,.600,0,0,,3,5,.600,.600,1,2,.500,3,4,7,0,0,0,3,10,7
19144,POR,2011,Earl Barron,29,2,1,37,3,11,.273,0,0,,3,11,.273,.273,1,2,.500,4,10,14,3,0,0,3,4,7
19145,POR,2011,Jarron Collins,32,5,0,24,1,6,.167,0,0,,1,6,.167,.167,0,0,,7,0,7,1,0,0,2,5,2
19146,POR,2010,LaMarcus Aldridge,24,78,78,2922,579,1169,.495,5,16,.313,574,1153,.498,.497,230,304,.757,192,435,627,160,67,48,104,231,1393
19147,POR,2010,Andre Miller,33,82,66,2500,404,908,.445,16,80,.200,388,828,.469,.454,322,392,.821,81,185,266,445,93,9,173,169,1146
19148,POR,2010,Brandon Roy,25,65,65,2419,491,1038,.473,73,221,.330,418,817,.512,.508,343,440,.780,73,212,285,305,61,16,129,136,1398
19149,POR,2010,Martell Webster,23,82,49,2005,259,639,.405,124,332,.373,135,307,.440,.502,126,155,.813,47,221,268,62,45,40,60,153,768
19150,POR,2010,Juwan Howard,36,73,27,1632,191,375,.509,0,1,.000,191,374,.511,.509,55,70,.786,108,227,335,61,27,10,72,191,437
19151,POR,2010,Rudy Fernández,24,62,2,1441,160,423,.378,98,266,.368,62,157,.395,.494,85,98,.867,35,129,164,127,62,11,72,87,503
19152,POR,2010,Steve Blake,29,51,28,1397,143,355,.403,78,207,.377,65,148,.439,.513,24,32,.750,15,103,118,203,37,2,65,84,388
19153,POR,2010,Jerryd Bayless,21,74,11,1304,200,483,.414,29,92,.315,171,391,.437,.444,201,242,.831,18,102,120,172,26,5,94,152,630
19154,POR,2010,Nicolas Batum,21,37,25,918,139,268,.519,54,132,.409,85,136,.625,.619,43,51,.843,32,109,141,44,24,25,27,83,375
19155,POR,2010,Marcus Camby,35,23,23,718,72,145,.497,0,1,.000,72,144,.500,.497,18,31,.581,83,172,255,35,26,47,27,56,162
19156,POR,2010,Dante Cunningham,22,63,2,707,106,214,.495,0,2,.000,106,212,.500,.495,31,48,.646,54,106,160,14,24,22,15,97,243
19157,POR,2010,Joel Przybilla,30,30,9,681,45,86,.523,0,0,,45,86,.523,.523,33,51,.647,72,166,238,8,8,43,39,95,123
19158,POR,2010,Greg Oden,22,21,21,502,92,152,.605,0,0,,92,152,.605,.605,49,64,.766,64,114,178,19,8,48,39,84,233
19159,POR,2010,Jeff Ayres,22,39,4,405,43,65,.662,0,0,,43,65,.662,.662,18,20,.900,25,73,98,1,7,16,12,76,104
19160,POR,2010,Travis Outlaw,25,11,0,231,38,101,.376,12,31,.387,26,70,.371,.436,21,24,.875,13,25,38,8,7,8,12,13,109
19161,POR,2010,Patty Mills,21,10,0,38,10,24,.417,2,4,.500,8,20,.400,.458,4,7,.571,1,1,2,5,0,0,4,6,26
19162,POR,2010,Travis Diener,27,5,0,26,1,4,.250,0,2,.000,1,2,.500,.250,1,2,.500,0,1,1,4,1,0,0,1,3
19163,POR,2010,Shavlik Randolph,26,3,0,6,1,3,.333,0,0,,1,3,.333,.333,2,2,1.000,0,1,1,1,0,0,1,0,4
19164,POR,2010,Anthony Tolliver,24,2,0,4,0,1,.000,0,1,.000,0,0,,.000,0,0,,0,1,1,0,0,0,0,1,0
19165,POR,2009,LaMarcus Aldridge,23,81,81,3004,601,1243,.484,7,28,.250,594,1215,.489,.486,261,334,.781,234,371,605,157,77,77,121,207,1470
19166,POR,2009,Brandon Roy,24,78,78,2903,633,1318,.480,83,220,.377,550,1098,.501,.512,416,505,.824,104,266,370,400,88,22,152,127,1765
19167,POR,2009,Travis Outlaw,24,81,6,2246,385,850,.453,89,236,.377,296,614,.482,.505,175,242,.723,70,261,331,83,47,57,94,168,1034
19168,POR,2009,Steve Blake,28,69,69,2188,277,647,.428,140,328,.427,137,319,.429,.536,63,75,.840,28,145,173,348,69,4,108,126,757
19169,POR,2009,Rudy Fernández,23,78,4,1993,268,630,.425,159,398,.399,109,232,.470,.552,120,143,.839,47,160,207,159,69,12,86,111,815
19170,POR,2009,Joel Przybilla,29,82,43,1952,168,269,.625,0,1,.000,168,268,.627,.625,112,169,.663,204,513,717,27,34,97,78,215,448
19171,POR,2009,Nicolas Batum,20,79,76,1454,161,361,.446,62,168,.369,99,193,.513,.532,42,52,.808,84,136,220,74,50,40,50,139,426
19172,POR,2009,Greg Oden,21,61,39,1314,198,351,.564,0,0,,198,351,.564,.564,144,226,.637,169,255,424,31,25,69,87,238,540
19173,POR,2009,Sergio Rodríguez,22,80,13,1225,129,329,.392,37,114,.325,92,215,.428,.448,61,77,.792,43,87,130,286,54,2,119,133,356
19174,POR,2009,Channing Frye,25,63,1,746,113,267,.423,11,33,.333,102,234,.436,.444,26,36,.722,41,99,140,24,17,16,29,106,263
19175,POR,2009,Jerryd Bayless,20,53,0,655,69,189,.365,7,27,.259,62,162,.383,.384,83,103,.806,8,49,57,78,16,2,56,81,228
19176,POR,2009,Ike Diogu,25,19,0,73,6,19,.316,0,0,,6,19,.316,.316,15,20,.750,12,5,17,0,1,2,6,9,27
19177,POR,2009,Shavlik Randolph,25,10,0,37,8,13,.615,1,1,1.000,7,12,.583,.654,1,4,.250,10,8,18,0,0,1,6,4,18
19178,POR,2009,Michael Ruffin,32,11,0,35,2,7,.286,0,0,,2,7,.286,.286,2,2,1.000,6,5,11,0,3,1,2,7,6
19179,POR,2009,Martell Webster,22,1,0,5,0,1,.000,0,1,.000,0,0,,.000,0,0,,0,0,0,0,0,0,0,0,0
19180,POR,2008,Brandon Roy,23,74,74,2792,531,1170,.454,73,215,.340,458,955,.480,.485,281,373,.753,81,267,348,430,79,16,136,147,1416
19181,POR,2008,LaMarcus Aldridge,22,76,76,2649,561,1160,.484,1,7,.143,560,1153,.486,.484,227,298,.762,220,358,578,122,55,94,126,240,1350
19182,POR,2008,Steve Blake,27,81,78,2424,261,640,.408,121,298,.406,140,342,.409,.502,49,64,.766,31,164,195,413,55,4,113,133,692
19183,POR,2008,Jarrett Jack,24,82,16,2229,267,620,.431,65,190,.342,202,430,.470,.483,215,248,.867,31,203,234,313,61,1,178,129,814
19184,POR,2008,Travis Outlaw,23,82,6,2186,417,964,.433,40,101,.396,377,863,.437,.453,218,294,.741,96,280,376,106,59,63,107,173,1092
19185,POR,2008,Martell Webster,21,75,70,2132,277,656,.422,123,317,.388,154,339,.454,.516,122,166,.735,54,242,296,90,42,28,83,159,799
19186,POR,2008,Joel Przybilla,28,77,67,1819,144,250,.576,0,1,.000,144,249,.578,.576,83,122,.680,195,454,649,27,13,93,95,234,371
19187,POR,2008,Channing Frye,24,78,20,1342,221,453,.488,3,10,.300,218,443,.492,.491,85,109,.780,107,247,354,57,29,27,55,208,530
19188,POR,2008,James Jones,27,58,3,1276,143,327,.437,91,205,.444,52,122,.426,.576,86,98,.878,43,118,161,34,24,15,28,96,463
19189,POR,2008,Sergio Rodríguez,21,72,0,628,69,196,.352,17,58,.293,52,138,.377,.395,25,38,.658,13,45,58,123,24,0,53,57,180
19190,POR,2008,Raef LaFrentz,31,39,0,291,27,61,.443,0,4,.000,27,57,.474,.443,11,19,.579,28,39,67,6,12,17,10,59,65
19191,POR,2008,Von Wafer,22,8,0,64,7,23,.304,3,11,.273,4,12,.333,.370,2,4,.500,0,9,9,2,0,2,2,3,19
19192,POR,2008,Taurean Green,21,8,0,44,4,16,.250,1,8,.125,3,8,.375,.281,8,8,1.000,0,4,4,8,1,0,7,3,17
19193,POR,2008,Josh McRoberts,20,8,0,28,6,10,.600,0,1,.000,6,9,.667,.600,0,0,,2,8,10,2,1,0,2,1,12
19194,POR,2007,Jarrett Jack,23,79,79,2651,320,705,.454,63,180,.350,257,525,.490,.499,243,279,.871,18,190,208,417,86,9,187,202,946
19195,POR,2007,Zach Randolph,25,68,67,2425,600,1286,.467,14,48,.292,586,1238,.473,.472,394,481,.819,199,489,688,147,53,15,215,184,1608
19196,POR,2007,Ime Udoka,29,75,75,2144,237,514,.461,89,219,.406,148,295,.502,.548,66,89,.742,95,184,279,112,71,17,73,207,629
19197,POR,2007,Brandon Roy,22,57,55,2015,349,765,.456,55,146,.377,294,619,.475,.492,202,241,.838,58,192,250,230,67,10,116,139,955
19198,POR,2007,Martell Webster,20,82,27,1759,195,492,.396,91,250,.364,104,242,.430,.489,93,132,.705,43,197,240,52,35,19,76,126,574
19199,POR,2007,Jamaal Magloire,28,81,23,1703,199,395,.504,0,0,,199,395,.504,.504,131,242,.541,151,341,492,30,21,66,129,226,529
19200,POR,2007,Travis Outlaw,22,67,1,1532,246,567,.434,10,37,.270,236,530,.445,.443,143,181,.790,65,152,217,52,61,74,66,150,645
19201,POR,2007,LaMarcus Aldridge,21,63,22,1392,241,479,.503,0,2,.000,241,477,.505,.503,83,115,.722,144,168,312,24,22,73,43,186,565
19202,POR,2007,Juan Dixon,28,55,1,1243,189,444,.426,52,143,.364,137,301,.455,.484,60,72,.833,16,69,85,82,49,7,77,112,490
19203,POR,2007,Sergio Rodríguez,20,67,1,862,101,239,.423,24,85,.282,77,154,.500,.473,21,26,.808,20,71,91,218,35,2,77,72,247
19204,POR,2007,Joel Przybilla,27,43,43,701,37,78,.474,0,0,,37,78,.474,.474,10,27,.370,59,109,168,12,10,67,40,124,84
19205,POR,2007,Fred Jones,27,24,3,449,43,112,.384,7,27,.259,36,85,.424,.415,22,26,.846,7,26,33,53,18,4,17,41,115
19206,POR,2007,Dan Dickau,28,50,3,444,54,151,.358,16,61,.262,38,90,.422,.411,42,53,.792,7,36,43,70,14,1,27,55,166
19207,POR,2007,Raef LaFrentz,30,27,9,352,39,102,.382,2,23,.087,37,79,.468,.392,20,26,.769,25,45,70,8,7,11,13,57,100
19208,POR,2007,Stephen Graham,24,14,1,165,17,40,.425,3,11,.273,14,29,.483,.463,8,9,.889,6,15,21,5,4,1,13,25,45
19209,POR,2007,Luke Schenscher,24,11,0,118,7,23,.304,0,0,,7,23,.304,.304,5,7,.714,10,15,25,1,2,4,4,25,19
19210,POR,2007,Jeremy Richardson,22,1,0,1,0,0,,0,0,,0,0,,,0,0,,0,0,0,0,0,0,0,0,0
19211,POR,2006,Zach Randolph,24,74,71,2545,536,1229,.436,16,55,.291,520,1174,.443,.443,245,343,.714,193,399,592,144,57,14,165,185,1333
19212,POR,2006,Juan Dixon,27,76,42,1920,357,821,.435,65,170,.382,292,651,.449,.474,156,194,.804,30,147,177,149,58,6,113,157,935
19213,POR,2006,Steve Blake,25,68,57,1781,206,470,.438,76,184,.413,130,286,.455,.519,72,91,.791,26,120,146,306,42,5,83,107,560
19214,POR,2006,Sebastian Telfair,20,68,30,1641,228,578,.394,57,162,.352,171,416,.411,.444,130,175,.743,19,101,120,247,66,6,115,167,643
19215,POR,2006,Jarrett Jack,22,79,4,1599,189,428,.442,20,76,.263,169,352,.480,.465,128,160,.800,18,142,160,219,41,2,102,138,526
19216,POR,2006,Viktor Khryapa,23,69,53,1492,158,342,.462,10,30,.333,148,312,.474,.477,77,111,.694,114,193,307,88,50,29,84,209,403
19217,POR,2006,Joel Przybilla,26,56,52,1395,131,239,.548,0,0,,131,239,.548,.548,82,154,.532,146,245,391,43,20,130,76,149,344
19218,POR,2006,Theo Ratliff,32,55,19,1301,108,189,.571,0,0,,108,189,.571,.571,54,83,.651,89,190,279,28,18,88,47,143,270
19219,POR,2006,Darius Miles,24,40,23,1286,235,510,.461,2,10,.200,233,500,.466,.463,87,163,.534,24,158,182,73,42,39,99,100,559
19220,POR,2006,Travis Outlaw,21,69,11,1153,162,368,.440,14,53,.264,148,315,.470,.459,62,89,.697,48,141,189,34,31,46,37,112,400
19221,POR,2006,Martell Webster,19,61,18,1070,139,348,.399,65,182,.357,74,166,.446,.493,61,71,.859,29,101,130,34,21,14,43,90,404
19222,POR,2006,Ruben Patterson,30,45,2,1056,188,379,.496,0,7,.000,188,372,.505,.496,138,226,.611,73,81,154,60,42,12,82,79,514
19223,POR,2006,Brian Skinner,29,27,5,515,44,91,.484,0,0,,44,91,.484,.484,15,29,.517,46,81,127,13,14,23,27,65,103
19224,POR,2006,Sergei Monia,22,23,15,336,29,85,.341,9,33,.273,20,52,.385,.394,8,12,.667,11,40,51,19,6,5,12,41,75
19225,POR,2006,Voshon Lenard,32,14,0,220,33,88,.375,15,43,.349,18,45,.400,.460,11,18,.611,3,16,19,23,13,2,20,18,92
19226,POR,2006,Ha Seung-Jin,20,27,4,212,18,31,.581,0,0,,18,31,.581,.581,8,17,.471,14,35,49,1,3,8,14,41,44
19227,POR,2006,Charles Smith,30,21,4,208,30,71,.423,15,37,.405,15,34,.441,.528,5,8,.625,3,13,16,9,5,6,4,27,80
19228,POR,2005,Damon Stoudamire,31,81,70,2762,457,1165,.392,181,490,.369,276,675,.409,.470,182,199,.915,56,254,310,458,86,2,164,158,1277
19229,POR,2005,Ruben Patterson,29,70,36,1957,319,601,.531,2,25,.080,317,576,.550,.532,169,282,.599,126,147,273,138,106,21,143,164,809
19230,POR,2005,Shareef Abdur-Rahim,28,54,49,1867,337,670,.503,15,39,.385,322,631,.510,.514,220,254,.866,123,269,392,111,49,26,117,150,909
19231,POR,2005,Joel Przybilla,25,76,50,1858,199,333,.598,0,0,,199,333,.598,.598,90,174,.517,178,410,588,74,24,163,98,239,488
19232,POR,2005,Theo Ratliff,31,63,45,1731,115,257,.447,0,0,,115,257,.447,.447,74,107,.692,111,220,331,34,23,158,56,183,304
19233,POR,2005,Darius Miles,23,63,22,1699,336,697,.482,8,23,.348,328,674,.487,.488,129,215,.600,71,228,299,129,75,78,157,189,809
19234,POR,2005,Nick Van Exel,33,53,34,1619,214,561,.381,100,257,.389,114,304,.375,.471,58,74,.784,20,141,161,227,44,0,92,70,586
19235,POR,2005,Zach Randolph,23,46,37,1603,332,741,.448,0,6,.000,332,735,.452,.448,207,254,.815,142,300,442,86,34,17,112,112,871
19236,POR,2005,Sebastian Telfair,19,68,26,1330,169,430,.393,17,69,.246,152,361,.421,.413,105,133,.789,10,94,104,224,35,4,125,120,460
19237,POR,2005,Derek Anderson,30,47,32,1239,152,391,.389,58,151,.384,94,240,.392,.463,70,87,.805,25,103,128,143,36,4,70,89,432
19238,POR,2005,Travis Outlaw,20,59,2,793,133,267,.498,4,10,.400,129,257,.502,.506,49,75,.653,40,81,121,35,30,40,39,77,319
19239,POR,2005,Viktor Khryapa,22,32,5,523,54,124,.435,4,11,.364,50,113,.442,.452,23,42,.548,28,80,108,25,20,18,33,80,135
19240,POR,2005,Richie Frahm,27,43,0,499,56,140,.400,31,80,.388,25,60,.417,.511,21,25,.840,17,44,61,30,15,4,14,35,164
19241,POR,2005,James Thomas,24,9,2,112,11,18,.611,0,0,,11,18,.611,.611,2,6,.333,15,20,35,4,4,4,7,12,24
19242,POR,2005,Ha Seung-Jin,19,19,0,104,10,23,.435,0,0,,10,23,.435,.435,6,11,.545,6,12,18,2,1,5,12,21,26
19243,POR,2005,Maurice Baker,25,4,0,18,0,1,.000,0,0,,0,1,.000,.000,0,0,,1,1,2,1,1,0,1,3,0
19244,POR,2005,Geno Carlisle,28,6,0,16,2,3,.667,0,0,,2,3,.667,.667,4,6,.667,1,0,1,1,0,0,1,1,8
19245,POR,2004,Damon Stoudamire,30,82,82,3118,408,1018,.401,156,427,.365,252,591,.426,.477,127,145,.876,52,256,308,500,99,9,180,173,1099
19246,POR,2004,Zach Randolph,22,81,80,3067,663,1368,.485,1,5,.200,662,1363,.486,.485,299,393,.761,242,609,851,163,68,41,247,227,1626
19247,POR,2004,Derek Anderson,29,51,46,1810,230,612,.376,79,259,.305,151,353,.428,.440,155,188,.824,26,156,182,228,66,3,90,79,694
19248,POR,2004,Dale Davis,34,76,37,1682,133,281,.473,0,0,,133,281,.473,.473,65,106,.613,158,240,398,72,43,62,40,154,331
19249,POR,2004,Rasheed Wallace,29,45,44,1675,296,669,.442,59,173,.341,237,496,.478,.487,115,155,.742,69,229,298,114,36,72,87,131,766
19250,POR,2004,Ruben Patterson,28,73,1,1651,200,395,.506,2,12,.167,198,383,.517,.509,105,190,.553,129,139,268,139,84,21,105,152,507
19251,POR,2004,Jeff McInnis,29,39,26,1269,196,416,.471,15,47,.319,181,369,.491,.489,58,76,.763,16,78,94,196,36,2,61,94,465
19252,POR,2004,Darius Miles,22,42,40,1191,222,422,.526,2,10,.200,220,412,.534,.528,85,121,.702,64,128,192,82,42,34,74,84,531
19253,POR,2004,Theo Ratliff,30,32,31,1016,95,176,.540,0,0,,95,176,.540,.540,44,70,.629,90,143,233,20,24,141,34,111,234
19254,POR,2004,Shareef Abdur-Rahim,27,32,3,728,118,264,.447,4,11,.364,114,253,.451,.455,79,95,.832,48,96,144,47,24,18,53,75,319
19255,POR,2004,Qyntel Woods,22,62,8,673,88,237,.371,10,29,.345,78,208,.375,.392,38,60,.633,46,90,136,46,20,14,52,88,224
19256,POR,2004,Wesley Person,32,33,0,621,80,168,.476,36,76,.474,44,92,.478,.583,19,25,.760,12,62,74,38,11,6,18,22,215
19257,POR,2004,Vladimir Stepania,27,42,2,453,43,103,.417,0,0,,43,103,.417,.417,22,36,.611,50,75,125,23,11,15,19,61,108
19258,POR,2004,Bonzi Wells,27,13,10,404,68,175,.389,1,8,.125,67,167,.401,.391,21,27,.778,21,40,61,35,20,3,32,38,158
19259,POR,2004,Eddie Gill,25,22,0,157,15,36,.417,3,8,.375,12,28,.429,.458,17,20,.850,4,13,17,16,9,1,12,16,50
19260,POR,2004,Dan Dickau,25,20,0,151,16,49,.327,7,20,.350,9,29,.310,.398,7,8,.875,3,7,10,20,8,0,13,22,46
19261,POR,2004,Omar Cook,22,17,0,139,7,27,.259,0,1,.000,7,26,.269,.259,0,0,,3,3,6,24,10,0,10,14,14
19262,POR,2004,Matt Carroll,23,13,0,48,5,11,.455,1,3,.333,4,8,.500,.500,2,2,1.000,0,3,3,1,0,0,2,3,13
19263,POR,2004,Tracy Murray,32,7,0,35,3,12,.250,2,5,.400,1,7,.143,.333,0,1,.000,3,2,5,1,1,0,2,3,8
19264,POR,2004,Desmond Ferguson,26,7,0,32,5,12,.417,3,8,.375,2,4,.500,.542,0,2,.000,0,4,4,1,0,0,1,0,13
19265,POR,2004,Ruben Boumtje-Boumtje,25,9,0,26,1,5,.200,0,0,,1,5,.200,.200,2,2,1.000,0,1,1,1,0,1,0,2,4
19266,POR,2004,Travis Outlaw,19,8,0,19,3,7,.429,0,0,,3,7,.429,.429,2,4,.500,2,2,4,1,1,0,1,1,8
19267,POR,2004,Kaniel Dickens,25,3,0,12,3,3,1.000,0,0,,3,3,1.000,1.000,1,2,.500,2,0,2,0,0,0,1,3,7
19268,POR,2004,Slavko Vraneš,21,1,0,3,0,1,.000,0,0,,0,1,.000,.000,0,0,,0,0,0,0,0,0,0,1,0
19269,POR,2003,Rasheed Wallace,28,74,74,2684,515,1094,.471,110,307,.358,405,787,.515,.521,200,272,.735,113,435,548,153,70,77,140,223,1340
19270,POR,2003,Derek Anderson,28,76,76,2556,355,832,.427,116,331,.350,239,501,.477,.496,231,269,.859,53,211,264,325,90,16,128,141,1057
19271,POR,2003,Bonzi Wells,26,75,65,2396,437,990,.441,38,130,.292,399,860,.464,.461,226,313,.722,98,296,394,246,123,18,215,220,1138
19272,POR,2003,Dale Davis,33,78,78,2282,237,438,.541,0,0,,237,438,.541,.541,105,166,.633,233,331,564,94,51,70,71,189,579
19273,POR,2003,Scottie Pippen,37,64,58,1911,265,597,.444,38,133,.286,227,464,.489,.476,121,148,.818,57,221,278,285,105,25,164,149,689
19274,POR,2003,Ruben Patterson,27,78,17,1655,254,516,.492,3,20,.150,251,496,.506,.495,138,220,.627,120,144,264,101,73,29,117,161,649
19275,POR,2003,Damon Stoudamire,29,59,27,1315,156,415,.376,44,114,.386,112,301,.372,.429,53,67,.791,40,115,155,204,39,6,82,67,409
19276,POR,2003,Jeff McInnis,28,75,1,1311,188,423,.444,6,35,.171,182,388,.469,.452,50,67,.746,22,75,97,170,21,2,75,117,432
19277,POR,2003,Zach Randolph,21,77,11,1301,264,515,.513,0,5,.000,264,510,.518,.513,122,161,.758,139,204,343,41,42,14,62,141,650
19278,POR,2003,Arvydas Sabonis,38,78,1,1209,172,361,.476,3,6,.500,169,355,.476,.481,129,164,.787,88,247,335,142,61,49,75,141,476
19279,POR,2003,Antonio Daniels,27,67,2,872,84,186,.452,18,59,.305,66,127,.520,.500,65,76,.855,11,61,72,85,33,9,32,43,251
19280,POR,2003,Qyntel Woods,21,53,0,334,59,118,.500,3,9,.333,56,109,.514,.513,7,20,.350,15,38,53,12,15,1,23,36,128
19281,POR,2003,Charles Smith,27,3,0,13,1,4,.250,0,1,.000,1,3,.333,.250,3,4,.750,0,0,0,1,1,0,1,3,5
19282,POR,2003,Chris Dudley,37,3,0,11,0,1,.000,0,0,,0,1,.000,.000,0,0,,2,0,2,0,0,0,0,3,0
19283,POR,2003,Ruben Boumtje-Boumtje,24,2,0,5,0,1,.000,0,0,,0,1,.000,.000,0,0,,1,0,1,1,1,0,0,0,0
19284,POR,2002,Rasheed Wallace,27,79,79,2963,603,1287,.469,114,317,.360,489,970,.504,.513,201,274,.734,136,509,645,152,101,101,131,212,1521
19285,POR,2002,Damon Stoudamire,28,75,71,2796,369,918,.402,104,295,.353,265,623,.425,.459,174,196,.888,78,214,292,490,67,7,149,153,1016
19286,POR,2002,Dale Davis,32,78,77,2447,296,580,.510,0,0,,296,580,.510,.510,150,212,.708,262,426,688,96,62,83,62,193,742
19287,POR,2002,Bonzi Wells,25,74,69,2348,487,1039,.469,66,172,.384,421,867,.486,.500,215,290,.741,121,323,444,204,113,25,191,208,1255
19288,POR,2002,Scottie Pippen,36,62,60,1996,246,599,.411,54,177,.305,192,422,.455,.456,113,146,.774,77,244,321,363,101,35,171,162,659
19289,POR,2002,Derek Anderson,27,70,27,1860,247,612,.404,85,228,.373,162,384,.422,.473,178,208,.856,47,142,189,216,68,8,87,113,757
19290,POR,2002,Ruben Patterson,26,75,13,1765,319,619,.515,9,36,.250,310,583,.532,.523,192,274,.701,155,143,298,107,79,37,114,140,839
19291,POR,2002,Shawn Kemp,32,75,5,1232,175,407,.430,0,4,.000,175,403,.434,.430,104,131,.794,90,198,288,52,43,33,81,184,454
19292,POR,2002,Steve Kerr,36,65,0,775,102,217,.470,26,66,.394,76,151,.503,.530,39,40,.975,6,54,60,63,13,1,24,49,269
19293,POR,2002,Rick Brunson,29,59,2,520,45,113,.398,6,11,.545,39,102,.382,.425,29,41,.707,23,45,68,114,25,2,47,51,125
19294,POR,2002,Chris Dudley,36,43,2,327,20,50,.400,0,2,.000,20,48,.417,.400,8,15,.533,27,53,80,13,3,14,14,42,48
19295,POR,2002,Ruben Boumtje-Boumtje,23,33,1,245,13,32,.406,0,0,,13,32,.406,.406,13,25,.520,21,34,55,4,3,16,14,38,39
19296,POR,2002,Zach Randolph,20,41,0,238,48,107,.449,0,0,,48,107,.449,.449,18,27,.667,31,38,69,13,7,4,15,29,114
19297,POR,2002,Erick Barkley,23,19,4,228,24,68,.353,1,7,.143,23,61,.377,.360,9,10,.900,5,13,18,34,17,1,12,29,58
19298,POR,2002,Mitchell Butler,31,11,0,90,10,23,.435,1,3,.333,9,20,.450,.457,8,12,.667,6,8,14,5,0,1,5,10,29
19299,POR,2001,Rasheed Wallace,26,77,75,2940,590,1178,.501,52,162,.321,538,1016,.530,.523,245,320,.766,147,455,602,212,90,135,158,206,1477
19300,POR,2001,Damon Stoudamire,27,82,82,2655,406,935,.434,82,219,.374,324,716,.453,.478,172,207,.831,69,234,303,468,106,8,191,202,1066
19301,POR,2001,Steve Smith,31,81,36,2542,359,788,.456,78,230,.339,281,558,.504,.505,309,347,.890,87,185,272,213,48,24,137,203,1105
19302,POR,2001,Dale Davis,31,81,43,2162,242,487,.497,0,4,.000,242,483,.501,.497,96,152,.632,233,373,606,103,44,76,67,199,580
19303,POR,2001,Scottie Pippen,35,64,60,2133,269,596,.451,64,186,.344,205,410,.500,.505,119,161,.739,70,263,333,294,94,35,154,158,721
19304,POR,2001,Bonzi Wells,24,75,46,1995,387,726,.533,17,50,.340,370,676,.547,.545,159,240,.663,120,247,367,208,94,20,169,203,950
19305,POR,2001,Arvydas Sabonis,36,61,42,1299,247,516,.479,1,15,.067,246,501,.491,.480,121,156,.776,51,280,331,91,40,62,85,137,616
19306,POR,2001,Stacey Augmon,32,66,23,1182,127,266,.477,0,4,.000,127,262,.485,.477,57,87,.655,60,99,159,98,48,21,48,105,311
19307,POR,2001,Shawn Kemp,31,68,3,1083,168,413,.407,4,11,.364,164,402,.408,.412,101,131,.771,63,196,259,65,45,23,99,184,441
19308,POR,2001,Greg Anthony,33,58,0,856,97,253,.383,65,159,.409,32,94,.340,.512,23,35,.657,21,40,61,82,40,3,43,63,282
19309,POR,2001,Detlef Schrempf,38,26,0,397,39,95,.411,3,8,.375,36,87,.414,.426,23,27,.852,17,61,78,44,7,3,28,43,104
19310,POR,2001,Rod Strickland,34,21,0,351,41,98,.418,0,1,.000,41,97,.423,.418,15,26,.577,11,24,35,72,10,1,24,21,97
19311,POR,2001,Antonio Harvey,30,12,0,72,13,28,.464,0,0,,13,28,.464,.464,5,6,.833,5,9,14,4,1,6,3,10,31
19312,POR,2001,Will Perdue,35,13,0,58,6,9,.667,0,0,,6,9,.667,.667,2,4,.500,6,12,18,2,3,2,0,8,14
19313,POR,2001,Erick Barkley,22,8,0,38,8,22,.364,3,8,.375,5,14,.357,.432,0,0,,0,3,3,6,2,0,5,2,19
19314,POR,2001,Gary Grant,35,4,0,17,5,7,.714,0,0,,5,7,.714,.714,0,0,,0,0,0,1,0,0,0,1,10
19315,POR,2000,Rasheed Wallace,25,81,77,2845,542,1045,.519,8,50,.160,534,995,.537,.522,233,331,.704,129,437,566,142,87,107,157,216,1325
19316,POR,2000,Scottie Pippen,34,82,82,2749,388,860,.451,86,263,.327,302,597,.506,.501,160,223,.717,114,399,513,406,117,41,208,208,1022
19317,POR,2000,Steve Smith,30,82,81,2689,420,900,.467,96,241,.398,324,659,.492,.520,289,340,.850,123,190,313,209,71,31,117,214,1225
19318,POR,2000,Damon Stoudamire,26,78,78,2372,386,894,.432,80,212,.377,306,682,.449,.477,122,145,.841,61,182,243,405,77,1,149,173,974
19319,POR,2000,Arvydas Sabonis,35,66,61,1688,302,598,.505,7,19,.368,295,579,.509,.511,167,198,.843,97,416,513,118,43,78,97,184,778
19320,POR,2000,Detlef Schrempf,37,77,6,1662,187,433,.432,21,52,.404,166,381,.436,.456,179,215,.833,79,253,332,197,37,17,100,182,574
19321,POR,2000,Greg Anthony,32,82,3,1548,169,416,.406,88,233,.378,81,183,.443,.512,88,114,.772,17,116,133,208,59,9,85,143,514
19322,POR,2000,Brian Grant,27,63,14,1322,173,352,.491,1,2,.500,172,350,.491,.493,112,166,.675,121,223,344,64,32,28,84,166,459
19323,POR,2000,Bonzi Wells,23,66,0,1162,236,480,.492,20,53,.377,216,427,.506,.513,88,129,.682,78,104,182,97,69,12,97,153,580
19324,POR,2000,Jermaine O'Neal,21,70,8,859,108,222,.486,0,1,.000,108,221,.489,.486,57,98,.582,97,132,229,18,11,55,47,127,273
19325,POR,2000,Stacey Augmon,31,59,0,692,83,175,.474,0,2,.000,83,173,.480,.474,37,55,.673,42,74,116,53,27,11,38,69,203
19326,POR,2000,Antonio Harvey,29,19,0,137,17,30,.567,0,0,,17,30,.567,.567,7,12,.583,8,25,33,5,1,6,12,20,41
19327,POR,2000,Joe Kleine,38,7,0,31,4,11,.364,0,0,,4,11,.364,.364,3,3,1.000,0,6,6,2,1,0,2,7,11
19328,POR,2000,Gary Grant,34,3,0,24,6,14,.429,0,0,,6,14,.429,.429,0,0,,0,3,3,1,1,0,2,3,12
19329,POR,1999,Damon Stoudamire,25,50,50,1673,249,629,.396,44,142,.310,205,487,.421,.431,89,122,.730,41,126,167,312,49,4,110,81,631
19330,POR,1999,Brian Grant,26,48,46,1525,183,382,.479,0,0,,183,382,.479,.479,184,226,.814,173,297,470,67,21,34,96,136,550
19331,POR,1999,Rasheed Wallace,24,49,18,1414,242,476,.508,13,31,.419,229,445,.515,.522,131,179,.732,57,184,241,60,48,54,80,175,628
19332,POR,1999,Isaiah Rider,27,47,41,1385,249,605,.412,42,111,.378,207,494,.419,.446,111,147,.755,59,137,196,104,25,9,95,100,651
19333,POR,1999,Arvydas Sabonis,34,50,48,1349,232,478,.485,7,24,.292,225,454,.496,.493,135,175,.771,88,305,393,119,34,63,85,147,606
19334,POR,1999,Jim Jackson,28,49,9,1175,152,370,.411,25,90,.278,127,280,.454,.445,85,101,.842,36,123,159,128,43,6,82,80,414
19335,POR,1999,Walt Williams,28,48,16,1044,147,347,.424,63,144,.438,84,203,.414,.514,89,107,.832,36,107,143,80,37,28,63,101,446
19336,POR,1999,Stacey Augmon,30,48,21,874,78,174,.448,0,2,.000,78,172,.453,.448,52,76,.684,47,78,125,58,57,18,30,81,208
19337,POR,1999,Greg Anthony,31,50,0,806,104,251,.414,49,125,.392,55,126,.437,.512,62,89,.697,14,49,63,100,66,3,55,75,319
19338,POR,1999,Kelvin Cato,24,43,0,545,58,129,.450,1,1,1.000,57,128,.445,.453,34,67,.507,49,101,150,19,23,56,27,100,151
19339,POR,1999,Jermaine O'Neal,20,36,1,311,36,83,.434,0,1,.000,36,82,.439,.434,18,35,.514,42,55,97,13,4,14,14,41,90
19340,POR,1999,Bonzi Wells,22,7,0,35,11,20,.550,1,3,.333,10,17,.588,.575,8,18,.444,4,5,9,3,1,1,6,5,31
19341,POR,1999,John Crotty,29,3,0,19,4,8,.500,1,1,1.000,3,7,.429,.563,3,3,1.000,0,1,1,5,2,0,0,1,12
19342,POR,1999,Carlos Rogers,27,2,0,8,2,2,1.000,0,0,,2,2,1.000,1.000,1,4,.250,0,1,1,1,0,0,0,2,5
19343,POR,1999,Gary Grant,33,2,0,7,0,1,.000,0,0,,0,1,.000,.000,0,0,,0,0,0,3,1,0,0,0,0
19344,POR,1999,Brian Shaw,32,1,0,5,0,1,.000,0,0,,0,1,.000,.000,0,0,,0,1,1,1,0,0,1,1,0
19345,POR,1998,Rasheed Wallace,23,77,77,2896,466,875,.533,8,39,.205,458,836,.548,.537,184,278,.662,132,346,478,195,75,88,167,268,1124
19346,POR,1998,Isaiah Rider,26,74,66,2786,551,1302,.423,135,420,.321,416,882,.472,.475,221,267,.828,99,247,346,231,55,19,187,188,1458
19347,POR,1998,Arvydas Sabonis,33,73,73,2333,407,826,.493,30,115,.261,377,711,.530,.511,323,405,.798,149,580,729,218,65,80,190,267,1167
19348,POR,1998,Brian Grant,25,61,49,1921,283,557,.508,0,1,.000,283,556,.509,.508,171,228,.750,197,358,555,86,44,45,110,184,737
19349,POR,1998,Kenny Anderson,27,45,40,1472,204,527,.387,47,133,.353,157,394,.398,.432,112,145,.772,36,98,134,245,61,1,114,99,567
19350,POR,1998,Stacey Augmon,29,71,23,1445,154,372,.414,1,7,.143,153,365,.419,.415,94,156,.603,104,131,235,88,57,32,81,144,403
19351,POR,1998,Kelvin Cato,23,74,8,1007,98,229,.428,0,3,.000,98,226,.434,.428,86,125,.688,91,161,252,23,29,94,44,164,282
19352,POR,1998,Gary Trent,23,41,13,1005,177,359,.493,4,9,.444,173,350,.494,.499,113,163,.693,80,154,234,58,27,19,72,115,471
19353,POR,1998,Alvin Williams,23,41,10,864,109,238,.458,7,24,.292,102,214,.477,.473,58,79,.734,19,41,60,83,30,2,50,60,283
19354,POR,1998,Jermaine O'Neal,19,60,9,808,112,231,.485,0,2,.000,112,229,.489,.485,45,89,.506,80,121,201,17,15,58,55,101,269
19355,POR,1998,Damon Stoudamire,24,22,22,806,94,258,.364,26,99,.263,68,159,.428,.415,59,75,.787,24,57,81,181,33,2,64,38,273
19356,POR,1998,Rick Brunson,25,38,10,622,49,141,.348,22,61,.361,27,80,.338,.426,42,62,.677,14,42,56,100,25,3,52,55,162
19357,POR,1998,Walt Williams,27,31,1,594,85,225,.378,31,90,.344,54,135,.400,.447,59,65,.908,23,59,82,53,19,12,40,61,260
19358,POR,1998,Vincent Askew,31,30,5,443,19,54,.352,0,2,.000,19,52,.365,.352,28,39,.718,21,47,68,38,19,5,35,39,66
19359,POR,1998,John Crotty,28,26,2,379,29,90,.322,6,20,.300,23,70,.329,.356,32,34,.941,4,28,32,63,10,1,42,28,96
19360,POR,1998,Gary Grant,32,22,2,359,43,93,.462,7,19,.368,36,74,.486,.500,12,14,.857,8,40,48,84,17,2,24,30,105
19361,POR,1998,Alton Lister,39,7,0,44,3,8,.375,0,0,,3,8,.375,.375,0,0,,2,9,11,1,1,1,2,12,6
19362,POR,1998,Carlos Rogers,26,3,0,25,2,4,.500,0,1,.000,2,3,.667,.500,0,0,,1,1,2,2,1,0,1,1,4
19363,POR,1998,Sean Higgins,29,2,0,12,0,5,.000,0,2,.000,0,3,.000,.000,0,0,,0,0,0,0,2,0,1,3,0
19364,POR,1998,Dontonio Wingfield,23,3,0,9,0,3,.000,0,0,,0,3,.000,.000,1,2,.500,2,2,4,0,0,0,1,2,1
19365,POR,1997,Kenny Anderson,26,82,81,3081,485,1137,.427,132,366,.361,353,771,.458,.485,334,435,.768,91,272,363,584,162,15,193,222,1436
19366,POR,1997,Clifford Robinson,30,81,79,3077,444,1043,.426,121,350,.346,323,693,.466,.484,215,309,.696,90,231,321,261,99,66,172,251,1224
19367,POR,1997,Isaiah Rider,25,76,68,2563,456,983,.464,99,257,.385,357,726,.492,.514,212,261,.812,94,210,304,198,45,19,212,199,1223
19368,POR,1997,Gary Trent,22,82,28,1918,361,674,.536,0,11,.000,361,663,.544,.536,160,229,.699,156,272,428,87,48,35,129,186,882
19369,POR,1997,Rasheed Wallace,22,62,56,1892,380,681,.558,9,33,.273,371,648,.573,.565,169,265,.638,122,297,419,74,48,59,114,198,938
19370,POR,1997,Chris Dudley,31,81,14,1840,126,293,.430,0,0,,126,293,.430,.430,65,137,.474,204,389,593,41,39,96,80,247,317
19371,POR,1997,Arvydas Sabonis,32,69,68,1762,328,658,.498,49,132,.371,279,526,.530,.536,223,287,.777,114,433,547,146,63,84,151,203,928
19372,POR,1997,Aaron McKie,24,41,8,775,53,156,.340,23,55,.418,30,101,.297,.413,41,49,.837,13,80,93,84,34,15,48,61,170
19373,POR,1997,Stacey Augmon,28,40,7,650,74,143,.517,0,0,,74,143,.517,.517,41,56,.732,33,56,89,41,32,7,37,58,189
19374,POR,1997,Dontonio Wingfield,22,47,0,569,79,193,.409,26,77,.338,53,116,.457,.477,27,40,.675,63,74,137,45,14,6,49,101,211
19375,POR,1997,Mitchell Butler,26,49,1,465,52,125,.416,12,39,.308,40,86,.465,.464,32,50,.640,19,34,53,30,13,2,27,55,148
19376,POR,1997,Jermaine O'Neal,18,45,0,458,69,153,.451,0,1,.000,69,152,.454,.451,47,78,.603,39,85,124,8,2,26,27,46,185
19377,POR,1997,Rumeal Robinson,30,27,0,295,33,82,.402,9,23,.391,24,59,.407,.457,20,23,.870,3,27,30,52,18,0,27,40,95
19378,POR,1997,Marcus Brown,22,21,0,184,28,70,.400,13,32,.406,15,38,.395,.493,13,19,.684,4,11,15,20,8,2,13,26,82
19379,POR,1997,Randolph Childress,24,19,0,125,10,30,.333,3,16,.188,7,14,.500,.383,6,8,.750,1,4,5,15,7,0,13,11,29
19380,POR,1997,Reggie Jordan,29,9,0,99,8,16,.500,0,0,,8,16,.500,.500,4,10,.400,11,12,23,11,5,3,6,13,20
19381,POR,1997,Aleksandar Djordjevic,29,8,0,61,8,16,.500,5,7,.714,3,9,.333,.656,4,5,.800,1,4,5,5,0,0,5,3,25
19382,POR,1997,Ennis Whatley,34,3,0,22,2,4,.500,0,0,,2,4,.500,.500,0,0,,0,3,3,3,0,0,1,5,4
19383,POR,1997,Ruben Nembhard,24,2,0,19,4,8,.500,0,2,.000,4,6,.667,.500,0,0,,0,0,0,5,3,0,5,3,8
19384,POR,1996,Clifford Robinson,29,78,76,2980,553,1306,.423,178,471,.378,375,835,.449,.492,360,542,.664,123,320,443,190,86,68,194,248,1644
19385,POR,1996,Rod Strickland,29,67,63,2526,471,1023,.460,38,111,.342,433,912,.475,.479,276,423,.652,89,208,297,640,97,16,255,135,1256
19386,POR,1996,Harvey Grant,30,76,75,2394,314,679,.462,21,67,.313,293,612,.479,.478,60,110,.545,117,244,361,111,60,43,82,173,709
19387,POR,1996,Aaron McKie,23,81,73,2259,337,722,.467,38,117,.325,299,605,.494,.493,152,199,.764,86,218,304,205,92,21,135,205,864
19388,POR,1996,Chris Dudley,30,80,61,1924,162,358,.453,0,1,.000,162,357,.454,.453,80,157,.510,239,481,720,37,41,100,79,251,404
19389,POR,1996,Arvydas Sabonis,31,73,21,1735,394,723,.545,39,104,.375,355,619,.574,.572,231,305,.757,147,441,588,130,64,78,154,211,1058
19390,POR,1996,Buck Williams,35,70,10,1672,192,384,.500,2,3,.667,190,381,.499,.503,125,187,.668,159,245,404,42,40,47,90,187,511
19391,POR,1996,James Robinson,25,76,5,1627,229,574,.399,102,284,.359,127,290,.438,.488,89,135,.659,44,113,157,150,34,16,111,146,649
19392,POR,1996,Gary Trent,21,69,10,1219,220,429,.513,0,9,.000,220,420,.524,.513,78,141,.553,84,154,238,50,25,11,92,116,518
19393,POR,1996,Rumeal Robinson,29,43,14,715,92,221,.416,30,79,.380,62,142,.437,.484,33,51,.647,19,59,78,142,26,5,72,79,247
19394,POR,1996,Dontonio Wingfield,21,44,2,487,60,157,.382,19,63,.302,41,94,.436,.443,26,34,.765,45,59,104,28,20,6,31,73,165
19395,POR,1996,Randolph Childress,23,28,0,250,25,79,.316,13,47,.277,12,32,.375,.399,22,27,.815,1,18,19,32,8,1,28,22,85
19396,POR,1996,Anthony Cook,28,11,0,60,7,16,.438,0,2,.000,7,14,.500,.438,1,4,.250,5,7,12,2,0,1,1,8,15
19397,POR,1996,Elmore Spencer,26,11,0,37,5,12,.417,0,0,,5,12,.417,.417,4,6,.667,2,7,9,1,0,2,3,4,14
19398,POR,1996,Reggie Slater,25,4,0,20,3,5,.600,0,0,,3,5,.600,.600,0,0,,0,3,3,0,1,2,3,1,6
19399,POR,1995,Clifford Robinson,28,75,73,2725,597,1320,.452,142,383,.371,455,937,.486,.506,265,382,.694,152,271,423,198,79,82,158,240,1601
19400,POR,1995,Buck Williams,34,82,82,2422,309,604,.512,1,2,.500,308,602,.512,.512,138,205,.673,251,418,669,78,67,69,119,254,757
19401,POR,1995,Rod Strickland,28,64,61,2267,441,946,.466,46,123,.374,395,823,.480,.490,283,380,.745,73,244,317,562,123,9,209,118,1211
19402,POR,1995,Chris Dudley,29,82,82,2245,181,446,.406,0,1,.000,181,445,.407,.406,85,183,.464,325,439,764,34,43,126,81,286,447
19403,POR,1995,Harvey Grant,29,75,14,1771,286,621,.461,8,26,.308,278,595,.467,.467,103,146,.705,103,181,284,82,56,53,62,163,683
19404,POR,1995,James Robinson,24,71,25,1539,255,624,.409,76,223,.341,179,401,.446,.470,65,110,.591,42,90,132,180,48,13,127,142,651
19405,POR,1995,Clyde Drexler,32,41,41,1428,305,712,.428,87,240,.363,218,472,.462,.489,207,248,.835,84,150,234,208,74,22,97,117,904
19406,POR,1995,Jerome Kersey,32,63,0,1143,203,489,.415,7,27,.259,196,462,.424,.422,95,124,.766,93,163,256,82,52,35,64,173,508
19407,POR,1995,Otis Thorpe,32,34,0,908,179,315,.568,0,4,.000,179,311,.576,.568,100,154,.649,89,147,236,54,19,15,56,122,458
19408,POR,1995,Aaron McKie,22,45,20,827,116,261,.444,11,28,.393,105,233,.451,.466,50,73,.685,35,94,129,89,36,16,39,97,293
19409,POR,1995,Terry Porter,31,35,9,770,105,267,.393,44,114,.386,61,153,.399,.476,58,82,.707,18,63,81,133,30,2,58,60,312
19410,POR,1995,Mark Bryant,29,49,0,658,101,192,.526,1,2,.500,100,190,.526,.529,41,63,.651,55,106,161,28,19,16,39,109,244
19411,POR,1995,Steve Henson,26,37,0,380,37,86,.430,23,52,.442,14,34,.412,.564,22,25,.880,3,23,26,85,9,0,30,52,119
19412,POR,1995,Tracy Murray,23,29,3,313,63,153,.412,16,41,.390,47,112,.420,.464,28,34,.824,18,19,37,14,7,1,20,42,170
19413,POR,1995,James Edwards,39,28,0,266,32,83,.386,0,0,,32,83,.386,.386,11,17,.647,10,33,43,8,5,8,14,44,75
19414,POR,1995,Negele Knight,27,3,0,43,7,15,.467,0,0,,7,15,.467,.467,4,4,1.000,1,2,3,11,1,0,4,5,18
19415,POR,1994,Rod Strickland,27,82,58,2889,528,1093,.483,2,10,.200,526,1083,.486,.484,353,471,.749,122,248,370,740,147,24,257,171,1411
19416,POR,1994,Clifford Robinson,27,82,64,2853,641,1404,.457,13,53,.245,628,1351,.465,.461,352,460,.765,164,386,550,159,118,111,169,263,1647
19417,POR,1994,Buck Williams,33,81,81,2636,291,524,.555,0,1,.000,291,523,.556,.555,201,296,.679,315,528,843,80,58,47,111,239,783
19418,POR,1994,Clyde Drexler,31,68,68,2334,473,1105,.428,71,219,.324,402,886,.454,.460,286,368,.777,154,291,445,333,98,34,167,202,1303
19419,POR,1994,Harvey Grant,28,77,73,2112,356,774,.460,2,7,.286,354,767,.462,.461,84,131,.641,109,242,351,107,70,49,56,179,798
19420,POR,1994,Terry Porter,30,77,34,2074,348,836,.416,110,282,.390,238,554,.430,.482,204,234,.872,45,170,215,401,79,18,166,132,1010
19421,POR,1994,Mark Bryant,28,79,10,1441,185,384,.482,0,1,.000,185,383,.483,.482,72,104,.692,117,198,315,37,32,29,66,187,442
19422,POR,1994,Jerome Kersey,31,78,6,1276,203,469,.433,1,8,.125,202,461,.438,.434,101,135,.748,130,201,331,75,71,49,63,213,508
19423,POR,1994,Tracy Murray,22,66,1,820,167,355,.470,50,109,.459,117,246,.476,.541,50,72,.694,43,68,111,31,21,20,37,76,434
19424,POR,1994,James Robinson,23,58,3,673,104,285,.365,23,73,.315,81,212,.382,.405,45,67,.672,34,44,78,68,30,15,52,69,276
19425,POR,1994,Reggie Smith,23,43,9,316,29,72,.403,0,0,,29,72,.403,.403,18,38,.474,40,59,99,4,12,6,12,47,76
19426,POR,1994,Jaren Jackson,26,29,0,187,34,87,.391,0,6,.000,34,81,.420,.391,12,14,.857,6,11,17,27,4,2,14,20,80
19427,POR,1994,Chris Dudley,28,6,3,86,6,25,.240,0,0,,6,25,.240,.240,2,4,.500,16,8,24,5,4,3,2,18,14
19428,POR,1994,Kevin Thompson,22,14,0,58,6,14,.429,0,1,.000,6,13,.462,.429,1,2,.500,7,6,13,3,0,2,5,11,13
19429,POR,1993,Terry Porter,29,81,81,2883,503,1108,.454,143,345,.414,360,763,.472,.519,327,388,.843,58,258,316,419,101,10,199,122,1476
19430,POR,1993,Clifford Robinson,26,82,12,2575,632,1336,.473,19,77,.247,613,1259,.487,.480,287,416,.690,165,377,542,182,98,163,173,287,1570
19431,POR,1993,Buck Williams,32,82,82,2498,270,528,.511,0,1,.000,270,527,.512,.511,138,214,.645,232,458,690,75,81,61,101,270,678
19432,POR,1993,Rod Strickland,26,78,35,2474,396,816,.485,4,30,.133,392,786,.499,.488,273,381,.717,120,217,337,559,131,24,199,153,1069
19433,POR,1993,Kevin Duckworth,28,74,55,1762,301,688,.438,0,2,.000,301,686,.439,.438,127,174,.730,118,269,387,70,45,39,87,222,729
19434,POR,1993,Mario Elie,29,82,7,1757,240,524,.458,45,129,.349,195,395,.494,.501,183,214,.855,59,157,216,177,74,20,89,145,708
19435,POR,1993,Jerome Kersey,30,65,50,1719,281,642,.438,8,28,.286,273,614,.445,.444,116,183,.634,126,280,406,121,80,41,84,181,686
19436,POR,1993,Clyde Drexler,30,49,49,1671,350,816,.429,31,133,.233,319,683,.467,.448,245,292,.839,126,183,309,278,95,37,115,159,976
19437,POR,1993,Mark Bryant,27,80,24,1396,186,370,.503,0,1,.000,186,369,.504,.503,104,148,.703,132,192,324,41,37,23,65,226,476
19438,POR,1993,Tracy Murray,21,48,14,495,108,260,.415,21,70,.300,87,190,.458,.456,35,40,.875,40,43,83,11,8,5,31,59,272
19439,POR,1993,Dave Johnson,22,42,0,356,57,149,.383,3,14,.214,54,135,.400,.393,40,59,.678,18,30,48,13,8,1,28,23,157
19440,POR,1993,Joe Wolf,28,21,0,156,20,43,.465,0,1,.000,20,42,.476,.465,12,14,.857,13,32,45,5,7,0,5,22,52
19441,POR,1993,Delaney Rudd,30,15,1,95,7,36,.194,1,11,.091,6,25,.240,.208,11,14,.786,4,5,9,17,1,0,11,7,26
19442,POR,1993,Reggie Smith,22,23,0,68,10,27,.370,0,1,.000,10,26,.385,.370,3,14,.214,15,6,21,1,4,1,4,16,23
19443,POR,1992,Terry Porter,28,82,82,2784,521,1129,.461,128,324,.395,393,805,.488,.518,315,368,.856,51,204,255,477,127,12,188,155,1485
19444,POR,1992,Clyde Drexler,29,76,76,2751,694,1476,.470,114,338,.337,580,1138,.510,.509,401,505,.794,166,334,500,512,138,70,240,229,1903
19445,POR,1992,Jerome Kersey,29,77,76,2553,398,852,.467,1,8,.125,397,844,.470,.468,174,262,.664,241,392,633,243,114,71,151,254,971
19446,POR,1992,Buck Williams,31,80,80,2519,340,563,.604,0,1,.000,340,562,.605,.604,221,293,.754,260,444,704,108,62,41,130,244,901
19447,POR,1992,Kevin Duckworth,27,82,82,2222,362,786,.461,0,3,.000,362,783,.462,.461,156,226,.690,151,346,497,99,38,37,143,264,880
19448,POR,1992,Clifford Robinson,25,82,7,2124,398,854,.466,1,11,.091,397,843,.471,.467,219,330,.664,140,276,416,137,85,107,154,274,1016
19449,POR,1992,Danny Ainge,32,81,6,1595,299,676,.442,78,230,.339,221,446,.496,.500,108,131,.824,40,108,148,202,73,13,70,148,784
19450,POR,1992,Alaa Abdelnaby,23,71,1,934,178,361,.493,0,0,,178,361,.493,.493,76,101,.752,81,179,260,30,25,16,66,132,432
19451,POR,1992,Robert Pack,22,72,0,894,115,272,.423,0,10,.000,115,262,.439,.423,102,127,.803,32,65,97,140,40,4,92,101,332
19452,POR,1992,Mark Bryant,26,56,0,800,95,198,.480,0,3,.000,95,195,.487,.480,40,60,.667,87,114,201,41,26,8,30,105,230
19453,POR,1992,Wayne Cooper,35,35,0,344,35,82,.427,0,0,,35,82,.427,.427,7,11,.636,38,63,101,21,4,27,15,57,77
19454,POR,1992,Ennis Whatley,29,23,0,209,21,51,.412,0,4,.000,21,47,.447,.412,27,31,.871,6,15,21,34,14,3,14,12,69
19455,POR,1992,Danny Young,29,18,0,134,16,40,.400,3,10,.300,13,30,.433,.438,10,14,.714,0,9,9,20,6,0,5,6,45
19456,POR,1992,Lamont Strothers,23,4,0,17,4,12,.333,0,2,.000,4,10,.400,.333,2,4,.500,1,0,1,1,1,1,2,2,10
19457,POR,1991,Clyde Drexler,28,82,82,2852,645,1338,.482,61,191,.319,584,1147,.509,.505,416,524,.794,212,334,546,493,144,60,232,226,1767
19458,POR,1991,Terry Porter,27,81,81,2665,486,944,.515,130,313,.415,356,631,.564,.584,279,339,.823,52,230,282,649,158,12,189,151,1381
19459,POR,1991,Buck Williams,30,80,80,2582,358,595,.602,0,0,,358,595,.602,.602,217,308,.705,227,524,751,97,47,47,137,247,933
19460,POR,1991,Kevin Duckworth,26,81,81,2511,521,1084,.481,0,2,.000,521,1082,.482,.481,240,311,.772,177,354,531,89,33,34,186,251,1282
19461,POR,1991,Jerome Kersey,28,73,72,2359,424,887,.478,4,13,.308,420,874,.481,.480,232,327,.709,169,312,481,227,101,76,149,251,1084
19462,POR,1991,Clifford Robinson,24,82,11,1940,373,806,.463,6,19,.316,367,787,.466,.467,205,314,.653,123,226,349,151,78,76,133,263,957
19463,POR,1991,Danny Ainge,31,80,0,1710,337,714,.472,102,251,.406,235,463,.508,.543,114,138,.826,45,160,205,285,63,13,100,195,890
19464,POR,1991,Danny Young,28,75,1,897,103,271,.380,36,104,.346,67,167,.401,.446,41,45,.911,22,53,75,141,50,7,50,49,283
19465,POR,1991,Mark Bryant,25,53,0,781,99,203,.488,0,1,.000,99,202,.490,.488,74,101,.733,65,125,190,27,15,12,33,120,272
19466,POR,1991,Wayne Cooper,34,67,1,746,57,145,.393,0,1,.000,57,144,.396,.393,33,42,.786,54,134,188,22,7,61,22,120,147
19467,POR,1991,Walter Davis,36,32,1,439,87,195,.446,1,3,.333,86,192,.448,.449,21,23,.913,19,39,58,41,18,0,25,42,196
19468,POR,1991,Alaa Abdelnaby,22,43,0,290,55,116,.474,0,0,,55,116,.474,.474,25,44,.568,27,62,89,12,4,12,22,39,135
19469,POR,1991,Dražen Petrović,26,18,0,133,32,71,.451,1,6,.167,31,65,.477,.458,15,22,.682,10,8,18,20,6,0,12,21,80
19470,POR,1990,Jerome Kersey,27,82,82,2843,519,1085,.478,3,20,.150,516,1065,.485,.480,269,390,.690,251,439,690,188,121,63,144,304,1310
19471,POR,1990,Buck Williams,29,82,82,2801,413,754,.548,0,1,.000,413,753,.548,.548,288,408,.706,250,550,800,116,69,39,168,285,1114
19472,POR,1990,Terry Porter,26,80,80,2781,448,969,.462,89,238,.374,359,731,.491,.508,421,472,.892,59,213,272,726,151,4,245,150,1406
19473,POR,1990,Clyde Drexler,27,73,73,2683,670,1357,.494,30,106,.283,640,1251,.512,.505,333,430,.774,208,299,507,432,145,51,191,222,1703
19474,POR,1990,Kevin Duckworth,25,82,82,2462,548,1146,.478,0,0,,548,1146,.478,.478,231,312,.740,184,325,509,91,36,34,171,271,1327
19475,POR,1990,Clifford Robinson,23,82,0,1565,298,751,.397,12,44,.273,286,707,.405,.405,138,251,.550,110,198,308,72,53,53,129,226,746
19476,POR,1990,Danny Young,27,82,8,1393,138,328,.421,16,59,.271,122,269,.454,.445,91,112,.813,29,93,122,231,82,4,80,84,383
19477,POR,1990,Wayne Cooper,33,79,0,1176,138,304,.454,0,3,.000,138,301,.458,.454,25,39,.641,118,221,339,44,18,95,39,211,301
19478,POR,1990,Dražen Petrović,25,77,0,967,207,427,.485,34,74,.459,173,353,.490,.525,135,160,.844,50,61,111,116,23,2,96,134,583
19479,POR,1990,Mark Bryant,24,58,0,562,70,153,.458,0,0,,70,153,.458,.458,28,50,.560,54,92,146,13,18,9,25,93,168
19480,POR,1990,Byron Irvin,23,50,2,488,96,203,.473,5,14,.357,91,189,.481,.485,61,91,.670,30,44,74,47,28,1,39,40,258
19481,POR,1990,Robert Reid,34,12,1,85,13,33,.394,1,3,.333,12,30,.400,.409,4,8,.500,1,7,8,8,2,2,1,17,31
19482,POR,1990,Nate Johnston,23,15,0,74,14,37,.378,0,3,.000,14,34,.412,.378,7,11,.636,11,10,21,1,3,7,5,11,35
19483,POR,1989,Terry Porter,25,81,81,3102,540,1146,.471,79,219,.361,461,927,.497,.506,272,324,.840,85,282,367,770,146,8,248,187,1431
19484,POR,1989,Clyde Drexler,26,78,78,3064,829,1672,.496,27,104,.260,802,1568,.511,.504,438,548,.799,289,326,615,450,213,54,250,269,2123
19485,POR,1989,Jerome Kersey,26,76,76,2716,533,1137,.469,6,21,.286,527,1116,.472,.471,258,372,.694,246,383,629,243,137,84,167,277,1330
19486,POR,1989,Kevin Duckworth,24,79,79,2662,554,1161,.477,0,2,.000,554,1159,.478,.477,324,428,.757,246,389,635,60,56,49,200,300,1432
19487,POR,1989,Steve Johnson,31,72,11,1477,296,565,.524,0,0,,296,565,.524,.524,129,245,.527,135,223,358,105,20,44,140,254,721
19488,POR,1989,Caldwell Jones,38,72,40,1279,77,183,.421,0,1,.000,77,182,.423,.421,48,61,.787,88,212,300,59,24,85,83,166,202
19489,POR,1989,Richard Anderson,28,72,3,1082,145,348,.417,49,141,.348,96,207,.464,.487,32,38,.842,62,169,231,98,44,12,54,100,371
19490,POR,1989,Danny Young,26,48,2,952,115,250,.460,17,50,.340,98,200,.490,.494,50,64,.781,17,57,74,123,55,3,45,50,297
19491,POR,1989,Adrian Branch,25,67,4,811,202,436,.463,7,31,.226,195,405,.481,.471,87,120,.725,63,69,132,60,45,3,64,99,498
19492,POR,1989,Mark Bryant,23,56,32,803,120,247,.486,0,0,,120,247,.486,.486,40,69,.580,65,114,179,33,20,7,41,144,280
19493,POR,1989,Kiki Vandeweghe,30,18,1,432,103,217,.475,16,38,.421,87,179,.486,.512,29,33,.879,11,24,35,34,7,4,18,40,251
19494,POR,1989,Sam Bowie,27,20,0,412,69,153,.451,5,7,.714,64,146,.438,.467,28,49,.571,36,70,106,36,7,33,33,43,171
19495,POR,1989,Jerry Sichting,32,25,1,390,46,104,.442,3,12,.250,43,92,.467,.457,7,8,.875,9,20,29,59,15,0,25,17,102
19496,POR,1989,Brook Steppe,29,27,2,244,33,78,.423,5,9,.556,28,69,.406,.455,32,37,.865,13,19,32,16,11,1,13,32,103
19497,POR,1989,Clinton Wheeler,29,20,0,211,21,45,.467,0,1,.000,21,44,.477,.467,7,10,.700,12,7,19,33,19,0,18,17,49
19498,POR,1989,Craig Neal,24,21,0,159,11,35,.314,2,9,.222,9,26,.346,.343,1,2,.500,3,8,11,32,9,0,14,24,25
19499,POR,1989,Rolando Ferreira,24,12,0,34,1,18,.056,0,0,,1,18,.056,.056,7,8,.875,4,9,13,1,0,1,6,7,9
19500,POR,1988,Clyde Drexler,25,81,80,3060,849,1679,.506,11,52,.212,838,1627,.515,.509,476,587,.811,261,272,533,467,203,52,236,250,2185
19501,POR,1988,Terry Porter,24,82,82,2991,462,890,.519,24,69,.348,438,821,.533,.533,274,324,.846,65,313,378,831,150,16,244,204,1222
19502,POR,1988,Jerome Kersey,25,79,75,2888,611,1225,.499,3,15,.200,608,1210,.502,.500,291,396,.735,211,446,657,243,127,65,161,302,1516
19503,POR,1988,Kevin Duckworth,23,78,50,2223,450,907,.496,0,0,,450,907,.496,.496,331,430,.770,224,352,576,66,31,32,177,280,1231
19504,POR,1988,Caldwell Jones,37,79,77,1778,128,263,.487,0,4,.000,128,259,.494,.487,78,106,.736,105,303,408,81,29,99,82,251,334
19505,POR,1988,Richard Anderson,27,62,3,1297,160,413,.387,42,135,.311,118,278,.424,.438,54,72,.750,82,204,286,108,50,16,60,133,416
19506,POR,1988,Michael Holton,26,82,2,1279,163,353,.462,3,15,.200,160,338,.473,.466,107,129,.829,50,99,149,211,41,10,86,154,436
19507,POR,1988,Maurice Lucas,35,73,0,1191,168,373,.450,0,3,.000,168,370,.454,.450,109,148,.736,101,214,315,94,33,10,73,188,445
19508,POR,1988,Steve Johnson,30,43,33,1050,258,488,.529,0,1,.000,258,487,.530,.529,146,249,.586,84,158,242,57,17,32,122,151,662
19509,POR,1988,Kiki Vandeweghe,29,37,7,1038,283,557,.508,22,58,.379,261,499,.523,.528,159,181,.878,36,73,109,71,21,7,48,68,747
19510,POR,1988,Jerry Sichting,31,28,0,324,49,90,.544,8,14,.571,41,76,.539,.589,9,11,.818,4,11,15,33,7,0,8,30,115
19511,POR,1988,Jim Paxson,30,17,1,263,43,107,.402,3,8,.375,40,99,.404,.416,14,18,.778,8,10,18,27,7,1,11,29,103
19512,POR,1988,Charles Jones,26,37,0,186,16,40,.400,0,1,.000,16,39,.410,.400,19,33,.576,11,20,31,8,3,6,12,28,51
19513,POR,1988,Ronnie Murphy,23,18,0,89,14,49,.286,1,4,.250,13,45,.289,.296,7,11,.636,5,6,11,6,5,1,8,14,36
19514,POR,1988,Nikita Wilson,23,15,0,54,7,23,.304,0,0,,7,23,.304,.304,5,6,.833,2,9,11,3,0,0,5,7,19
19515,POR,1988,Kevin Gamble,22,9,0,19,0,3,.000,0,1,.000,0,2,.000,.000,0,0,,2,1,3,1,2,0,2,2,0
19516,POR,1987,Clyde Drexler,24,82,82,3114,707,1408,.502,11,47,.234,696,1361,.511,.506,357,470,.760,227,291,518,566,204,71,253,281,1782
19517,POR,1987,Kiki Vandeweghe,28,79,79,3029,808,1545,.523,39,81,.481,769,1464,.525,.536,467,527,.886,86,165,251,220,52,17,139,137,2122
19518,POR,1987,Terry Porter,23,80,80,2714,376,770,.488,13,60,.217,363,710,.511,.497,280,334,.838,70,267,337,715,159,9,255,192,1045
19519,POR,1987,Steve Johnson,29,79,74,2345,494,889,.556,0,0,,494,889,.556,.556,342,490,.698,194,372,566,155,49,76,276,340,1330
19520,POR,1987,Jerome Kersey,24,82,8,2088,373,733,.509,1,23,.043,372,710,.524,.510,262,364,.720,201,295,496,194,122,77,149,328,1009
19521,POR,1987,Jim Paxson,29,72,1,1798,337,733,.460,26,98,.265,311,635,.490,.477,174,216,.806,41,98,139,237,76,12,108,134,874
19522,POR,1987,Caldwell Jones,36,78,37,1578,111,224,.496,0,2,.000,111,222,.500,.496,97,124,.782,114,341,455,64,23,77,87,227,319
19523,POR,1987,Kenny Carr,31,49,43,1443,201,399,.504,0,2,.000,201,397,.506,.504,126,169,.746,131,368,499,83,29,13,103,159,528
19524,POR,1987,Kevin Duckworth,22,51,0,753,112,228,.491,0,1,.000,112,227,.493,.491,83,120,.692,63,129,192,23,16,18,74,165,307
19525,POR,1987,Michael Holton,25,58,1,479,70,171,.409,7,23,.304,63,148,.426,.430,44,55,.800,9,29,38,73,16,2,41,51,191
19526,POR,1987,Sam Bowie,25,5,5,163,30,66,.455,0,0,,30,66,.455,.455,20,30,.667,14,19,33,9,1,10,15,19,80
19527,POR,1987,Fernando Martín,24,24,0,146,9,31,.290,0,1,.000,9,30,.300,.290,4,11,.364,8,20,28,9,7,1,20,24,22
19528,POR,1987,Perry Young,23,4,0,52,4,17,.235,0,0,,4,17,.235,.235,0,0,,3,4,7,7,4,1,3,11,8
19529,POR,1987,Joe Binion,25,11,0,51,4,10,.400,0,0,,4,10,.400,.400,6,10,.600,8,10,18,1,2,2,3,5,14
19530,POR,1987,Walter Berry,22,7,0,19,6,8,.750,0,0,,6,8,.750,.750,1,1,1.000,4,3,7,1,2,0,0,8,13
19531,POR,1987,Chris Engler,27,7,0,17,4,8,.500,0,0,,4,8,.500,.500,3,3,1.000,6,2,8,1,1,1,2,0,11
19532,POR,1987,Ron Rowan,24,7,0,16,4,9,.444,1,1,1.000,3,8,.375,.500,3,4,.750,1,0,1,1,4,0,3,1,12
19533,POR,1986,Kiki Vandeweghe,27,79,76,2791,719,1332,.540,1,8,.125,718,1324,.542,.540,523,602,.869,92,124,216,187,54,17,177,161,1962
19534,POR,1986,Clyde Drexler,23,75,58,2576,542,1142,.475,12,60,.200,530,1082,.490,.480,293,381,.769,171,250,421,600,197,46,282,270,1389
19535,POR,1986,Mychal Thompson,31,82,78,2569,503,1011,.498,0,0,,503,1011,.498,.498,198,309,.641,181,427,608,176,76,35,196,267,1204
19536,POR,1986,Jim Paxson,28,75,31,1931,372,792,.470,20,62,.323,352,730,.482,.482,217,244,.889,42,106,148,278,94,5,112,156,981
19537,POR,1986,Steve Colter,23,81,51,1868,272,597,.456,27,83,.325,245,514,.477,.478,135,164,.823,41,136,177,257,113,10,115,188,706
19538,POR,1986,Kenny Carr,30,55,31,1557,232,466,.498,0,4,.000,232,462,.502,.498,149,217,.687,146,346,492,70,38,30,106,203,613
19539,POR,1986,Caldwell Jones,35,80,19,1437,126,254,.496,0,7,.000,126,247,.510,.496,124,150,.827,105,250,355,74,38,61,102,244,376
19540,POR,1986,Jerome Kersey,23,79,2,1217,258,470,.549,0,6,.000,258,464,.556,.549,156,229,.681,137,156,293,83,85,32,113,208,672
19541,POR,1986,Terry Porter,22,79,3,1214,212,447,.474,13,42,.310,199,405,.491,.489,125,155,.806,35,82,117,198,81,1,106,136,562
19542,POR,1986,Sam Bowie,24,38,34,1132,167,345,.484,0,0,,167,345,.484,.484,114,161,.708,93,234,327,99,21,96,88,142,448
19543,POR,1986,Ken Johnson,23,64,0,815,113,214,.528,0,0,,113,214,.528,.528,37,85,.435,90,153,243,19,13,22,59,147,263
19544,POR,1986,Darnell Valentine,26,28,27,734,92,206,.447,1,3,.333,91,203,.448,.449,71,100,.710,20,52,72,139,49,1,58,78,256
19545,POR,1986,Brian Martin,23,5,0,14,2,5,.400,0,0,,2,5,.400,.400,0,2,.000,0,0,0,0,0,0,0,5,4
19546,POR,1985,Mychal Thompson,30,79,55,2616,572,1111,.515,0,0,,572,1111,.515,.515,307,449,.684,211,407,618,205,78,104,231,216,1451
19547,POR,1985,Clyde Drexler,22,80,43,2555,573,1161,.494,8,37,.216,565,1124,.503,.497,223,294,.759,217,259,476,441,177,68,223,265,1377
19548,POR,1985,Kiki Vandeweghe,26,72,69,2502,618,1158,.534,11,33,.333,607,1125,.540,.538,369,412,.896,74,154,228,106,37,22,116,116,1616
19549,POR,1985,Darnell Valentine,25,75,59,2278,321,679,.473,0,2,.000,321,677,.474,.473,230,290,.793,54,165,219,522,143,5,194,189,872
19550,POR,1985,Jim Paxson,27,68,57,2253,508,988,.514,6,39,.154,502,949,.529,.517,196,248,.790,69,153,222,264,101,5,108,115,1218
19551,POR,1985,Sam Bowie,23,76,62,2216,299,557,.537,0,0,,299,557,.537,.537,160,225,.711,207,449,656,215,55,203,172,278,758
19552,POR,1985,Steve Colter,22,78,22,1462,216,477,.453,26,74,.351,190,403,.471,.480,98,130,.754,40,110,150,243,75,9,112,142,556
19553,POR,1985,Kenny Carr,29,48,30,1120,190,363,.523,0,3,.000,190,360,.528,.523,118,164,.720,90,233,323,56,25,17,100,141,498
19554,POR,1985,Audie Norris,24,78,13,1117,133,245,.543,0,3,.000,133,242,.550,.543,135,203,.665,90,160,250,47,42,33,100,221,401
19555,POR,1985,Jerome Kersey,22,77,0,958,178,372,.478,0,3,.000,178,369,.482,.478,117,181,.646,95,111,206,63,49,29,66,147,473
19556,POR,1985,Bernard Thompson,22,59,0,535,79,212,.373,0,8,.000,79,204,.387,.373,39,51,.765,37,39,76,52,31,10,35,79,197
19557,POR,1985,Tom Scheffler,30,39,0,268,21,51,.412,0,0,,21,51,.412,.412,10,20,.500,18,58,76,11,8,11,15,48,52
19558,POR,1984,Jim Paxson,26,81,81,2686,680,1322,.514,17,59,.288,663,1263,.525,.521,345,410,.841,68,105,173,251,122,10,142,165,1722
19559,POR,1984,Mychal Thompson,29,79,74,2648,487,929,.524,0,2,.000,487,927,.525,.524,266,399,.667,235,453,688,308,84,108,235,237,1240
19560,POR,1984,Calvin Natt,27,79,74,2638,500,857,.583,2,17,.118,498,840,.593,.585,275,345,.797,166,310,476,179,69,22,166,218,1277
19561,POR,1984,Kenny Carr,28,82,57,2455,518,923,.561,0,5,.000,518,918,.564,.561,247,367,.673,208,434,642,157,68,33,202,274,1283
19562,POR,1984,Fat Lever,23,81,22,2010,313,701,.447,3,15,.200,310,686,.452,.449,159,214,.743,96,122,218,372,135,31,125,178,788
19563,POR,1984,Darnell Valentine,24,68,60,1893,251,561,.447,0,3,.000,251,558,.450,.447,194,246,.789,49,78,127,395,107,6,149,179,696
19564,POR,1984,Wayne Cooper,27,81,38,1662,304,663,.459,0,7,.000,304,656,.463,.459,185,230,.804,176,300,476,76,26,106,110,247,793
19565,POR,1984,Clyde Drexler,21,82,3,1408,252,559,.451,1,4,.250,251,555,.452,.452,123,169,.728,112,123,235,153,107,29,123,209,628
19566,POR,1984,Audie Norris,23,79,1,1157,124,246,.504,0,0,,124,246,.504,.504,104,149,.698,82,175,257,76,30,34,114,231,352
19567,POR,1984,Jeff Lamp,24,64,0,660,128,261,.490,2,13,.154,126,248,.508,.494,60,67,.896,23,40,63,51,22,4,52,67,318
19568,POR,1984,Pete Verhoeven,24,43,0,327,50,100,.500,0,1,.000,50,99,.505,.500,17,25,.680,27,34,61,20,22,11,21,75,117
19569,POR,1984,Eddie Jordan,29,13,0,183,13,41,.317,0,3,.000,13,38,.342,.317,7,10,.700,3,10,13,39,21,0,18,32,33
19570,POR,1984,Tom Piotrowski,23,18,0,78,12,26,.462,0,0,,12,26,.462,.462,6,6,1.000,6,10,16,5,1,3,6,22,30
19571,POR,1983,Mychal Thompson,28,80,80,3017,505,1033,.489,0,1,.000,505,1032,.489,.489,249,401,.621,183,570,753,380,68,110,281,213,1259
19572,POR,1983,Calvin Natt,26,80,80,2879,644,1187,.543,3,20,.150,641,1167,.549,.544,339,428,.792,214,385,599,171,63,29,203,184,1630
19573,POR,1983,Jim Paxson,25,81,81,2740,682,1323,.515,4,25,.160,678,1298,.522,.517,388,478,.812,68,106,174,231,140,17,156,160,1756
19574,POR,1983,Kenny Carr,27,82,26,2331,362,717,.505,2,6,.333,360,711,.506,.506,255,366,.697,182,407,589,116,62,42,185,306,981
19575,POR,1983,Wayne Cooper,26,80,60,2099,320,723,.443,0,5,.000,320,718,.446,.443,135,197,.685,214,397,611,116,27,136,162,318,775
19576,POR,1983,Fat Lever,22,81,45,2020,256,594,.431,5,15,.333,251,579,.434,.435,116,159,.730,85,140,225,426,153,15,137,179,633
19577,POR,1983,Darnell Valentine,23,47,36,1298,209,460,.454,0,1,.000,209,459,.455,.454,169,213,.793,34,83,117,293,101,5,131,139,587
19578,POR,1983,Jeff Lamp,23,59,1,690,107,252,.425,1,6,.167,106,246,.431,.427,42,52,.808,25,51,76,58,20,3,38,67,257
19579,POR,1983,Don Buse,32,41,1,643,72,182,.396,9,35,.257,63,147,.429,.420,41,46,.891,19,35,54,115,44,2,25,60,194
19580,POR,1983,Pete Verhoeven,23,48,0,527,87,171,.509,0,1,.000,87,170,.512,.509,21,31,.677,44,52,96,32,18,9,40,95,195
19581,POR,1983,Linton Townes,23,55,0,516,105,234,.449,9,25,.360,96,209,.459,.468,28,38,.737,30,35,65,31,19,5,33,81,247
19582,POR,1983,Hank McDowell,23,42,0,375,45,97,.464,0,2,.000,45,95,.474,.464,33,43,.767,39,50,89,20,6,7,32,58,123
19583,POR,1983,Audie Norris,22,30,0,311,26,63,.413,0,0,,26,63,.413,.413,14,30,.467,25,44,69,24,13,2,33,61,66
19584,POR,1983,Jeff Judkins,26,34,0,309,39,88,.443,2,8,.250,37,80,.463,.455,25,30,.833,18,25,43,17,15,2,17,39,105
19585,POR,1982,Mychal Thompson,27,79,78,3129,681,1303,.523,0,0,,681,1303,.523,.523,280,446,.628,258,663,921,319,69,107,245,233,1642
19586,POR,1982,Jim Paxson,24,82,82,2756,662,1258,.526,8,35,.229,654,1223,.535,.529,220,287,.767,75,146,221,276,129,12,144,159,1552
19587,POR,1982,Calvin Natt,25,75,71,2599,515,894,.576,2,8,.250,513,886,.579,.577,294,392,.750,193,420,613,150,62,36,140,175,1326
19588,POR,1982,Kelvin Ransey,23,78,68,2418,504,1095,.460,3,38,.079,501,1057,.474,.462,242,318,.761,39,147,186,555,97,4,229,169,1253
19589,POR,1982,Mike Harper,24,68,38,1433,184,370,.497,0,1,.000,184,369,.499,.497,96,153,.627,127,212,339,54,55,82,92,229,464
19590,POR,1982,Darnell Valentine,22,82,14,1387,187,453,.413,0,9,.000,187,444,.421,.413,152,200,.760,48,101,149,270,94,3,127,187,526
19591,POR,1982,Bob Gross,28,59,24,1377,173,322,.537,3,6,.500,170,316,.538,.542,78,104,.750,101,158,259,125,75,41,88,162,427
19592,POR,1982,Billy Ray Bates,25,75,0,1229,327,692,.473,12,41,.293,315,651,.484,.481,166,211,.787,53,55,108,111,41,5,93,100,832
19593,POR,1982,Pete Verhoeven,22,71,22,1207,149,296,.503,0,0,,149,296,.503,.503,51,72,.708,106,148,254,52,42,22,55,215,349
19594,POR,1982,Pétur Guðmundsson,23,68,6,845,83,166,.500,1,1,1.000,82,165,.497,.503,52,76,.684,51,135,186,59,13,30,73,163,219
19595,POR,1982,Jeff Lamp,22,54,0,617,100,196,.510,0,1,.000,100,195,.513,.510,50,61,.820,24,40,64,28,16,1,45,83,250
19596,POR,1982,Kermit Washington,30,20,4,418,38,78,.487,0,0,,38,78,.487,.487,24,41,.585,40,77,117,29,9,16,19,56,100
19597,POR,1982,Kevin Kunnert,30,21,0,237,20,48,.417,0,0,,20,48,.417,.417,9,17,.529,20,46,66,18,3,6,18,51,49
19598,POR,1982,Dennis Awtrey,33,10,3,121,5,15,.333,0,0,,5,15,.333,.333,5,9,.556,7,7,14,8,1,2,6,28,15
19599,POR,1982,Carl Bailey,23,1,0,7,1,1,1.000,0,0,,1,1,1.000,1.000,0,0,,0,0,0,0,0,0,2,2,2
19600,POR,1981,Mychal Thompson,26,79,,2790,569,1151,.494,0,1,.000,569,1150,.495,.494,207,323,.641,223,463,686,284,62,170,241,260,1345
19601,POR,1981,Jim Paxson,23,79,,2701,585,1092,.536,2,30,.067,583,1062,.549,.537,182,248,.734,74,137,211,299,140,9,131,172,1354
19602,POR,1981,Kelvin Ransey,22,80,,2431,525,1162,.452,3,31,.097,522,1131,.462,.453,164,219,.749,42,153,195,555,88,9,232,201,1217
19603,POR,1981,Kermit Washington,29,73,,2120,325,571,.569,0,1,.000,325,570,.570,.569,181,288,.628,236,450,686,149,85,86,144,258,831
19604,POR,1981,Calvin Natt,24,74,,2111,395,794,.497,4,8,.500,391,786,.497,.500,200,283,.707,149,282,431,159,73,18,163,188,994
19605,POR,1981,Bob Gross,27,82,,1934,253,479,.528,0,9,.000,253,470,.538,.528,135,159,.849,126,202,328,251,90,67,151,238,641
19606,POR,1981,Tom Owens,31,79,,1843,322,630,.511,0,4,.000,322,626,.514,.511,191,250,.764,165,291,456,140,36,47,130,273,835
19607,POR,1981,Billy Ray Bates,24,77,,1560,439,902,.487,14,54,.259,425,848,.501,.494,170,199,.854,71,86,157,196,82,6,149,120,1062
19608,POR,1981,Kevin Kunnert,29,55,,842,101,216,.468,0,0,,101,216,.468,.468,42,54,.778,98,189,287,67,17,32,50,143,244
19609,POR,1981,Ron Brewer,25,29,,548,95,246,.386,1,3,.333,94,243,.387,.388,26,34,.765,13,20,33,55,34,9,38,42,217
19610,POR,1981,Mike Gale,30,42,,476,71,145,.490,1,4,.250,70,141,.496,.493,36,42,.857,9,38,47,70,39,5,38,61,179
19611,POR,1981,Mike Harper,23,55,,461,56,136,.412,0,3,.000,56,133,.421,.412,37,85,.435,28,65,93,17,23,20,32,73,149
19612,POR,1981,Geoff Crompton,25,6,,33,4,8,.500,0,0,,4,8,.500,.500,1,5,.200,7,11,18,2,0,2,5,4,9
19613,POR,1981,Roy Hamilton,23,1,,5,1,3,.333,0,0,,1,3,.333,.333,1,2,.500,2,1,3,0,0,0,1,1,3
19614,POR,1980,Ron Brewer,24,82,82,2815,548,1182,.464,6,32,.188,542,1150,.471,.466,184,219,.840,54,160,214,216,98,48,167,154,1286
19615,POR,1980,Kermit Washington,28,80,,2657,421,761,.553,0,3,.000,421,758,.555,.553,231,360,.642,325,517,842,167,73,131,170,307,1073
19616,POR,1980,Tom Owens,30,76,,2337,518,1008,.514,1,2,.500,517,1006,.514,.514,213,283,.753,189,384,573,194,45,53,174,270,1250
19617,POR,1980,T.R. Dunn,24,82,,1841,240,551,.436,0,3,.000,240,548,.438,.436,84,111,.757,132,192,324,147,102,31,91,145,564
19618,POR,1980,Dave Twardzik,29,67,,1594,183,394,.464,4,7,.571,179,387,.463,.470,197,252,.782,52,104,156,273,77,1,131,149,567
19619,POR,1980,Bob Gross,26,62,,1581,221,472,.468,1,10,.100,220,462,.476,.469,95,114,.833,84,165,249,228,60,47,166,179,538
19620,POR,1980,Abdul Jeelani,25,77,,1286,288,565,.510,0,6,.000,288,559,.515,.510,161,204,.789,114,156,270,95,40,40,117,155,737
19621,POR,1980,Jim Paxson,22,72,,1270,189,460,.411,1,22,.045,188,438,.429,.412,64,90,.711,25,84,109,144,48,5,93,97,443
19622,POR,1980,Maurice Lucas,27,41,,1176,243,552,.440,2,5,.400,241,547,.441,.442,100,137,.730,85,240,325,125,23,35,148,141,588
19623,POR,1980,Jim Brewer,28,67,,1016,90,184,.489,0,5,.000,90,179,.503,.489,14,29,.483,101,156,257,75,42,43,47,129,194
19624,POR,1980,Calvin Natt,23,25,,811,201,419,.480,2,4,.500,199,415,.480,.482,107,139,.770,66,112,178,57,24,12,65,57,511
19625,POR,1980,Larry Steele,30,16,,446,62,146,.425,0,4,.000,62,142,.437,.425,22,27,.815,13,32,45,67,25,1,33,53,146
19626,POR,1980,Lionel Hollins,26,20,,413,82,213,.385,1,10,.100,81,203,.399,.387,34,53,.642,5,15,20,50,30,1,60,35,199
19627,POR,1980,Kevin Kunnert,28,18,,302,50,114,.439,0,0,,50,114,.439,.439,26,43,.605,37,75,112,29,7,22,41,59,126
19628,POR,1980,Billy Ray Bates,23,16,,235,72,146,.493,8,19,.421,64,127,.504,.521,28,39,.718,13,16,29,31,14,2,20,26,180
19629,SAC,2024,Domantas Sabonis,27,82,82,2928,634,1068,.594,33,87,.379,601,981,.613,.609,292,415,.704,294,826,1120,673,74,48,272,250,1593
19630,SAC,2024,De'Aaron Fox,26,74,74,2659,720,1549,.465,214,580,.369,506,969,.522,.534,312,423,.738,67,273,340,418,150,31,194,193,1966
19631,SAC,2024,Keegan Murray,23,77,77,2588,443,975,.454,183,511,.358,260,464,.560,.548,103,124,.831,106,314,420,129,79,59,64,205,1172
19632,SAC,2024,Harrison Barnes,31,82,82,2381,347,732,.474,149,385,.387,198,347,.571,.576,157,196,.801,67,182,249,99,54,12,58,98,1000
19633,SAC,2024,Malik Monk,25,72,0,1872,396,893,.443,148,423,.350,248,470,.528,.526,170,205,.829,28,184,212,370,45,39,150,156,1110
19634,SAC,2024,Kevin Huerter,25,64,59,1562,248,560,.443,123,341,.361,125,219,.571,.553,36,47,.766,38,186,224,166,45,23,53,135,655
19635,SAC,2024,Trey Lyles,28,58,0,1158,143,321,.445,84,219,.384,59,102,.578,.576,49,70,.700,61,196,257,72,17,19,38,86,419
19636,SAC,2024,Davion Mitchell,25,72,4,1101,146,323,.452,57,158,.361,89,165,.539,.540,30,42,.714,19,76,95,134,17,3,43,85,379
19637,SAC,2024,Keon Ellis,24,57,21,978,107,232,.461,70,168,.417,37,64,.578,.612,26,35,.743,32,92,124,85,51,29,37,112,310
19638,SAC,2024,Chris Duarte,26,59,11,719,80,210,.381,44,127,.346,36,83,.434,.486,26,33,.788,26,80,106,44,28,8,26,80,230
19639,SAC,2024,Sasha Vezenkov,28,42,0,511,84,191,.440,45,120,.375,39,71,.549,.558,12,15,.800,30,66,96,19,20,7,12,42,225
19640,SAC,2024,Alex Len,30,48,0,444,50,81,.617,0,3,.000,50,78,.641,.617,20,34,.588,46,82,128,50,11,33,27,66,120
19641,SAC,2024,JaVale McGee,36,46,0,339,79,132,.598,1,7,.143,78,125,.624,.602,26,45,.578,42,84,126,17,14,20,34,46,185
19642,SAC,2024,Kessler Edwards,23,54,0,275,34,82,.415,20,52,.385,14,30,.467,.537,5,9,.556,9,33,42,15,10,4,4,26,93
19643,SAC,2024,Colby Jones,21,30,0,192,28,71,.394,2,22,.091,26,49,.531,.408,6,11,.545,17,23,40,20,7,5,10,29,64
19644,SAC,2024,Juan Toscano-Anderson,30,11,0,53,3,12,.250,1,4,.250,2,8,.250,.292,0,0,,4,10,14,4,1,1,2,11,7
19645,SAC,2024,Jalen Slawson,24,12,0,37,4,6,.667,0,2,.000,4,4,1.000,.667,0,0,,1,6,7,2,1,1,2,8,8
19646,SAC,2024,Mason Jones,25,5,0,28,2,8,.250,2,7,.286,0,1,.000,.375,1,2,.500,1,4,5,5,1,0,2,3,7
19647,SAC,2024,Jordan Ford,25,6,0,22,4,7,.571,2,3,.667,2,4,.500,.714,2,2,1.000,0,2,2,2,0,0,1,0,12
19648,SAC,2024,Filip Petrušev,23,2,0,7,1,2,.500,0,0,,1,2,.500,.500,1,2,.500,0,0,0,0,0,0,0,1,3
19649,SAC,2023,Domantas Sabonis,26,79,79,2736,577,938,.615,31,83,.373,546,855,.639,.632,325,438,.742,251,722,973,573,65,39,230,279,1510
19650,SAC,2023,Harrison Barnes,30,82,82,2662,374,791,.473,132,353,.374,242,438,.553,.556,350,413,.847,87,279,366,128,57,10,86,103,1230
19651,SAC,2023,De'Aaron Fox,25,73,73,2435,682,1331,.512,119,367,.324,563,964,.584,.557,343,440,.780,40,266,306,447,83,23,181,172,1826
19652,SAC,2023,Keegan Murray,22,80,78,2382,354,782,.453,206,501,.411,148,281,.527,.584,62,81,.765,89,282,371,98,61,42,60,162,976
19653,SAC,2023,Kevin Huerter,24,75,75,2203,420,866,.485,205,510,.402,215,356,.604,.603,95,131,.725,42,209,251,221,80,24,97,181,1140
19654,SAC,2023,Malik Monk,24,77,0,1719,357,796,.448,143,398,.359,214,398,.538,.538,184,207,.889,32,171,203,298,49,20,146,125,1041
19655,SAC,2023,Davion Mitchell,24,80,9,1447,181,399,.454,63,197,.320,118,202,.584,.533,25,31,.806,16,89,105,185,44,15,62,112,450
19656,SAC,2023,Trey Lyles,27,74,0,1247,187,408,.458,87,240,.363,100,168,.595,.565,101,124,.815,68,232,300,66,27,31,64,97,562
19657,SAC,2023,Terence Davis,25,64,5,841,154,364,.423,89,243,.366,65,121,.537,.545,34,43,.791,20,119,139,67,43,12,53,104,431
19658,SAC,2023,Chimezie Metu,25,66,0,689,129,219,.589,9,38,.237,120,181,.663,.610,54,73,.740,47,151,198,40,22,21,32,81,321
19659,SAC,2023,Richaun Holmes,29,42,1,348,55,89,.618,5,8,.625,50,81,.617,.646,15,19,.789,29,51,80,9,3,11,14,50,130
19660,SAC,2023,Kessler Edwards,22,22,3,306,30,69,.435,15,43,.349,15,26,.577,.543,10,13,.769,17,30,47,21,11,5,9,37,85
19661,SAC,2023,KZ Okpala,23,35,3,248,16,38,.421,7,21,.333,9,17,.529,.513,7,8,.875,7,27,34,13,7,7,7,39,46
19662,SAC,2023,Matthew Dellavedova,32,32,0,213,17,50,.340,9,27,.333,8,23,.348,.430,4,7,.571,1,12,13,41,7,0,10,20,47
19663,SAC,2023,Alex Len,29,26,2,161,16,30,.533,0,2,.000,16,28,.571,.533,11,16,.688,24,36,60,12,4,11,16,28,43
19664,SAC,2023,PJ Dozier,26,16,0,79,10,33,.303,2,16,.125,8,17,.471,.333,0,0,,1,13,14,10,6,1,5,7,22
19665,SAC,2023,Keon Ellis,23,16,0,71,7,16,.438,6,12,.500,1,4,.250,.625,4,7,.571,4,4,8,6,5,1,1,10,24
19666,SAC,2023,Neemias Queta,23,5,0,29,6,9,.667,0,0,,6,9,.667,.667,0,2,.000,5,6,11,1,0,2,1,7,12
19667,SAC,2023,Chima Moneke,27,2,0,8,1,2,.500,0,0,,1,2,.500,.500,0,2,.000,2,0,2,1,0,0,2,2,2
19668,SAC,2023,Deonte Burton,29,2,0,6,0,2,.000,0,1,.000,0,1,.000,.000,0,0,,0,0,0,0,0,0,0,0,0
19669,SAC,2022,Harrison Barnes,29,77,77,2580,391,834,.469,142,360,.394,249,474,.525,.554,341,413,.826,82,350,432,186,53,14,118,94,1265
19670,SAC,2022,De'Aaron Fox,24,59,59,2084,516,1092,.473,74,249,.297,442,843,.524,.506,261,348,.750,25,206,231,330,68,25,168,172,1367
19671,SAC,2022,Davion Mitchell,23,75,19,2076,352,843,.418,101,320,.316,251,523,.480,.477,56,85,.659,33,133,166,313,55,24,114,141,861
19672,SAC,2022,Tyrese Haliburton,21,51,51,1757,268,586,.457,104,252,.413,164,334,.491,.546,87,104,.837,39,160,199,379,86,34,115,71,727
19673,SAC,2022,Buddy Hield,29,55,6,1574,265,693,.382,182,495,.368,83,198,.419,.514,80,92,.870,43,178,221,105,48,15,90,113,792
19674,SAC,2022,Chimezie Metu,24,60,20,1279,203,449,.452,57,186,.306,146,263,.555,.516,71,91,.780,34,301,335,60,51,32,61,93,534
19675,SAC,2022,Richaun Holmes,28,45,37,1074,198,300,.660,2,5,.400,196,295,.664,.663,70,90,.778,93,224,317,48,17,41,56,128,468
19676,SAC,2022,Damian Jones,26,56,15,1017,175,266,.658,10,29,.345,165,237,.696,.677,94,131,.718,75,171,246,69,26,47,59,130,454
19677,SAC,2022,Maurice Harkless,28,47,24,863,83,181,.459,31,101,.307,52,80,.650,.544,20,28,.714,12,100,112,23,29,24,31,77,217
19678,SAC,2022,Donte DiVincenzo,25,25,1,665,79,218,.362,53,144,.368,26,74,.351,.484,47,56,.839,22,88,110,89,37,5,44,43,258
19679,SAC,2022,Marvin Bagley III,22,30,17,663,114,246,.463,15,62,.242,99,184,.538,.494,35,47,.745,67,148,215,17,9,11,21,50,278
19680,SAC,2022,Justin Holiday,32,25,25,641,71,204,.348,50,146,.342,21,58,.362,.471,16,21,.762,11,44,55,38,21,15,21,49,208
19681,SAC,2022,Alex Len,28,39,10,620,94,176,.534,6,21,.286,88,155,.568,.551,41,63,.651,52,109,161,45,13,25,43,100,235
19682,SAC,2022,Trey Lyles,26,24,20,547,87,178,.489,23,63,.365,64,115,.557,.553,57,67,.851,29,106,135,30,7,6,19,32,254
19683,SAC,2022,Terence Davis,24,30,11,536,113,267,.423,49,149,.329,64,118,.542,.515,36,44,.818,11,83,94,40,25,11,33,70,311
19684,SAC,2022,Domantas Sabonis,25,15,15,504,112,202,.554,4,17,.235,108,185,.584,.564,55,74,.743,46,139,185,87,13,5,52,57,283
19685,SAC,2022,Tristan Thompson,30,30,3,455,76,151,.503,1,1,1.000,75,150,.500,.507,32,60,.533,72,89,161,18,11,12,29,52,185
19686,SAC,2022,Jeremy Lamb,29,17,0,322,48,119,.403,16,53,.302,32,66,.485,.471,22,26,.846,11,49,60,30,8,8,13,15,134
19687,SAC,2022,Jahmi'us Ramsey,20,19,0,134,24,58,.414,5,18,.278,19,40,.475,.457,7,14,.500,4,9,13,7,1,1,5,10,60
19688,SAC,2022,Josh Jackson,24,12,0,123,17,49,.347,3,17,.176,14,32,.438,.378,15,21,.714,4,14,18,5,5,4,9,17,52
19689,SAC,2022,Neemias Queta,22,15,0,120,17,38,.447,0,0,,17,38,.447,.447,11,17,.647,14,17,31,6,1,8,6,18,45
19690,SAC,2022,Louis King,22,10,0,104,15,47,.319,8,27,.296,7,20,.350,.404,7,10,.700,0,12,12,9,2,1,0,14,45
19691,SAC,2022,Robert Woodard II,22,12,0,42,2,16,.125,1,4,.250,1,12,.083,.156,2,2,1.000,5,6,11,3,1,1,1,3,7
19692,SAC,2022,Justin Robinson,24,3,0,15,1,8,.125,0,3,.000,1,5,.200,.125,0,0,,0,1,1,2,0,0,1,2,2
19693,SAC,2022,Emmanuel Mudiay,25,2,0,11,0,2,.000,0,0,,0,2,.000,.000,3,4,.750,0,0,0,4,1,0,1,1,3
19694,SAC,2022,Ade Murkey,24,1,0,1,0,0,,0,0,,0,0,,,0,0,,0,0,0,0,0,0,0,0,0
19695,SAC,2021,Buddy Hield,28,71,71,2433,403,992,.406,282,721,.391,121,271,.446,.548,88,104,.846,29,305,334,257,63,30,130,175,1176
19696,SAC,2021,Harrison Barnes,28,58,58,2102,319,642,.497,100,256,.391,219,386,.567,.575,195,235,.830,64,321,385,201,43,11,93,75,933
19697,SAC,2021,De'Aaron Fox,23,58,58,2036,529,1110,.477,103,320,.322,426,790,.539,.523,300,417,.719,33,170,203,417,87,27,174,170,1461
19698,SAC,2021,Richaun Holmes,27,61,61,1782,366,575,.637,2,11,.182,364,564,.645,.638,135,170,.794,144,360,504,101,39,96,75,213,869
19699,SAC,2021,Tyrese Haliburton,20,58,20,1746,292,619,.472,121,296,.409,171,323,.529,.569,48,56,.857,39,134,173,309,77,28,92,83,753
19700,SAC,2021,Marvin Bagley III,21,43,42,1112,247,490,.504,37,108,.343,210,382,.550,.542,77,134,.575,106,212,318,43,21,21,59,100,608
19701,SAC,2021,Cory Joseph,29,44,2,944,111,250,.444,31,94,.330,80,156,.513,.506,36,47,.766,25,74,99,108,39,9,44,98,289
19702,SAC,2021,Delon Wright,28,27,8,696,104,225,.462,33,83,.398,71,142,.500,.536,30,36,.833,28,77,105,97,43,11,35,30,271
19703,SAC,2021,Maurice Harkless,27,26,20,648,64,152,.421,18,73,.247,46,79,.582,.480,33,41,.805,11,65,76,37,28,16,19,72,179
19704,SAC,2021,Terence Davis,23,27,0,581,108,246,.439,54,145,.372,54,101,.535,.549,29,37,.784,11,77,88,46,27,7,34,49,299
19705,SAC,2021,Hassan Whiteside,31,36,4,546,126,224,.563,0,1,.000,126,223,.565,.563,41,79,.519,61,154,215,20,9,46,40,73,293
19706,SAC,2021,Chimezie Metu,23,36,6,488,91,179,.508,13,37,.351,78,142,.549,.545,31,43,.721,31,81,112,28,14,18,29,59,226
19707,SAC,2021,Nemanja Bjelica,32,26,1,439,69,150,.460,17,58,.293,52,92,.565,.517,32,42,.762,24,76,100,49,8,2,28,48,187
19708,SAC,2021,Glenn Robinson III,27,23,2,369,42,99,.424,16,44,.364,26,55,.473,.505,21,23,.913,11,34,45,20,4,3,11,23,121
19709,SAC,2021,Damian Jones,25,17,4,341,46,70,.657,1,4,.250,45,66,.682,.664,25,35,.714,21,56,77,24,9,17,15,36,118
19710,SAC,2021,Justin James,24,36,0,310,52,111,.468,14,38,.368,38,73,.521,.532,21,36,.583,9,21,30,22,8,3,15,23,139
19711,SAC,2021,Kyle Guy,23,31,0,235,29,88,.330,13,46,.283,16,42,.381,.403,16,20,.800,5,30,35,32,6,0,11,20,87
19712,SAC,2021,DaQuan Jeffries,23,18,2,232,24,57,.421,9,28,.321,15,29,.517,.500,6,7,.857,9,20,29,6,7,4,8,23,63
19713,SAC,2021,Jahmi'us Ramsey,19,13,0,94,15,38,.395,5,19,.263,10,19,.526,.461,5,5,1.000,2,8,10,6,4,1,3,8,40
19714,SAC,2021,Louis King,21,6,1,85,17,34,.500,4,11,.364,13,23,.565,.559,6,6,1.000,5,13,18,9,7,3,4,9,44
19715,SAC,2021,Robert Woodard II,21,13,0,45,8,20,.400,1,6,.167,7,14,.500,.425,3,8,.375,4,12,16,2,0,3,1,4,20
19716,SAC,2021,Jabari Parker,25,3,0,27,4,7,.571,0,1,.000,4,6,.667,.571,0,0,,1,5,6,1,0,1,3,4,8
19717,SAC,2021,Chris Silva,24,4,0,9,1,3,.333,0,0,,1,3,.333,.333,0,0,,0,2,2,0,0,1,1,4,2
19718,SAC,2021,Norvel Pelle,27,1,0,4,0,1,.000,0,0,,0,1,.000,.000,3,4,.750,1,0,1,1,0,0,0,1,3
19719,SAC,2020,Harrison Barnes,27,72,72,2482,365,793,.460,102,268,.381,263,525,.501,.525,214,267,.801,77,278,355,159,43,12,88,93,1046
19720,SAC,2020,Buddy Hield,27,72,44,2216,498,1162,.429,271,688,.394,227,474,.479,.545,115,136,.846,57,271,328,213,66,17,168,165,1382
19721,SAC,2020,Nemanja Bjelica,31,72,67,2011,314,653,.481,134,320,.419,180,333,.541,.583,69,84,.821,111,347,458,203,62,40,99,216,831
19722,SAC,2020,Bogdan Bogdanović,27,61,28,1766,337,766,.440,164,441,.372,173,325,.532,.547,86,116,.741,26,181,207,207,64,15,102,133,924
19723,SAC,2020,Cory Joseph,28,72,26,1759,171,412,.415,56,159,.352,115,253,.455,.483,60,70,.857,44,144,188,251,53,21,80,133,458
19724,SAC,2020,De'Aaron Fox,22,51,49,1634,391,815,.480,54,185,.292,337,630,.535,.513,241,342,.705,35,161,196,348,74,25,158,145,1077
19725,SAC,2020,Richaun Holmes,26,44,38,1242,223,344,.648,0,0,,223,344,.648,.648,93,118,.788,127,231,358,42,41,56,52,169,539
19726,SAC,2020,Trevor Ariza,34,32,0,791,64,165,.388,43,122,.352,21,43,.488,.518,21,27,.778,21,125,146,50,35,7,28,63,192
19727,SAC,2020,Harry Giles,21,46,17,667,139,251,.554,0,2,.000,139,249,.558,.554,38,49,.776,43,145,188,60,22,18,44,119,316
19728,SAC,2020,Kent Bazemore,30,25,0,577,87,208,.418,28,73,.384,59,135,.437,.486,55,75,.733,14,108,122,32,29,9,31,75,257
19729,SAC,2020,Dewayne Dedmon,30,34,10,541,69,171,.404,14,71,.197,55,100,.550,.444,23,28,.821,46,121,167,15,15,26,47,93,175
19730,SAC,2020,Yogi Ferrell,26,50,0,530,79,188,.420,24,79,.304,55,109,.505,.484,36,42,.857,6,43,49,69,18,4,28,38,218
19731,SAC,2020,Marvin Bagley III,20,13,6,334,78,167,.467,4,22,.182,74,145,.510,.479,25,31,.806,29,68,97,10,6,12,18,43,185
19732,SAC,2020,Justin James,23,36,0,232,35,84,.417,9,29,.310,26,55,.473,.470,10,21,.476,6,26,32,18,6,9,8,17,89
19733,SAC,2020,Alex Len,26,15,3,225,35,59,.593,2,3,.667,33,56,.589,.610,17,24,.708,31,60,91,8,3,15,16,34,89
19734,SAC,2020,DaQuan Jeffries,22,13,0,141,20,40,.500,5,18,.278,15,22,.682,.563,5,6,.833,3,15,18,7,4,1,2,19,50
19735,SAC,2020,Anthony Tolliver,34,9,0,82,3,17,.176,2,15,.133,1,2,.500,.235,1,2,.500,2,9,11,3,4,1,4,6,9
19736,SAC,2020,Jabari Parker,24,6,0,80,21,36,.583,1,4,.250,20,32,.625,.597,8,9,.889,7,16,23,10,3,1,4,6,51
19737,SAC,2020,Wenyen Gabriel,22,11,0,61,6,17,.353,1,8,.125,5,9,.556,.382,6,10,.600,4,6,10,3,3,2,5,7,19
19738,SAC,2020,Corey Brewer,33,5,0,33,2,4,.500,0,1,.000,2,3,.667,.500,1,3,.333,2,6,8,2,4,0,2,7,5
19739,SAC,2020,Caleb Swanigan,22,7,0,23,2,4,.500,0,0,,2,4,.500,.500,1,2,.500,2,5,7,2,1,2,6,8,5
19740,SAC,2020,Eric Mika,25,1,0,19,2,3,.667,0,0,,2,3,.667,.667,2,2,1.000,2,5,7,0,0,0,0,5,6
19741,SAC,2020,Kyle Guy,22,3,0,10,2,5,.400,0,3,.000,2,2,1.000,.400,0,0,,0,1,1,1,0,0,0,1,4
19742,SAC,2019,Buddy Hield,26,82,82,2615,623,1360,.458,278,651,.427,345,709,.487,.560,171,193,.886,106,306,412,205,58,33,146,202,1695
19743,SAC,2019,De'Aaron Fox,21,81,81,2546,505,1102,.458,86,232,.371,419,870,.482,.497,303,417,.727,43,261,304,590,133,45,227,204,1399
19744,SAC,2019,Willie Cauley-Stein,25,81,81,2213,412,741,.556,1,2,.500,411,739,.556,.557,140,254,.551,181,497,678,194,96,51,84,227,965
19745,SAC,2019,Bogdan Bogdanović,26,70,17,1947,361,863,.418,134,372,.360,227,491,.462,.496,134,162,.827,40,203,243,267,72,15,117,142,990
19746,SAC,2019,Nemanja Bjelica,30,77,70,1788,284,593,.479,103,257,.401,181,336,.539,.566,70,92,.761,125,319,444,147,54,56,82,197,741
19747,SAC,2019,Marvin Bagley III,19,62,4,1567,356,706,.504,30,96,.313,326,610,.534,.525,181,262,.691,162,309,471,62,33,59,98,120,923
19748,SAC,2019,Iman Shumpert,28,42,40,1099,133,348,.382,74,202,.366,59,146,.404,.489,34,41,.829,19,110,129,91,47,20,38,92,374
19749,SAC,2019,Justin Jackson,23,52,3,1083,125,295,.424,55,159,.346,70,136,.515,.517,41,50,.820,25,121,146,68,23,13,22,67,346
19750,SAC,2019,Yogi Ferrell,25,71,3,1067,153,352,.435,54,149,.362,99,203,.488,.511,60,67,.896,13,96,109,137,36,4,40,64,420
19751,SAC,2019,Harrison Barnes,26,28,28,949,141,310,.455,53,130,.408,88,180,.489,.540,64,80,.800,21,133,154,53,17,2,30,43,399
19752,SAC,2019,Harry Giles,20,58,0,820,175,348,.503,0,6,.000,175,342,.512,.503,58,91,.637,66,156,222,85,31,22,73,150,408
19753,SAC,2019,Kosta Koufos,29,42,1,502,73,153,.477,0,0,,73,153,.477,.477,10,24,.417,52,125,177,36,15,18,27,68,156
19754,SAC,2019,Frank Mason III,24,38,0,435,71,169,.420,14,64,.219,57,105,.543,.462,39,57,.684,6,37,43,84,16,4,36,34,195
19755,SAC,2019,Corey Brewer,32,24,0,352,33,74,.446,10,30,.333,23,44,.523,.514,22,30,.733,22,37,59,29,20,5,11,47,98
19756,SAC,2019,Troy Williams,24,21,0,312,44,98,.449,14,44,.318,30,54,.556,.520,9,15,.600,12,47,59,11,10,8,9,37,111
19757,SAC,2019,Ben McLemore,25,19,0,158,25,64,.391,17,41,.415,8,23,.348,.523,8,12,.667,3,14,17,4,6,3,5,22,75
19758,SAC,2019,Alec Burks,27,13,0,127,9,20,.450,0,6,.000,9,14,.643,.450,4,5,.800,2,20,22,10,8,1,4,7,22
19759,SAC,2019,Skal Labissière,22,13,0,113,13,30,.433,4,11,.364,9,19,.474,.500,6,11,.545,4,20,24,6,2,3,7,21,36
19760,SAC,2019,Caleb Swanigan,21,3,0,33,4,9,.444,0,2,.000,4,7,.571,.444,0,2,.000,4,8,12,4,2,1,2,6,8
19761,SAC,2019,B.J. Johnson,23,1,0,6,1,2,.500,0,1,.000,1,1,1.000,.500,0,0,,0,0,0,0,0,0,0,1,2
19762,SAC,2018,Bogdan Bogdanović,25,78,52,2175,344,772,.446,129,329,.392,215,443,.485,.529,100,119,.840,31,192,223,258,72,16,125,172,917
19763,SAC,2018,Willie Cauley-Stein,24,73,57,2044,388,773,.502,3,12,.250,385,761,.506,.504,153,247,.619,131,379,510,172,77,67,109,185,932
19764,SAC,2018,De'Aaron Fox,20,73,61,2026,328,797,.412,47,153,.307,281,644,.436,.441,141,195,.723,33,171,204,320,70,20,173,163,844
19765,SAC,2018,Buddy Hield,25,80,13,2024,416,933,.446,176,408,.431,240,525,.457,.540,71,81,.877,55,252,307,155,85,22,124,148,1079
19766,SAC,2018,Garrett Temple,31,65,35,1615,199,476,.418,89,227,.392,110,249,.442,.512,60,78,.769,22,130,152,124,57,27,79,135,547
19767,SAC,2018,Zach Randolph,36,59,58,1508,361,763,.473,51,147,.347,310,616,.503,.507,84,107,.785,97,300,397,127,42,10,116,119,857
19768,SAC,2018,Justin Jackson,22,68,41,1506,185,419,.442,57,185,.308,128,234,.547,.510,26,36,.722,27,160,187,74,28,13,40,81,453
19769,SAC,2018,Kosta Koufos,28,71,12,1391,222,389,.571,0,0,,222,389,.571,.571,33,74,.446,149,323,472,87,47,32,49,146,477
19770,SAC,2018,Skal Labissière,21,60,29,1240,205,458,.448,18,51,.353,187,407,.459,.467,95,118,.805,99,189,288,72,25,49,73,132,523
19771,SAC,2018,George Hill,31,43,36,1143,153,326,.469,58,128,.453,95,198,.480,.558,77,99,.778,22,95,117,119,39,12,60,75,441
19772,SAC,2018,Vince Carter,41,58,4,1026,114,283,.403,57,165,.345,57,118,.483,.504,28,37,.757,18,130,148,69,42,26,36,96,313
19773,SAC,2018,Frank Mason III,23,52,2,984,144,380,.379,31,86,.360,113,294,.384,.420,94,115,.817,30,100,130,147,34,10,65,72,413
19774,SAC,2018,JaKarr Sampson,24,22,6,344,44,81,.543,5,10,.500,39,71,.549,.574,10,16,.625,21,57,78,9,8,22,8,48,103
19775,SAC,2018,Malachi Richardson,22,25,4,319,29,88,.330,12,39,.308,17,49,.347,.398,17,22,.773,5,28,33,13,10,1,10,27,87
19776,SAC,2018,Georgios Papagiannis,20,16,0,118,17,41,.415,0,0,,17,41,.415,.415,0,0,,12,24,36,9,2,6,8,12,34
19777,SAC,2018,Nigel Hayes,23,5,0,105,8,28,.286,2,12,.167,6,16,.375,.321,0,2,.000,4,18,22,4,2,3,1,8,18
19778,SAC,2018,Bruno Caboclo,22,10,0,100,9,29,.310,3,15,.200,6,14,.429,.362,5,6,.833,7,14,21,3,2,4,4,7,26
19779,SAC,2018,Jack Cooley,26,7,0,87,13,27,.481,0,0,,13,27,.481,.481,14,19,.737,14,16,30,6,1,0,3,13,40
19780,SAC,2017,Darren Collison,29,68,64,2063,340,714,.476,73,175,.417,267,539,.495,.527,147,171,.860,23,129,152,312,67,9,114,119,900
19781,SAC,2017,DeMarcus Cousins,26,55,55,1891,505,1118,.452,95,267,.356,410,851,.482,.494,423,549,.770,115,468,583,266,75,74,207,203,1528
19782,SAC,2017,Ty Lawson,29,69,24,1732,237,522,.454,34,118,.288,203,404,.502,.487,173,217,.797,44,135,179,334,74,6,129,119,681
19783,SAC,2017,Garrett Temple,30,65,20,1728,183,432,.424,82,220,.373,101,212,.476,.519,58,74,.784,32,152,184,168,84,28,78,141,506
19784,SAC,2017,Arron Afflalo,31,61,45,1580,185,420,.440,62,151,.411,123,269,.457,.514,83,93,.892,9,116,125,78,21,6,42,104,515
19785,SAC,2017,Anthony Tolliver,31,65,9,1477,155,351,.442,90,230,.391,65,121,.537,.570,61,82,.744,51,186,237,77,34,20,56,109,461
19786,SAC,2017,Willie Cauley-Stein,23,75,21,1421,255,481,.530,0,2,.000,255,479,.532,.530,101,151,.669,85,254,339,80,53,44,69,147,611
19787,SAC,2017,Kosta Koufos,27,71,62,1419,216,392,.551,0,1,.000,216,391,.552,.551,38,62,.613,118,285,403,47,36,48,61,172,470
19788,SAC,2017,Matt Barnes,36,54,13,1367,147,383,.384,69,211,.327,78,172,.453,.474,50,66,.758,55,238,293,150,36,17,83,138,413
19789,SAC,2017,Ben McLemore,23,61,27,1176,180,419,.430,65,170,.382,115,249,.462,.507,70,93,.753,19,110,129,51,29,6,62,108,495
19790,SAC,2017,Rudy Gay,30,30,30,1013,201,442,.455,42,113,.372,159,329,.483,.502,118,138,.855,35,155,190,83,44,26,74,79,562
19791,SAC,2017,Buddy Hield,24,25,18,727,142,296,.480,59,138,.428,83,158,.525,.579,35,43,.814,16,87,103,44,20,2,53,34,378
19792,SAC,2017,Skal Labissière,20,33,12,612,117,218,.537,3,8,.375,114,210,.543,.544,52,74,.703,51,111,162,27,16,13,37,64,289
19793,SAC,2017,Omri Casspi,28,22,2,397,53,117,.453,11,29,.379,42,88,.477,.500,12,21,.571,20,70,90,26,10,1,17,23,129
19794,SAC,2017,Langston Galloway,25,19,2,375,42,104,.404,19,40,.475,23,64,.359,.495,11,12,.917,7,28,35,28,6,1,18,20,114
19795,SAC,2017,Georgios Papagiannis,19,22,0,355,56,102,.549,0,2,.000,56,100,.560,.549,12,14,.857,24,62,86,20,3,17,24,44,124
19796,SAC,2017,Tyreke Evans,27,14,6,314,59,143,.413,21,48,.438,38,95,.400,.486,24,34,.706,7,44,51,33,12,5,22,19,163
19797,SAC,2017,Malachi Richardson,21,22,0,198,28,68,.412,8,28,.286,20,40,.500,.471,15,19,.789,3,20,23,11,5,1,8,23,79
19798,SAC,2017,Jordan Farmar,30,2,0,35,4,12,.333,4,9,.444,0,3,.000,.500,0,0,,1,2,3,9,2,0,3,1,12
19799,SAC,2016,Rajon Rondo,29,72,72,2537,355,782,.454,62,170,.365,293,612,.479,.494,87,150,.580,77,358,435,839,141,10,278,175,859
19800,SAC,2016,Rudy Gay,29,70,70,2379,466,1007,.463,74,215,.344,392,792,.495,.500,198,254,.780,103,353,456,120,100,51,139,184,1204
19801,SAC,2016,DeMarcus Cousins,25,65,65,2246,601,1332,.451,70,210,.333,531,1122,.473,.477,476,663,.718,158,589,747,214,101,92,249,236,1748
19802,SAC,2016,Darren Collison,28,74,15,2219,377,776,.486,87,217,.401,290,559,.519,.542,194,226,.858,28,141,169,318,76,4,130,142,1035
19803,SAC,2016,Omri Casspi,27,69,21,1880,299,622,.481,112,274,.409,187,348,.537,.571,103,159,.648,58,352,410,95,56,17,94,154,813
19804,SAC,2016,Marco Belinelli,29,68,7,1672,245,635,.386,91,297,.306,154,338,.456,.457,115,138,.833,10,107,117,127,37,2,80,91,696
19805,SAC,2016,Kosta Koufos,26,78,14,1482,236,444,.532,0,0,,236,444,.532,.532,57,104,.548,169,254,423,33,40,70,48,185,529
19806,SAC,2016,Ben McLemore,22,68,53,1443,195,455,.429,67,185,.362,128,270,.474,.502,74,103,.718,34,114,148,79,52,10,99,140,531
19807,SAC,2016,Willie Cauley-Stein,22,66,39,1412,191,339,.563,0,2,.000,191,337,.567,.563,81,125,.648,134,218,352,37,48,66,46,146,463
19808,SAC,2016,Quincy Acy,25,59,29,876,119,214,.556,19,49,.388,100,165,.606,.600,50,68,.735,65,123,188,27,29,24,27,103,307
19809,SAC,2016,James Anderson,26,51,15,721,67,178,.376,23,86,.267,44,92,.478,.441,22,29,.759,13,73,86,41,21,14,42,54,179
19810,SAC,2016,Seth Curry,25,44,9,692,102,224,.455,50,111,.450,52,113,.460,.567,45,54,.833,9,51,60,67,22,3,36,41,299
19811,SAC,2016,Caron Butler,35,17,1,176,25,59,.424,3,18,.167,22,41,.537,.449,10,12,.833,5,17,22,10,9,1,3,19,63
19812,SAC,2016,Eric Moreland,24,8,0,48,3,6,.500,0,0,,3,6,.500,.500,2,4,.500,3,8,11,1,0,4,3,4,8
19813,SAC,2016,Duje Dukan,24,1,0,24,2,10,.200,2,5,.400,0,5,.000,.300,0,0,,2,2,4,1,1,0,0,2,6
19814,SAC,2015,Ben McLemore,21,82,82,2670,363,831,.437,140,391,.358,223,440,.507,.521,130,160,.813,31,210,241,140,77,19,138,219,996
19815,SAC,2015,Rudy Gay,28,68,67,2408,508,1116,.455,79,220,.359,429,896,.479,.491,337,393,.858,98,301,399,250,71,41,183,157,1432
19816,SAC,2015,DeMarcus Cousins,24,59,59,2013,498,1066,.467,2,8,.250,496,1058,.469,.468,423,541,.782,185,562,747,210,90,103,254,241,1421
19817,SAC,2015,Jason Thompson,28,81,63,1991,201,428,.470,0,1,.000,201,427,.471,.470,89,143,.622,139,391,530,85,33,57,84,239,491
19818,SAC,2015,Darren Collison,27,45,45,1565,260,550,.473,60,161,.373,200,389,.514,.527,145,184,.788,19,124,143,252,67,14,112,95,725
19819,SAC,2015,Derrick Williams,23,74,6,1462,217,485,.447,49,156,.314,168,329,.511,.498,134,196,.684,41,161,202,50,34,4,56,67,617
19820,SAC,2015,Ray McCallum,23,68,30,1436,206,470,.438,34,111,.306,172,359,.479,.474,57,84,.679,52,128,180,188,45,11,85,92,503
19821,SAC,2015,Omri Casspi,26,67,19,1416,209,427,.489,35,87,.402,174,340,.512,.530,140,191,.733,54,206,260,102,31,9,88,107,593
19822,SAC,2015,Carl Landry,31,70,15,1192,190,369,.515,0,0,,190,369,.515,.515,123,150,.820,99,169,268,26,15,17,54,132,503
19823,SAC,2015,Nik Stauskas,21,73,1,1127,108,296,.365,48,149,.322,60,147,.408,.446,55,64,.859,11,77,88,67,20,17,40,92,319
19824,SAC,2015,Reggie Evans,34,47,7,764,58,137,.423,0,2,.000,58,135,.430,.423,60,97,.619,97,202,299,32,22,5,45,91,176
19825,SAC,2015,Ramon Sessions,28,36,7,642,63,183,.344,6,28,.214,57,155,.368,.361,64,88,.727,13,56,69,96,13,0,51,45,196
19826,SAC,2015,Andre Miller,38,30,0,622,68,148,.459,6,26,.231,62,122,.508,.480,30,38,.789,16,60,76,141,18,4,58,47,172
19827,SAC,2015,Ryan Hollins,30,46,9,441,53,82,.646,0,0,,53,82,.646,.646,31,54,.574,36,67,103,14,6,19,25,65,137
19828,SAC,2015,Quincy Miller,22,6,0,61,4,18,.222,1,7,.143,3,11,.273,.250,8,11,.727,2,10,12,3,6,3,3,4,17
19829,SAC,2015,David Stockton,23,3,0,33,2,6,.333,1,2,.500,1,4,.250,.417,3,6,.500,0,2,2,9,2,0,4,1,8
19830,SAC,2015,David Wear,24,2,0,7,0,2,.000,0,1,.000,0,1,.000,.000,0,0,,2,0,2,1,0,0,0,1,0
19831,SAC,2015,Sim Bhullar,22,3,0,3,1,2,.500,0,0,,1,2,.500,.500,0,0,,0,1,1,1,0,1,0,0,2
19832,SAC,2015,Eric Moreland,23,3,0,2,1,1,1.000,0,0,,1,1,1.000,1.000,0,0,,0,1,1,0,0,0,0,1,2
19833,SAC,2014,Isaiah Thomas,24,72,54,2497,496,1096,.453,127,364,.349,369,732,.504,.510,346,407,.850,47,163,210,454,93,8,213,185,1465
19834,SAC,2014,DeMarcus Cousins,23,71,71,2298,591,1191,.496,0,7,.000,591,1184,.499,.496,432,595,.726,218,613,831,207,109,91,251,270,1614
19835,SAC,2014,Ben McLemore,20,82,55,2187,255,679,.376,95,297,.320,160,382,.419,.446,115,143,.804,53,182,235,82,45,18,96,201,720
19836,SAC,2014,Jason Thompson,27,82,61,2007,251,496,.506,0,0,,251,496,.506,.506,84,145,.579,153,374,527,53,32,56,95,251,586
19837,SAC,2014,Rudy Gay,27,55,55,1892,407,844,.482,43,138,.312,364,706,.516,.508,250,299,.836,84,220,304,169,67,33,165,124,1107
19838,SAC,2014,Derrick Williams,22,67,15,1658,187,428,.437,24,84,.286,163,344,.474,.465,172,243,.708,68,229,297,55,44,16,70,105,570
19839,SAC,2014,Marcus Thornton,26,46,26,1121,142,373,.381,57,179,.318,85,194,.438,.457,42,52,.808,39,85,124,47,31,8,38,74,383
19840,SAC,2014,Travis Outlaw,29,63,4,1065,130,326,.399,41,117,.350,89,209,.426,.462,42,52,.808,36,132,168,48,20,19,26,94,343
19841,SAC,2014,Ray McCallum,22,45,10,897,113,300,.377,22,59,.373,91,241,.378,.413,32,43,.744,18,61,79,120,22,9,39,69,280
19842,SAC,2014,Quincy Acy,23,56,0,786,60,127,.472,2,10,.200,58,117,.496,.480,30,45,.667,67,134,201,24,19,23,28,114,152
19843,SAC,2014,Reggie Evans,33,24,14,500,48,91,.527,0,0,,48,91,.527,.527,37,65,.569,62,123,185,16,24,1,30,65,133
19844,SAC,2014,Greivis Vásquez,27,18,18,465,65,150,.433,16,50,.320,49,100,.490,.487,30,32,.938,5,29,34,95,6,1,27,38,176
19845,SAC,2014,Jimmer Fredette,24,41,0,463,94,198,.475,36,73,.493,58,125,.464,.566,17,19,.895,7,38,45,61,14,3,44,28,241
19846,SAC,2014,John Salmons,34,18,8,445,41,117,.350,16,42,.381,25,75,.333,.419,7,7,1.000,8,38,46,44,12,8,14,32,105
19847,SAC,2014,Patrick Patterson,24,17,6,415,50,122,.410,9,39,.231,41,83,.494,.447,9,16,.563,34,65,99,15,13,3,16,39,118
19848,SAC,2014,Aaron Gray,29,33,6,335,25,58,.431,0,1,.000,25,57,.439,.431,10,18,.556,39,64,103,19,10,8,27,57,60
19849,SAC,2014,Carl Landry,30,18,1,233,31,60,.517,0,0,,31,60,.517,.517,14,17,.824,15,42,57,5,3,1,9,34,76
19850,SAC,2014,Luc Mbah a Moute,27,9,5,196,15,32,.469,1,3,.333,14,29,.483,.484,9,13,.692,9,18,27,15,9,5,4,18,40
19851,SAC,2014,Chuck Hayes,30,16,1,179,14,32,.438,0,0,,14,32,.438,.438,5,7,.714,20,27,47,6,11,2,7,18,33
19852,SAC,2014,Hamady N'Diaye,27,14,0,74,3,9,.333,0,0,,3,9,.333,.333,0,1,.000,5,13,18,3,0,4,3,15,6
19853,SAC,2014,Jared Cunningham,22,8,0,58,5,19,.263,1,6,.167,4,13,.308,.289,13,14,.929,1,4,5,5,3,0,0,13,24
19854,SAC,2014,Orlando Johnson,24,7,0,50,3,17,.176,1,6,.167,2,11,.182,.206,2,4,.500,2,2,4,4,0,1,1,3,9
19855,SAC,2014,Royce White,22,3,0,9,0,1,.000,0,0,,0,1,.000,.000,0,0,,0,0,0,0,0,0,0,2,0
19856,SAC,2013,DeMarcus Cousins,22,75,74,2289,482,1036,.465,4,22,.182,478,1014,.471,.467,312,423,.738,222,524,746,199,108,55,225,269,1280
19857,SAC,2013,Jason Thompson,26,82,81,2285,374,745,.502,0,3,.000,374,742,.504,.502,143,206,.694,172,377,549,84,48,61,101,227,891
19858,SAC,2013,John Salmons,33,76,72,2278,244,612,.399,99,267,.371,145,345,.420,.480,85,110,.773,33,174,207,226,51,25,85,143,672
19859,SAC,2013,Isaiah Thomas,23,79,62,2122,366,832,.440,115,321,.358,251,511,.491,.509,253,287,.882,29,132,161,316,67,3,140,167,1100
19860,SAC,2013,Tyreke Evans,23,65,61,2016,366,765,.478,45,133,.338,321,632,.508,.508,210,271,.775,56,231,287,229,90,27,128,133,987
19861,SAC,2013,Marcus Thornton,25,72,8,1726,332,774,.429,141,379,.372,191,395,.484,.520,111,126,.881,50,131,181,91,61,4,68,105,916
19862,SAC,2013,Chuck Hayes,29,74,1,1209,84,190,.442,0,1,.000,84,189,.444,.442,30,48,.625,113,186,299,112,31,18,44,114,198
19863,SAC,2013,Jimmer Fredette,23,69,0,967,172,409,.421,65,156,.417,107,253,.423,.500,85,99,.859,19,52,71,92,31,3,68,64,494
19864,SAC,2013,Aaron Brooks,28,46,20,959,139,303,.459,48,127,.378,91,176,.517,.538,40,52,.769,12,66,78,108,29,7,63,89,366
19865,SAC,2013,James Johnson,25,54,11,878,117,283,.413,2,21,.095,115,262,.439,.417,40,67,.597,49,96,145,58,41,50,68,99,276
19866,SAC,2013,Thomas Robinson,21,51,0,809,103,243,.424,0,0,,103,243,.424,.424,41,71,.577,92,146,238,36,25,21,65,95,247
19867,SAC,2013,Francisco García,31,40,15,710,77,205,.376,40,109,.367,37,96,.385,.473,12,14,.857,7,61,68,43,32,31,20,66,206
19868,SAC,2013,Patrick Patterson,23,24,3,556,83,168,.494,16,36,.444,67,132,.508,.542,11,14,.786,40,76,116,30,13,13,19,48,193
19869,SAC,2013,Travis Outlaw,28,38,2,444,74,177,.418,14,50,.280,60,127,.472,.458,38,52,.731,17,44,61,21,11,8,19,35,200
19870,SAC,2013,Toney Douglas,26,22,0,376,49,114,.430,21,54,.389,28,60,.467,.522,16,16,1.000,11,37,48,58,31,1,25,42,135
19871,SAC,2013,Cole Aldrich,24,15,0,175,21,37,.568,0,0,,21,37,.568,.568,8,11,.727,18,45,63,3,2,14,9,19,50
19872,SAC,2013,Tyler Honeycutt,22,9,0,32,3,11,.273,0,2,.000,3,9,.333,.273,2,2,1.000,3,7,10,2,0,1,5,2,8
19873,SAC,2012,Tyreke Evans,22,63,61,2162,408,900,.453,20,99,.202,388,801,.484,.464,201,258,.779,64,225,289,283,84,29,171,136,1037
19874,SAC,2012,DeMarcus Cousins,21,64,62,1950,448,999,.448,2,14,.143,446,985,.453,.449,262,373,.702,265,438,703,102,93,75,170,257,1160
19875,SAC,2012,Marcus Thornton,24,51,51,1780,352,803,.438,107,310,.345,245,493,.497,.505,141,163,.865,84,104,188,98,71,12,84,111,952
19876,SAC,2012,Jason Thompson,25,64,47,1657,237,443,.535,0,2,.000,237,441,.537,.535,109,181,.602,166,277,443,79,43,44,68,149,583
19877,SAC,2012,Isaiah Thomas,22,65,37,1656,256,571,.448,83,219,.379,173,352,.491,.521,154,185,.832,48,120,168,266,53,8,105,121,749
19878,SAC,2012,John Salmons,32,46,32,1250,141,345,.409,33,112,.295,108,233,.464,.457,29,45,.644,20,114,134,93,37,7,45,77,344
19879,SAC,2012,Jimmer Fredette,22,61,7,1135,172,446,.386,78,216,.361,94,230,.409,.473,40,48,.833,17,56,73,108,30,3,67,73,462
19880,SAC,2012,Chuck Hayes,28,54,9,1039,73,170,.429,0,2,.000,73,168,.435,.429,26,39,.667,72,162,234,77,36,17,50,111,172
19881,SAC,2012,Francisco García,30,49,3,798,86,229,.376,38,131,.290,48,98,.490,.459,24,30,.800,11,88,99,31,36,37,22,73,234
19882,SAC,2012,Donté Greene,23,53,7,777,108,266,.406,25,105,.238,83,161,.516,.453,44,55,.800,19,114,133,34,18,29,32,67,285
19883,SAC,2012,J.J. Hickson,23,35,9,644,64,173,.370,0,1,.000,64,172,.372,.370,37,58,.638,67,110,177,22,18,17,39,44,165
19884,SAC,2012,Travis Outlaw,27,39,5,500,60,175,.343,16,60,.267,44,115,.383,.389,31,46,.674,19,42,61,16,19,21,20,34,167
19885,SAC,2012,Terrence Williams,24,18,0,369,65,141,.461,8,27,.296,57,114,.500,.489,21,34,.618,11,63,74,55,16,6,33,19,159
19886,SAC,2012,Hassan Whiteside,22,18,0,109,12,27,.444,0,0,,12,27,.444,.444,5,12,.417,16,23,39,0,3,15,5,12,29
19887,SAC,2012,Tyler Honeycutt,21,15,0,88,8,24,.333,1,3,.333,7,21,.333,.354,3,5,.600,3,11,14,7,4,3,2,3,20
19888,SAC,2011,Beno Udrih,28,79,64,2734,412,824,.500,65,182,.357,347,642,.540,.539,197,228,.864,41,224,265,386,94,9,141,181,1086
19889,SAC,2011,DeMarcus Cousins,20,81,62,2309,432,1004,.430,3,18,.167,429,986,.435,.432,276,402,.687,217,482,699,204,85,68,268,332,1143
19890,SAC,2011,Tyreke Evans,21,57,53,2107,382,933,.409,43,148,.291,339,785,.432,.432,205,266,.771,46,229,275,319,85,30,184,143,1012
19891,SAC,2011,Samuel Dalembert,29,80,46,1938,268,567,.473,0,2,.000,268,565,.474,.473,108,148,.730,212,445,657,67,36,116,132,225,644
19892,SAC,2011,Jason Thompson,24,75,39,1748,271,534,.507,0,3,.000,271,531,.510,.507,121,200,.605,144,310,454,88,28,44,99,212,663
19893,SAC,2011,Omri Casspi,22,71,27,1702,225,546,.412,92,247,.372,133,299,.445,.496,68,101,.673,74,233,307,74,54,13,68,115,610
19894,SAC,2011,Carl Landry,27,53,16,1406,238,484,.492,0,3,.000,238,481,.495,.492,155,215,.721,127,126,253,50,30,20,82,125,631
19895,SAC,2011,Francisco García,29,58,34,1386,207,475,.436,81,224,.362,126,251,.502,.521,65,76,.855,24,109,133,71,51,49,45,126,560
19896,SAC,2011,Donté Greene,22,69,21,1127,156,386,.404,45,154,.292,111,232,.478,.462,43,65,.662,49,98,147,48,36,20,60,88,400
19897,SAC,2011,Marcus Thornton,23,27,23,1030,213,473,.450,53,147,.361,160,326,.491,.506,95,118,.805,36,91,127,92,45,5,56,60,574
19898,SAC,2011,Eugene Jeter,27,62,1,858,106,259,.409,6,30,.200,100,229,.437,.421,37,41,.902,9,61,70,162,29,2,51,54,255
19899,SAC,2011,Luther Head,28,36,14,586,68,164,.415,25,64,.391,43,100,.430,.491,39,50,.780,16,44,60,70,10,9,32,43,200
19900,SAC,2011,Darnell Jackson,25,59,2,486,77,158,.487,3,11,.273,74,147,.503,.497,30,49,.612,49,45,94,14,12,3,23,61,187
19901,SAC,2011,Jermaine Taylor,24,26,8,406,78,164,.476,12,40,.300,66,124,.532,.512,16,22,.727,25,28,53,30,12,3,40,35,184
19902,SAC,2011,Antoine Wright,26,7,0,31,1,8,.125,0,4,.000,1,4,.250,.125,0,0,,2,1,3,0,1,0,1,3,2
19903,SAC,2011,Hassan Whiteside,21,1,0,2,0,0,,0,0,,0,0,,,0,0,,0,0,0,0,0,0,0,2,0
19904,SAC,2010,Tyreke Evans,20,72,72,2677,533,1165,.458,36,141,.255,497,1024,.485,.473,348,465,.748,66,314,380,414,109,26,216,204,1450
19905,SAC,2010,Beno Udrih,27,79,41,2477,415,841,.493,75,199,.377,340,642,.530,.538,118,141,.837,38,181,219,372,89,10,136,166,1023
19906,SAC,2010,Jason Thompson,23,75,58,2357,370,784,.472,1,10,.100,369,774,.477,.473,198,277,.715,224,413,637,124,41,73,139,279,939
19907,SAC,2010,Omri Casspi,21,77,31,1931,300,672,.446,75,203,.369,225,469,.480,.502,117,174,.672,75,274,349,95,54,17,98,125,792
19908,SAC,2010,Spencer Hawes,21,72,59,1904,312,666,.468,26,87,.299,286,579,.494,.488,73,106,.689,145,291,436,158,32,83,131,200,723
19909,SAC,2010,Donté Greene,21,76,50,1630,244,553,.441,69,183,.377,175,370,.473,.504,90,140,.643,53,181,234,71,41,53,93,150,647
19910,SAC,2010,Andrés Nocioni,30,75,28,1477,234,587,.399,96,249,.386,138,338,.408,.480,71,99,.717,32,190,222,75,32,26,67,160,635
19911,SAC,2010,Carl Landry,26,28,28,1054,197,379,.520,1,3,.333,196,376,.521,.521,109,147,.741,66,116,182,26,27,17,50,88,504
19912,SAC,2010,Ime Udoka,32,69,2,944,91,241,.378,26,91,.286,65,150,.433,.432,42,57,.737,51,140,191,58,34,6,42,83,250
19913,SAC,2010,Kevin Martin,26,22,21,774,135,339,.398,39,110,.355,96,229,.419,.456,127,155,.819,20,74,94,57,23,4,35,51,436
19914,SAC,2010,Jon Brockman,22,52,4,654,55,103,.534,0,0,,55,103,.534,.534,37,62,.597,105,108,213,22,15,5,23,115,147
19915,SAC,2010,Francisco García,28,25,4,575,82,176,.466,23,59,.390,59,117,.504,.531,15,17,.882,11,55,66,45,10,19,21,49,202
19916,SAC,2010,Sergio Rodríguez,23,39,0,517,88,190,.463,15,42,.357,73,148,.493,.503,43,62,.694,15,35,50,121,29,3,59,46,234
19917,SAC,2010,Sean May,25,37,4,331,51,111,.459,0,4,.000,51,107,.477,.459,21,32,.656,20,50,70,17,12,7,19,46,123
19918,SAC,2010,Kenny Thomas,32,26,2,313,17,35,.486,0,0,,17,35,.486,.486,7,12,.583,35,51,86,15,10,10,17,42,41
19919,SAC,2010,Dominic McGuire,24,10,2,67,4,12,.333,0,0,,4,12,.333,.333,0,2,.000,6,12,18,3,1,1,7,3,8
19920,SAC,2010,Desmond Mason,32,5,4,66,5,12,.417,0,0,,5,12,.417,.417,3,4,.750,4,9,13,2,1,1,4,5,13
19921,SAC,2010,Hilton Armstrong,25,6,0,56,4,12,.333,0,0,,4,12,.333,.333,2,2,1.000,5,9,14,2,2,4,4,5,10
19922,SAC,2010,Joey Dorsey,26,8,0,52,4,9,.444,0,0,,4,9,.444,.444,4,10,.400,5,13,18,0,1,1,2,9,12
19923,SAC,2010,Garrett Temple,23,5,0,23,3,8,.375,0,2,.000,3,6,.500,.375,5,5,1.000,1,2,3,2,1,0,2,1,11
19924,SAC,2009,Jason Thompson,22,82,56,2303,356,717,.497,0,8,.000,356,709,.502,.497,198,286,.692,234,372,606,93,46,59,146,314,910
19925,SAC,2009,Beno Udrih,26,73,72,2270,321,696,.461,35,113,.310,286,583,.491,.486,123,150,.820,46,174,220,342,81,12,158,192,800
19926,SAC,2009,Spencer Hawes,20,77,51,2259,373,800,.466,40,115,.348,333,685,.486,.491,90,136,.662,148,401,549,149,44,93,160,249,876
19927,SAC,2009,John Salmons,29,53,53,1980,351,744,.472,77,184,.418,274,560,.489,.524,191,232,.823,43,178,221,196,58,9,122,122,970
19928,SAC,2009,Francisco García,27,65,36,1975,295,665,.444,88,221,.398,207,444,.466,.510,146,178,.820,56,162,218,150,80,67,112,196,824
19929,SAC,2009,Kevin Martin,25,51,46,1947,341,811,.420,115,277,.415,226,534,.423,.491,457,527,.867,29,154,183,138,61,8,146,116,1254
19930,SAC,2009,Bobby Jackson,35,71,10,1484,193,485,.398,60,197,.305,133,288,.462,.460,86,101,.851,42,158,200,143,62,4,66,100,532
19931,SAC,2009,Brad Miller,32,43,43,1354,184,388,.474,20,43,.465,164,345,.475,.500,125,156,.801,83,261,344,148,30,24,83,135,513
19932,SAC,2009,Mikki Moore,33,46,20,746,63,121,.521,0,0,,63,121,.521,.521,34,42,.810,45,107,152,28,13,14,27,112,160
19933,SAC,2009,Donté Greene,20,55,4,725,77,236,.326,26,100,.260,51,136,.375,.381,29,34,.853,19,67,86,30,16,14,37,68,209
19934,SAC,2009,Andrés Nocioni,29,23,16,713,113,252,.448,45,102,.441,68,150,.453,.538,45,59,.763,20,119,139,42,13,17,40,85,316
19935,SAC,2009,Bobby Brown,24,47,1,675,94,247,.381,31,94,.330,63,153,.412,.443,26,34,.765,8,28,36,87,15,1,47,74,245
19936,SAC,2009,Rashad McCants,24,24,1,465,87,196,.444,25,70,.357,62,126,.492,.508,47,60,.783,10,37,47,36,20,8,19,40,246
19937,SAC,2009,Shelden Williams,25,30,0,305,40,89,.449,0,2,.000,40,87,.460,.449,32,42,.762,25,53,78,8,12,10,26,36,112
19938,SAC,2009,Quincy Douby,24,20,0,227,30,88,.341,10,37,.270,20,51,.392,.398,14,15,.933,3,22,25,13,2,5,6,23,84
19939,SAC,2009,Will Solomon,30,14,0,168,26,64,.406,13,29,.448,13,35,.371,.508,5,10,.500,3,18,21,10,7,0,5,11,70
19940,SAC,2009,Ike Diogu,25,10,1,142,33,55,.600,1,2,.500,32,53,.604,.609,25,33,.758,14,25,39,3,2,1,6,14,92
19941,SAC,2009,Kenny Thomas,31,8,0,62,3,8,.375,0,0,,3,8,.375,.375,0,0,,4,11,15,1,6,1,1,9,6
19942,SAC,2009,Calvin Booth,32,7,0,55,5,10,.500,0,0,,5,10,.500,.500,6,8,.750,4,6,10,0,1,2,1,10,16
19943,SAC,2009,Drew Gooden,27,1,0,26,5,9,.556,0,0,,5,9,.556,.556,2,2,1.000,3,10,13,2,0,0,3,2,12
19944,SAC,2009,Cedric Simmons,23,7,0,23,0,4,.000,0,0,,0,4,.000,.000,1,2,.500,1,3,4,0,0,0,2,2,1
19945,SAC,2008,John Salmons,28,81,41,2517,381,799,.477,39,120,.325,342,679,.504,.501,214,260,.823,76,273,349,208,93,31,170,171,1015
19946,SAC,2008,Brad Miller,31,72,72,2513,337,728,.463,28,90,.311,309,638,.484,.482,262,309,.848,167,514,681,264,69,74,164,247,964
19947,SAC,2008,Mikki Moore,32,82,79,2385,282,489,.577,0,2,.000,282,487,.579,.577,134,182,.736,160,334,494,84,35,46,110,310,698
19948,SAC,2008,Kevin Martin,24,61,57,2216,417,914,.456,107,266,.402,310,648,.478,.515,502,578,.869,48,225,273,129,62,5,131,150,1443
19949,SAC,2008,Metta World Peace,28,57,54,2172,436,962,.453,84,221,.380,352,741,.475,.497,212,295,.719,101,227,328,199,133,38,148,159,1168
19950,SAC,2008,Francisco García,26,79,20,2096,348,752,.463,113,289,.391,235,463,.508,.538,162,208,.779,52,212,264,128,96,50,128,232,971
19951,SAC,2008,Beno Udrih,25,65,51,2080,328,708,.463,53,137,.387,275,571,.482,.501,125,147,.850,34,183,217,282,56,10,148,138,834
19952,SAC,2008,Spencer Hawes,19,71,8,931,146,318,.459,4,21,.190,142,297,.478,.465,38,58,.655,68,162,230,44,14,40,56,128,334
19953,SAC,2008,Quincy Douby,23,74,0,876,132,335,.394,42,122,.344,90,213,.423,.457,48,52,.923,17,66,83,53,30,12,59,80,354
19954,SAC,2008,Mike Bibby,29,15,12,473,78,192,.406,24,61,.393,54,131,.412,.469,23,31,.742,11,45,56,75,19,2,38,34,203
19955,SAC,2008,Anthony Johnson,33,27,11,410,40,88,.455,15,30,.500,25,58,.431,.540,9,11,.818,5,34,39,60,10,1,34,29,104
19956,SAC,2008,Shelden Williams,24,28,0,362,55,112,.491,0,1,.000,55,111,.495,.491,36,54,.667,34,64,98,8,9,10,21,50,146
19957,SAC,2008,Kenny Thomas,30,23,3,281,16,38,.421,0,0,,16,38,.421,.421,0,5,.000,18,43,61,13,6,1,21,38,32
19958,SAC,2008,Dahntay Jones,27,25,0,206,23,53,.434,1,6,.167,22,47,.468,.443,34,51,.667,7,28,35,12,8,6,10,28,81
19959,SAC,2008,Justin Williams,23,22,0,117,12,26,.462,0,0,,12,26,.462,.462,7,22,.318,19,29,48,0,5,5,3,14,31
19960,SAC,2008,Darryl Watkins,23,9,0,71,5,15,.333,0,0,,5,15,.333,.333,2,5,.400,5,7,12,0,2,2,7,8,12
19961,SAC,2008,Orien Greene,25,7,2,61,3,11,.273,0,1,.000,3,10,.300,.273,0,0,,0,6,6,3,3,1,7,9,6
19962,SAC,2008,Shareef Abdur-Rahim,31,6,0,51,3,14,.214,0,0,,3,14,.214,.214,4,4,1.000,6,4,10,4,1,0,1,9,10
19963,SAC,2008,Lorenzen Wright,32,5,0,13,1,4,.250,0,0,,1,4,.250,.250,0,0,,1,0,1,1,0,0,2,5,2
19964,SAC,2007,Kevin Martin,23,80,80,2818,505,1067,.473,127,333,.381,378,734,.515,.533,481,570,.844,69,273,342,173,98,11,135,181,1618
19965,SAC,2007,Mike Bibby,28,82,82,2784,471,1166,.404,173,481,.360,298,685,.435,.478,288,347,.830,39,224,263,388,88,6,197,139,1403
19966,SAC,2007,Metta World Peace,27,70,65,2641,458,1040,.440,93,260,.358,365,780,.468,.485,307,415,.740,102,352,454,235,149,43,146,205,1316
19967,SAC,2007,John Salmons,27,79,19,2135,236,517,.456,40,112,.357,196,405,.484,.495,159,204,.779,47,217,264,254,73,27,119,177,671
19968,SAC,2007,Shareef Abdur-Rahim,30,80,45,2015,310,654,.474,3,20,.150,307,634,.484,.476,170,234,.726,122,276,398,109,53,40,116,243,793
19969,SAC,2007,Brad Miller,30,63,56,1783,224,494,.453,5,33,.152,219,461,.475,.459,115,149,.772,79,322,401,224,38,39,108,155,568
19970,SAC,2007,Kenny Thomas,29,62,53,1412,146,303,.482,0,1,.000,146,302,.483,.482,39,76,.513,134,243,377,76,43,16,90,141,331
19971,SAC,2007,Francisco García,25,79,5,1410,163,380,.429,53,149,.356,110,231,.476,.499,95,114,.833,53,152,205,87,45,43,70,190,474
19972,SAC,2007,Corliss Williamson,33,68,1,1337,236,463,.510,0,2,.000,236,461,.512,.510,148,207,.715,63,158,221,39,29,15,97,183,620
19973,SAC,2007,Ronnie Price,23,58,1,563,67,172,.390,21,65,.323,46,107,.430,.451,37,55,.673,15,56,71,48,28,4,33,64,192
19974,SAC,2007,Quincy Douby,22,42,0,359,48,126,.381,12,50,.240,36,76,.474,.429,11,15,.733,11,26,37,15,15,4,15,21,119
19975,SAC,2007,Justin Williams,22,26,1,333,54,88,.614,0,1,.000,54,87,.621,.614,23,63,.365,51,64,115,2,5,16,15,51,131
19976,SAC,2007,Maurice Taylor,30,12,2,103,8,28,.286,0,0,,8,28,.286,.286,8,13,.615,10,18,28,5,4,1,6,16,24
19977,SAC,2007,Jason Hart,28,13,0,100,15,30,.500,3,6,.500,12,24,.500,.550,10,11,.909,2,13,15,10,3,0,4,23,43
19978,SAC,2007,Vitaly Potapenko,31,3,0,13,0,4,.000,0,0,,0,4,.000,.000,0,0,,0,2,2,0,0,0,2,3,0
19979,SAC,2006,Mike Bibby,27,82,82,3167,597,1382,.432,192,497,.386,405,885,.458,.501,342,403,.849,29,211,240,444,82,10,199,169,1728
19980,SAC,2006,Brad Miller,29,79,79,2923,434,877,.495,34,88,.386,400,789,.507,.514,280,338,.828,122,493,615,374,61,62,180,234,1182
19981,SAC,2006,Kenny Thomas,28,82,55,2293,305,604,.505,0,1,.000,305,603,.506,.505,138,204,.676,199,419,618,168,72,39,135,196,748
19982,SAC,2006,Shareef Abdur-Rahim,29,72,30,1961,332,632,.525,5,22,.227,327,610,.536,.529,218,278,.784,106,251,357,149,48,42,108,227,887
19983,SAC,2006,Kevin Martin,22,72,41,1913,262,546,.480,66,179,.369,196,367,.534,.540,188,222,.847,58,203,261,97,55,9,81,138,778
19984,SAC,2006,Bonzi Wells,29,52,41,1684,284,613,.463,10,45,.222,274,568,.482,.471,129,190,.679,142,259,401,144,94,25,126,156,707
19985,SAC,2006,Metta World Peace,26,40,40,1604,241,630,.383,60,199,.302,181,431,.420,.430,132,184,.717,49,159,208,168,80,30,88,119,674
19986,SAC,2006,Francisco García,24,67,11,1301,130,325,.400,39,137,.285,91,188,.484,.460,78,101,.772,39,146,185,94,41,47,75,135,377
19987,SAC,2006,Peja Stojaković,28,31,31,1147,171,424,.403,71,179,.397,100,245,.408,.487,98,105,.933,34,131,165,68,19,2,51,82,511
19988,SAC,2006,Jason Hart,27,66,0,818,86,221,.389,9,31,.290,77,190,.405,.410,37,56,.661,12,59,71,70,31,5,43,85,218
19989,SAC,2006,Brian Skinner,29,38,0,429,38,69,.551,0,0,,38,69,.551,.551,12,27,.444,30,71,101,17,11,20,18,54,88
19990,SAC,2006,Corliss Williamson,32,37,0,362,43,103,.417,2,2,1.000,41,101,.406,.427,38,49,.776,21,46,67,14,7,4,30,56,126
19991,SAC,2006,Ronnie Price,22,29,0,150,21,58,.362,6,27,.222,15,31,.484,.414,12,12,1.000,5,10,15,11,6,0,10,10,60
19992,SAC,2006,Jamal Sampson,22,12,0,39,5,7,.714,0,0,,5,7,.714,.714,0,2,.000,5,13,18,5,0,4,0,5,10
19993,SAC,2006,Vitaly Potapenko,30,9,0,32,5,7,.714,0,0,,5,7,.714,.714,0,0,,1,1,2,2,0,0,2,6,10
19994,SAC,2006,Sergei Monia,22,3,0,7,0,2,.000,0,1,.000,0,1,.000,.000,2,2,1.000,0,1,1,0,1,0,0,0,2
19995,SAC,2005,Mike Bibby,26,80,80,3084,560,1264,.443,131,364,.360,429,900,.477,.495,320,413,.775,77,255,332,541,124,30,203,191,1571
19996,SAC,2005,Peja Stojaković,27,66,66,2534,451,1016,.444,174,433,.402,277,583,.475,.530,253,275,.920,62,223,285,138,79,12,102,157,1329
19997,SAC,2005,Brad Miller,28,56,56,2089,319,609,.524,5,19,.263,314,590,.532,.528,233,287,.812,139,382,521,220,69,68,82,181,876
19998,SAC,2005,Darius Songaila,26,81,21,1668,257,488,.527,0,3,.000,257,485,.530,.527,94,111,.847,125,219,344,114,51,18,70,206,608
19999,SAC,2005,Chris Webber,31,46,46,1668,412,917,.449,11,29,.379,401,888,.452,.455,143,179,.799,94,353,447,252,68,34,133,144,978
20000,SAC,2005,Cuttino Mobley,29,43,43,1662,280,636,.440,92,217,.424,188,419,.449,.513,113,136,.831,34,132,166,146,51,21,92,103,765
20001,SAC,2005,Maurice Evans,26,65,11,1233,165,373,.442,27,82,.329,138,291,.474,.479,59,78,.756,88,113,201,45,37,8,34,104,416
20002,SAC,2005,Doug Christie,34,31,31,996,83,204,.407,10,39,.256,73,165,.442,.431,50,56,.893,29,94,123,153,43,13,68,61,226
20003,SAC,2005,Kenny Thomas,27,26,15,823,150,305,.492,0,1,.000,150,304,.493,.492,78,108,.722,78,149,227,75,27,11,48,76,378
20004,SAC,2005,Matt Barnes,24,43,9,715,62,151,.411,5,22,.227,57,129,.442,.427,35,58,.603,49,84,133,57,30,7,45,80,164
20005,SAC,2005,Brian Skinner,28,25,23,695,82,148,.554,0,0,,82,148,.554,.554,20,53,.377,84,134,218,38,26,43,27,73,184
20006,SAC,2005,Greg Ostertag,31,56,3,556,37,84,.440,0,2,.000,37,82,.451,.440,13,38,.342,55,112,167,37,7,40,24,88,87
20007,SAC,2005,Eddie House,26,50,2,550,98,214,.458,28,62,.452,70,152,.461,.523,13,14,.929,14,47,61,67,18,3,22,39,237
20008,SAC,2005,Bobby Jackson,31,25,0,536,109,255,.427,33,96,.344,76,159,.478,.492,50,58,.862,23,62,85,59,14,2,28,58,301
20009,SAC,2005,Corliss Williamson,31,24,4,471,79,167,.473,0,0,,79,167,.473,.473,65,79,.823,31,50,81,35,12,3,26,74,223
20010,SAC,2005,Kevin Martin,21,45,0,455,45,117,.385,5,25,.200,40,92,.435,.406,36,55,.655,29,29,58,22,16,3,24,35,131
20011,SAC,2005,Erik Daniels,22,21,0,72,6,18,.333,1,2,.500,5,16,.313,.361,0,0,,7,11,18,4,2,0,6,7,13
20012,SAC,2005,Michael Bradley,25,8,0,48,8,12,.667,0,0,,8,12,.667,.667,2,6,.333,5,6,11,2,0,0,3,8,18
20013,SAC,2004,Peja Stojaković,26,81,81,3264,665,1386,.480,240,554,.433,425,832,.511,.566,394,425,.927,91,417,508,173,108,14,153,159,1964
20014,SAC,2004,Mike Bibby,25,82,82,2980,527,1170,.450,148,378,.392,379,792,.479,.514,304,373,.815,67,210,277,444,112,18,175,146,1506
20015,SAC,2004,Doug Christie,33,82,82,2780,317,688,.461,49,142,.345,268,546,.491,.496,148,172,.860,69,260,329,347,151,41,155,186,831
20016,SAC,2004,Brad Miller,27,72,53,2621,373,731,.510,12,38,.316,361,693,.521,.518,256,329,.778,191,552,743,312,68,86,144,247,1014
20017,SAC,2004,Vlade Divac,35,81,81,2317,314,668,.470,2,13,.154,312,655,.476,.472,170,260,.654,136,327,463,432,57,77,173,222,800
20018,SAC,2004,Anthony Peeler,34,75,0,1391,156,348,.448,68,141,.482,88,207,.425,.546,51,61,.836,31,122,153,120,56,10,77,103,431
20019,SAC,2004,Bobby Jackson,30,50,0,1185,263,592,.444,81,219,.370,182,373,.488,.513,82,109,.752,55,119,174,105,49,8,63,106,689
20020,SAC,2004,Darius Songaila,25,73,7,976,133,273,.487,0,0,,133,273,.487,.487,71,88,.807,91,134,225,48,42,12,43,126,337
20021,SAC,2004,Chris Webber,30,23,23,831,174,421,.413,1,5,.200,173,416,.416,.414,81,114,.711,48,152,200,105,31,20,60,76,430
20022,SAC,2004,Tony Massenburg,36,59,0,789,104,219,.475,0,1,.000,104,218,.477,.475,43,63,.683,57,131,188,29,14,18,45,144,251
20023,SAC,2004,Gerald Wallace,21,37,1,337,32,89,.360,0,2,.000,32,87,.368,.360,11,24,.458,35,39,74,19,14,14,8,37,75
20024,SAC,2004,Jabari Smith,26,31,0,168,26,70,.371,0,3,.000,26,67,.388,.371,12,20,.600,11,20,31,11,2,6,7,25,64
20025,SAC,2004,Rodney Buford,26,22,0,141,19,56,.339,0,2,.000,19,54,.352,.339,3,6,.500,6,9,15,7,6,1,4,9,41
20026,SAC,2003,Doug Christie,32,80,80,2710,267,557,.479,73,185,.395,194,372,.522,.545,141,174,.810,61,281,342,376,180,37,144,186,748
20027,SAC,2003,Chris Webber,29,67,67,2622,661,1433,.461,5,21,.238,656,1412,.465,.463,215,354,.607,160,544,704,364,106,88,215,204,1542
20028,SAC,2003,Peja Stojaković,25,72,72,2450,497,1034,.481,155,406,.382,342,628,.545,.556,231,264,.875,61,336,397,141,72,5,101,143,1380
20029,SAC,2003,Vlade Divac,34,80,80,2384,305,655,.466,6,25,.240,299,630,.475,.470,179,251,.713,157,417,574,274,83,105,152,239,795
20030,SAC,2003,Mike Bibby,24,55,55,1835,329,700,.470,56,137,.409,273,563,.485,.510,161,187,.861,34,113,147,285,72,8,127,93,875
20031,SAC,2003,Keon Clark,27,80,11,1780,226,451,.501,0,4,.000,226,447,.506,.501,84,128,.656,138,313,451,80,38,150,94,227,536
20032,SAC,2003,Bobby Jackson,29,59,26,1676,340,732,.464,89,235,.379,251,497,.505,.525,126,149,.846,57,162,219,182,71,3,106,126,895
20033,SAC,2003,Jim Jackson,32,63,0,1309,204,462,.442,32,71,.451,172,391,.440,.476,47,55,.855,84,178,262,118,31,4,80,132,487
20034,SAC,2003,Hedo Türkoğlu,23,67,11,1175,165,391,.422,29,78,.372,136,313,.435,.459,88,110,.800,35,153,188,87,25,12,50,125,447
20035,SAC,2003,Damon Jones,26,49,1,709,80,210,.381,44,121,.364,36,89,.404,.486,20,27,.741,11,59,70,80,18,4,23,42,224
20036,SAC,2003,Gerald Wallace,20,47,7,571,90,183,.492,1,4,.250,89,179,.497,.495,39,74,.527,38,90,128,23,24,15,44,68,220
20037,SAC,2003,Scot Pollard,27,23,0,325,40,87,.460,0,0,,40,87,.460,.460,23,38,.605,46,60,106,6,13,15,15,50,103
20038,SAC,2003,Lawrence Funderburke,32,27,0,229,32,72,.444,0,0,,32,72,.444,.444,10,17,.588,17,38,55,8,1,11,6,25,74
20039,SAC,2003,Mateen Cleaves,25,12,0,55,6,23,.261,1,1,1.000,5,22,.227,.283,3,4,.750,1,7,8,10,2,0,14,6,16
20040,SAC,2002,Doug Christie,31,81,81,2798,338,735,.460,90,256,.352,248,479,.518,.521,206,242,.851,74,300,374,340,160,25,164,209,972
20041,SAC,2002,Mike Bibby,23,80,80,2659,446,985,.453,51,138,.370,395,847,.466,.479,155,193,.803,37,185,222,403,87,15,134,133,1098
20042,SAC,2002,Peja Stojaković,24,71,71,2649,547,1130,.484,129,310,.416,418,820,.510,.541,283,323,.876,72,301,373,175,81,14,140,120,1506
20043,SAC,2002,Vlade Divac,33,80,80,2420,338,716,.472,3,13,.231,335,703,.477,.474,209,340,.615,205,466,671,297,79,94,158,229,888
20044,SAC,2002,Chris Webber,28,54,54,2071,532,1075,.495,5,19,.263,527,1056,.499,.497,253,338,.749,150,396,546,258,90,76,158,181,1322
20045,SAC,2002,Hedo Türkoğlu,22,80,10,1970,290,687,.422,63,171,.368,227,516,.440,.468,167,230,.726,63,300,363,163,57,31,81,184,810
20046,SAC,2002,Scot Pollard,26,80,29,1881,197,358,.550,0,0,,197,358,.550,.550,115,166,.693,188,377,565,53,70,76,68,202,509
20047,SAC,2002,Bobby Jackson,28,81,3,1750,334,754,.443,79,219,.361,255,535,.477,.495,149,184,.810,82,169,251,164,73,11,93,145,896
20048,SAC,2002,Lawrence Funderburke,31,56,1,722,115,245,.469,0,3,.000,115,242,.475,.469,34,56,.607,76,122,198,32,11,18,33,65,264
20049,SAC,2002,Gerald Wallace,19,54,1,430,75,175,.429,0,7,.000,75,168,.446,.429,23,46,.500,49,40,89,27,19,6,22,46,173
20050,SAC,2002,Mateen Cleaves,24,32,0,153,30,68,.441,2,8,.250,28,60,.467,.456,8,9,.889,1,7,8,25,7,0,27,9,70
20051,SAC,2002,Chucky Brown,33,18,0,92,10,27,.370,0,0,,10,27,.370,.370,1,2,.500,10,23,33,6,2,4,5,12,21
20052,SAC,2002,Brent Price,33,20,0,89,9,27,.333,4,15,.267,5,12,.417,.407,9,13,.692,4,4,8,9,3,1,10,13,31
20053,SAC,2002,Jabari Smith,24,12,0,71,6,21,.286,0,1,.000,6,20,.300,.286,6,12,.500,2,12,14,6,2,4,2,12,18
20054,SAC,2001,Doug Christie,30,81,81,2939,311,788,.395,94,250,.376,217,538,.403,.454,280,312,.897,95,260,355,289,183,45,154,224,996
20055,SAC,2001,Peja Stojaković,23,75,75,2905,559,1189,.470,144,360,.400,415,829,.501,.531,267,312,.856,93,341,434,164,91,13,146,144,1529
20056,SAC,2001,Chris Webber,27,70,70,2836,786,1635,.481,2,28,.071,784,1607,.488,.481,324,461,.703,179,598,777,294,93,118,195,226,1898
20057,SAC,2001,Vlade Divac,32,81,81,2420,364,755,.482,4,14,.286,360,741,.486,.485,242,350,.691,207,466,673,231,87,93,192,242,974
20058,SAC,2001,Jason Williams,25,77,77,2290,281,690,.407,98,311,.315,183,379,.483,.478,60,76,.789,19,166,185,416,94,9,160,114,720
20059,SAC,2001,Scot Pollard,25,77,8,1658,185,395,.468,0,2,.000,185,393,.471,.468,128,171,.749,173,292,465,47,48,97,66,206,498
20060,SAC,2001,Bobby Jackson,27,79,7,1648,231,526,.439,39,104,.375,192,422,.455,.476,65,88,.739,74,172,246,161,87,7,103,139,566
20061,SAC,2001,Hedo Türkoğlu,21,74,7,1245,138,335,.412,28,86,.326,110,249,.442,.454,87,112,.777,49,161,210,69,52,24,55,139,391
20062,SAC,2001,Jon Barry,31,62,2,1010,103,255,.404,46,132,.348,57,123,.463,.494,64,73,.877,16,78,94,130,28,6,53,66,316
20063,SAC,2001,Lawrence Funderburke,30,59,2,698,120,242,.496,0,0,,120,242,.496,.496,48,77,.623,74,122,196,17,9,13,32,44,288
20064,SAC,2001,Darrick Martin,29,31,0,176,29,76,.382,14,27,.519,15,49,.306,.474,31,35,.886,2,14,16,14,7,0,10,27,103
20065,SAC,2001,Nick Anderson,33,21,0,169,14,57,.246,10,39,.256,4,18,.222,.333,0,0,,3,22,25,13,10,4,7,13,38
20066,SAC,2001,Jabari Smith,23,9,0,66,11,22,.500,0,0,,11,22,.500,.500,4,6,.667,1,7,8,6,4,0,3,7,26
20067,SAC,2001,Art Long,28,9,0,20,0,4,.000,0,0,,0,4,.000,.000,0,2,.000,2,6,8,1,0,3,2,5,0
20068,SAC,2000,Chris Webber,26,75,75,2880,748,1548,.483,27,95,.284,721,1453,.496,.492,311,414,.751,189,598,787,345,120,128,218,264,1834
20069,SAC,2000,Jason Williams,24,81,81,2760,363,973,.373,145,505,.287,218,468,.466,.448,128,170,.753,22,208,230,589,117,8,296,140,999
20070,SAC,2000,Vlade Divac,31,82,81,2374,384,764,.503,7,26,.269,377,738,.511,.507,230,333,.691,174,482,656,244,103,103,190,251,1005
20071,SAC,2000,Nick Anderson,32,72,72,2094,306,782,.391,132,397,.332,174,385,.452,.476,37,76,.487,83,256,339,123,94,16,95,118,781
20072,SAC,2000,Peja Stojaković,22,74,11,1749,321,717,.448,100,267,.375,221,450,.491,.517,135,153,.882,74,202,276,106,52,7,88,97,877
20073,SAC,2000,Corliss Williamson,26,76,76,1707,311,622,.500,0,0,,311,622,.500,.500,163,212,.769,122,168,290,82,38,19,110,192,785
20074,SAC,2000,Scot Pollard,24,76,5,1336,149,283,.527,0,0,,149,283,.527,.527,114,159,.717,168,236,404,43,55,59,50,213,412
20075,SAC,2000,Jon Barry,30,62,1,1281,161,346,.465,66,154,.429,95,192,.495,.561,107,116,.922,38,121,159,150,75,7,85,104,495
20076,SAC,2000,Lawrence Funderburke,29,75,1,1026,184,352,.523,0,2,.000,184,350,.526,.523,115,163,.706,98,136,234,33,32,20,40,91,483
20077,SAC,2000,Tyrone Corbin,37,54,5,941,88,247,.356,10,44,.227,78,203,.384,.377,33,39,.846,40,125,165,60,36,5,29,99,219
20078,SAC,2000,Darrick Martin,28,71,1,893,133,350,.380,38,124,.306,95,226,.420,.434,98,119,.824,7,37,44,122,28,2,62,89,402
20079,SAC,2000,Tony Delk,26,46,1,682,120,279,.430,9,40,.225,111,239,.464,.446,47,59,.797,36,52,88,55,35,5,32,58,296
20080,SAC,2000,Bill Wennington,36,7,0,57,6,19,.316,0,0,,6,19,.316,.316,2,2,1.000,5,14,19,1,2,2,1,13,14
20081,SAC,2000,Ryan Robertson,23,1,0,25,2,6,.333,0,2,.000,2,4,.500,.333,1,1,1.000,0,0,0,0,0,0,0,0,5
20082,SAC,1999,Jason Williams,23,50,50,1805,231,617,.374,100,323,.310,131,294,.446,.455,79,105,.752,14,139,153,299,95,1,143,91,641
20083,SAC,1999,Vlade Divac,30,50,50,1761,262,557,.470,11,43,.256,251,514,.488,.480,179,255,.702,140,361,501,215,44,51,131,166,714
20084,SAC,1999,Chris Webber,25,42,42,1719,378,778,.486,4,34,.118,374,744,.503,.488,79,174,.454,149,396,545,173,60,89,148,145,839
20085,SAC,1999,Corliss Williamson,25,50,50,1374,269,555,.485,1,5,.200,268,550,.487,.486,120,188,.638,85,121,206,66,30,8,75,118,659
20086,SAC,1999,Tariq Abdul-Wahad,24,49,49,1205,177,407,.435,6,21,.286,171,386,.443,.442,94,136,.691,72,114,186,50,50,16,70,121,454
20087,SAC,1999,Peja Stojaković,21,48,1,1025,141,373,.378,57,178,.320,84,195,.431,.454,63,74,.851,43,100,143,72,41,7,53,43,402
20088,SAC,1999,Vernon Maxwell,33,46,1,1007,164,421,.390,80,231,.346,84,190,.442,.485,84,114,.737,13,72,85,76,30,3,67,111,492
20089,SAC,1999,Lawrence Funderburke,28,47,2,936,167,299,.559,1,5,.200,166,294,.565,.560,85,120,.708,101,121,222,30,22,23,52,77,420
20090,SAC,1999,Jon Barry,29,43,0,736,59,138,.428,24,79,.304,35,59,.593,.514,71,84,.845,25,71,96,112,53,5,47,61,213
20091,SAC,1999,Scot Pollard,23,16,5,259,33,61,.541,0,0,,33,61,.541,.541,16,23,.696,38,44,82,4,8,18,5,41,82
20092,SAC,1999,Michael Hawkins,26,24,0,203,14,40,.350,5,19,.263,9,21,.429,.413,3,3,1.000,10,15,25,27,3,1,13,14,36
20093,SAC,1999,Kevin Ollie,26,7,0,68,4,13,.308,0,0,,4,13,.308,.308,4,5,.800,0,6,6,3,3,1,3,8,12
20094,SAC,1999,Jerome James,23,16,0,42,9,24,.375,0,0,,9,24,.375,.375,6,12,.500,6,11,17,1,2,6,9,11,24
20095,SAC,1999,Oliver Miller,28,4,0,35,5,11,.455,0,0,,5,11,.455,.455,0,0,,7,1,8,0,0,2,4,3,10
20096,SAC,1999,Terry Dehere,27,4,0,20,4,11,.364,1,5,.200,3,6,.500,.409,0,0,,2,0,2,1,2,0,2,2,9
20097,SAC,1999,Peter Aluma,25,2,0,5,1,2,.500,0,0,,1,2,.500,.500,0,0,,1,1,2,0,1,1,2,4,2
20098,SAC,1998,Corliss Williamson,24,79,75,2819,561,1134,.495,0,9,.000,561,1125,.499,.495,279,443,.630,162,284,446,230,76,48,199,252,1401
20099,SAC,1998,Mitch Richmond,32,70,70,2569,543,1220,.445,130,334,.389,413,886,.466,.498,407,471,.864,50,179,229,279,88,15,181,154,1623
20100,SAC,1998,Billy Owens,28,78,78,2348,338,728,.464,26,70,.371,312,658,.474,.482,116,197,.589,170,412,582,219,93,38,153,231,818
20101,SAC,1998,Anthony Johnson,23,77,62,2266,226,609,.371,42,128,.328,184,481,.383,.406,80,110,.727,51,120,171,329,64,6,120,188,574
20102,SAC,1998,Michael Stewart,22,81,37,1761,155,323,.480,0,0,,155,323,.480,.480,65,142,.458,197,339,536,61,29,195,85,251,375
20103,SAC,1998,Olden Polynice,33,70,25,1458,249,542,.459,0,1,.000,249,541,.460,.459,52,115,.452,173,266,439,107,37,45,98,158,550
20104,SAC,1998,Terry Dehere,26,77,18,1410,180,451,.399,50,132,.379,130,319,.408,.455,79,99,.798,21,85,106,196,52,4,96,150,489
20105,SAC,1998,Lawrence Funderburke,27,52,1,1094,191,390,.490,1,7,.143,190,383,.496,.491,110,162,.679,80,154,234,63,19,15,62,56,493
20106,SAC,1998,Tariq Abdul-Wahad,23,59,16,959,144,357,.403,4,19,.211,140,338,.414,.409,84,125,.672,44,72,116,51,35,13,65,81,376
20107,SAC,1998,Mark Hendrickson,23,48,1,737,58,149,.389,0,5,.000,58,144,.403,.389,47,57,.825,33,110,143,41,26,9,31,60,163
20108,SAC,1998,Otis Thorpe,35,27,20,623,89,194,.459,0,1,.000,89,193,.461,.459,46,70,.657,51,115,166,61,18,7,37,80,224
20109,SAC,1998,Mahmoud Abdul-Rauf,28,31,0,530,103,273,.377,5,31,.161,98,242,.405,.386,16,16,1.000,6,31,37,58,16,1,19,31,227
20110,SAC,1998,Bobby Hurley,26,34,3,417,47,115,.409,4,15,.267,43,100,.430,.426,30,37,.811,7,29,36,80,13,0,42,36,128
20111,SAC,1998,Michael Smith,25,18,4,347,26,61,.426,0,0,,26,61,.426,.426,17,30,.567,35,65,100,29,15,9,15,35,69
20112,SAC,1998,Chris Robinson,23,19,0,271,42,111,.378,17,42,.405,25,69,.362,.455,7,14,.500,9,24,33,29,12,3,18,29,108
20113,SAC,1998,Kevin Salvadori,27,16,0,87,1,13,.077,0,0,,1,13,.077,.077,3,6,.500,5,15,20,3,0,11,5,12,5
20114,SAC,1998,Derek Grimm,23,9,0,34,4,14,.286,4,12,.333,0,2,.000,.429,2,2,1.000,0,4,4,0,3,1,3,6,14
20115,SAC,1997,Mitch Richmond,31,81,81,3125,717,1578,.454,204,477,.428,513,1101,.466,.519,457,531,.861,59,260,319,338,118,24,237,211,2095
20116,SAC,1997,Olden Polynice,32,82,82,2893,442,967,.457,0,6,.000,442,961,.460,.457,141,251,.562,272,500,772,178,46,80,166,298,1025
20117,SAC,1997,Michael Smith,24,81,52,2526,202,375,.539,0,0,,202,375,.539,.539,128,258,.496,257,512,769,191,82,60,130,251,532
20118,SAC,1997,Mahmoud Abdul-Rauf,27,75,51,2131,411,924,.445,94,246,.382,317,678,.468,.496,115,136,.846,16,106,122,189,56,6,119,174,1031
20119,SAC,1997,Billy Owens,27,66,56,1995,299,640,.467,25,72,.347,274,568,.482,.487,101,145,.697,134,258,392,187,62,25,133,187,724
20120,SAC,1997,Corliss Williamson,23,79,31,1992,371,745,.498,0,3,.000,371,742,.500,.498,173,251,.689,139,187,326,124,60,49,157,263,915
20121,SAC,1997,Tyus Edney,23,70,20,1376,150,391,.384,8,42,.190,142,349,.407,.394,177,215,.823,34,79,113,226,60,2,112,98,485
20122,SAC,1997,Kevin Gamble,31,62,2,953,123,286,.430,54,112,.482,69,174,.397,.524,7,10,.700,13,94,107,77,21,17,27,76,307
20123,SAC,1997,Bobby Hurley,25,49,12,632,46,125,.368,14,45,.311,32,80,.400,.424,37,53,.698,9,29,38,146,27,3,55,53,143
20124,SAC,1997,Brian Grant,24,24,15,607,91,207,.440,0,0,,91,207,.440,.440,70,90,.778,49,93,142,28,19,25,44,75,252
20125,SAC,1997,Duane Causwell,28,46,8,581,48,94,.511,2,3,.667,46,91,.505,.521,20,37,.541,57,70,127,20,15,38,34,131,118
20126,SAC,1997,Lionel Simmons,28,41,0,521,45,136,.331,7,30,.233,38,106,.358,.357,42,48,.875,30,74,104,57,8,13,34,63,139
20127,SAC,1997,Jeff Grayer,31,25,0,316,38,83,.458,4,11,.364,34,72,.472,.482,11,20,.550,21,17,38,25,8,7,15,42,91
20128,SAC,1997,Kevin Salvadori,26,23,0,154,12,33,.364,0,0,,12,33,.364,.364,13,18,.722,6,19,25,10,2,13,12,17,37
20129,SAC,1997,Lloyd Daniels,29,5,0,28,2,16,.125,2,11,.182,0,5,.000,.188,0,0,,1,3,4,1,1,0,3,4,6
20130,SAC,1997,Devin Gray,24,3,0,25,3,11,.273,0,0,,3,11,.273,.273,2,4,.500,3,6,9,2,3,0,0,3,8
20131,SAC,1996,Mitch Richmond,30,81,81,2946,611,1368,.447,225,515,.437,386,853,.453,.529,425,491,.866,54,215,269,255,125,19,220,233,1872
20132,SAC,1996,Tyus Edney,22,80,60,2481,305,740,.412,53,144,.368,252,596,.423,.448,197,252,.782,63,138,201,491,89,3,192,203,860
20133,SAC,1996,Olden Polynice,31,81,80,2441,431,818,.527,1,3,.333,430,815,.528,.528,122,203,.601,257,507,764,58,52,66,127,250,985
20134,SAC,1996,Brian Grant,23,78,75,2398,427,842,.507,4,17,.235,423,825,.513,.510,262,358,.732,175,370,545,127,40,103,185,269,1120
20135,SAC,1996,Michael Smith,23,65,0,1384,144,238,.605,1,1,1.000,143,237,.603,.607,68,177,.384,143,246,389,110,47,46,72,166,357
20136,SAC,1996,Walt Williams,25,45,45,1381,235,540,.435,58,170,.341,177,370,.478,.489,130,172,.756,62,145,207,165,53,42,103,151,658
20137,SAC,1996,Bobby Hurley,24,72,22,1059,65,230,.283,22,76,.289,43,154,.279,.330,68,85,.800,12,63,75,216,28,3,86,121,220
20138,SAC,1996,Duane Causwell,27,73,26,1044,90,216,.417,0,1,.000,90,215,.419,.417,70,96,.729,86,162,248,20,27,78,53,173,250
20139,SAC,1996,Šarūnas Marčiulionis,31,53,0,1039,176,389,.452,64,157,.408,112,232,.483,.535,155,200,.775,20,57,77,118,52,4,96,112,571
20140,SAC,1996,Tyrone Corbin,33,49,2,930,117,259,.452,1,12,.083,116,247,.470,.454,77,92,.837,55,124,179,61,47,17,50,96,312
20141,SAC,1996,Lionel Simmons,27,54,5,810,86,217,.396,19,51,.373,67,166,.404,.440,55,75,.733,41,104,145,83,31,20,51,85,246
20142,SAC,1996,Corliss Williamson,22,53,3,609,125,268,.466,0,3,.000,125,265,.472,.466,47,84,.560,56,58,114,23,11,9,76,115,297
20143,SAC,1996,Billy Owens,26,22,11,594,84,200,.420,5,12,.417,79,188,.420,.433,45,70,.643,49,76,125,70,19,16,51,60,218
20144,SAC,1996,Kevin Gamble,30,21,0,292,35,82,.427,6,23,.261,29,59,.492,.463,5,10,.500,7,20,27,18,4,3,11,28,81
20145,SAC,1996,Byron Houston,26,25,0,276,32,64,.500,1,3,.333,31,61,.508,.508,21,26,.808,31,53,84,7,13,7,17,59,86
20146,SAC,1996,Clint McDaniel,23,12,0,71,8,23,.348,2,6,.333,6,17,.353,.391,12,16,.750,3,7,10,7,5,0,2,10,30
20147,SAC,1995,Mitch Richmond,29,82,82,3172,668,1497,.446,156,424,.368,512,1073,.477,.498,375,445,.843,69,288,357,311,91,29,234,227,1867
20148,SAC,1995,Walt Williams,24,77,77,2739,445,998,.446,103,296,.348,342,702,.487,.497,266,364,.731,100,245,345,316,123,63,243,265,1259
20149,SAC,1995,Olden Polynice,30,81,81,2534,376,691,.544,1,1,1.000,375,690,.543,.545,124,194,.639,277,448,725,62,48,52,113,238,877
20150,SAC,1995,Spud Webb,31,76,76,2458,302,689,.438,48,145,.331,254,544,.467,.473,226,242,.934,29,145,174,468,75,8,185,148,878
20151,SAC,1995,Brian Grant,22,80,59,2289,413,809,.511,1,4,.250,412,805,.512,.511,231,363,.636,207,391,598,99,49,116,163,276,1058
20152,SAC,1995,Michael Smith,22,82,0,1736,220,406,.542,0,2,.000,220,404,.545,.542,127,262,.485,174,312,486,67,61,49,106,235,567
20153,SAC,1995,Bobby Hurley,23,68,6,1105,103,284,.363,21,76,.276,82,208,.394,.400,58,76,.763,14,56,70,226,29,0,110,79,285
20154,SAC,1995,Randy Brown,26,67,2,1086,124,287,.432,14,47,.298,110,240,.458,.456,55,82,.671,24,84,108,133,99,19,78,153,317
20155,SAC,1995,Lionel Simmons,26,58,3,1064,131,312,.420,6,16,.375,125,296,.422,.429,59,84,.702,61,135,196,89,28,23,70,118,327
20156,SAC,1995,Duane Causwell,26,58,24,820,76,147,.517,0,1,.000,76,146,.521,.517,57,98,.582,57,117,174,15,14,80,33,146,209
20157,SAC,1995,Alaa Abdelnaby,26,51,0,476,117,220,.532,0,2,.000,117,218,.537,.532,20,35,.571,34,72,106,13,15,12,40,102,254
20158,SAC,1995,Henry Turner,28,30,0,149,23,57,.404,2,5,.400,21,52,.404,.421,20,35,.571,17,11,28,7,8,1,12,20,68
20159,SAC,1995,Trevor Wilson,26,15,0,147,18,40,.450,0,0,,18,40,.450,.450,11,14,.786,10,16,26,12,4,2,6,12,47
20160,SAC,1995,Doug Lee,30,22,0,75,9,25,.360,7,18,.389,2,7,.286,.500,18,21,.857,0,5,5,5,6,3,5,18,43
20161,SAC,1995,Derrick Phelps,22,3,0,5,0,1,.000,0,0,,0,1,.000,.000,0,2,.000,0,0,0,1,0,0,0,3,0
20162,SAC,1994,Mitch Richmond,28,78,78,2897,635,1428,.445,127,312,.407,508,1116,.455,.489,426,511,.834,70,216,286,313,103,17,216,211,1823
20163,SAC,1994,Lionel Simmons,25,75,74,2702,436,996,.438,6,17,.353,430,979,.439,.441,251,323,.777,168,394,562,305,104,50,183,189,1129
20164,SAC,1994,Spud Webb,30,79,62,2567,373,810,.460,55,164,.335,318,646,.492,.494,204,251,.813,44,178,222,528,93,23,168,182,1005
20165,SAC,1994,Wayman Tisdale,29,79,77,2557,552,1102,.501,0,0,,552,1102,.501,.501,215,266,.808,159,401,560,139,37,52,124,290,1319
20166,SAC,1994,Walt Williams,23,57,4,1356,226,580,.390,38,132,.288,188,448,.420,.422,148,233,.635,71,164,235,132,52,23,145,200,638
20167,SAC,1994,Trevor Wilson,25,52,9,1095,168,349,.481,0,2,.000,168,347,.484,.481,79,141,.560,108,137,245,60,33,10,87,106,415
20168,SAC,1994,Olden Polynice,29,31,29,1052,124,256,.484,0,1,.000,124,255,.486,.484,55,99,.556,151,202,353,19,18,31,29,81,303
20169,SAC,1994,Randy Brown,25,61,2,1041,110,251,.438,0,4,.000,110,247,.445,.438,53,87,.609,40,72,112,133,63,14,75,132,273
20170,SAC,1994,Pete Chilcutt,25,46,24,974,152,328,.463,0,1,.000,152,327,.465,.463,31,52,.596,100,171,271,71,43,28,56,116,335
20171,SAC,1994,LaBradford Smith,24,59,2,829,116,288,.403,21,60,.350,95,228,.417,.439,48,64,.750,29,47,76,104,37,4,49,88,301
20172,SAC,1994,Duane Causwell,25,41,8,674,71,137,.518,0,0,,71,137,.518,.518,40,68,.588,68,118,186,11,19,49,33,109,182
20173,SAC,1994,Mike Peplowski,23,55,19,667,76,141,.539,0,1,.000,76,140,.543,.539,24,44,.545,49,120,169,24,17,25,34,131,176
20174,SAC,1994,Bobby Hurley,22,19,19,499,54,146,.370,2,16,.125,52,130,.400,.377,24,30,.800,6,28,34,115,13,1,48,28,134
20175,SAC,1994,Andre Spencer,29,23,0,286,43,100,.430,0,0,,43,100,.430,.430,52,73,.712,26,35,61,19,18,5,19,37,138
20176,SAC,1994,Randy Breuer,33,26,3,247,8,26,.308,0,1,.000,8,25,.320,.308,3,14,.214,15,41,56,8,6,19,9,30,19
20177,SAC,1994,Jim Les,30,18,0,169,13,34,.382,8,18,.444,5,16,.313,.500,11,13,.846,5,8,13,39,7,1,11,16,45
20178,SAC,1994,Evers Burns,22,23,0,143,22,55,.400,0,0,,22,55,.400,.400,12,23,.522,13,17,30,9,6,3,7,33,56
20179,SAC,1993,Lionel Simmons,24,69,68,2502,468,1055,.444,1,11,.091,467,1044,.447,.444,298,364,.819,156,339,495,312,95,38,196,197,1235
20180,SAC,1993,Spud Webb,29,69,68,2335,342,789,.433,37,135,.274,305,654,.466,.457,279,328,.851,44,149,193,481,104,6,194,177,1000
20181,SAC,1993,Wayman Tisdale,28,76,75,2283,544,1068,.509,0,2,.000,544,1066,.510,.509,175,231,.758,127,373,500,108,52,47,117,277,1263
20182,SAC,1993,Anthony Bonner,24,70,35,1764,229,497,.461,0,7,.000,229,490,.467,.461,143,241,.593,188,267,455,96,86,17,105,183,601
20183,SAC,1993,Mitch Richmond,27,45,45,1728,371,782,.474,48,130,.369,323,652,.495,.505,197,233,.845,18,136,154,221,53,9,130,137,987
20184,SAC,1993,Randy Brown,24,75,34,1726,225,486,.463,2,6,.333,223,480,.465,.465,115,157,.732,75,137,212,196,108,34,120,206,567
20185,SAC,1993,Walt Williams,22,59,26,1673,358,823,.435,61,191,.319,297,632,.470,.472,224,302,.742,115,150,265,178,66,29,179,209,1001
20186,SAC,1993,Rod Higgins,33,69,4,1425,199,483,.412,43,133,.323,156,350,.446,.457,130,151,.861,66,127,193,119,51,29,63,141,571
20187,SAC,1993,Duane Causwell,24,55,45,1211,175,321,.545,0,1,.000,175,320,.547,.545,103,165,.624,112,191,303,35,32,87,58,192,453
20188,SAC,1993,Jim Les,29,73,0,881,110,259,.425,66,154,.429,44,105,.419,.552,42,50,.840,20,69,89,169,40,7,48,81,328
20189,SAC,1993,Pete Chilcutt,24,59,9,834,165,340,.485,0,0,,165,340,.485,.485,32,46,.696,80,114,194,64,22,21,54,102,362
20190,SAC,1993,Kurt Rambis,34,67,1,781,63,122,.516,0,2,.000,63,120,.525,.516,42,63,.667,75,146,221,52,40,18,36,119,168
20191,SAC,1993,Marty Conlon,25,46,0,467,81,171,.474,0,4,.000,81,167,.485,.474,57,81,.704,48,75,123,37,13,5,28,43,219
20192,SAC,1993,Henry James,27,8,0,79,20,45,.444,3,10,.300,17,35,.486,.478,17,20,.850,6,4,10,1,3,0,7,9,60
20193,SAC,1993,Vincent Askew,26,9,0,76,8,17,.471,0,0,,8,17,.471,.471,11,15,.733,7,4,11,5,2,1,8,11,27
20194,SAC,1993,Stan Kimbrough,26,3,0,15,2,6,.333,1,2,.500,1,4,.250,.417,0,0,,0,0,0,1,1,0,0,1,5
20195,SAC,1992,Mitch Richmond,26,80,80,3095,685,1465,.468,103,268,.384,582,1197,.486,.503,330,406,.813,62,257,319,411,92,34,247,231,1803
20196,SAC,1992,Lionel Simmons,23,78,78,2895,527,1162,.454,1,5,.200,526,1157,.455,.454,281,365,.770,149,485,634,337,135,132,218,205,1336
20197,SAC,1992,Spud Webb,28,77,77,2724,448,1006,.445,73,199,.367,375,807,.465,.482,262,305,.859,30,193,223,547,125,24,229,193,1231
20198,SAC,1992,Wayman Tisdale,27,72,71,2521,522,1043,.500,0,2,.000,522,1041,.501,.500,151,198,.763,135,334,469,106,55,79,124,248,1195
20199,SAC,1992,Duane Causwell,23,80,77,2291,250,455,.549,0,1,.000,250,454,.551,.549,136,222,.613,196,384,580,59,47,215,124,281,636
20200,SAC,1992,Anthony Bonner,23,79,18,2287,294,658,.447,1,4,.250,293,654,.448,.448,151,241,.627,192,293,485,125,94,26,133,194,740
20201,SAC,1992,Dennis Hopson,26,69,0,1304,275,591,.465,12,47,.255,263,544,.483,.475,179,253,.708,105,101,206,102,66,39,100,113,741
20202,SAC,1992,Pete Chilcutt,23,69,2,817,113,250,.452,2,2,1.000,111,248,.448,.456,23,28,.821,78,109,187,38,32,17,41,70,251
20203,SAC,1992,Jim Les,28,62,5,712,74,192,.385,45,131,.344,29,61,.475,.503,38,47,.809,11,52,63,143,31,3,42,58,231
20204,SAC,1992,Randy Brown,23,56,0,535,77,169,.456,0,6,.000,77,163,.472,.456,38,58,.655,26,43,69,59,35,12,42,68,192
20205,SAC,1992,Dwayne Schintzius,23,33,0,400,50,117,.427,0,4,.000,50,113,.442,.427,10,12,.833,43,75,118,20,6,28,19,67,110
20206,SAC,1992,Les Jepsen,24,31,0,87,9,24,.375,0,1,.000,9,23,.391,.375,7,11,.636,12,18,30,1,1,5,3,17,25
20207,SAC,1992,Stephen Thompson,23,18,0,76,13,34,.382,0,1,.000,13,33,.394,.382,3,8,.375,11,7,18,7,6,3,3,7,29
20208,SAC,1992,Bob Hansen,31,2,2,40,4,9,.444,0,2,.000,4,7,.571,.444,0,0,,2,2,4,1,1,0,0,6,8
20209,SAC,1992,Carl Thomas,22,1,0,31,5,12,.417,1,2,.500,4,10,.400,.458,1,2,.500,0,0,0,1,1,0,1,3,12
20210,SAC,1992,Steve Scheffler,24,4,0,15,2,2,1.000,0,0,,2,2,1.000,1.000,5,6,.833,2,1,3,0,0,1,0,2,9
20211,SAC,1991,Lionel Simmons,22,79,79,2978,549,1301,.422,3,11,.273,546,1290,.423,.423,320,435,.736,193,504,697,315,113,85,230,249,1421
20212,SAC,1991,Antoine Carr,29,77,48,2527,628,1228,.511,0,3,.000,628,1225,.513,.511,295,389,.758,163,257,420,191,45,101,171,315,1551
20213,SAC,1991,Rory Sparrow,32,80,74,2375,371,756,.491,31,78,.397,340,678,.501,.511,58,83,.699,45,141,186,362,83,16,126,189,831
20214,SAC,1991,Travis Mays,22,64,55,2145,294,724,.406,72,197,.365,222,527,.421,.456,255,331,.770,54,124,178,253,81,11,159,169,915
20215,SAC,1991,Duane Causwell,22,76,55,1719,210,413,.508,0,0,,210,413,.508,.508,105,165,.636,141,250,391,69,49,148,96,225,525
20216,SAC,1991,Bill Wennington,27,77,23,1455,181,415,.436,1,5,.200,180,410,.439,.437,74,94,.787,101,239,340,69,46,59,51,230,437
20217,SAC,1991,Jim Les,27,55,8,1399,119,268,.444,71,154,.461,48,114,.421,.576,86,103,.835,18,93,111,299,57,4,75,141,395
20218,SAC,1991,Wayman Tisdale,26,33,31,1116,262,542,.483,0,1,.000,262,541,.484,.483,136,170,.800,75,178,253,66,23,28,82,99,660
20219,SAC,1991,Bob Hansen,30,36,24,811,96,256,.375,19,69,.275,77,187,.412,.412,18,36,.500,33,63,96,90,20,5,34,72,229
20220,SAC,1991,Anthony Bonner,22,34,6,750,103,230,.448,0,0,,103,230,.448,.448,44,76,.579,59,102,161,49,39,5,41,62,250
20221,SAC,1991,Rick Calloway,24,64,0,678,75,192,.391,0,2,.000,75,190,.395,.391,55,79,.696,25,53,78,61,22,7,51,98,205
20222,SAC,1991,Anthony Frederick,26,35,3,475,67,168,.399,0,0,,67,168,.399,.399,43,60,.717,36,48,84,44,22,13,40,50,177
20223,SAC,1991,Eric Leckner,24,32,0,378,39,96,.406,0,0,,39,96,.406,.406,16,27,.593,27,60,87,18,4,11,25,69,94
20224,SAC,1991,Ralph Sampson,30,25,4,348,34,93,.366,1,5,.200,33,88,.375,.371,5,19,.263,41,70,111,17,11,17,27,54,74
20225,SAC,1991,Steve Colter,28,19,0,251,23,56,.411,5,14,.357,18,42,.429,.455,7,10,.700,5,21,26,37,11,1,11,27,58
20226,SAC,1991,Leon Wood,28,12,0,222,25,63,.397,12,38,.316,13,25,.520,.492,19,21,.905,5,14,19,49,5,0,12,10,81
20227,SAC,1991,Mike Higgins,23,7,0,61,6,10,.600,0,0,,6,10,.600,.600,4,7,.571,4,1,5,2,0,2,4,16,16
20228,SAC,1991,Tony Dawson,23,4,0,17,4,7,.571,1,1,1.000,3,6,.500,.643,0,0,,2,0,2,0,0,0,1,0,9
20229,SAC,1990,Rodney McCray,28,82,82,3238,537,1043,.515,11,42,.262,526,1001,.525,.520,273,348,.784,192,477,669,377,60,70,174,176,1358
20230,SAC,1990,Wayman Tisdale,25,79,79,2937,726,1383,.525,0,6,.000,726,1377,.527,.525,306,391,.783,185,410,595,108,54,54,153,251,1758
20231,SAC,1990,Danny Ainge,30,75,68,2727,506,1154,.438,108,289,.374,398,865,.460,.485,222,267,.831,69,257,326,453,113,18,185,238,1342
20232,SAC,1990,Vinny Del Negro,23,76,29,1858,297,643,.462,10,32,.313,287,611,.470,.470,135,155,.871,39,159,198,250,64,10,111,182,739
20233,SAC,1990,Kenny Smith,24,46,46,1747,280,607,.461,22,59,.373,258,548,.471,.479,106,131,.809,11,109,120,303,57,7,122,98,688
20234,SAC,1990,Harold Pressley,26,72,10,1603,240,566,.424,46,148,.311,194,418,.464,.465,110,141,.780,94,215,309,149,58,36,88,148,636
20235,SAC,1990,Greg Kite,28,71,47,1515,101,234,.432,1,1,1.000,100,233,.429,.434,27,54,.500,131,246,377,76,31,51,76,201,230
20236,SAC,1990,Antoine Carr,28,33,4,924,228,473,.482,0,3,.000,228,470,.485,.482,158,196,.806,65,108,173,66,15,34,71,119,614
20237,SAC,1990,Pervis Ellison,22,34,22,866,111,251,.442,0,2,.000,111,249,.446,.442,49,78,.628,64,132,196,65,16,57,62,132,271
20238,SAC,1990,Randy Allen,25,63,6,746,106,239,.444,0,7,.000,106,232,.457,.444,23,43,.535,49,89,138,23,16,19,28,102,235
20239,SAC,1990,Sedric Toney,27,32,9,682,57,178,.320,16,50,.320,41,128,.320,.365,46,58,.793,11,35,46,122,23,0,52,71,176
20240,SAC,1990,Ralph Sampson,29,26,7,417,48,129,.372,1,4,.250,47,125,.376,.376,12,23,.522,11,73,84,28,14,22,34,66,109
20241,SAC,1990,Henry Turner,23,36,1,315,58,122,.475,0,3,.000,58,119,.487,.475,40,65,.615,22,28,50,22,17,7,26,40,156
20242,SAC,1990,Mike Williams,26,16,0,88,6,14,.429,0,1,.000,6,13,.462,.429,3,6,.500,5,17,22,2,3,7,3,28,15
20243,SAC,1990,Michael Jackson,25,17,0,58,3,11,.273,1,2,.500,2,9,.222,.318,3,6,.500,2,5,7,8,5,0,4,3,10
20244,SAC,1990,Greg Stokes,26,11,0,34,1,9,.111,0,0,,1,9,.111,.111,2,2,1.000,2,3,5,0,0,0,3,8,4
20245,SAC,1989,Kenny Smith,23,81,81,3145,547,1183,.462,46,128,.359,501,1055,.475,.482,263,357,.737,49,177,226,621,102,7,249,173,1403
20246,SAC,1989,Rodney McCray,27,68,65,2435,340,729,.466,5,22,.227,335,707,.474,.470,169,234,.722,143,371,514,293,57,36,168,121,854
20247,SAC,1989,Harold Pressley,25,80,36,2257,383,873,.439,119,295,.403,264,578,.457,.507,96,123,.780,216,269,485,174,93,76,124,215,981
20248,SAC,1989,Jim Petersen,26,66,40,1633,278,606,.459,0,8,.000,278,598,.465,.459,115,154,.747,121,292,413,81,47,68,147,236,671
20249,SAC,1989,Vinny Del Negro,22,80,2,1556,239,503,.475,6,20,.300,233,483,.482,.481,85,100,.850,48,123,171,206,65,14,77,160,569
20250,SAC,1989,Ricky Berry,24,64,21,1406,255,567,.450,65,160,.406,190,407,.467,.507,131,166,.789,57,140,197,80,37,22,82,197,706
20251,SAC,1989,Ed Pinckney,25,51,24,1334,224,446,.502,0,6,.000,224,440,.509,.502,177,221,.801,106,195,301,74,54,43,81,125,625
20252,SAC,1989,LaSalle Thompson,27,43,42,1276,247,536,.461,0,1,.000,247,535,.462,.461,152,188,.809,120,272,392,44,46,55,117,153,646
20253,SAC,1989,Wayman Tisdale,24,31,30,1108,247,472,.523,0,0,,247,472,.523,.523,119,160,.744,88,211,299,53,20,20,65,109,613
20254,SAC,1989,Danny Ainge,29,28,26,1028,209,462,.452,58,150,.387,151,312,.484,.515,91,112,.813,34,67,101,187,41,7,63,78,567
20255,SAC,1989,Joe Kleine,27,47,11,913,116,303,.383,0,1,.000,116,302,.384,.383,81,88,.920,75,166,241,35,18,18,67,126,313
20256,SAC,1989,Derek Smith,27,29,20,600,111,276,.402,3,15,.200,108,261,.414,.408,64,95,.674,30,51,81,60,19,8,44,64,289
20257,SAC,1989,Brad Lohaus,24,29,10,476,93,216,.431,1,7,.143,92,209,.440,.433,46,57,.807,37,77,114,17,9,30,28,60,233
20258,SAC,1989,Randy Wittman,29,31,2,416,50,117,.427,2,4,.500,48,113,.425,.436,16,22,.727,6,20,26,32,10,0,12,12,118
20259,SAC,1989,Ben Gillery,23,24,0,84,6,19,.316,0,0,,6,19,.316,.316,13,23,.565,7,16,23,2,2,4,5,29,25
20260,SAC,1989,Michael Jackson,24,14,0,70,9,24,.375,2,6,.333,7,18,.389,.417,1,2,.500,1,3,4,11,3,0,4,12,21
20261,SAC,1989,Randy Allen,24,7,0,43,8,19,.421,0,1,.000,8,18,.444,.421,1,2,.500,3,4,7,0,1,1,2,7,17
20262,SAC,1988,Otis Thorpe,25,82,82,3072,622,1226,.507,0,6,.000,622,1220,.510,.507,460,609,.755,279,558,837,266,62,56,228,264,1704
20263,SAC,1988,Reggie Theus,30,73,73,2653,619,1318,.470,16,59,.271,603,1259,.479,.476,320,385,.831,72,160,232,463,59,16,234,173,1574
20264,SAC,1988,Kenny Smith,22,61,60,2170,331,694,.477,12,39,.308,319,655,.487,.486,167,204,.819,40,98,138,434,92,8,184,140,841
20265,SAC,1988,Harold Pressley,24,80,49,2029,318,702,.453,36,110,.327,282,592,.476,.479,103,130,.792,139,230,369,185,84,55,135,211,775
20266,SAC,1988,Joe Kleine,26,82,60,1999,324,686,.472,0,0,,324,686,.472,.472,153,188,.814,179,400,579,93,28,59,107,228,801
20267,SAC,1988,LaSalle Thompson,26,69,9,1257,215,456,.471,2,5,.400,213,451,.472,.474,118,164,.720,138,289,427,68,54,73,109,217,550
20268,SAC,1988,Terry Tyler,31,74,28,1185,184,407,.452,1,7,.143,183,400,.458,.453,41,64,.641,87,155,242,56,43,47,43,85,410
20269,SAC,1988,Ed Pinckney,24,79,7,1177,179,343,.522,0,2,.000,179,341,.525,.522,133,178,.747,94,136,230,66,39,32,77,118,491
20270,SAC,1988,Jawann Oldham,30,54,13,946,119,250,.476,0,0,,119,250,.476,.476,59,87,.678,82,222,304,33,12,110,62,143,297
20271,SAC,1988,Derek Smith,26,35,18,899,174,364,.478,8,23,.348,166,341,.487,.489,87,113,.770,35,68,103,89,21,17,48,108,443
20272,SAC,1988,Mike McGee,28,37,0,886,201,478,.421,48,141,.340,153,337,.454,.471,74,96,.771,51,61,112,58,47,6,58,75,524
20273,SAC,1988,Michael Jackson,23,58,0,760,64,171,.374,6,25,.240,58,146,.397,.392,23,32,.719,17,42,59,179,20,5,58,81,157
20274,SAC,1988,Franklin Edwards,28,16,11,414,54,115,.470,0,2,.000,54,113,.478,.470,24,32,.750,4,15,19,92,10,1,47,10,132
20275,SAC,1988,Conner Henry,24,15,0,207,38,81,.469,15,31,.484,23,50,.460,.562,26,30,.867,6,14,20,26,7,3,16,15,117
20276,SAC,1988,Joe Arlauckas,22,9,0,85,14,43,.326,0,0,,14,43,.326,.326,6,8,.750,6,7,13,8,3,4,4,16,34
20277,SAC,1988,Martin Nessley,22,9,0,41,2,3,.667,0,0,,2,3,.667,.667,1,4,.250,3,6,9,0,1,1,2,11,5
20278,SAC,1987,Otis Thorpe,24,82,82,2956,567,1050,.540,0,3,.000,567,1047,.542,.540,413,543,.761,259,560,819,201,46,60,189,292,1547
20279,SAC,1987,Reggie Theus,29,79,76,2872,577,1223,.472,17,78,.218,560,1145,.489,.479,429,495,.867,86,180,266,692,78,16,289,208,1600
20280,SAC,1987,Eddie Johnson,27,81,30,2457,606,1309,.463,37,118,.314,569,1191,.478,.477,267,322,.829,146,207,353,251,42,19,163,218,1516
20281,SAC,1987,LaSalle Thompson,25,82,53,2166,362,752,.481,0,5,.000,362,747,.485,.481,188,255,.737,237,450,687,122,69,126,143,290,912
20282,SAC,1987,Terry Tyler,30,82,48,1930,329,664,.495,1,3,.333,328,661,.496,.496,101,140,.721,116,212,328,73,55,78,78,151,760
20283,SAC,1987,Joe Kleine,25,79,31,1658,256,543,.471,0,1,.000,256,542,.472,.471,110,140,.786,173,310,483,71,35,30,90,213,622
20284,SAC,1987,Derek Smith,25,52,42,1658,338,757,.446,9,33,.273,329,724,.454,.452,178,228,.781,60,122,182,204,46,23,126,184,863
20285,SAC,1987,Mark Olberding,30,76,0,1002,69,165,.418,0,1,.000,69,164,.421,.418,116,131,.885,50,135,185,91,18,9,56,144,254
20286,SAC,1987,Harold Pressley,23,67,23,913,134,317,.423,7,28,.250,127,289,.439,.434,35,48,.729,68,108,176,120,40,21,63,96,310
20287,SAC,1987,Othell Wilson,25,53,2,789,82,185,.443,3,18,.167,79,167,.473,.451,43,54,.796,28,53,81,207,42,4,77,67,210
20288,SAC,1987,Brook Steppe,27,34,7,665,95,199,.477,3,9,.333,92,190,.484,.485,73,88,.830,21,40,61,81,18,3,54,56,266
20289,SAC,1987,Johnny Rogers,23,45,15,468,90,185,.486,0,5,.000,90,180,.500,.486,9,15,.600,30,47,77,26,9,8,20,66,189
20290,SAC,1987,Franklin Edwards,27,8,0,122,9,32,.281,0,4,.000,9,28,.321,.281,10,14,.714,2,8,10,29,5,0,17,7,28
20291,SAC,1987,Bruce Douglas,22,8,1,98,7,24,.292,0,1,.000,7,23,.304,.292,0,4,.000,5,9,14,17,9,0,9,9,14
20292,SAC,1987,Jerry Eaves,27,3,0,26,1,8,.125,0,0,,1,8,.125,.125,2,2,1.000,1,0,1,0,1,0,2,6,4
20293,SAC,1986,Reggie Theus,28,82,82,2919,546,1137,.480,6,35,.171,540,1102,.490,.483,405,490,.827,73,231,304,788,112,20,327,231,1503
20294,SAC,1986,Eddie Johnson,26,82,30,2514,623,1311,.475,4,20,.200,619,1291,.479,.477,280,343,.816,173,246,419,214,54,17,191,237,1530
20295,SAC,1986,Mike Woodson,27,81,51,2417,510,1073,.475,2,13,.154,508,1060,.479,.476,242,289,.837,94,132,226,197,92,37,145,215,1264
20296,SAC,1986,LaSalle Thompson,24,80,64,2377,411,794,.518,0,1,.000,411,793,.518,.518,202,276,.732,252,518,770,168,71,109,184,295,1024
20297,SAC,1986,Mark Olberding,29,81,64,2157,225,403,.558,0,2,.000,225,401,.561,.558,162,210,.771,113,310,423,266,43,23,148,276,612
20298,SAC,1986,Larry Drew,27,75,31,1971,376,776,.485,10,31,.323,366,745,.491,.491,128,161,.795,25,100,125,338,66,2,133,134,890
20299,SAC,1986,Otis Thorpe,23,75,18,1675,289,492,.587,0,0,,289,492,.587,.587,164,248,.661,137,283,420,84,35,34,123,233,742
20300,SAC,1986,Terry Tyler,29,71,52,1651,295,649,.455,0,3,.000,295,646,.457,.455,84,112,.750,109,204,313,94,64,108,94,159,674
20301,SAC,1986,Joe Kleine,24,80,18,1180,160,344,.465,0,0,,160,344,.465,.465,94,130,.723,113,260,373,46,24,34,107,224,414
20302,SAC,1986,Rich Kelley,32,37,0,324,28,49,.571,0,2,.000,28,47,.596,.571,18,22,.818,29,52,81,43,10,3,22,62,74
20303,SAC,1986,Mike Bratz,30,33,0,269,26,70,.371,4,14,.286,22,56,.393,.400,14,18,.778,2,21,23,39,13,0,17,43,70
20304,SAC,1986,Carl Henry,25,28,0,149,31,67,.463,4,10,.400,27,57,.474,.493,12,17,.706,8,11,19,4,5,0,9,11,78
20305,SAC,1986,Michael Adams,23,18,0,139,16,44,.364,0,3,.000,16,41,.390,.364,8,12,.667,2,4,6,22,9,1,11,9,40
20306,SAC,1986,David Cooke,22,6,0,38,2,11,.182,0,0,,2,11,.182,.182,5,10,.500,5,5,10,1,4,0,2,5,9
20307,KCK,1985,Eddie Johnson,25,82,81,3029,769,1565,.491,13,54,.241,756,1511,.500,.496,325,373,.871,151,256,407,273,83,22,225,237,1876
20308,KCK,1985,Reggie Theus,27,82,80,2543,501,1029,.487,5,38,.132,496,991,.501,.489,334,387,.863,106,164,270,656,95,18,307,250,1341
20309,KCK,1985,LaSalle Thompson,23,82,77,2458,369,695,.531,0,0,,369,695,.531,.531,227,315,.721,274,580,854,130,98,128,202,328,965
20310,KCK,1985,Larry Drew,26,72,66,2373,457,913,.501,7,28,.250,450,885,.508,.504,154,194,.794,39,125,164,484,93,8,179,147,1075
20311,KCK,1985,Mark Olberding,28,81,62,2277,265,528,.502,0,3,.000,265,525,.505,.502,293,352,.832,139,374,513,243,56,11,185,298,823
20312,KCK,1985,Mike Woodson,26,78,3,1998,530,1068,.496,5,21,.238,525,1047,.501,.499,264,330,.800,69,129,198,143,117,28,139,216,1329
20313,KCK,1985,Otis Thorpe,22,82,23,1918,411,685,.600,0,2,.000,411,683,.602,.600,230,371,.620,187,369,556,111,34,37,187,256,1052
20314,KCK,1985,Joe Meriweather,31,76,4,1061,121,243,.498,1,2,.500,120,241,.498,.500,96,124,.774,94,169,263,27,17,28,50,181,339
20315,KCK,1985,Don Buse,34,65,14,939,82,203,.404,31,87,.356,51,116,.440,.480,23,30,.767,21,40,61,203,38,1,45,75,218
20316,KCK,1985,Pete Verhoeven,25,54,0,366,51,108,.472,0,0,,51,108,.472,.472,21,25,.840,28,35,63,17,15,7,20,85,123
20317,KCK,1985,Ed Nealy,24,22,0,225,26,44,.591,0,0,,26,44,.591,.591,10,19,.526,15,29,44,18,3,1,12,26,62
20318,KCK,1985,Mark McNamara,25,33,0,210,28,58,.483,0,0,,28,58,.483,.483,23,44,.523,24,33,57,6,5,7,13,22,79
20319,KCK,1985,Billy Knight,32,16,0,189,31,69,.449,1,1,1.000,30,68,.441,.457,13,16,.813,10,12,22,21,2,1,13,14,76
20320,KCK,1985,David Pope,22,22,0,129,17,53,.321,0,1,.000,17,52,.327,.321,7,13,.538,9,9,18,5,3,3,7,30,41
20321,KCK,1985,Dane Suttle,23,6,0,24,6,13,.462,0,1,.000,6,12,.500,.462,2,2,1.000,0,3,3,2,1,0,1,3,14
20322,KCK,1985,Kenny Natt,26,4,0,16,0,1,.000,0,0,,0,1,.000,.000,0,0,,1,0,1,3,1,0,0,1,0
20323,KCK,1984,Eddie Johnson,24,82,82,2920,753,1552,.485,20,64,.313,733,1488,.493,.492,268,331,.810,165,290,455,296,76,21,213,266,1794
20324,KCK,1984,Larry Drew,25,73,73,2363,474,1026,.462,3,10,.300,471,1016,.464,.463,243,313,.776,33,113,146,558,121,10,194,170,1194
20325,KCK,1984,Mark Olberding,27,81,81,2160,249,504,.494,0,1,.000,249,503,.495,.494,261,318,.821,119,326,445,192,50,28,166,291,759
20326,KCK,1984,LaSalle Thompson,22,80,38,1915,333,637,.523,0,0,,333,637,.523,.523,160,223,.717,260,449,709,86,71,145,168,327,826
20327,KCK,1984,Billy Knight,31,75,39,1885,358,729,.491,4,14,.286,354,715,.495,.494,243,283,.859,89,166,255,160,54,6,155,122,963
20328,KCK,1984,Mike Woodson,25,71,12,1838,389,816,.477,2,8,.250,387,808,.479,.478,247,302,.818,62,113,175,175,83,28,115,174,1027
20329,KCK,1984,Joe Meriweather,30,73,31,1501,193,363,.532,0,0,,193,363,.532,.532,94,123,.764,111,242,353,51,35,61,83,247,480
20330,KCK,1984,Don Buse,33,76,10,1327,150,352,.426,18,59,.305,132,293,.451,.452,63,80,.788,29,87,116,303,86,1,87,62,381
20331,KCK,1984,Ed Nealy,23,71,1,960,63,126,.500,0,0,,63,126,.500,.500,48,60,.800,73,149,222,50,41,9,33,138,174
20332,KCK,1984,Reggie Theus,26,30,30,897,170,388,.438,4,27,.148,166,361,.460,.443,130,173,.751,29,54,83,210,29,9,97,93,474
20333,KCK,1984,Steve Johnson,26,50,12,893,189,342,.553,0,0,,189,342,.553,.553,101,177,.571,94,158,252,63,22,48,105,188,479
20334,KCK,1984,Dane Suttle,22,40,1,469,109,214,.509,0,3,.000,109,211,.517,.509,40,47,.851,21,25,46,46,20,0,32,46,258
20335,KCK,1984,Larry Micheaux,23,39,0,332,49,90,.544,0,0,,49,90,.544,.544,21,39,.538,40,73,113,19,21,11,21,46,119
20336,KCK,1984,Dave Robisch,34,8,0,162,18,48,.375,0,0,,18,48,.375,.375,11,13,.846,12,17,29,6,3,1,0,15,47
20337,KCK,1984,Kevin Loder,24,10,0,133,19,43,.442,1,3,.333,18,40,.450,.453,9,13,.692,7,11,18,14,3,5,11,15,48
20338,KCK,1983,Eddie Johnson,23,82,82,2933,677,1370,.494,20,71,.282,657,1299,.506,.501,247,317,.779,191,310,501,216,70,20,181,259,1621
20339,KCK,1983,Larry Drew,24,75,74,2690,599,1218,.492,2,16,.125,597,1202,.497,.493,310,378,.820,44,163,207,610,126,10,272,207,1510
20340,KCK,1983,Mike Woodson,24,81,3,2426,584,1154,.506,7,33,.212,577,1121,.515,.509,298,377,.790,84,164,248,254,137,59,174,203,1473
20341,KCK,1983,Ray Williams,28,72,68,2170,419,1068,.392,15,74,.203,404,994,.406,.399,256,333,.769,93,234,327,569,120,26,335,248,1109
20342,KCK,1983,Joe Meriweather,29,78,74,1706,258,453,.570,0,0,,258,453,.570,.570,102,163,.626,150,274,424,64,47,86,118,285,618
20343,KCK,1983,Ed Nealy,22,82,61,1643,147,247,.595,0,0,,147,247,.595,.595,70,114,.614,170,315,485,62,68,12,51,247,364
20344,KCK,1983,Steve Johnson,25,79,21,1544,371,595,.624,0,0,,371,595,.624,.624,186,324,.574,140,258,398,95,40,83,180,323,928
20345,KCK,1983,Reggie King,25,58,5,995,104,225,.462,0,0,,104,225,.462,.462,73,96,.760,91,149,240,58,28,11,65,94,281
20346,KCK,1983,Reggie Johnson,25,50,0,992,178,355,.501,1,4,.250,177,351,.504,.503,73,100,.730,75,126,201,48,18,26,69,150,430
20347,KCK,1983,LaSalle Thompson,21,71,3,987,147,287,.512,0,1,.000,147,286,.514,.512,89,137,.650,133,242,375,33,40,61,96,186,383
20348,KCK,1983,Kevin Loder,23,66,13,818,138,300,.460,5,9,.556,133,291,.457,.468,53,80,.663,37,88,125,72,29,8,64,98,334
20349,KCK,1983,Brook Steppe,23,62,6,606,84,176,.477,1,7,.143,83,169,.491,.480,76,100,.760,25,48,73,68,26,3,55,92,245
20350,KCK,1983,Kenny Dennard,24,22,0,224,11,34,.324,0,0,,11,34,.324,.324,6,9,.667,20,32,52,6,16,1,5,27,28
20351,KCK,1983,Leon Douglas,28,5,0,46,2,3,.667,0,0,,2,3,.667,.667,0,2,.000,3,4,7,0,0,3,1,13,4
20352,KCK,1982,Reggie King,24,80,76,2609,383,752,.509,0,0,,383,752,.509,.509,201,285,.705,162,361,523,173,84,29,155,221,967
20353,KCK,1982,Mike Woodson,23,76,74,2186,508,1001,.507,7,24,.292,501,977,.513,.511,198,254,.780,97,137,234,206,135,33,144,199,1221
20354,KCK,1982,Larry Drew,23,81,19,1973,358,757,.473,8,27,.296,350,730,.479,.478,150,189,.794,30,119,149,419,110,1,174,150,874
20355,KCK,1982,Phil Ford,25,72,65,1952,285,649,.439,7,32,.219,278,617,.451,.445,136,166,.819,24,81,105,451,63,1,194,160,713
20356,KCK,1982,Ernie Grunfeld,26,81,11,1892,420,822,.511,2,14,.143,418,808,.517,.512,188,229,.821,55,127,182,276,72,39,148,191,1030
20357,KCK,1982,Steve Johnson,24,78,50,1741,395,644,.613,0,0,,395,644,.613,.613,212,330,.642,152,307,459,91,39,89,197,372,1002
20358,KCK,1982,Eddie Johnson,22,74,27,1517,295,643,.459,1,11,.091,294,632,.465,.460,99,149,.664,128,194,322,109,50,14,97,210,690
20359,KCK,1982,Cliff Robinson,21,38,30,1229,322,708,.455,0,3,.000,322,705,.457,.455,125,180,.694,83,239,322,71,46,60,86,120,769
20360,KCK,1982,Kevin Loder,22,71,13,1139,208,448,.464,0,11,.000,208,437,.476,.464,77,107,.720,69,126,195,88,35,30,68,147,493
20361,KCK,1982,Leon Douglas,27,63,17,1093,70,140,.500,0,0,,70,140,.500,.500,32,80,.400,111,179,290,35,15,38,55,210,172
20362,KCK,1982,Reggie Johnson,24,31,9,783,163,293,.556,0,1,.000,163,292,.558,.556,51,72,.708,54,135,189,31,20,27,50,117,377
20363,KCK,1982,Kenny Dennard,23,30,3,607,62,121,.512,0,0,,62,121,.512,.512,26,40,.650,47,86,133,42,35,8,35,81,150
20364,KCK,1982,John Lambert,29,42,1,493,60,139,.432,1,6,.167,59,133,.444,.435,21,28,.750,36,91,127,24,12,10,38,80,142
20365,KCK,1982,Joe Meriweather,28,18,10,380,47,91,.516,0,0,,47,91,.516,.516,31,40,.775,25,63,88,17,13,21,25,68,125
20366,KCK,1982,Hawkeye Whitney,24,23,4,266,25,71,.352,0,1,.000,25,70,.357,.352,4,7,.571,13,27,40,19,12,1,14,31,54
20367,KCK,1982,Sam Lacey,33,2,1,20,3,5,.600,0,0,,3,5,.600,.600,0,2,.000,0,4,4,4,2,1,2,2,6
20368,KCK,1981,Scott Wedman,28,81,,2902,685,1437,.477,25,77,.325,660,1360,.485,.485,140,204,.686,128,305,433,226,97,46,161,294,1535
20369,KCK,1981,Reggie King,23,81,,2743,472,867,.544,0,0,,472,867,.544,.544,264,386,.684,235,551,786,122,102,41,164,227,1208
20370,KCK,1981,Otis Birdsong,25,71,,2593,710,1306,.544,10,35,.286,700,1271,.551,.547,317,455,.697,119,139,258,233,93,18,173,172,1747
20371,KCK,1981,Phil Ford,24,66,,2287,424,887,.478,11,36,.306,413,851,.485,.484,294,354,.831,26,102,128,580,99,6,241,190,1153
20372,KCK,1981,Sam Lacey,32,82,,2228,237,536,.442,1,5,.200,236,531,.444,.443,92,117,.786,131,453,584,399,95,120,182,302,567
20373,KCK,1981,Ernie Grunfeld,25,79,,1584,260,486,.535,0,0,,260,486,.535,.535,75,101,.743,31,175,206,205,60,15,88,155,595
20374,KCK,1981,Joe Meriweather,27,74,,1514,206,415,.496,0,0,,206,415,.496,.496,148,213,.695,126,267,393,77,27,80,125,219,560
20375,KCK,1981,Leon Douglas,26,79,,1356,185,323,.573,0,3,.000,185,320,.578,.573,102,186,.548,150,234,384,69,25,38,90,251,472
20376,KCK,1981,Lloyd Walton,27,61,,821,90,218,.413,0,1,.000,90,217,.415,.413,26,33,.788,13,35,48,208,32,2,80,45,206
20377,KCK,1981,Hawkeye Whitney,23,47,,782,149,306,.487,2,6,.333,147,300,.490,.490,50,65,.769,29,77,106,68,47,6,48,98,350
20378,KCK,1981,John Lambert,28,43,,475,65,160,.406,0,2,.000,65,158,.411,.406,18,23,.783,27,63,90,24,12,5,17,74,148
20379,KCK,1981,Jo Jo White,34,13,,236,36,82,.439,0,0,,36,82,.439,.439,11,18,.611,3,18,21,37,11,1,18,21,83
20380,KCK,1981,Frankie Sanders,24,23,,186,34,77,.442,0,0,,34,77,.442,.442,20,22,.909,6,15,21,17,16,1,21,20,88
20381,KCK,1981,Gus Gerard,27,16,,123,19,51,.373,0,3,.000,19,48,.396,.373,19,29,.655,13,16,29,6,3,6,7,24,57
20382,KCK,1980,Otis Birdsong,24,82,,2885,781,1546,.505,10,36,.278,771,1510,.511,.508,286,412,.694,170,161,331,202,136,22,179,226,1858
20383,KCK,1980,Phil Ford,23,82,82,2621,489,1058,.462,4,23,.174,485,1035,.469,.464,346,423,.818,29,143,172,610,136,4,282,208,1328
20384,KCK,1980,Sam Lacey,31,81,,2412,303,677,.448,0,1,.000,303,676,.448,.448,137,185,.741,172,473,645,460,111,109,211,307,743
20385,KCK,1980,Scott Wedman,27,68,,2347,569,1112,.512,7,22,.318,562,1090,.516,.515,145,181,.801,114,272,386,145,84,45,112,230,1290
20386,KCK,1980,Reggie King,22,82,,2052,257,499,.515,0,1,.000,257,498,.516,.515,159,219,.726,184,382,566,106,69,31,100,230,673
20387,KCK,1980,Bill Robinzine,27,81,,1917,362,723,.501,1,2,.500,361,721,.501,.501,200,274,.730,184,342,526,62,106,23,148,311,925
20388,KCK,1980,Ernie Grunfeld,24,80,,1397,186,420,.443,1,2,.500,185,418,.443,.444,101,131,.771,87,145,232,109,56,9,81,151,474
20389,KCK,1980,Billy McKinney,24,76,,1333,206,459,.449,1,10,.100,205,449,.457,.450,107,133,.805,20,66,86,248,58,5,89,87,520
20390,KCK,1980,Len Elmore,27,58,,915,104,242,.430,0,0,,104,242,.430,.430,51,74,.689,74,183,257,64,41,39,67,154,259
20391,KCK,1980,Gus Gerard,26,73,,869,159,348,.457,1,3,.333,158,345,.458,.458,66,100,.660,77,100,177,43,41,26,49,96,385
20392,KCK,1980,Mike Green,28,21,,459,69,159,.434,0,2,.000,69,157,.439,.434,24,42,.571,35,78,113,28,13,21,36,55,162
20393,KCK,1980,Marlon Redmond,24,24,,298,59,138,.428,0,9,.000,59,129,.457,.428,24,34,.706,18,34,52,19,4,9,19,27,142
20394,KCK,1980,Tom Burleson,27,37,,272,36,104,.346,0,3,.000,36,101,.356,.346,23,40,.575,23,49,72,20,8,13,25,49,95
20395,KCK,1980,Terry Crosby,23,4,,28,2,4,.500,0,0,,2,4,.500,.500,2,2,1.000,0,1,1,7,0,0,5,4,6
20396,SAS,2024,Devin Vassell,23,68,62,2248,498,1056,.472,166,446,.372,332,610,.544,.550,161,201,.801,27,234,261,277,73,23,108,74,1323
20397,SAS,2024,Jeremy Sochan,20,74,73,2193,340,776,.438,70,227,.308,270,549,.492,.483,111,144,.771,137,339,476,249,62,40,140,168,861
20398,SAS,2024,Tre Jones,24,77,48,2138,303,600,.505,64,191,.335,239,409,.584,.558,101,118,.856,58,231,289,478,78,9,116,92,771
20399,SAS,2024,Victor Wembanyama,20,71,71,2106,551,1186,.465,128,394,.325,423,792,.534,.519,292,367,.796,161,594,755,274,88,254,260,153,1522
20400,SAS,2024,Keldon Johnson,24,69,27,2038,391,862,.454,127,367,.346,264,495,.533,.527,175,221,.792,95,282,377,195,51,20,100,149,1084
20401,SAS,2024,Malaki Branham,20,75,29,1594,271,628,.432,93,268,.347,178,360,.494,.506,55,63,.873,28,120,148,156,27,8,91,94,690
20402,SAS,2024,Zach Collins,26,69,29,1526,298,616,.484,58,181,.320,240,435,.552,.531,122,162,.753,118,252,370,194,34,52,132,206,776
20403,SAS,2024,Julian Champagnie,22,74,59,1468,164,402,.408,101,277,.365,63,125,.504,.534,75,92,.815,42,164,206,103,48,42,57,77,504
20404,SAS,2024,Cedi Osman,28,72,3,1269,184,384,.479,86,221,.389,98,163,.601,.591,35,52,.673,25,155,180,119,36,11,47,107,489
20405,SAS,2024,Blake Wesley,20,61,3,876,102,215,.474,12,55,.218,90,160,.563,.502,52,78,.667,18,76,94,166,29,9,55,89,268
20406,SAS,2024,Doug McDermott,32,46,0,700,95,215,.442,76,173,.439,19,42,.452,.619,10,17,.588,8,40,48,57,11,2,24,48,276
20407,SAS,2024,Sandro Mamukelashvili,24,46,5,451,73,155,.471,19,64,.297,54,91,.593,.532,25,34,.735,45,102,147,49,7,12,19,35,190
20408,SAS,2024,Dominick Barlow,20,33,1,420,56,113,.496,3,9,.333,53,104,.510,.509,29,42,.690,45,68,113,36,12,14,9,47,144
20409,SAS,2024,Devonte' Graham,28,23,0,313,38,108,.352,25,83,.301,13,25,.520,.468,13,16,.813,5,31,36,49,9,2,17,14,114
20410,SAS,2024,Charles Bassey,23,19,0,205,29,40,.725,0,1,.000,29,39,.744,.725,5,6,.833,23,53,76,21,8,17,15,31,63
20411,SAS,2024,Sidy Cissoko,19,12,0,141,16,33,.485,1,12,.083,15,21,.714,.500,12,15,.800,8,14,22,10,7,3,3,18,45
20412,SAS,2024,David Duke Jr.,24,4,0,51,10,18,.556,3,6,.500,7,12,.583,.639,3,3,1.000,2,8,10,5,2,0,3,4,26
20413,SAS,2024,RaiQuan Gray,24,3,0,39,10,17,.588,3,7,.429,7,10,.700,.676,0,0,,2,5,7,6,1,1,1,0,23
20414,SAS,2024,Jamaree Bouyea,24,3,0,38,5,7,.714,1,1,1.000,4,6,.667,.786,0,0,,1,8,9,3,1,0,1,7,11
20415,SAS,2024,Mamadi Diakite,27,3,0,16,4,5,.800,0,0,,4,5,.800,.800,4,6,.667,1,2,3,2,0,1,0,1,12
20416,SAS,2023,Keldon Johnson,23,63,63,2063,503,1113,.452,134,407,.329,369,706,.523,.512,245,327,.749,56,262,318,183,46,11,134,125,1385
20417,SAS,2023,Tre Jones,23,68,65,1984,341,743,.459,45,158,.285,296,585,.506,.489,148,172,.860,56,189,245,448,89,9,110,98,875
20418,SAS,2023,Malaki Branham,19,66,32,1550,269,611,.440,77,255,.302,192,356,.539,.503,58,70,.829,28,153,181,127,33,7,76,115,673
20419,SAS,2023,Jeremy Sochan,19,56,53,1458,250,552,.453,33,134,.246,217,418,.519,.483,81,116,.698,95,200,295,142,43,23,97,138,614
20420,SAS,2023,Keita Bates-Diop,27,67,42,1452,236,465,.508,56,142,.394,180,323,.557,.568,119,150,.793,65,183,248,103,46,20,56,63,647
20421,SAS,2023,Zach Collins,25,63,26,1441,284,548,.518,55,147,.374,229,401,.571,.568,108,142,.761,116,286,402,180,37,49,129,199,731
20422,SAS,2023,Doug McDermott,31,64,0,1314,239,523,.457,123,298,.413,116,225,.516,.575,53,70,.757,23,116,139,91,13,6,58,118,654
20423,SAS,2023,Jakob Poeltl,27,46,46,1199,239,388,.616,0,1,.000,239,387,.618,.616,78,129,.605,152,264,416,141,36,52,96,118,556
20424,SAS,2023,Devin Vassell,22,38,32,1178,261,595,.439,103,266,.387,158,329,.480,.525,78,100,.780,8,140,148,136,43,17,57,57,703
20425,SAS,2023,Josh Richardson,29,42,6,997,177,406,.436,74,207,.357,103,199,.518,.527,53,60,.883,30,89,119,137,40,11,63,70,481
20426,SAS,2023,Romeo Langford,23,43,21,844,121,259,.467,16,61,.262,105,198,.530,.498,39,56,.696,57,57,114,50,24,13,30,67,297
20427,SAS,2023,Blake Wesley,19,37,1,669,69,215,.321,20,52,.385,49,163,.301,.367,26,44,.591,12,69,81,98,25,5,65,67,184
20428,SAS,2023,Devonte' Graham,27,20,8,527,76,200,.380,53,148,.358,23,52,.442,.513,54,72,.750,7,43,50,80,15,6,26,31,259
20429,SAS,2023,Charles Bassey,22,35,2,508,87,135,.644,3,8,.375,84,127,.661,.656,22,37,.595,75,118,193,48,16,33,41,74,199
20430,SAS,2023,Isaiah Roby,24,42,2,474,67,155,.432,18,60,.300,49,95,.516,.490,20,41,.488,21,86,107,38,18,7,31,53,172
20431,SAS,2023,Stanley Johnson,26,30,0,469,65,122,.533,18,40,.450,47,82,.573,.607,26,39,.667,22,73,95,67,16,6,33,48,174
20432,SAS,2023,Sandro Mamukelashvili,23,19,7,443,78,172,.453,23,67,.343,55,105,.524,.520,27,39,.692,52,77,129,46,10,7,26,33,206
20433,SAS,2023,Dominick Barlow,19,28,0,408,46,86,.535,0,4,.000,46,82,.561,.535,18,25,.720,46,56,102,24,10,19,15,56,110
20434,SAS,2023,Gorgui Dieng,33,31,1,358,45,117,.385,21,75,.280,24,42,.571,.474,10,13,.769,27,80,107,53,4,14,32,57,121
20435,SAS,2023,Julian Champagnie,21,15,3,313,59,128,.461,33,81,.407,26,47,.553,.590,14,17,.824,10,50,60,10,5,5,11,26,165
20436,SAS,2023,Joshua Primo,20,4,0,93,9,26,.346,3,12,.250,6,14,.429,.404,7,9,.778,2,11,13,18,1,2,11,8,28
20437,SAS,2023,Jordan Hall,21,9,0,83,9,28,.321,3,15,.200,6,13,.462,.375,7,9,.778,3,9,12,11,1,0,7,6,28
20438,SAS,2023,Alize Johnson,26,4,0,30,3,6,.500,0,2,.000,3,4,.750,.500,1,2,.500,2,8,10,1,1,0,4,3,7
20439,SAS,2022,Keldon Johnson,22,75,74,2392,471,1011,.466,159,399,.398,312,612,.510,.545,177,234,.756,80,377,457,158,58,14,92,148,1278
20440,SAS,2022,Dejounte Murray,25,68,68,2366,573,1241,.462,96,294,.327,477,947,.504,.500,196,247,.794,80,483,563,627,138,23,180,138,1438
20441,SAS,2022,Jakob Poeltl,26,68,67,1970,410,663,.618,1,1,1.000,409,662,.618,.619,94,190,.495,262,372,634,189,45,118,109,212,915
20442,SAS,2022,Devin Vassell,21,71,32,1937,326,764,.427,137,380,.361,189,384,.492,.516,83,99,.838,44,262,306,136,76,41,58,143,872
20443,SAS,2022,Lonnie Walker IV,23,70,6,1612,311,764,.407,111,353,.314,200,411,.487,.480,116,148,.784,18,163,181,152,44,19,71,98,849
20444,SAS,2022,Derrick White,27,49,48,1486,243,570,.426,81,258,.314,162,312,.519,.497,139,160,.869,25,148,173,274,49,42,87,116,706
20445,SAS,2022,Doug McDermott,30,51,51,1223,215,465,.462,108,256,.422,107,209,.512,.578,40,51,.784,18,97,115,64,13,6,43,79,578
20446,SAS,2022,Tre Jones,22,69,11,1148,166,339,.490,10,51,.196,156,288,.542,.504,71,91,.780,29,126,155,233,42,7,46,78,413
20447,SAS,2022,Joshua Primo,19,50,16,965,101,270,.374,42,137,.307,59,133,.444,.452,44,59,.746,32,81,113,81,20,23,57,79,288
20448,SAS,2022,Keita Bates-Diop,26,59,14,957,136,263,.517,17,55,.309,119,208,.572,.549,46,61,.754,62,169,231,41,27,14,45,61,335
20449,SAS,2022,Bryn Forbes,28,40,1,676,128,296,.432,63,151,.417,65,145,.448,.539,44,49,.898,4,59,63,41,17,3,33,42,363
20450,SAS,2022,Drew Eubanks,24,49,9,595,84,159,.528,1,8,.125,83,151,.550,.531,59,79,.747,64,132,196,50,13,30,46,61,228
20451,SAS,2022,Jock Landale,26,54,1,589,101,204,.495,29,89,.326,72,115,.626,.566,34,41,.829,63,75,138,45,10,14,31,53,265
20452,SAS,2022,Josh Richardson,28,21,7,513,82,191,.429,40,90,.444,42,101,.416,.534,35,37,.946,16,44,60,49,22,6,27,34,239
20453,SAS,2022,Zach Collins,24,28,4,502,76,155,.490,14,41,.341,62,114,.544,.535,52,65,.800,46,107,153,61,13,23,45,67,218
20454,SAS,2022,Thaddeus Young,33,26,1,370,74,128,.578,0,5,.000,74,123,.602,.578,10,22,.455,40,53,93,59,23,7,30,38,158
20455,SAS,2022,Joe Wieskamp,22,29,0,205,20,56,.357,14,43,.326,6,13,.462,.482,7,13,.538,4,10,14,9,4,3,2,14,61
20456,SAS,2022,Devontae Cacok,25,15,0,121,21,31,.677,0,0,,21,31,.677,.677,4,7,.571,8,34,42,6,8,7,3,16,46
20457,SAS,2022,Tyler Johnson,29,3,0,53,2,10,.200,2,6,.333,0,4,.000,.300,0,0,,2,4,6,5,2,2,1,3,6
20458,SAS,2022,Juancho Hernangómez,26,5,0,51,2,6,.333,0,3,.000,2,3,.667,.333,3,4,.750,4,11,15,3,1,1,2,0,7
20459,SAS,2022,Romeo Langford,22,4,0,43,4,7,.571,0,2,.000,4,5,.800,.571,3,8,.375,0,4,4,2,1,0,0,1,11
20460,SAS,2022,Jaylen Morris,26,3,0,16,0,6,.000,0,2,.000,0,4,.000,.000,2,4,.500,0,2,2,2,0,0,1,2,2
20461,SAS,2022,Tomáš Satoranský,30,1,0,9,0,0,,0,0,,0,0,,,3,4,.750,0,1,1,0,0,0,0,0,3
20462,SAS,2022,Anthony Lamb,24,2,0,8,0,2,.000,0,2,.000,0,0,,.000,0,0,,0,1,1,2,0,0,0,0,0
20463,SAS,2021,Dejounte Murray,24,67,67,2139,441,974,.453,63,199,.317,378,775,.488,.485,106,134,.791,58,415,473,363,101,7,117,135,1051
20464,SAS,2021,DeMar DeRozan,31,61,61,2056,455,920,.495,19,74,.257,436,846,.515,.505,387,440,.880,40,219,259,422,56,15,119,128,1316
20465,SAS,2021,Keldon Johnson,21,69,67,1968,338,705,.479,60,181,.331,278,524,.531,.522,145,196,.740,93,319,412,121,40,24,78,142,881
20466,SAS,2021,Jakob Poeltl,25,69,51,1845,265,430,.616,0,0,,265,430,.616,.616,63,124,.508,219,328,547,134,47,123,83,172,593
20467,SAS,2021,Patty Mills,32,68,1,1685,252,611,.412,161,429,.375,91,182,.500,.544,71,78,.910,18,98,116,162,42,3,66,81,736
20468,SAS,2021,Lonnie Walker IV,22,60,38,1522,256,609,.420,100,282,.355,156,327,.477,.502,57,70,.814,14,141,155,101,29,15,65,101,669
20469,SAS,2021,Rudy Gay,34,63,1,1358,264,628,.420,106,278,.381,158,350,.451,.505,82,102,.804,42,261,303,88,45,40,65,115,716
20470,SAS,2021,Derrick White,26,36,32,1064,186,453,.411,84,243,.346,102,210,.486,.503,97,114,.851,13,94,107,127,26,36,45,91,553
20471,SAS,2021,Devin Vassell,20,62,7,1056,123,303,.406,52,150,.347,71,153,.464,.492,43,51,.843,24,150,174,56,43,18,22,88,341
20472,SAS,2021,Drew Eubanks,23,54,3,755,116,205,.566,2,2,1.000,114,203,.562,.571,77,106,.726,74,167,241,42,18,49,45,88,311
20473,SAS,2021,LaMarcus Aldridge,35,21,18,544,115,248,.464,27,75,.360,88,173,.509,.518,31,37,.838,17,77,94,36,8,18,20,36,288
20474,SAS,2021,Trey Lyles,25,23,9,358,43,90,.478,14,40,.350,29,50,.580,.556,15,23,.652,9,77,86,14,6,1,6,13,115
20475,SAS,2021,Luka Šamanić,21,33,4,308,47,105,.448,12,43,.279,35,62,.565,.505,16,29,.552,16,52,68,15,8,8,20,43,122
20476,SAS,2021,Tre Jones,21,37,1,269,37,78,.474,3,5,.600,34,73,.466,.494,17,19,.895,8,13,21,39,8,0,13,13,94
20477,SAS,2021,Keita Bates-Diop,25,30,0,245,30,67,.448,5,17,.294,25,50,.500,.485,14,21,.667,9,40,49,12,11,5,7,11,79
20478,SAS,2021,Gorgui Dieng,31,16,0,181,29,55,.527,7,22,.318,22,33,.667,.591,20,24,.833,12,30,42,19,9,2,10,18,85
20479,SAS,2021,Quinndary Weatherspoon,24,20,0,121,16,35,.457,1,6,.167,15,29,.517,.471,13,16,.813,3,8,11,8,8,2,10,18,46
20480,SAS,2021,Cameron Reynolds,25,3,0,6,1,2,.500,0,0,,1,2,.500,.500,0,0,,0,0,0,0,0,0,0,0,2
20481,SAS,2020,DeMar DeRozan,30,68,68,2316,557,1049,.531,9,35,.257,548,1014,.540,.535,381,451,.845,44,331,375,380,70,20,164,180,1504
20482,SAS,2020,LaMarcus Aldridge,34,53,53,1754,391,793,.493,61,157,.389,330,636,.519,.532,158,191,.827,103,289,392,129,36,87,74,128,1001
20483,SAS,2020,Dejounte Murray,23,66,58,1687,294,637,.462,41,111,.369,253,526,.481,.494,91,114,.798,69,314,383,271,111,17,125,143,720
20484,SAS,2020,Derrick White,25,68,20,1677,253,552,.458,79,216,.366,174,336,.518,.530,180,211,.853,35,188,223,241,44,59,89,152,765
20485,SAS,2020,Bryn Forbes,26,63,62,1579,242,581,.417,148,381,.388,94,200,.470,.544,75,90,.833,12,114,126,108,33,0,57,113,707
20486,SAS,2020,Patty Mills,31,66,1,1485,258,598,.431,154,403,.382,104,195,.533,.560,97,112,.866,22,86,108,118,53,6,54,105,767
20487,SAS,2020,Rudy Gay,33,67,5,1461,266,596,.446,74,220,.336,192,376,.511,.508,120,136,.882,61,301,362,114,35,33,88,103,726
20488,SAS,2020,Trey Lyles,24,63,53,1271,153,343,.446,65,168,.387,88,175,.503,.541,33,45,.733,71,290,361,69,28,28,39,98,404
20489,SAS,2020,Jakob Poeltl,24,66,18,1171,166,266,.624,0,0,,166,266,.624,.624,40,86,.465,131,244,375,116,37,95,54,126,372
20490,SAS,2020,Lonnie Walker IV,21,61,12,988,152,357,.426,41,101,.406,111,256,.434,.483,44,61,.721,23,116,139,68,32,14,44,78,389
20491,SAS,2020,Marco Belinelli,33,57,0,883,123,314,.392,67,178,.376,56,136,.412,.498,48,58,.828,7,92,99,69,12,1,19,45,361
20492,SAS,2020,Keldon Johnson,20,17,1,301,53,89,.596,13,22,.591,40,67,.597,.669,35,44,.795,10,47,57,15,14,2,13,28,154
20493,SAS,2020,Drew Eubanks,22,22,3,272,43,67,.642,1,1,1.000,42,66,.636,.649,20,26,.769,28,57,85,15,5,17,21,37,107
20494,SAS,2020,DeMarre Carroll,33,15,0,135,9,29,.310,3,13,.231,6,16,.375,.362,12,20,.600,7,24,31,11,2,2,10,20,33
20495,SAS,2020,Chimezie Metu,22,18,0,105,24,42,.571,0,2,.000,24,40,.600,.571,10,13,.769,12,21,33,10,3,6,10,7,58
20496,SAS,2020,Quinndary Weatherspoon,23,11,0,78,5,17,.294,1,5,.200,4,12,.333,.324,1,2,.500,1,6,7,11,3,1,5,8,12
20497,SAS,2020,Luka Šamanić,20,3,1,48,5,16,.313,3,8,.375,2,8,.250,.406,3,4,.750,1,9,10,6,0,2,2,6,16
20498,SAS,2020,Tyler Zeller,30,2,0,4,1,4,.250,0,0,,1,4,.250,.250,0,0,,3,1,4,0,0,0,0,0,2
20499,SAS,2019,DeMar DeRozan,29,77,77,2688,631,1313,.481,7,45,.156,624,1268,.492,.483,366,441,.830,54,408,462,475,86,36,199,177,1635
20500,SAS,2019,LaMarcus Aldridge,33,81,81,2687,684,1319,.519,10,42,.238,674,1277,.528,.522,349,412,.847,251,493,744,194,43,107,144,179,1727
20501,SAS,2019,Bryn Forbes,25,82,81,2293,361,791,.456,176,413,.426,185,378,.489,.568,69,78,.885,18,221,239,175,45,4,80,159,967
20502,SAS,2019,Patty Mills,30,82,1,1908,282,663,.425,159,404,.394,123,259,.475,.545,88,103,.854,24,158,182,245,49,10,93,129,811
20503,SAS,2019,Rudy Gay,32,69,51,1842,376,746,.504,74,184,.402,302,562,.537,.554,120,147,.816,63,407,470,182,54,34,114,159,946
20504,SAS,2019,Marco Belinelli,32,79,1,1815,285,690,.413,147,395,.372,138,295,.468,.520,112,124,.903,16,182,198,132,35,8,72,121,829
20505,SAS,2019,Derrick White,24,67,55,1728,260,543,.479,48,142,.338,212,401,.529,.523,95,123,.772,35,212,247,263,67,47,97,145,663
20506,SAS,2019,Dāvis Bertāns,26,76,12,1632,204,453,.450,145,338,.429,59,115,.513,.610,53,60,.883,23,241,264,100,35,33,43,133,606
20507,SAS,2019,Jakob Poeltl,23,77,24,1273,187,290,.645,0,0,,187,290,.645,.645,49,92,.533,178,232,410,93,29,68,48,124,423
20508,SAS,2019,Dante Cunningham,31,64,21,928,75,158,.475,30,65,.462,45,93,.484,.570,14,18,.778,48,140,188,50,27,13,22,71,194
20509,SAS,2019,Pau Gasol,38,27,6,330,41,88,.466,5,10,.500,36,78,.462,.494,27,38,.711,22,105,127,50,5,14,14,28,114
20510,SAS,2019,Quincy Pondexter,30,53,0,292,29,58,.500,6,18,.333,23,40,.575,.552,34,42,.810,8,38,46,24,11,1,13,24,98
20511,SAS,2019,Chimezie Metu,21,29,0,145,19,58,.328,0,2,.000,19,56,.339,.328,13,17,.765,9,27,36,13,6,2,15,14,51
20512,SAS,2019,Lonnie Walker IV,20,17,0,118,16,46,.348,5,13,.385,11,33,.333,.402,8,10,.800,0,17,17,9,7,3,4,7,45
20513,SAS,2019,Drew Eubanks,21,23,0,113,15,26,.577,0,0,,15,26,.577,.577,11,13,.846,6,28,34,7,2,5,8,11,41
20514,SAS,2019,Donatas Motiejūnas,28,3,0,13,3,6,.500,0,0,,3,6,.500,.500,0,2,.000,2,1,3,1,0,1,3,6,6
20515,SAS,2018,LaMarcus Aldridge,32,75,75,2509,687,1347,.510,27,92,.293,660,1255,.526,.520,334,399,.837,246,389,635,152,43,90,111,161,1735
20516,SAS,2018,Patty Mills,29,82,36,2107,280,682,.411,154,414,.372,126,268,.470,.523,105,118,.890,26,128,154,229,55,11,106,128,819
20517,SAS,2018,Kyle Anderson,24,74,67,1978,231,438,.527,19,57,.333,212,381,.556,.549,104,146,.712,84,312,396,202,115,60,94,114,585
20518,SAS,2018,Pau Gasol,37,77,63,1812,287,627,.458,43,120,.358,244,507,.481,.492,158,209,.756,129,490,619,238,24,79,108,121,775
20519,SAS,2018,Danny Green,30,70,60,1791,217,561,.387,116,320,.363,101,241,.419,.490,50,65,.769,41,208,249,110,63,80,74,122,600
20520,SAS,2018,Dejounte Murray,21,81,48,1743,270,609,.443,9,34,.265,261,575,.454,.451,105,148,.709,110,349,459,231,97,31,134,151,654
20521,SAS,2018,Bryn Forbes,24,80,12,1517,209,497,.421,89,228,.390,120,269,.446,.510,48,72,.667,12,98,110,80,28,2,37,108,555
20522,SAS,2018,Manu Ginóbili,40,65,0,1299,201,463,.434,64,192,.333,137,271,.506,.503,110,131,.840,19,123,142,163,43,16,105,126,576
20523,SAS,2018,Rudy Gay,31,57,6,1231,253,537,.471,37,118,.314,216,419,.516,.506,112,145,.772,76,215,291,73,46,38,78,98,655
20524,SAS,2018,Dāvis Bertāns,25,77,10,1086,161,366,.440,94,252,.373,67,114,.588,.568,40,49,.816,18,135,153,74,26,28,36,93,456
20525,SAS,2018,Tony Parker,35,55,21,1071,178,388,.459,10,37,.270,168,351,.479,.472,55,78,.705,7,88,95,195,28,1,68,52,421
20526,SAS,2018,Brandon Paul,26,64,2,576,55,127,.433,15,54,.278,40,73,.548,.492,22,43,.512,6,62,68,37,25,7,29,58,147
20527,SAS,2018,Joffrey Lauvergne,26,55,1,534,98,190,.516,0,5,.000,98,185,.530,.516,30,47,.638,63,108,171,41,9,3,33,45,226
20528,SAS,2018,Kawhi Leonard,26,9,9,210,52,111,.468,11,35,.314,41,76,.539,.518,31,38,.816,6,36,42,21,18,9,16,9,146
20529,SAS,2018,Derrick White,23,17,0,139,16,33,.485,8,13,.615,8,20,.400,.606,14,20,.700,5,21,26,9,4,3,6,8,54
20530,SAS,2018,Darrun Hilliard,24,14,0,95,5,19,.263,0,6,.000,5,13,.385,.263,6,7,.857,0,7,7,11,2,0,4,7,16
20531,SAS,2018,Matt Costello,24,4,0,32,2,4,.500,0,0,,2,4,.500,.500,0,0,,1,8,9,2,2,2,1,7,4
20532,SAS,2017,Kawhi Leonard,25,74,74,2474,636,1312,.485,147,387,.380,489,925,.529,.541,469,533,.880,80,350,430,260,133,55,154,122,1888
20533,SAS,2017,LaMarcus Aldridge,31,72,72,2335,500,1049,.477,23,56,.411,477,993,.480,.488,220,271,.812,172,351,523,139,46,88,98,158,1243
20534,SAS,2017,Danny Green,29,68,68,1807,176,449,.392,118,311,.379,58,138,.420,.523,27,32,.844,31,193,224,124,70,57,76,120,497
20535,SAS,2017,Patty Mills,28,80,8,1754,273,621,.440,147,355,.414,126,266,.474,.558,66,80,.825,24,117,141,280,65,3,101,109,759
20536,SAS,2017,Pau Gasol,36,64,39,1627,303,604,.502,56,104,.538,247,500,.494,.548,130,184,.707,107,394,501,150,24,70,81,110,792
20537,SAS,2017,Tony Parker,34,63,63,1587,265,569,.466,23,69,.333,242,500,.484,.486,85,117,.726,9,104,113,285,34,2,89,92,638
20538,SAS,2017,David Lee,33,79,10,1477,248,420,.590,0,0,,248,420,.590,.590,80,113,.708,149,292,441,124,31,40,82,125,576
20539,SAS,2017,Jonathon Simmons,27,78,8,1392,177,421,.420,30,102,.294,147,319,.461,.456,99,132,.750,20,140,160,126,47,25,76,146,483
20540,SAS,2017,Dewayne Dedmon,27,76,37,1330,161,259,.622,0,0,,161,259,.622,.622,65,93,.699,129,367,496,44,37,61,61,180,387
20541,SAS,2017,Manu Ginóbili,39,69,0,1291,171,439,.390,89,227,.392,82,212,.387,.491,86,107,.804,28,129,157,183,82,16,96,119,517
20542,SAS,2017,Kyle Anderson,23,72,14,1020,93,209,.445,15,40,.375,78,169,.462,.481,45,57,.789,33,175,208,91,51,26,39,63,246
20543,SAS,2017,Dāvis Bertāns,24,67,6,808,103,234,.440,69,173,.399,34,61,.557,.588,28,34,.824,22,76,98,46,20,28,32,75,303
20544,SAS,2017,Dejounte Murray,20,38,8,322,50,116,.431,9,23,.391,41,93,.441,.470,21,30,.700,6,36,42,48,8,6,38,29,130
20545,SAS,2017,Bryn Forbes,23,36,0,285,36,99,.364,17,53,.321,19,46,.413,.449,5,6,.833,2,21,23,23,1,0,11,20,94
20546,SAS,2017,Nicolás Laprovíttola,27,18,3,174,20,47,.426,10,27,.370,10,20,.500,.532,9,9,1.000,1,9,10,28,4,1,19,19,59
20547,SAS,2017,Joel Anthony,34,19,0,122,10,16,.625,0,0,,10,16,.625,.625,5,8,.625,8,23,31,3,2,6,4,11,25
20548,SAS,2016,Kawhi Leonard,24,72,72,2380,551,1090,.506,129,291,.443,422,799,.528,.565,292,334,.874,95,398,493,186,128,71,105,133,1523
20549,SAS,2016,LaMarcus Aldridge,30,74,74,2261,536,1045,.513,0,16,.000,536,1029,.521,.513,259,302,.858,176,456,632,110,38,81,99,151,1331
20550,SAS,2016,Danny Green,28,79,79,2062,211,561,.376,116,349,.332,95,212,.448,.480,34,46,.739,48,255,303,141,79,64,75,141,572
20551,SAS,2016,Tony Parker,33,72,72,1980,350,710,.493,27,65,.415,323,645,.501,.512,130,171,.760,17,159,176,379,54,11,131,114,857
20552,SAS,2016,Patty Mills,27,81,3,1662,260,612,.425,123,320,.384,137,292,.469,.525,47,58,.810,27,131,158,226,59,6,76,102,690
20553,SAS,2016,Tim Duncan,39,61,60,1536,215,441,.488,0,2,.000,215,439,.490,.488,92,131,.702,115,332,447,163,47,78,90,125,522
20554,SAS,2016,David West,35,78,19,1404,244,448,.545,3,7,.429,241,441,.546,.548,63,80,.788,72,237,309,143,44,55,68,142,554
20555,SAS,2016,Boris Diaw,33,76,4,1386,202,383,.527,25,69,.362,177,314,.564,.560,56,76,.737,58,175,233,176,26,21,97,102,485
20556,SAS,2016,Kyle Anderson,22,78,11,1245,138,295,.468,12,37,.324,126,258,.488,.488,62,83,.747,25,219,244,123,60,29,59,97,350
20557,SAS,2016,Manu Ginóbili,38,58,0,1134,197,435,.453,70,179,.391,127,256,.496,.533,91,112,.813,26,120,146,177,66,11,99,99,555
20558,SAS,2016,Jonathon Simmons,26,55,2,813,122,242,.504,18,47,.383,104,195,.533,.541,69,92,.750,16,80,96,58,24,5,53,103,331
20559,SAS,2016,Boban Marjanović,27,54,4,508,105,174,.603,0,0,,105,174,.603,.603,87,114,.763,73,121,194,21,12,23,29,54,297
20560,SAS,2016,Rasual Butler,36,46,0,432,49,104,.471,15,49,.306,34,55,.618,.543,11,16,.688,3,53,56,24,13,23,8,11,124
20561,SAS,2016,Kevin Martin,32,16,1,261,30,85,.353,11,33,.333,19,52,.365,.418,28,30,.933,4,25,29,12,9,2,13,15,99
20562,SAS,2016,Ray McCallum,24,31,3,256,27,67,.403,5,16,.313,22,51,.431,.440,9,10,.900,6,25,31,33,5,4,11,14,68
20563,SAS,2016,Matt Bonner,35,30,2,206,29,57,.509,15,34,.441,14,23,.609,.640,3,4,.750,3,24,27,9,6,1,3,16,76
20564,SAS,2016,Andre Miller,39,13,4,181,23,48,.479,1,4,.250,22,44,.500,.490,9,13,.692,6,21,27,29,7,0,12,14,56
20565,SAS,2015,Danny Green,27,81,80,2312,322,738,.436,191,457,.418,131,281,.466,.566,111,127,.874,54,289,343,158,101,87,93,163,946
20566,SAS,2015,Tim Duncan,38,77,77,2227,419,819,.512,2,7,.286,417,812,.514,.513,230,311,.740,170,534,704,230,63,151,131,165,1070
20567,SAS,2015,Kawhi Leonard,23,64,64,2033,394,822,.479,67,192,.349,327,630,.519,.520,202,252,.802,85,376,461,161,148,48,97,128,1057
20568,SAS,2015,Boris Diaw,32,81,15,1984,291,632,.460,54,169,.320,237,463,.512,.503,72,93,.774,78,270,348,233,36,23,126,148,708
20569,SAS,2015,Tony Parker,32,68,68,1953,404,832,.486,38,89,.427,366,743,.493,.508,130,166,.783,15,114,129,335,44,2,146,108,976
20570,SAS,2015,Manu Ginóbili,37,70,0,1587,251,589,.426,89,258,.345,162,331,.489,.502,147,204,.721,28,183,211,293,67,20,154,138,738
20571,SAS,2015,Cory Joseph,23,79,14,1444,207,411,.504,16,44,.364,191,367,.520,.523,105,143,.734,44,148,192,188,46,17,67,105,535
20572,SAS,2015,Marco Belinelli,28,62,9,1388,199,470,.423,86,230,.374,113,240,.471,.515,84,99,.848,26,131,157,94,31,3,61,85,568
20573,SAS,2015,Aron Baynes,28,70,17,1122,185,327,.566,1,4,.250,184,323,.570,.567,90,104,.865,109,209,318,35,16,22,65,162,461
20574,SAS,2015,Tiago Splitter,30,52,35,1030,169,303,.558,0,0,,169,303,.558,.558,90,120,.750,91,161,252,78,35,37,60,103,428
20575,SAS,2015,Matt Bonner,34,72,19,935,94,230,.409,46,126,.365,48,104,.462,.509,30,37,.811,29,86,115,47,10,12,11,65,264
20576,SAS,2015,Patty Mills,26,51,0,801,128,336,.381,62,182,.341,66,154,.429,.473,33,40,.825,21,54,75,87,28,2,35,58,351
20577,SAS,2015,Jeff Ayres,27,51,0,383,55,95,.579,0,0,,55,95,.579,.579,27,36,.750,37,80,117,14,8,8,26,60,137
20578,SAS,2015,Kyle Anderson,21,33,8,358,31,89,.348,3,11,.273,28,78,.359,.365,9,14,.643,5,67,72,28,15,7,10,28,74
20579,SAS,2015,Austin Daye,26,26,4,268,40,115,.348,19,57,.333,21,58,.362,.430,4,4,1.000,6,55,61,9,8,3,18,30,103
20580,SAS,2015,Reggie Williams,28,20,0,105,15,39,.385,3,19,.158,12,20,.600,.423,4,4,1.000,5,12,17,10,1,0,2,12,37
20581,SAS,2015,JaMychal Green,24,4,0,25,4,7,.571,0,2,.000,4,5,.800,.571,0,0,,3,3,6,0,0,2,2,6,8
20582,SAS,2014,Tim Duncan,37,74,74,2158,444,906,.490,0,5,.000,444,901,.493,.490,231,316,.731,158,563,721,220,43,139,159,134,1119
20583,SAS,2014,Marco Belinelli,27,80,25,2016,337,695,.485,126,293,.430,211,402,.525,.576,111,131,.847,18,208,226,179,50,7,95,130,911
20584,SAS,2014,Tony Parker,31,68,68,1997,456,914,.499,25,67,.373,431,847,.509,.513,197,243,.811,17,138,155,388,36,9,151,86,1134
20585,SAS,2014,Boris Diaw,31,79,24,1974,302,580,.521,45,112,.402,257,468,.549,.559,68,92,.739,74,252,326,222,44,32,121,140,717
20586,SAS,2014,Kawhi Leonard,22,66,65,1923,337,645,.522,69,182,.379,268,463,.579,.576,101,126,.802,76,336,412,133,114,50,80,127,844
20587,SAS,2014,Danny Green,26,68,59,1651,218,505,.432,132,318,.415,86,187,.460,.562,50,63,.794,25,204,229,104,65,61,76,107,618
20588,SAS,2014,Manu Ginóbili,36,68,3,1550,294,627,.469,90,258,.349,204,369,.553,.541,160,188,.851,30,172,202,293,70,17,139,128,838
20589,SAS,2014,Patty Mills,25,81,2,1527,309,666,.464,135,318,.425,174,348,.500,.565,73,82,.890,34,135,169,149,68,9,63,114,826
20590,SAS,2014,Tiago Splitter,29,59,50,1271,181,346,.523,0,3,.000,181,343,.528,.523,121,173,.699,123,240,363,90,29,31,75,117,483
20591,SAS,2014,Jeff Ayres,26,73,10,952,101,174,.580,0,0,,101,174,.580,.580,38,55,.691,89,169,258,60,13,25,63,146,240
20592,SAS,2014,Cory Joseph,22,68,19,936,126,265,.475,12,38,.316,114,227,.502,.498,79,96,.823,32,75,107,114,35,14,43,84,343
20593,SAS,2014,Matt Bonner,33,61,0,690,73,164,.445,42,98,.429,31,66,.470,.573,9,12,.750,16,114,130,31,15,11,16,49,197
20594,SAS,2014,Aron Baynes,27,53,4,491,71,163,.436,0,0,,71,163,.436,.436,19,21,.905,57,88,145,34,2,5,36,77,161
20595,SAS,2014,Nando De Colo,26,26,3,301,42,93,.452,10,31,.323,32,62,.516,.505,18,22,.818,6,39,45,32,15,3,21,25,112
20596,SAS,2014,Austin Daye,25,14,1,115,21,55,.382,12,29,.414,9,26,.346,.491,4,7,.571,3,17,20,6,4,4,5,14,58
20597,SAS,2014,Shannon Brown,28,10,1,103,8,28,.286,0,2,.000,8,26,.308,.286,7,9,.778,1,12,13,5,1,0,8,12,23
20598,SAS,2014,Damion James,26,5,1,50,2,9,.222,0,2,.000,2,7,.286,.222,2,2,1.000,1,11,12,3,0,1,1,3,6
20599,SAS,2014,Othyus Jeffers,28,4,1,34,3,5,.600,0,1,.000,3,4,.750,.600,1,2,.500,1,5,6,1,0,0,0,2,7
20600,SAS,2014,Malcolm Thomas,25,1,0,15,1,4,.250,0,0,,1,4,.250,.250,0,2,.000,1,8,9,0,0,2,1,0,2
20601,SAS,2013,Danny Green,25,80,80,2201,297,663,.448,177,413,.429,120,250,.480,.581,67,79,.848,36,208,244,141,92,54,94,124,838
20602,SAS,2013,Tony Parker,30,66,66,2174,519,995,.522,24,68,.353,495,927,.534,.534,279,330,.845,18,180,198,499,54,6,170,92,1341
20603,SAS,2013,Tim Duncan,36,69,69,2078,490,976,.502,2,7,.286,488,969,.504,.503,245,300,.817,124,562,686,184,50,183,147,117,1227
20604,SAS,2013,Tiago Splitter,28,81,58,1997,315,563,.560,0,2,.000,315,561,.561,.560,208,285,.730,144,371,515,130,63,64,100,161,838
20605,SAS,2013,Kawhi Leonard,21,58,57,1810,260,526,.494,65,174,.374,195,352,.554,.556,104,126,.825,63,283,346,93,97,32,62,99,689
20606,SAS,2013,Boris Diaw,30,75,20,1709,179,332,.539,30,78,.385,149,254,.587,.584,47,65,.723,66,188,254,180,52,27,84,143,435
20607,SAS,2013,Gary Neal,28,68,17,1484,246,597,.412,89,251,.355,157,346,.454,.487,64,74,.865,13,130,143,129,30,2,69,93,645
20608,SAS,2013,Manu Ginóbili,35,60,0,1393,229,539,.425,83,235,.353,146,304,.480,.502,164,206,.796,30,171,201,274,80,13,132,114,705
20609,SAS,2013,Stephen Jackson,34,55,6,1075,123,330,.373,46,170,.271,77,160,.481,.442,49,70,.700,22,133,155,80,37,14,77,89,341
20610,SAS,2013,Nando De Colo,25,72,6,920,105,241,.436,31,82,.378,74,159,.465,.500,35,44,.795,23,115,138,138,41,6,81,87,276
20611,SAS,2013,Matt Bonner,32,68,4,909,112,230,.487,53,120,.442,59,110,.536,.602,11,15,.733,25,104,129,36,17,19,16,86,288
20612,SAS,2013,DeJuan Blair,23,61,16,851,142,271,.524,0,1,.000,142,270,.526,.524,44,70,.629,66,164,230,45,37,10,49,112,328
20613,SAS,2013,Patty Mills,24,58,2,656,113,241,.469,52,130,.400,61,111,.550,.577,16,19,.842,9,41,50,62,26,4,39,55,294
20614,SAS,2013,Cory Joseph,21,28,9,388,51,110,.464,6,21,.286,45,89,.506,.491,18,21,.857,12,40,52,53,15,4,21,25,126
20615,SAS,2013,Aron Baynes,26,16,0,141,18,36,.500,0,1,.000,18,35,.514,.500,7,12,.583,12,20,32,5,1,6,11,23,43
20616,SAS,2013,James Anderson,23,10,0,94,11,25,.440,5,11,.455,6,14,.429,.540,7,9,.778,3,11,14,9,3,2,7,7,34
20617,SAS,2012,Tony Parker,29,60,60,1923,427,890,.480,14,61,.230,413,829,.498,.488,227,284,.799,22,149,171,463,57,5,153,75,1095
20618,SAS,2012,Tim Duncan,35,58,58,1634,361,733,.492,0,4,.000,361,729,.495,.492,173,249,.695,110,410,520,132,38,88,97,98,895
20619,SAS,2012,Kawhi Leonard,20,64,39,1534,199,404,.493,41,109,.376,158,295,.536,.543,68,88,.773,104,223,327,70,85,24,44,88,507
20620,SAS,2012,Danny Green,24,66,38,1522,211,477,.442,102,234,.436,109,243,.449,.549,79,100,.790,54,174,228,86,58,46,67,107,603
20621,SAS,2012,DeJuan Blair,22,64,62,1363,269,504,.534,0,1,.000,269,503,.535,.534,73,119,.613,154,197,351,78,59,12,92,168,611
20622,SAS,2012,Matt Bonner,31,65,2,1326,154,350,.440,105,250,.420,49,100,.490,.590,16,21,.762,29,185,214,61,15,21,14,68,429
20623,SAS,2012,Gary Neal,27,56,7,1206,212,486,.436,83,198,.419,129,288,.448,.522,50,64,.781,12,106,118,117,27,2,60,75,557
20624,SAS,2012,Richard Jefferson,31,41,41,1168,132,319,.414,80,190,.421,52,129,.403,.539,35,50,.700,18,125,143,55,25,12,32,83,379
20625,SAS,2012,Tiago Splitter,27,59,2,1121,212,343,.618,0,0,,212,343,.618,.618,125,181,.691,93,213,306,65,21,47,87,134,549
20626,SAS,2012,Manu Ginóbili,34,34,7,792,150,285,.526,52,126,.413,98,159,.616,.618,88,101,.871,18,98,116,151,24,12,64,56,440
20627,SAS,2012,James Anderson,22,51,2,603,66,174,.379,19,68,.279,47,106,.443,.434,39,52,.750,16,63,79,41,8,2,30,35,190
20628,SAS,2012,Stephen Jackson,33,21,1,500,62,153,.405,19,62,.306,43,91,.473,.467,44,54,.815,6,75,81,41,28,7,37,38,187
20629,SAS,2012,Boris Diaw,29,20,7,406,40,68,.588,8,13,.615,32,55,.582,.647,5,8,.625,23,62,85,47,14,6,28,54,93
20630,SAS,2012,Cory Joseph,20,29,1,266,22,70,.314,3,15,.200,19,55,.345,.336,11,17,.647,5,20,25,34,7,3,12,16,58
20631,SAS,2012,Patty Mills,23,16,3,261,63,130,.485,24,56,.429,39,74,.527,.577,15,15,1.000,4,24,28,39,10,1,26,14,165
20632,SAS,2012,T.J. Ford,28,14,0,191,19,43,.442,2,8,.250,17,35,.486,.465,11,14,.786,3,15,18,45,9,2,23,23,51
20633,SAS,2012,Eric Dawson,27,4,0,39,7,12,.583,0,0,,7,12,.583,.583,1,2,.500,5,5,10,0,1,2,3,6,15
20634,SAS,2012,Derrick Byars,27,2,0,37,3,11,.273,0,6,.000,3,5,.600,.273,4,4,1.000,6,5,11,1,2,0,0,2,10
20635,SAS,2012,Justin Dentmon,26,2,0,19,2,6,.333,0,4,.000,2,2,1.000,.333,0,0,,0,1,1,1,1,0,1,2,4
20636,SAS,2012,Malcolm Thomas,23,3,0,15,0,3,.000,0,0,,0,3,.000,.000,1,2,.500,1,2,3,1,1,1,0,0,1
20637,SAS,2012,Ike Diogu,28,2,0,14,0,2,.000,0,0,,0,2,.000,.000,2,2,1.000,0,1,1,0,0,0,1,1,2
20638,SAS,2011,Tony Parker,28,78,78,2528,555,1069,.519,25,70,.357,530,999,.531,.531,233,303,.769,30,208,238,513,90,3,200,135,1368
20639,SAS,2011,Richard Jefferson,30,81,81,2459,304,642,.474,135,307,.440,169,335,.504,.579,148,195,.759,54,256,310,107,38,34,93,164,891
20640,SAS,2011,Manu Ginóbili,33,80,79,2426,441,1018,.433,154,441,.349,287,577,.497,.509,357,410,.871,42,253,295,393,123,28,174,163,1393
20641,SAS,2011,Tim Duncan,34,76,76,2156,419,838,.500,0,4,.000,419,834,.502,.500,184,257,.716,169,509,678,203,50,146,122,119,1022
20642,SAS,2011,George Hill,24,76,5,2148,287,633,.453,77,204,.377,210,429,.490,.514,233,270,.863,24,175,199,193,66,21,99,153,884
20643,SAS,2011,DeJuan Blair,21,81,65,1734,292,583,.501,0,2,.000,292,581,.503,.501,90,137,.657,215,350,565,77,95,42,113,213,674
20644,SAS,2011,Gary Neal,26,80,1,1685,285,632,.451,129,308,.419,156,324,.481,.553,84,104,.808,21,175,196,96,27,4,78,148,783
20645,SAS,2011,Matt Bonner,30,66,1,1432,172,371,.464,105,230,.457,67,141,.475,.605,32,43,.744,60,179,239,60,26,21,27,110,481
20646,SAS,2011,Antonio McDyess,36,73,16,1387,169,344,.491,0,1,.000,169,343,.493,.491,52,77,.675,122,273,395,84,36,39,72,163,390
20647,SAS,2011,Tiago Splitter,26,60,6,738,101,191,.529,0,1,.000,101,190,.532,.529,76,140,.543,72,129,201,26,29,17,32,91,278
20648,SAS,2011,Chris Quinn,27,41,0,292,33,91,.363,11,37,.297,22,54,.407,.423,4,8,.500,3,22,25,42,5,1,12,29,81
20649,SAS,2011,James Anderson,21,26,2,286,31,81,.383,18,46,.391,13,35,.371,.494,14,18,.778,2,21,23,18,3,6,13,24,94
20650,SAS,2011,Steve Novak,27,23,0,197,31,59,.525,23,42,.548,8,17,.471,.720,8,8,1.000,4,19,23,3,1,5,4,11,93
20651,SAS,2011,Ime Udoka,33,20,0,130,5,21,.238,0,8,.000,5,13,.385,.238,4,8,.500,5,14,19,13,8,1,5,14,14
20652,SAS,2011,Danny Green,23,8,0,92,17,35,.486,7,19,.368,10,16,.625,.586,0,0,,3,12,15,2,2,1,5,7,41
20653,SAS,2011,Larry Owens,28,7,0,31,3,6,.500,1,3,.333,2,3,.667,.583,2,4,.500,0,4,4,1,2,0,0,4,9
20654,SAS,2011,Garrett Temple,24,3,0,21,1,5,.200,0,1,.000,1,4,.250,.200,0,2,.000,1,1,2,2,1,1,1,2,2
20655,SAS,2011,Alonzo Gee,23,5,0,18,1,3,.333,0,0,,1,3,.333,.333,0,0,,2,1,3,0,0,2,3,3,2
20656,SAS,2011,Bobby Simmons,30,2,0,16,0,3,.000,0,3,.000,0,0,,.000,0,0,,0,0,0,2,0,0,0,2,0
20657,SAS,2011,Othyus Jeffers,25,1,0,8,1,3,.333,0,0,,1,3,.333,.333,0,0,,0,2,2,1,0,0,1,1,2
20658,SAS,2010,Richard Jefferson,29,81,70,2520,362,775,.467,59,187,.316,303,588,.515,.505,211,287,.735,58,298,356,158,45,40,105,178,994
20659,SAS,2010,Tim Duncan,33,78,77,2438,561,1082,.518,2,11,.182,559,1071,.522,.519,271,374,.725,221,567,788,246,45,117,140,152,1395
20660,SAS,2010,George Hill,23,78,43,2276,353,738,.478,75,188,.399,278,550,.505,.529,183,237,.772,42,163,205,226,69,26,101,222,964
20661,SAS,2010,Manu Ginóbili,32,75,21,2150,398,903,.441,132,350,.377,266,553,.481,.514,309,355,.870,68,216,284,370,103,24,154,154,1237
20662,SAS,2010,Tony Parker,27,56,50,1728,349,716,.487,10,34,.294,339,682,.497,.494,186,246,.756,7,128,135,317,29,8,149,96,894
20663,SAS,2010,Antonio McDyess,35,77,50,1617,205,428,.479,0,2,.000,205,426,.481,.479,36,57,.632,149,306,455,83,43,32,79,147,446
20664,SAS,2010,Keith Bogans,29,79,50,1559,120,298,.403,70,196,.357,50,102,.490,.520,37,50,.740,25,151,176,95,45,12,53,156,347
20665,SAS,2010,Roger Mason,29,79,5,1515,193,496,.389,88,264,.333,105,232,.453,.478,27,34,.794,11,151,162,137,30,14,59,99,501
20666,SAS,2010,DeJuan Blair,20,82,23,1494,275,495,.556,0,2,.000,275,493,.558,.556,88,161,.547,200,326,526,65,50,39,112,224,638
20667,SAS,2010,Matt Bonner,29,65,8,1161,166,372,.446,90,231,.390,76,141,.539,.567,35,48,.729,52,162,214,68,30,24,39,109,457
20668,SAS,2010,Michael Finley,36,25,6,395,37,97,.381,13,41,.317,24,56,.429,.448,6,9,.667,5,33,38,19,6,4,13,12,93
20669,SAS,2010,Malik Hairston,22,47,0,317,40,76,.526,2,11,.182,38,65,.585,.539,17,30,.567,13,36,49,16,4,9,11,29,99
20670,SAS,2010,Garrett Temple,23,13,4,193,28,64,.438,10,23,.435,18,41,.439,.516,14,21,.667,3,11,14,12,8,2,11,25,80
20671,SAS,2010,Theo Ratliff,36,21,3,183,16,36,.444,0,0,,16,36,.444,.444,2,4,.500,15,25,40,9,3,18,16,27,34
20672,SAS,2010,Ian Mahinmi,23,26,0,165,35,55,.636,0,0,,35,55,.636,.636,31,47,.660,13,39,52,2,3,8,15,32,101
20673,SAS,2010,Marcus Haislip,29,10,0,44,10,21,.476,3,5,.600,7,16,.438,.548,2,5,.400,4,6,10,0,0,2,3,5,25
20674,SAS,2010,Cedric Jackson,23,3,0,25,2,7,.286,0,2,.000,2,5,.400,.286,3,4,.750,1,3,4,6,3,2,2,2,7
20675,SAS,2009,Tim Duncan,32,75,75,2524,558,1107,.504,0,2,.000,558,1105,.505,.504,334,483,.692,201,599,800,264,38,126,165,173,1450
20676,SAS,2009,Roger Mason,28,82,71,2496,349,822,.425,166,394,.421,183,428,.428,.526,105,118,.890,16,235,251,173,40,12,100,160,969
20677,SAS,2009,Tony Parker,26,72,71,2456,639,1263,.506,19,65,.292,620,1198,.518,.513,284,363,.782,27,196,223,496,67,4,186,110,1581
20678,SAS,2009,Michael Finley,35,81,77,2336,301,689,.437,131,319,.411,170,370,.459,.532,51,62,.823,26,244,270,114,37,17,61,82,784
20679,SAS,2009,Matt Bonner,28,81,67,1928,266,536,.496,118,268,.440,148,268,.552,.606,17,23,.739,97,289,386,82,47,26,37,190,667
20680,SAS,2009,Bruce Bowen,37,80,10,1506,79,187,.422,42,98,.429,37,89,.416,.535,14,26,.538,16,129,145,40,36,13,25,123,214
20681,SAS,2009,Kurt Thomas,36,79,10,1404,153,304,.503,0,2,.000,153,302,.507,.503,37,45,.822,134,271,405,66,34,58,42,170,343
20682,SAS,2009,George Hill,22,77,7,1270,150,372,.403,24,73,.329,126,299,.421,.435,114,146,.781,30,128,158,136,45,21,74,150,438
20683,SAS,2009,Manu Ginóbili,31,44,7,1181,223,491,.454,69,209,.330,154,282,.546,.524,168,190,.884,24,174,198,157,64,16,88,90,683
20684,SAS,2009,Ime Udoka,31,67,3,1035,110,287,.383,41,125,.328,69,162,.426,.455,28,46,.609,28,159,187,54,36,12,38,86,289
20685,SAS,2009,Fabricio Oberto,33,54,11,677,61,104,.587,0,1,.000,61,103,.592,.587,20,35,.571,65,77,142,59,7,11,38,95,142
20686,SAS,2009,Drew Gooden,27,19,1,320,71,145,.490,0,1,.000,71,144,.493,.490,45,57,.789,28,55,83,3,4,4,16,39,187
20687,SAS,2009,Jacque Vaughn,33,30,0,292,24,75,.320,1,1,1.000,23,74,.311,.327,16,18,.889,4,18,22,55,6,0,15,26,65
20688,SAS,2009,Anthony Tolliver,23,19,0,208,19,65,.292,9,41,.220,10,24,.417,.362,5,10,.500,12,29,41,17,5,1,7,16,52
20689,SAS,2009,Malik Hairston,21,15,0,155,24,49,.490,0,1,.000,24,48,.500,.490,2,7,.286,11,17,28,13,6,7,12,19,50
20690,SAS,2009,Desmon Farmer,27,3,0,54,4,14,.286,3,12,.250,1,2,.500,.393,2,2,1.000,0,6,6,2,0,0,4,6,13
20691,SAS,2009,Austin Croshere,33,3,0,23,2,9,.222,0,4,.000,2,5,.400,.222,0,1,.000,4,6,10,3,0,0,2,1,4
20692,SAS,2009,Pops Mensah-Bonsu,25,3,0,20,5,7,.714,0,0,,5,7,.714,.714,5,7,.714,5,5,10,0,1,1,2,6,15
20693,SAS,2009,Blake Ahearn,24,3,0,19,2,6,.333,2,4,.500,0,2,.000,.500,2,2,1.000,0,1,1,2,1,0,1,3,8
20694,SAS,2009,Marcus Williams,22,2,0,3,2,2,1.000,0,0,,2,2,1.000,1.000,0,0,,0,0,0,0,0,0,0,1,4
20695,SAS,2008,Tim Duncan,31,78,78,2651,585,1178,.497,0,4,.000,585,1174,.498,.497,338,463,.730,237,644,881,218,56,152,178,185,1508
20696,SAS,2008,Bruce Bowen,36,81,81,2448,174,428,.407,90,215,.419,84,213,.394,.512,45,69,.652,33,201,234,91,54,22,46,177,483
20697,SAS,2008,Tony Parker,25,69,68,2312,515,1043,.494,17,66,.258,498,977,.510,.502,248,347,.715,30,191,221,411,55,8,164,93,1295
20698,SAS,2008,Manu Ginóbili,30,74,23,2299,453,984,.460,156,389,.401,297,595,.499,.540,380,442,.860,63,291,354,332,109,33,200,173,1442
20699,SAS,2008,Michael Finley,34,82,61,2204,315,761,.414,132,357,.370,183,404,.453,.501,64,80,.800,27,227,254,114,29,10,56,93,826
20700,SAS,2008,Fabricio Oberto,32,82,64,1644,180,296,.608,0,1,.000,180,295,.610,.608,37,61,.607,153,277,430,95,37,20,51,203,397
20701,SAS,2008,Ime Udoka,30,73,0,1316,159,375,.424,61,165,.370,98,210,.467,.505,44,58,.759,36,192,228,63,56,17,58,127,423
20702,SAS,2008,Jacque Vaughn,32,74,9,1139,121,283,.428,3,10,.300,118,273,.432,.433,61,80,.763,13,61,74,159,23,1,54,97,306
20703,SAS,2008,Matt Bonner,27,68,3,853,121,291,.416,46,137,.336,75,154,.487,.495,38,44,.864,53,139,192,32,14,17,39,111,326
20704,SAS,2008,Robert Horry,37,45,5,583,38,119,.319,18,70,.257,20,49,.408,.395,18,28,.643,35,74,109,47,21,19,22,55,112
20705,SAS,2008,Brent Barry,36,31,1,554,77,160,.481,48,112,.429,29,48,.604,.631,19,20,.950,12,43,55,54,17,3,18,43,221
20706,SAS,2008,Francisco Elson,31,41,3,534,62,148,.419,0,0,,62,148,.419,.419,20,24,.833,33,102,135,16,9,14,30,62,144
20707,SAS,2008,Kurt Thomas,35,28,9,524,56,125,.448,0,1,.000,56,124,.452,.448,14,24,.583,36,102,138,14,21,14,18,57,126
20708,SAS,2008,Damon Stoudamire,34,31,4,413,43,143,.301,14,55,.255,29,88,.330,.350,6,8,.750,6,41,47,53,11,2,30,30,106
20709,SAS,2008,Darius Washington,22,18,0,146,21,48,.438,4,12,.333,17,36,.472,.479,7,13,.538,4,16,20,15,5,0,14,16,53
20710,SAS,2008,Jeremy Richardson,23,5,1,29,3,7,.429,2,5,.400,1,2,.500,.571,2,2,1.000,0,1,1,1,1,0,0,5,10
20711,SAS,2008,DerMarr Johnson,27,5,0,28,7,14,.500,3,9,.333,4,5,.800,.607,0,2,.000,0,1,1,1,1,0,0,4,17
20712,SAS,2008,Ian Mahinmi,21,6,0,23,6,12,.500,0,0,,6,12,.500,.500,9,9,1.000,0,5,5,1,0,4,2,4,21
20713,SAS,2008,Bobby Jones,24,3,0,20,1,4,.250,0,2,.000,1,2,.500,.250,0,0,,0,2,2,1,2,0,1,1,2
20714,SAS,2008,Keith Langford,24,2,0,10,1,4,.250,0,0,,1,4,.250,.250,0,0,,0,2,2,0,0,0,0,1,2
20715,SAS,2008,Marcus Williams,21,1,0,2,0,1,.000,0,0,,0,1,.000,.000,0,0,,0,0,0,0,0,1,0,0,0
20716,SAS,2007,Tim Duncan,30,80,80,2726,618,1131,.546,1,9,.111,617,1122,.550,.547,362,568,.637,213,633,846,273,66,190,224,203,1599
20717,SAS,2007,Tony Parker,24,77,77,2499,570,1096,.520,15,38,.395,555,1058,.525,.527,274,350,.783,34,216,250,420,82,6,191,137,1429
20718,SAS,2007,Bruce Bowen,35,82,82,2464,189,467,.405,89,232,.384,100,235,.426,.500,43,73,.589,23,200,223,117,62,25,65,175,510
20719,SAS,2007,Manu Ginóbili,29,75,36,2060,396,854,.464,128,323,.396,268,531,.505,.539,320,372,.860,59,268,327,263,109,27,157,155,1240
20720,SAS,2007,Michael Finley,33,82,16,1823,273,663,.412,104,286,.364,169,377,.448,.490,90,98,.918,34,189,223,108,32,16,46,76,740
20721,SAS,2007,Brent Barry,35,75,28,1631,202,425,.475,128,287,.446,74,138,.536,.626,103,117,.880,17,143,160,138,56,12,61,88,635
20722,SAS,2007,Fabricio Oberto,31,79,33,1365,158,281,.562,0,0,,158,281,.562,.562,33,51,.647,131,237,368,68,25,24,69,213,349
20723,SAS,2007,Francisco Elson,30,70,41,1332,144,282,.511,0,2,.000,144,280,.514,.511,62,80,.775,81,255,336,55,31,59,86,184,350
20724,SAS,2007,Robert Horry,36,68,8,1124,90,251,.359,50,149,.336,40,102,.392,.458,38,64,.594,73,156,229,77,45,41,44,105,268
20725,SAS,2007,Beno Udrih,24,73,1,948,127,344,.369,33,115,.287,94,229,.410,.417,53,60,.883,11,71,82,122,27,1,56,70,340
20726,SAS,2007,Jacque Vaughn,31,64,4,760,71,167,.425,1,2,.500,70,165,.424,.428,49,65,.754,8,60,68,131,24,2,40,74,192
20727,SAS,2007,Matt Bonner,26,56,0,653,106,237,.447,36,94,.383,70,143,.490,.523,27,38,.711,64,92,156,22,17,11,25,67,275
20728,SAS,2007,James White,24,6,2,137,18,41,.439,2,7,.286,16,34,.471,.463,12,15,.800,3,17,20,5,3,1,5,7,50
20729,SAS,2007,Jackie Butler,21,11,2,103,16,35,.457,0,0,,16,35,.457,.457,9,10,.900,6,16,22,5,2,0,10,16,41
20730,SAS,2007,Eric Williams,34,16,0,88,15,34,.441,8,17,.471,7,17,.412,.559,4,7,.571,1,13,14,6,2,0,5,6,42
20731,SAS,2007,Melvin Ely,28,6,0,65,6,20,.300,0,0,,6,20,.300,.300,7,12,.583,3,11,14,4,4,2,5,12,19
20732,SAS,2006,Tim Duncan,29,80,80,2784,574,1185,.484,2,5,.400,572,1180,.485,.485,335,533,.629,231,650,881,253,70,162,198,219,1485
20733,SAS,2006,Bruce Bowen,34,82,82,2755,232,536,.433,104,245,.424,128,291,.440,.530,51,84,.607,35,285,320,126,79,30,67,191,619
20734,SAS,2006,Tony Parker,23,80,80,2715,623,1136,.548,11,36,.306,612,1100,.556,.553,253,358,.707,38,223,261,460,83,4,249,161,1510
20735,SAS,2006,Michael Finley,32,77,18,2038,286,695,.412,110,279,.394,176,416,.423,.491,98,115,.852,31,216,247,116,37,7,62,97,780
20736,SAS,2006,Manu Ginóbili,28,65,56,1813,309,669,.462,83,217,.382,226,452,.500,.524,280,360,.778,42,188,230,235,101,26,121,156,981
20737,SAS,2006,Rasho Nesterović,29,80,51,1515,172,334,.515,0,2,.000,172,332,.518,.515,18,30,.600,114,195,309,33,21,88,53,209,362
20738,SAS,2006,Nazr Mohammed,28,80,30,1389,190,377,.504,0,0,,190,377,.504,.504,113,144,.785,163,255,418,40,21,49,91,220,493
20739,SAS,2006,Brent Barry,34,74,5,1259,156,345,.452,80,202,.396,76,143,.531,.568,39,59,.661,29,130,159,123,39,27,52,99,431
20740,SAS,2006,Robert Horry,35,63,3,1182,112,292,.384,53,144,.368,59,148,.399,.474,44,68,.647,71,171,242,79,43,51,41,115,321
20741,SAS,2006,Nick Van Exel,34,65,2,986,136,343,.397,55,154,.357,81,189,.429,.477,28,41,.683,6,85,91,123,16,3,57,60,355
20742,SAS,2006,Beno Udrih,23,54,3,586,106,233,.455,24,70,.343,82,163,.503,.506,39,50,.780,18,34,52,92,14,2,53,55,275
20743,SAS,2006,Fabricio Oberto,30,59,0,490,44,93,.473,0,2,.000,44,91,.484,.473,15,27,.556,57,66,123,27,9,11,28,91,103
20744,SAS,2006,Sean Marks,30,25,0,181,37,71,.521,0,3,.000,37,68,.544,.521,7,12,.583,12,31,43,7,5,7,7,21,81
20745,SAS,2006,Melvin Sanders,25,16,0,113,16,33,.485,2,3,.667,14,30,.467,.515,7,10,.700,4,19,23,3,5,0,8,20,41
20746,SAS,2006,Alex Scales,27,1,0,0,0,0,,0,0,,0,0,,,0,0,,0,0,0,0,0,0,0,0,0
20747,SAS,2005,Tony Parker,22,80,80,2735,539,1118,.482,43,156,.276,496,962,.516,.501,210,323,.650,47,251,298,491,98,4,215,167,1331
20748,SAS,2005,Bruce Bowen,33,82,82,2627,251,598,.420,102,253,.403,149,345,.432,.505,71,112,.634,50,235,285,126,55,39,57,175,675
20749,SAS,2005,Tim Duncan,28,66,66,2203,517,1042,.496,3,9,.333,514,1033,.498,.498,305,455,.670,202,530,732,179,45,174,127,144,1342
20750,SAS,2005,Manu Ginóbili,27,74,74,2193,367,780,.471,97,258,.376,270,522,.517,.533,355,442,.803,75,254,329,288,119,27,172,190,1186
20751,SAS,2005,Rasho Nesterović,28,70,70,1785,198,430,.460,0,0,,198,430,.460,.460,14,30,.467,184,275,459,71,31,117,73,207,410
20752,SAS,2005,Brent Barry,33,81,8,1742,194,459,.423,100,280,.357,94,179,.525,.532,113,135,.837,29,161,190,178,39,20,64,123,601
20753,SAS,2005,Robert Horry,34,75,16,1396,157,375,.419,51,138,.370,106,237,.447,.487,86,109,.789,91,177,268,80,67,60,69,138,451
20754,SAS,2005,Devin Brown,26,67,0,1238,173,409,.423,45,121,.372,128,288,.444,.478,103,130,.792,37,139,176,92,39,12,53,83,494
20755,SAS,2005,Beno Udrih,22,80,2,1149,173,390,.444,58,142,.408,115,248,.464,.518,67,89,.753,16,67,83,150,41,10,77,96,471
20756,SAS,2005,Malik Rose,30,50,1,862,124,267,.464,0,4,.000,124,263,.471,.464,69,99,.697,95,132,227,41,31,9,56,124,317
20757,SAS,2005,Tony Massenburg,37,61,6,699,74,182,.407,0,0,,74,182,.407,.407,48,63,.762,54,109,163,14,18,20,40,122,196
20758,SAS,2005,Nazr Mohammed,27,23,5,414,55,142,.387,0,0,,55,142,.387,.387,32,56,.571,78,69,147,8,5,33,27,64,142
20759,SAS,2005,Mike Wilks,25,48,0,278,32,77,.416,5,16,.313,27,61,.443,.448,12,16,.750,4,21,25,33,14,1,14,26,81
20760,SAS,2005,Sean Marks,29,23,0,244,27,80,.338,0,3,.000,27,77,.351,.338,22,28,.786,18,38,56,8,3,11,14,29,76
20761,SAS,2005,Glenn Robinson,32,9,0,157,34,77,.442,2,6,.333,32,71,.451,.455,20,23,.870,4,20,24,8,4,3,7,19,90
20762,SAS,2005,Dion Glover,26,7,0,68,8,22,.364,1,8,.125,7,14,.500,.386,8,10,.800,3,8,11,4,3,3,2,9,25
20763,SAS,2005,Linton Johnson,24,2,0,15,0,2,.000,0,1,.000,0,1,.000,.000,0,0,,0,3,3,0,1,0,1,1,0
20764,SAS,2004,Bruce Bowen,32,82,82,2624,211,502,.420,77,212,.363,134,290,.462,.497,66,114,.579,45,208,253,113,84,33,90,166,565
20765,SAS,2004,Tony Parker,21,75,75,2577,423,946,.447,62,199,.312,361,747,.483,.480,191,272,.702,43,194,237,411,61,7,179,148,1099
20766,SAS,2004,Tim Duncan,27,69,68,2527,592,1181,.501,2,12,.167,590,1169,.505,.502,352,588,.599,227,632,859,213,62,185,183,164,1538
20767,SAS,2004,Rasho Nesterović,27,82,82,2353,328,700,.469,0,0,,328,700,.469,.469,54,114,.474,257,376,633,114,51,165,107,247,710
20768,SAS,2004,Manu Ginóbili,26,77,38,2260,330,789,.418,88,245,.359,242,544,.445,.474,239,298,.802,86,258,344,291,136,16,161,181,987
20769,SAS,2004,Hedo Türkoğlu,24,80,44,2073,262,645,.406,101,241,.419,161,404,.399,.484,114,161,.708,52,306,358,154,80,32,94,165,739
20770,SAS,2004,Robert Horry,33,81,1,1290,141,348,.405,41,108,.380,100,240,.417,.464,69,107,.645,108,164,272,101,48,49,55,165,392
20771,SAS,2004,Malik Rose,29,67,13,1256,173,404,.428,0,3,.000,173,401,.431,.428,183,225,.813,110,210,320,69,36,24,112,164,529
20772,SAS,2004,Jason Hart,25,53,5,660,71,159,.447,2,9,.222,69,150,.460,.453,33,43,.767,10,69,79,81,28,5,29,59,177
20773,SAS,2004,Devin Brown,25,58,0,627,85,196,.434,4,14,.286,81,182,.445,.444,60,74,.811,38,92,130,33,15,4,38,61,234
20774,SAS,2004,Ron Mercer,27,39,0,516,90,211,.427,2,7,.286,88,204,.431,.431,13,17,.765,10,39,49,22,14,5,26,37,195
20775,SAS,2004,Charlie Ward,33,36,0,425,45,130,.346,25,68,.368,20,62,.323,.442,4,6,.667,2,46,48,45,17,3,27,33,119
20776,SAS,2004,Kevin Willis,41,48,0,373,70,150,.467,0,1,.000,70,149,.470,.467,24,39,.615,37,61,98,11,21,9,32,61,164
20777,SAS,2004,Anthony Carter,28,5,2,87,11,37,.297,0,3,.000,11,34,.324,.297,0,0,,2,9,11,12,4,0,12,9,22
20778,SAS,2004,Shane Heal,33,6,0,72,7,24,.292,4,18,.222,3,6,.500,.375,4,5,.800,1,3,4,5,1,0,5,2,22
20779,SAS,2004,Matt Carroll,23,3,0,22,2,5,.400,0,0,,2,5,.400,.400,2,4,.500,1,2,3,1,1,0,4,5,6
20780,SAS,2004,Alex Garcia,23,2,0,13,1,7,.143,0,0,,1,7,.143,.143,1,2,.500,0,0,0,0,2,0,1,0,3
20781,SAS,2003,Tim Duncan,26,81,81,3181,714,1392,.513,6,22,.273,708,1370,.517,.515,450,634,.710,259,784,1043,316,55,237,248,231,1884
20782,SAS,2003,Tony Parker,20,82,82,2774,484,1043,.464,82,243,.337,402,800,.503,.503,219,290,.755,33,183,216,432,71,4,198,174,1269
20783,SAS,2003,Bruce Bowen,31,82,82,2566,223,479,.466,101,229,.441,122,250,.488,.571,36,89,.404,59,180,239,113,66,42,72,195,583
20784,SAS,2003,Stephen Jackson,24,80,58,2254,356,818,.435,95,297,.320,261,521,.501,.493,139,183,.760,66,220,286,183,125,30,176,202,946
20785,SAS,2003,Malik Rose,28,79,13,1933,289,630,.459,2,5,.400,287,625,.459,.460,242,306,.791,148,358,506,124,57,40,170,206,822
20786,SAS,2003,David Robinson,37,64,64,1676,197,420,.469,0,0,,197,420,.469,.469,152,214,.710,163,345,508,61,52,111,83,126,546
20787,SAS,2003,Manu Ginóbili,25,69,5,1431,174,397,.438,51,148,.345,123,249,.494,.503,126,171,.737,47,114,161,138,96,17,100,170,525
20788,SAS,2003,Steve Smith,33,53,18,1032,113,291,.388,39,118,.331,74,173,.428,.455,95,114,.833,21,78,99,70,28,9,43,79,360
20789,SAS,2003,Steve Kerr,37,75,0,952,110,256,.430,49,124,.395,61,132,.462,.525,30,34,.882,12,48,60,70,27,3,35,49,299
20790,SAS,2003,Kevin Willis,40,71,6,840,123,257,.479,0,2,.000,123,255,.482,.479,51,83,.614,83,143,226,24,20,20,60,120,297
20791,SAS,2003,Danny Ferry,36,64,1,601,44,124,.355,21,60,.350,23,64,.359,.440,10,13,.769,20,55,75,21,7,9,27,55,119
20792,SAS,2003,Speedy Claxton,24,30,0,471,67,145,.462,0,11,.000,67,134,.500,.462,39,57,.684,22,34,56,75,22,7,35,43,173
20793,SAS,2003,Anthony Goldwire,31,10,0,51,5,18,.278,2,8,.250,3,10,.300,.333,0,2,.000,0,3,3,3,3,0,2,5,12
20794,SAS,2003,Mengke Bateer,27,12,0,46,4,17,.235,1,3,.333,3,14,.214,.265,0,2,.000,2,8,10,4,0,0,6,14,9
20795,SAS,2003,Devin Brown,24,7,0,22,5,10,.500,0,0,,5,10,.500,.500,2,2,1.000,4,3,7,2,0,0,5,3,12
20796,SAS,2002,Tim Duncan,25,82,82,3329,764,1504,.508,1,10,.100,763,1494,.511,.508,560,701,.799,268,774,1042,307,61,203,263,217,2089
20797,SAS,2002,David Robinson,36,78,78,2303,341,672,.507,0,0,,341,672,.507,.507,269,395,.681,191,456,647,94,86,140,104,193,951
20798,SAS,2002,Tony Parker,19,77,72,2267,268,639,.419,61,189,.323,207,450,.460,.467,108,160,.675,33,164,197,334,89,7,151,166,705
20799,SAS,2002,Steve Smith,32,77,76,2211,310,682,.455,116,246,.472,194,436,.445,.540,159,181,.878,45,148,193,151,54,15,108,158,895
20800,SAS,2002,Antonio Daniels,26,82,13,2175,269,612,.440,57,196,.291,212,416,.510,.486,158,210,.752,23,153,176,228,48,12,70,104,753
20801,SAS,2002,Malik Rose,27,82,1,1725,293,633,.463,1,12,.083,292,621,.470,.464,185,257,.720,172,320,492,61,70,42,140,208,772
20802,SAS,2002,Bruce Bowen,30,59,59,1699,155,398,.389,56,148,.378,99,250,.396,.460,46,96,.479,42,120,162,88,62,25,66,116,412
20803,SAS,2002,Terry Porter,38,72,0,1294,136,321,.424,59,142,.415,77,179,.430,.516,68,83,.819,12,152,164,205,45,16,85,89,399
20804,SAS,2002,Charles Smith,26,60,22,1141,182,428,.425,35,131,.267,147,297,.495,.466,42,65,.646,34,99,133,80,52,44,59,114,441
20805,SAS,2002,Danny Ferry,35,50,2,799,76,177,.429,43,99,.434,33,78,.423,.551,34,36,.944,15,75,90,48,16,9,22,70,229
20806,SAS,2002,Cherokee Parks,29,42,1,234,30,83,.361,0,0,,30,83,.361,.361,3,8,.375,24,34,58,10,7,8,14,34,63
20807,SAS,2002,Stephen Jackson,23,23,1,227,34,91,.374,9,36,.250,25,55,.455,.423,12,17,.706,3,23,26,11,15,3,23,29,89
20808,SAS,2002,Mark Bryant,36,30,3,206,25,55,.455,0,0,,25,55,.455,.455,6,8,.750,25,19,44,10,7,2,6,38,56
20809,SAS,2002,Amal McCaskill,28,27,0,153,20,49,.408,0,0,,20,49,.408,.408,12,26,.462,16,20,36,4,6,10,14,23,52
20810,SAS,2002,Jason Hart,23,10,0,92,10,19,.526,0,2,.000,10,17,.588,.526,6,6,1.000,4,9,13,12,7,1,8,16,26
20811,SAS,2001,Tim Duncan,24,82,82,3174,702,1406,.499,7,27,.259,695,1379,.504,.502,409,662,.618,259,738,997,245,70,192,242,247,1820
20812,SAS,2001,Derek Anderson,26,82,82,2859,413,993,.416,101,253,.399,312,740,.422,.467,342,402,.851,75,288,363,301,120,14,165,188,1269
20813,SAS,2001,David Robinson,35,80,80,2371,400,823,.486,0,1,.000,400,822,.487,.486,351,470,.747,208,483,691,116,80,197,122,212,1151
20814,SAS,2001,Antonio Daniels,25,79,23,2060,275,588,.468,74,183,.404,201,405,.496,.531,121,156,.776,26,137,163,304,61,14,109,120,745
20815,SAS,2001,Danny Ferry,34,80,29,1688,178,375,.475,70,156,.449,108,219,.493,.568,22,30,.733,55,168,223,71,28,21,50,169,448
20816,SAS,2001,Terry Porter,37,80,42,1678,197,440,.448,87,205,.424,110,235,.468,.547,92,116,.793,24,177,201,251,52,11,104,88,573
20817,SAS,2001,Avery Johnson,35,55,20,1290,134,300,.447,1,6,.167,133,294,.452,.448,41,60,.683,21,64,85,237,33,4,60,90,310
20818,SAS,2001,Sean Elliott,32,52,34,1229,147,339,.434,55,129,.426,92,210,.438,.515,60,84,.714,17,153,170,81,23,25,51,80,409
20819,SAS,2001,Malik Rose,26,57,9,1219,160,368,.435,3,17,.176,157,351,.447,.439,114,160,.713,95,213,308,48,59,40,74,148,437
20820,SAS,2001,Samaki Walker,24,61,1,963,121,252,.480,1,3,.333,120,249,.482,.482,78,124,.629,67,176,243,29,10,41,68,103,321
20821,SAS,2001,Steve Kerr,35,55,1,650,67,159,.421,33,77,.429,34,82,.415,.525,14,15,.933,6,29,35,57,16,1,21,30,181
20822,SAS,2001,Derrick Dial,25,33,0,207,36,83,.434,2,10,.200,34,73,.466,.446,12,21,.571,12,26,38,21,4,6,12,22,86
20823,SAS,2001,Ira Newble,26,27,6,184,21,55,.382,4,9,.444,17,46,.370,.418,8,16,.500,13,22,35,6,2,4,7,18,54
20824,SAS,2001,Shawnelle Scott,28,27,1,144,17,41,.415,0,0,,17,41,.415,.415,9,22,.409,23,27,50,4,5,6,11,23,43
20825,SAS,2001,Jaren Jackson,33,16,0,114,16,40,.400,7,18,.389,9,22,.409,.488,0,2,.000,1,11,12,7,5,0,3,13,39
20826,SAS,2000,Tim Duncan,23,74,74,2875,628,1281,.490,1,11,.091,627,1270,.494,.491,459,603,.761,262,656,918,234,66,165,242,210,1716
20827,SAS,2000,Avery Johnson,34,82,82,2571,402,850,.473,1,9,.111,401,841,.477,.474,114,155,.735,33,125,158,491,76,18,140,150,919
20828,SAS,2000,David Robinson,34,80,80,2557,528,1031,.512,0,2,.000,528,1029,.513,.512,371,511,.726,193,577,770,142,97,183,164,247,1427
20829,SAS,2000,Mario Elie,36,79,79,2217,195,457,.427,74,186,.398,121,271,.446,.508,126,149,.846,48,201,249,193,73,9,130,156,590
20830,SAS,2000,Jaren Jackson,32,81,12,1691,186,488,.381,108,306,.353,78,182,.429,.492,33,51,.647,34,147,181,118,54,7,66,157,513
20831,SAS,2000,Terry Porter,36,68,8,1613,207,463,.447,90,207,.435,117,256,.457,.544,137,170,.806,24,167,191,221,50,9,100,79,641
20832,SAS,2000,Malik Rose,25,74,3,1341,176,385,.457,1,3,.333,175,382,.458,.458,143,198,.722,133,202,335,47,35,52,99,232,496
20833,SAS,2000,Jerome Kersey,37,72,18,1310,146,354,.412,0,9,.000,146,345,.423,.412,29,41,.707,58,167,225,69,67,47,51,161,321
20834,SAS,2000,Antonio Daniels,24,68,1,1195,163,344,.474,22,66,.333,141,278,.507,.506,72,101,.713,16,70,86,177,55,5,58,73,420
20835,SAS,2000,Samaki Walker,23,71,7,980,137,305,.449,0,0,,137,305,.449,.449,86,126,.683,77,195,272,38,10,35,64,108,360
20836,SAS,2000,Chucky Brown,31,30,27,602,82,176,.466,1,3,.333,81,173,.468,.469,25,31,.806,11,66,77,41,8,10,28,53,190
20837,SAS,2000,Sean Elliott,31,19,19,391,38,106,.358,13,37,.351,25,69,.362,.420,25,32,.781,6,41,47,28,12,2,19,34,114
20838,SAS,2000,Steve Kerr,34,32,0,268,32,74,.432,16,31,.516,16,43,.372,.541,9,11,.818,3,16,19,12,4,0,7,14,89
20839,SAS,2000,Felton Spencer,32,26,0,149,15,33,.455,0,0,,15,33,.455,.455,20,30,.667,15,24,39,3,6,8,9,32,50
20840,SAS,2000,Derrick Dial,24,8,0,95,17,46,.370,3,12,.250,14,34,.412,.402,3,5,.600,14,12,26,5,1,1,6,10,40
20841,SAS,1999,Tim Duncan,22,50,50,1963,418,845,.495,1,7,.143,417,838,.498,.495,247,358,.690,159,412,571,121,45,126,146,147,1084
20842,SAS,1999,Avery Johnson,33,50,50,1672,218,461,.473,1,12,.083,217,449,.483,.474,50,88,.568,22,96,118,369,51,11,112,101,487
20843,SAS,1999,David Robinson,33,49,49,1554,268,527,.509,0,1,.000,268,526,.510,.509,239,363,.658,148,344,492,103,69,119,108,143,775
20844,SAS,1999,Sean Elliott,30,50,50,1509,208,507,.410,39,119,.328,169,388,.436,.449,106,140,.757,35,178,213,117,26,17,71,104,561
20845,SAS,1999,Mario Elie,35,47,37,1291,156,331,.471,40,107,.374,116,224,.518,.532,103,119,.866,36,101,137,89,46,12,61,91,455
20846,SAS,1999,Jaren Jackson,31,47,13,861,108,284,.380,53,147,.361,55,137,.401,.474,32,39,.821,21,78,99,49,41,9,37,63,301
20847,SAS,1999,Steve Kerr,33,44,0,734,68,174,.391,25,80,.313,43,94,.457,.463,31,35,.886,6,38,44,49,23,3,22,28,192
20848,SAS,1999,Jerome Kersey,36,45,0,699,68,200,.340,3,14,.214,65,186,.349,.348,6,14,.429,42,88,130,41,37,14,30,92,145
20849,SAS,1999,Antonio Daniels,23,47,0,614,83,183,.454,5,17,.294,78,166,.470,.467,49,65,.754,13,41,54,106,30,6,44,39,220
20850,SAS,1999,Malik Rose,24,47,0,608,93,201,.463,0,1,.000,93,200,.465,.463,98,146,.671,90,92,182,29,40,22,56,120,284
20851,SAS,1999,Will Perdue,33,37,1,445,38,60,.633,0,0,,38,60,.633,.633,14,26,.538,33,105,138,18,9,10,22,63,90
20852,SAS,1999,Gerard King,26,19,0,63,6,14,.429,0,0,,6,14,.429,.429,11,18,.611,6,8,14,4,2,1,4,12,23
20853,SAS,1999,Andrew Gaze,33,19,0,58,8,25,.320,5,16,.313,3,9,.333,.420,0,0,,2,3,5,6,2,1,4,7,21
20854,SAS,1999,Brandon Williams,23,3,0,4,0,0,,0,0,,0,0,,,2,4,.500,1,0,1,0,0,0,0,0,2
20855,SAS,1998,Tim Duncan,21,82,82,3204,706,1287,.549,0,10,.000,706,1277,.553,.549,319,482,.662,274,703,977,224,55,206,279,254,1731
20856,SAS,1998,Avery Johnson,32,75,73,2674,321,671,.478,2,13,.154,319,658,.485,.480,122,168,.726,30,120,150,591,84,18,165,140,766
20857,SAS,1998,David Robinson,32,73,73,2457,544,1065,.511,1,4,.250,543,1061,.512,.511,485,660,.735,239,536,775,199,64,192,202,204,1574
20858,SAS,1998,Jaren Jackson,30,82,45,2226,258,654,.394,112,297,.377,146,357,.409,.480,94,118,.797,55,155,210,156,60,8,104,222,722
20859,SAS,1998,Vinny Del Negro,31,54,38,1721,211,479,.441,17,39,.436,194,440,.441,.458,74,93,.796,13,139,152,183,39,6,53,113,513
20860,SAS,1998,Will Perdue,32,79,30,1491,162,295,.549,0,1,.000,162,294,.551,.549,70,133,.526,177,358,535,57,22,50,81,137,394
20861,SAS,1998,Chuck Person,33,61,11,1455,143,398,.359,95,276,.344,48,122,.393,.479,28,37,.757,17,187,204,86,29,10,67,121,409
20862,SAS,1998,Monty Williams,26,72,16,1314,165,368,.448,1,2,.500,164,366,.448,.450,122,182,.670,67,112,179,89,34,24,82,133,453
20863,SAS,1998,Sean Elliott,29,36,36,1012,122,303,.403,34,90,.378,88,213,.413,.459,56,78,.718,16,108,124,62,24,14,57,92,334
20864,SAS,1998,Reggie Geary,24,62,2,685,56,169,.331,12,40,.300,44,129,.341,.367,28,56,.500,19,48,67,74,37,12,42,95,152
20865,SAS,1998,Carl Herrera,31,58,1,516,76,175,.434,0,1,.000,76,174,.437,.434,18,44,.409,24,67,91,22,19,12,38,71,170
20866,SAS,1998,Cory Alexander,24,37,3,501,60,145,.414,20,64,.313,40,81,.494,.483,25,37,.676,7,40,47,71,25,5,47,53,165
20867,SAS,1998,Malik Rose,23,53,0,429,59,136,.434,1,3,.333,58,133,.436,.438,39,61,.639,40,50,90,19,21,7,44,79,158
20868,SAS,1998,Brad Lohaus,33,9,0,102,7,21,.333,4,14,.286,3,7,.429,.429,1,3,.333,3,9,12,5,1,2,3,10,19
20869,SAS,1998,Willie Burton,29,13,0,43,8,21,.381,3,9,.333,5,12,.417,.452,8,12,.667,3,6,9,1,2,2,1,7,27
20870,SAS,1997,Avery Johnson,31,76,76,2472,327,685,.477,6,26,.231,321,659,.487,.482,140,203,.690,32,115,147,513,96,15,146,158,800
20871,SAS,1997,Vinny Del Negro,30,72,53,2243,365,781,.467,44,140,.314,321,641,.501,.496,112,129,.868,39,171,210,231,59,7,92,131,886
20872,SAS,1997,Vernon Maxwell,31,72,31,2068,340,906,.375,115,372,.309,225,534,.421,.439,134,180,.744,27,132,159,153,87,19,121,168,929
20873,SAS,1997,Dominique Wilkins,37,63,26,1945,397,953,.417,70,239,.293,327,714,.458,.453,281,350,.803,169,233,402,119,39,31,135,100,1145
20874,SAS,1997,Will Perdue,31,65,34,1918,233,410,.568,0,0,,233,410,.568,.568,99,171,.579,251,387,638,38,32,102,87,184,565
20875,SAS,1997,Carl Herrera,30,75,58,1837,257,593,.433,2,6,.333,255,587,.434,.435,81,118,.686,118,222,340,50,62,53,95,217,597
20876,SAS,1997,Greg Anderson,32,82,48,1659,130,262,.496,0,1,.000,130,261,.498,.496,62,93,.667,157,291,448,34,63,67,73,225,322
20877,SAS,1997,Cory Alexander,23,80,6,1454,194,490,.396,94,252,.373,100,238,.420,.492,95,129,.736,29,94,123,254,82,16,146,148,577
20878,SAS,1997,Sean Elliott,28,39,39,1393,196,464,.422,42,126,.333,154,338,.456,.468,148,196,.755,48,142,190,124,24,24,89,105,582
20879,SAS,1997,Monty Williams,25,65,26,1345,234,460,.509,0,1,.000,234,459,.510,.509,120,186,.645,98,108,206,91,55,52,116,161,588
20880,SAS,1997,Jamie Feick,22,38,0,614,54,153,.353,4,13,.308,50,140,.357,.366,34,65,.523,81,130,211,26,16,13,31,75,146
20881,SAS,1997,Charles Smith,31,19,7,329,34,84,.405,0,1,.000,34,83,.410,.405,20,26,.769,18,47,65,14,13,22,22,44,88
20882,SAS,1997,David Robinson,31,6,6,147,36,72,.500,0,0,,36,72,.500,.500,34,52,.654,19,32,51,8,6,6,8,9,106
20883,SAS,1997,Stephen Howard,26,7,0,69,7,12,.583,0,0,,7,12,.583,.583,12,14,.857,4,5,9,1,8,2,5,7,26
20884,SAS,1997,Jason Sasser,23,6,0,62,8,19,.421,1,2,.500,7,17,.412,.447,0,0,,0,7,7,1,2,0,2,11,17
20885,SAS,1997,Tim Kempton,33,10,0,59,1,5,.200,0,0,,1,5,.200,.200,2,2,1.000,3,5,8,2,1,1,7,4,4
20886,SAS,1997,Joe Courtney,27,5,0,48,5,16,.313,0,0,,5,16,.313,.313,3,5,.600,4,3,7,0,0,0,2,6,13
20887,SAS,1997,Gaylon Nickerson,27,3,0,36,3,9,.333,0,1,.000,3,8,.375,.333,7,7,1.000,1,3,4,1,0,1,0,1,13
20888,SAS,1997,Devin Gray,24,3,0,24,5,15,.333,0,0,,5,15,.333,.333,0,1,.000,3,2,5,0,1,0,5,8,10
20889,SAS,1997,Darrin Hancock,25,1,0,8,1,2,.500,0,0,,1,2,.500,.500,2,2,1.000,0,0,0,1,0,0,0,2,4
20890,SAS,1996,Avery Johnson,30,82,82,3084,438,887,.494,6,31,.194,432,856,.505,.497,189,262,.721,37,169,206,789,119,21,195,179,1071
20891,SAS,1996,David Robinson,30,82,82,3019,711,1378,.516,3,9,.333,708,1369,.517,.517,626,823,.761,319,681,1000,247,111,271,190,262,2051
20892,SAS,1996,Sean Elliott,27,77,77,2901,525,1127,.466,161,392,.411,364,735,.495,.537,326,423,.771,69,327,396,211,69,33,198,178,1537
20893,SAS,1996,Vinny Del Negro,29,82,82,2766,478,962,.497,57,150,.380,421,812,.518,.527,178,214,.832,36,236,272,315,85,6,100,166,1191
20894,SAS,1996,Chuck Person,31,80,16,2131,308,705,.437,190,463,.410,118,242,.488,.572,67,104,.644,76,337,413,100,49,26,91,197,873
20895,SAS,1996,Will Perdue,30,80,22,1396,173,331,.523,0,1,.000,173,330,.524,.523,67,125,.536,175,310,485,33,28,75,86,183,413
20896,SAS,1996,Doc Rivers,34,78,0,1235,108,290,.372,47,137,.343,61,153,.399,.453,48,64,.750,30,108,138,123,73,21,57,175,311
20897,SAS,1996,Charles Smith,30,32,30,826,130,284,.458,0,0,,130,284,.458,.458,46,60,.767,74,128,202,36,32,29,45,100,306
20898,SAS,1996,J.R. Reid,27,32,5,643,72,164,.439,0,1,.000,72,163,.442,.439,64,87,.736,35,88,123,14,25,10,49,98,208
20899,SAS,1996,Cory Alexander,22,60,0,560,63,155,.406,26,66,.394,37,89,.416,.490,16,25,.640,9,33,42,121,27,2,68,94,168
20900,SAS,1996,Carl Herrera,29,44,6,393,40,97,.412,0,1,.000,40,96,.417,.412,5,17,.294,30,51,81,16,9,8,29,61,85
20901,SAS,1996,Greg Anderson,31,46,7,344,24,47,.511,0,1,.000,24,46,.522,.511,6,25,.240,29,71,100,10,9,24,22,66,54
20902,SAS,1996,Brad Lohaus,31,32,1,273,39,96,.406,27,65,.415,12,31,.387,.547,2,3,.667,5,28,33,17,2,7,9,34,107
20903,SAS,1996,Monty Williams,24,17,0,122,20,46,.435,0,1,.000,20,45,.444,.435,9,12,.750,11,12,23,4,4,2,13,17,49
20904,SAS,1996,Dell Demps,25,16,0,87,19,33,.576,1,2,.500,18,31,.581,.591,14,17,.824,2,7,9,8,3,1,12,10,53
20905,SAS,1995,David Robinson,29,81,81,3074,788,1487,.530,6,20,.300,782,1467,.533,.532,656,847,.774,234,643,877,236,134,262,233,230,2238
20906,SAS,1995,Avery Johnson,29,82,82,3011,448,863,.519,3,22,.136,445,841,.529,.521,202,295,.685,49,159,208,670,114,13,207,154,1101
20907,SAS,1995,Sean Elliott,26,81,81,2858,502,1072,.468,136,333,.408,366,739,.495,.532,326,404,.807,63,224,287,206,78,38,151,216,1466
20908,SAS,1995,Vinny Del Negro,28,75,71,2360,372,766,.486,66,162,.407,306,604,.507,.529,128,162,.790,28,164,192,226,61,14,56,179,938
20909,SAS,1995,Chuck Person,30,81,1,2033,317,750,.423,172,445,.387,145,305,.475,.537,66,102,.647,49,209,258,106,45,12,102,198,872
20910,SAS,1995,Dennis Rodman,33,49,26,1568,137,240,.571,0,2,.000,137,238,.576,.571,75,111,.676,274,549,823,97,31,23,98,159,349
20911,SAS,1995,J.R. Reid,26,81,37,1566,201,396,.508,1,2,.500,200,394,.508,.509,160,233,.687,120,273,393,55,60,32,113,230,563
20912,SAS,1995,Terry Cummings,33,76,20,1273,224,464,.483,0,0,,224,464,.483,.483,72,123,.585,138,240,378,59,36,19,95,188,520
20913,SAS,1995,Doc Rivers,33,60,0,942,104,289,.360,42,122,.344,62,167,.371,.433,52,71,.732,13,87,100,154,61,21,56,142,302
20914,SAS,1995,Willie Anderson,28,38,11,556,76,162,.469,3,19,.158,73,143,.510,.478,30,41,.732,15,40,55,52,26,10,38,71,185
20915,SAS,1995,Chris Whitney,23,25,0,179,14,47,.298,3,19,.158,11,28,.393,.330,11,11,1.000,4,9,13,28,4,0,18,34,42
20916,SAS,1995,Moses Malone,39,17,0,149,13,35,.371,1,2,.500,12,33,.364,.386,22,32,.688,20,26,46,6,2,3,11,15,49
20917,SAS,1995,Jack Haley,31,31,0,117,26,61,.426,0,1,.000,26,60,.433,.426,21,32,.656,8,19,27,2,3,5,13,31,73
20918,SAS,1995,Julius Nwosu,23,23,0,84,9,28,.321,0,0,,9,28,.321,.321,13,17,.765,11,13,24,3,0,3,9,20,31
20919,SAS,1995,Howard Eisley,22,15,0,56,3,17,.176,1,5,.200,2,12,.167,.206,0,0,,2,4,6,18,0,1,8,3,7
20920,SAS,1995,Corey Crowder,25,7,0,29,2,10,.200,0,4,.000,2,6,.333,.200,2,6,.333,1,2,3,1,1,0,2,1,6
20921,SAS,1994,David Robinson,28,80,80,3241,840,1658,.507,10,29,.345,830,1629,.510,.510,693,925,.749,241,614,855,381,139,265,253,228,2383
20922,SAS,1994,Dennis Rodman,32,79,51,2989,156,292,.534,5,24,.208,151,268,.563,.543,53,102,.520,453,914,1367,184,52,32,138,229,370
20923,SAS,1994,Dale Ellis,33,77,75,2590,478,967,.494,131,332,.395,347,635,.546,.562,83,107,.776,70,185,255,80,66,11,75,141,1170
20924,SAS,1994,Willie Anderson,27,80,79,2488,394,837,.471,22,68,.324,372,769,.484,.484,145,171,.848,68,174,242,347,71,46,153,187,955
20925,SAS,1994,Vinny Del Negro,27,77,56,1949,309,634,.487,15,43,.349,294,591,.497,.499,140,170,.824,27,134,161,320,64,1,102,168,773
20926,SAS,1994,Negele Knight,26,64,18,1430,224,471,.476,4,21,.190,220,450,.489,.480,141,174,.810,28,75,103,197,34,10,94,120,593
20927,SAS,1994,J.R. Reid,25,70,11,1344,260,530,.491,0,3,.000,260,527,.493,.491,107,153,.699,91,129,220,73,43,25,84,165,627
20928,SAS,1994,Terry Cummings,32,59,29,1133,183,428,.428,0,2,.000,183,426,.430,.428,63,107,.589,132,165,297,50,31,13,59,137,429
20929,SAS,1994,Lloyd Daniels,26,65,5,980,140,372,.376,44,125,.352,96,247,.389,.435,46,64,.719,45,66,111,94,29,16,60,69,370
20930,SAS,1994,Sleepy Floyd,33,53,2,737,70,209,.335,8,36,.222,62,173,.358,.354,52,78,.667,10,60,70,101,12,8,61,71,200
20931,SAS,1994,Antoine Carr,32,34,0,465,78,160,.488,0,1,.000,78,159,.491,.488,42,58,.724,12,39,51,15,9,22,15,75,198
20932,SAS,1994,Chris Whitney,22,40,4,339,25,82,.305,10,30,.333,15,52,.288,.366,12,15,.800,5,24,29,53,11,1,37,53,72
20933,SAS,1994,Jack Haley,30,28,0,94,21,48,.438,0,0,,21,48,.438,.438,17,21,.810,6,18,24,1,0,0,10,18,59
20934,SAS,1994,Chuck Nevitt,34,1,0,1,0,0,,0,0,,0,0,,,3,6,.500,1,0,1,0,0,0,1,1,3
20935,SAS,1993,David Robinson,27,82,82,3211,676,1348,.501,3,17,.176,673,1331,.506,.503,561,766,.732,229,727,956,301,127,264,241,239,1916
20936,SAS,1993,Dale Ellis,32,82,76,2731,545,1092,.499,119,297,.401,426,795,.536,.554,157,197,.797,81,231,312,107,78,18,111,179,1366
20937,SAS,1993,Sean Elliott,24,70,70,2604,451,918,.491,37,104,.356,414,814,.509,.511,268,337,.795,85,237,322,265,68,28,152,132,1207
20938,SAS,1993,Avery Johnson,27,75,49,2030,256,510,.502,0,8,.000,256,502,.510,.502,144,182,.791,20,126,146,561,85,16,145,141,656
20939,SAS,1993,Antoine Carr,31,71,46,1947,379,705,.538,0,5,.000,379,700,.541,.538,174,224,.777,107,281,388,97,35,87,96,264,932
20940,SAS,1993,J.R. Reid,24,66,24,1592,241,497,.485,0,4,.000,241,493,.489,.485,171,222,.770,100,286,386,56,36,26,101,217,653
20941,SAS,1993,Lloyd Daniels,25,77,10,1573,285,644,.443,59,177,.333,226,467,.484,.488,72,99,.727,86,130,216,148,38,30,102,144,701
20942,SAS,1993,Vinny Del Negro,26,73,31,1526,218,430,.507,6,24,.250,212,406,.522,.514,101,117,.863,19,144,163,291,44,1,92,146,543
20943,SAS,1993,Larry Smith,35,66,13,833,38,87,.437,0,0,,38,87,.437,.437,9,22,.409,103,165,268,28,23,16,39,133,85
20944,SAS,1993,David Wood,28,64,2,598,52,117,.444,5,21,.238,47,96,.490,.466,46,55,.836,38,59,97,34,13,12,29,93,155
20945,SAS,1993,Willie Anderson,26,38,7,560,80,186,.430,1,8,.125,79,178,.444,.433,22,28,.786,7,50,57,79,14,6,44,52,183
20946,SAS,1993,Sam Mack,22,40,0,267,47,118,.398,3,22,.136,44,96,.458,.411,45,58,.776,18,30,48,15,14,5,22,44,142
20947,SAS,1993,Sidney Green,32,15,0,202,20,49,.408,0,0,,20,49,.408,.408,13,15,.867,18,53,71,19,5,3,12,21,53
20948,SAS,1993,Terry Cummings,31,8,0,76,11,29,.379,0,0,,11,29,.379,.379,5,10,.500,6,13,19,4,1,1,2,17,27
20949,SAS,1993,William Bedford,29,16,0,66,9,27,.333,1,1,1.000,8,26,.308,.352,6,12,.500,1,9,10,0,0,1,1,15,25
20950,SAS,1993,Matt Othick,23,4,0,39,3,5,.600,2,4,.500,1,1,1.000,.800,0,2,.000,1,1,2,7,1,0,4,7,8
20951,SAS,1992,Sean Elliott,23,82,82,3120,514,1040,.494,25,82,.305,489,958,.510,.506,285,331,.861,143,296,439,214,84,29,152,149,1338
20952,SAS,1992,David Robinson,26,68,68,2564,592,1074,.551,1,8,.125,591,1066,.554,.552,393,561,.701,261,568,829,181,158,305,182,219,1578
20953,SAS,1992,Terry Cummings,30,70,67,2149,514,1053,.488,5,13,.385,509,1040,.489,.491,177,249,.711,247,384,631,102,58,34,115,210,1210
20954,SAS,1992,Rod Strickland,25,57,54,2053,300,659,.455,5,15,.333,295,644,.458,.459,182,265,.687,92,173,265,491,118,17,160,122,787
20955,SAS,1992,Willie Anderson,25,57,55,1889,312,685,.455,13,56,.232,299,629,.475,.465,107,138,.775,62,238,300,302,54,51,140,151,744
20956,SAS,1992,Antoine Carr,30,81,27,1867,359,732,.490,1,5,.200,358,727,.492,.491,162,212,.764,128,218,346,63,32,96,114,264,881
20957,SAS,1992,Vinnie Johnson,35,60,23,1350,202,499,.405,19,60,.317,183,439,.417,.424,55,85,.647,67,115,182,145,41,14,74,93,478
20958,SAS,1992,Sidney Green,31,80,1,1127,147,344,.427,0,0,,147,344,.427,.427,73,89,.820,92,250,342,36,29,11,62,148,367
20959,SAS,1992,Paul Pressey,33,56,7,759,60,161,.373,3,21,.143,57,140,.407,.382,28,41,.683,22,73,95,142,29,19,64,86,151
20960,SAS,1992,Donald Royal,25,60,4,718,80,178,.449,0,0,,80,178,.449,.449,92,133,.692,65,59,124,34,25,7,39,73,252
20961,SAS,1992,Greg Sutton,24,67,2,601,93,240,.388,26,89,.292,67,151,.444,.442,34,45,.756,6,41,47,91,26,9,70,111,246
20962,SAS,1992,Avery Johnson,26,20,14,463,55,108,.509,1,5,.200,54,103,.524,.514,24,32,.750,5,30,35,100,21,3,45,43,135
20963,SAS,1992,Trent Tucker,32,24,0,415,60,129,.465,19,48,.396,41,81,.506,.539,16,20,.800,8,29,37,27,21,3,14,39,155
20964,SAS,1992,Tom Garrick,25,19,5,374,44,93,.473,0,1,.000,44,92,.478,.473,10,16,.625,8,33,41,63,21,1,30,33,98
20965,SAS,1992,Jud Buechler,23,11,0,140,15,30,.500,0,0,,15,30,.500,.500,3,9,.333,6,16,22,11,8,3,5,18,33
20966,SAS,1992,Tom Copa,27,33,1,132,22,40,.550,0,0,,22,40,.550,.550,4,13,.308,14,22,36,3,2,6,8,29,48
20967,SAS,1992,Sean Higgins,23,6,0,36,4,15,.267,0,1,.000,4,14,.286,.267,7,7,1.000,2,6,8,4,2,0,4,6,15
20968,SAS,1992,Morlon Wiley,25,3,0,13,3,5,.600,0,0,,3,5,.600,.600,0,0,,0,1,1,1,0,0,0,3,6
20969,SAS,1992,Tony Massenburg,24,1,0,9,1,5,.200,0,0,,1,5,.200,.200,0,0,,0,0,0,0,0,0,0,2,2
20970,SAS,1992,Steve Bardo,23,1,0,1,0,0,,0,0,,0,0,,,0,0,,1,0,1,0,0,0,0,0,0
20971,SAS,1991,David Robinson,25,82,81,3095,754,1366,.552,1,7,.143,753,1359,.554,.552,592,777,.762,335,728,1063,208,127,320,270,264,2101
20972,SAS,1991,Sean Elliott,22,82,82,3044,478,976,.490,20,64,.313,458,912,.502,.500,325,402,.808,142,314,456,238,69,33,147,190,1301
20973,SAS,1991,Willie Anderson,24,75,75,2592,453,991,.457,7,35,.200,446,956,.467,.461,170,213,.798,68,283,351,358,79,46,167,226,1083
20974,SAS,1991,Terry Cummings,29,67,62,2195,503,1039,.484,7,33,.212,496,1006,.493,.487,164,240,.683,194,327,521,157,61,30,131,225,1177
20975,SAS,1991,Rod Strickland,24,58,56,2076,314,651,.482,11,33,.333,303,618,.490,.491,161,211,.763,57,162,219,463,117,11,156,125,800
20976,SAS,1991,Paul Pressey,32,70,18,1683,201,426,.472,16,57,.281,185,369,.501,.491,110,133,.827,50,126,176,271,63,32,130,174,528
20977,SAS,1991,Sidney Green,30,66,7,1099,177,384,.461,0,3,.000,177,381,.465,.461,89,105,.848,98,215,313,52,32,13,89,172,443
20978,SAS,1991,Dave Greenwood,33,63,11,1018,85,169,.503,0,2,.000,85,167,.509,.503,69,94,.734,61,160,221,52,29,25,71,172,239
20979,SAS,1991,Avery Johnson,25,47,10,742,101,209,.483,1,5,.200,100,204,.490,.486,38,55,.691,13,43,56,153,33,2,47,40,241
20980,SAS,1991,David Wingate,27,25,0,563,53,138,.384,1,9,.111,52,129,.403,.388,29,41,.707,24,51,75,46,19,5,42,66,136
20981,SAS,1991,Sean Higgins,22,50,0,464,97,212,.458,3,19,.158,94,193,.487,.465,28,33,.848,18,45,63,35,8,1,49,53,225
20982,SAS,1991,Dwayne Schintzius,22,42,7,398,68,155,.439,0,2,.000,68,153,.444,.439,22,40,.550,28,93,121,17,2,29,34,64,158
20983,SAS,1991,Reggie Williams,26,22,0,354,61,127,.480,14,26,.538,47,101,.465,.535,35,41,.854,17,42,59,46,20,11,36,64,171
20984,SAS,1991,Tony Massenburg,23,35,0,161,27,60,.450,0,0,,27,60,.450,.450,28,45,.622,23,35,58,4,4,9,13,26,82
20985,SAS,1991,Byron Dinkins,23,10,0,144,13,33,.394,0,0,,13,33,.394,.394,8,9,.889,0,11,11,19,2,0,13,12,34
20986,SAS,1991,Pete Myers,27,8,1,103,10,23,.435,0,1,.000,10,22,.455,.435,9,11,.818,2,16,18,14,3,3,14,14,29
20987,SAS,1991,Clifford Lett,25,7,0,99,14,29,.483,0,1,.000,14,28,.500,.483,6,9,.667,1,6,7,7,2,1,8,9,34
20988,SAS,1990,David Robinson,24,82,81,3002,690,1300,.531,0,2,.000,690,1298,.532,.531,613,837,.732,303,680,983,164,138,319,257,259,1993
20989,SAS,1990,Terry Cummings,28,81,78,2821,728,1532,.475,19,59,.322,709,1473,.481,.481,343,440,.780,226,451,677,219,110,52,202,286,1818
20990,SAS,1990,Willie Anderson,23,82,81,2788,532,1082,.492,7,26,.269,525,1056,.497,.495,217,290,.748,115,257,372,364,111,58,198,252,1288
20991,SAS,1990,Sean Elliott,21,81,69,2032,311,647,.481,1,9,.111,310,638,.486,.481,187,216,.866,127,170,297,154,45,14,112,172,810
20992,SAS,1990,David Wingate,26,78,2,1856,220,491,.448,0,13,.000,220,478,.460,.448,87,112,.777,62,133,195,208,89,18,127,154,527
20993,SAS,1990,Maurice Cheeks,33,50,49,1766,215,450,.478,1,9,.111,214,441,.485,.479,114,137,.832,39,128,167,302,82,5,85,46,545
20994,SAS,1990,Frank Brickowski,30,78,12,1438,211,387,.545,0,2,.000,211,385,.548,.545,95,141,.674,89,238,327,105,66,37,93,226,517
20995,SAS,1990,Rod Strickland,23,31,24,1121,173,370,.468,2,9,.222,171,361,.474,.470,91,148,.615,47,86,133,249,57,6,85,89,439
20996,SAS,1990,Vernon Maxwell,24,49,2,1118,133,306,.435,15,52,.288,118,254,.465,.459,59,95,.621,35,106,141,146,42,5,71,79,340
20997,SAS,1990,Caldwell Jones,39,72,2,885,67,144,.465,1,5,.200,66,139,.475,.469,38,54,.704,76,154,230,20,20,27,48,146,173
20998,SAS,1990,Johnny Moore,31,53,8,516,47,126,.373,8,34,.235,39,92,.424,.405,16,27,.593,16,36,52,82,32,3,39,55,118
20999,SAS,1990,Žarko Paspalj,23,28,1,181,27,79,.342,0,1,.000,27,78,.346,.342,18,22,.818,15,15,30,10,3,7,21,37,72
21000,SAS,1990,Reggie Williams,25,10,0,68,19,42,.452,0,5,.000,19,37,.514,.452,4,6,.667,3,5,8,5,1,3,4,16,42
21001,SAS,1990,Chris Welp,26,13,1,56,7,23,.304,0,0,,7,23,.304,.304,1,2,.500,7,5,12,5,1,0,6,21,15
21002,SAS,1990,Uwe Blab,27,7,0,50,6,11,.545,0,0,,6,11,.545,.545,3,6,.500,1,8,9,1,0,0,5,9,15
21003,SAS,1990,Jeff Lebo,23,4,0,32,2,7,.286,0,0,,2,7,.286,.286,2,2,1.000,2,2,4,3,2,0,1,7,6
21004,SAS,1989,Willie Anderson,22,81,79,2738,640,1285,.498,4,21,.190,636,1264,.503,.500,224,289,.775,152,265,417,372,150,62,261,295,1508
21005,SAS,1989,Greg Anderson,24,82,56,2401,460,914,.503,0,3,.000,460,911,.505,.503,207,403,.514,255,421,676,61,102,103,180,221,1127
21006,SAS,1989,Alvin Robertson,26,65,65,2287,465,962,.483,9,45,.200,456,917,.497,.488,183,253,.723,157,227,384,393,197,36,231,259,1122
21007,SAS,1989,Vernon Maxwell,23,79,36,2065,357,827,.432,32,129,.248,325,698,.466,.451,181,243,.745,49,153,202,301,86,8,178,136,927
21008,SAS,1989,Frank Brickowski,29,64,60,1822,337,654,.515,0,2,.000,337,652,.517,.515,201,281,.715,148,258,406,131,102,35,165,252,875
21009,SAS,1989,Dallas Comegys,24,67,10,1119,166,341,.487,0,2,.000,166,339,.490,.487,106,161,.658,112,122,234,30,42,63,85,160,438
21010,SAS,1989,Johnny Dawkins,25,32,30,1083,177,400,.443,0,4,.000,177,396,.447,.443,100,112,.893,32,69,101,224,55,0,111,64,454
21011,SAS,1989,Dave Greenwood,31,38,15,912,105,247,.425,0,0,,105,247,.425,.425,84,105,.800,92,146,238,55,30,24,55,123,294
21012,SAS,1989,Albert King,29,46,11,791,141,327,.431,8,32,.250,133,295,.451,.443,37,48,.771,33,107,140,79,27,7,74,97,327
21013,SAS,1989,Darwin Cook,30,36,0,757,147,315,.467,6,31,.194,141,284,.496,.476,46,56,.821,21,38,59,84,43,4,62,77,346
21014,SAS,1989,Michael Anderson,22,36,12,730,73,175,.417,1,7,.143,72,168,.429,.420,57,82,.695,44,45,89,153,44,3,84,64,204
21015,SAS,1989,Mike Smrek,26,43,18,623,72,153,.471,0,0,,72,153,.471,.471,49,76,.645,42,87,129,12,13,58,48,102,193
21016,SAS,1989,Jerome Whitehead,32,52,4,580,69,176,.392,0,0,,69,176,.392,.392,30,45,.667,49,80,129,17,22,4,22,107,168
21017,SAS,1989,Jay Vincent,29,24,3,551,91,219,.416,0,1,.000,91,218,.417,.416,35,51,.686,36,56,92,22,5,3,37,52,217
21018,SAS,1989,Scott Roth,25,47,3,464,52,143,.364,2,10,.200,50,133,.376,.371,52,76,.684,20,36,56,48,19,4,33,55,158
21019,SAS,1989,Anthony Bowie,25,18,5,438,72,144,.500,1,5,.200,71,139,.511,.503,10,15,.667,25,31,56,29,18,4,22,43,155
21020,SAS,1989,Calvin Natt,32,10,0,185,25,66,.379,0,0,,25,66,.379,.379,35,48,.729,16,16,32,11,2,2,19,19,85
21021,SAS,1989,Shelton Jones,22,7,0,92,9,25,.360,0,0,,9,25,.360,.360,8,13,.615,6,10,16,7,2,2,7,8,26
21022,SAS,1989,Pétur Guðmundsson,30,5,3,70,9,25,.360,0,0,,9,25,.360,.360,3,4,.750,5,11,16,5,1,1,8,15,21
21023,SAS,1989,Todd Mitchell,22,2,0,33,2,9,.222,0,0,,2,9,.222,.222,1,4,.250,1,2,3,1,1,0,4,2,5
21024,SAS,1989,Keith Smart,24,2,0,12,0,2,.000,0,1,.000,0,1,.000,.000,2,2,1.000,0,1,1,2,0,0,2,0,2
21025,SAS,1989,John Stroeder,30,1,0,2,0,0,,0,0,,0,0,,,0,0,,0,0,0,0,0,0,1,2,0
21026,SAS,1988,Alvin Robertson,25,82,82,2978,655,1408,.465,27,95,.284,628,1313,.478,.475,273,365,.748,165,333,498,557,243,69,251,300,1610
21027,SAS,1988,Frank Brickowski,28,70,68,2227,425,805,.528,1,5,.200,424,800,.530,.529,268,349,.768,167,316,483,266,74,36,207,275,1119
21028,SAS,1988,Johnny Dawkins,24,65,61,2179,405,835,.485,19,61,.311,386,774,.499,.496,198,221,.896,66,138,204,480,88,2,154,95,1027
21029,SAS,1988,Greg Anderson,23,82,45,1984,379,756,.501,1,5,.200,378,751,.503,.502,198,328,.604,161,352,513,79,54,122,143,228,957
21030,SAS,1988,Walter Berry,23,73,56,1922,540,960,.563,0,0,,540,960,.563,.563,192,320,.600,176,219,395,110,55,63,162,207,1272
21031,SAS,1988,Mike Mitchell,32,68,20,1501,378,784,.482,3,12,.250,375,772,.486,.484,160,194,.825,54,144,198,68,31,13,52,101,919
21032,SAS,1988,Dave Greenwood,30,45,40,1236,151,328,.460,0,2,.000,151,326,.463,.460,83,111,.748,92,208,300,97,33,22,74,134,385
21033,SAS,1988,Jon Sundvold,26,52,12,1024,176,379,.464,26,64,.406,150,315,.476,.499,43,48,.896,14,34,48,183,27,2,57,54,421
21034,SAS,1988,Pétur Guðmundsson,29,69,9,1017,139,280,.496,0,1,.000,139,279,.498,.496,117,145,.807,93,230,323,86,18,61,103,197,395
21035,SAS,1988,Kurt Nimphius,29,72,7,919,128,257,.498,0,1,.000,128,256,.500,.498,60,83,.723,62,91,153,53,22,56,49,141,316
21036,SAS,1988,Ed Nealy,27,68,1,837,50,109,.459,1,2,.500,49,107,.458,.463,41,63,.651,82,140,222,49,29,5,27,94,142
21037,SAS,1988,Leon Wood,25,38,8,830,120,282,.426,43,108,.398,77,174,.443,.502,69,91,.758,16,35,51,155,22,1,34,44,352
21038,SAS,1988,Ricky Wilson,23,18,1,373,36,99,.364,9,25,.360,27,74,.365,.409,23,29,.793,1,25,26,63,17,3,21,34,104
21039,SAS,1988,Pete Myers,24,22,0,328,43,95,.453,0,4,.000,43,91,.473,.453,26,39,.667,11,26,37,48,17,6,33,30,112
21040,SAS,1988,Charles Davis,29,16,0,187,42,97,.433,1,15,.067,41,82,.500,.438,7,10,.700,15,23,38,17,0,3,13,25,92
21041,SAS,1988,Nate Blackwell,22,10,0,112,15,41,.366,2,11,.182,13,30,.433,.390,5,6,.833,2,4,6,18,3,0,8,16,37
21042,SAS,1988,Phil Zevenbergen,23,8,0,58,15,27,.556,0,0,,15,27,.556,.556,0,2,.000,4,9,13,3,3,1,4,12,30
21043,SAS,1988,Johnny Moore,29,4,0,51,4,9,.444,0,1,.000,4,8,.500,.444,0,0,,1,3,4,11,3,0,4,1,8
21044,SAS,1988,Richard Rellford,23,4,0,42,5,8,.625,0,0,,5,8,.625,.625,6,8,.750,2,5,7,1,0,3,4,3,16
21045,SAS,1987,Alvin Robertson,24,81,78,2697,589,1264,.466,13,48,.271,576,1216,.474,.471,244,324,.753,186,238,424,421,260,35,243,264,1435
21046,SAS,1987,Dave Greenwood,29,79,78,2587,336,655,.513,3,6,.500,333,649,.513,.515,241,307,.785,256,527,783,237,71,50,161,248,916
21047,SAS,1987,Artis Gilmore,37,82,74,2405,346,580,.597,0,0,,346,580,.597,.597,242,356,.680,185,394,579,150,39,95,178,235,934
21048,SAS,1987,Jon Sundvold,25,76,42,1765,365,751,.486,50,149,.336,315,602,.523,.519,70,84,.833,20,78,98,315,35,0,97,109,850
21049,SAS,1987,Johnny Dawkins,23,81,14,1682,334,764,.437,14,47,.298,320,717,.446,.446,153,191,.801,56,113,169,290,67,3,120,118,835
21050,SAS,1987,Walter Berry,22,56,45,1567,401,758,.529,0,3,.000,401,755,.531,.529,186,287,.648,132,170,302,104,36,40,153,188,988
21051,SAS,1987,Johnny Moore,28,55,27,1234,198,448,.442,22,79,.278,176,369,.477,.467,56,70,.800,32,68,100,250,83,3,102,97,474
21052,SAS,1987,Mychal Thompson,32,49,6,1210,230,528,.436,1,1,1.000,229,527,.435,.437,144,196,.735,91,185,276,87,31,41,77,117,605
21053,SAS,1987,Larry Krystkowiak,22,68,2,1004,170,373,.456,1,12,.083,169,361,.468,.457,110,148,.743,77,162,239,85,22,12,67,141,451
21054,SAS,1987,Ed Nealy,26,60,7,980,84,192,.438,4,31,.129,80,161,.497,.448,51,69,.739,96,188,284,83,40,11,36,144,223
21055,SAS,1987,Mike Mitchell,31,40,18,922,208,478,.435,1,2,.500,207,476,.435,.436,92,112,.821,38,65,103,38,19,9,51,68,509
21056,SAS,1987,Anthony Jones,24,49,3,744,119,289,.412,7,19,.368,112,270,.415,.424,41,52,.788,39,56,95,66,32,18,38,68,286
21057,SAS,1987,Tyrone Corbin,24,31,15,732,113,264,.428,0,0,,113,264,.428,.428,49,67,.731,52,67,119,80,38,3,46,81,275
21058,SAS,1987,Kevin Duckworth,22,14,1,122,18,45,.400,0,0,,18,45,.400,.400,9,14,.643,13,18,31,6,5,3,4,27,45
21059,SAS,1987,Frank Brickowski,27,7,0,83,10,30,.333,0,4,.000,10,26,.385,.333,10,11,.909,8,11,19,5,6,2,7,13,30
21060,SAS,1987,Forrest McKenzie,23,6,0,42,7,28,.250,1,2,.500,6,26,.231,.268,2,2,1.000,2,5,7,1,1,0,3,9,17
21061,SAS,1987,Mike Brittain,23,6,0,29,4,9,.444,0,0,,4,9,.444,.444,1,2,.500,2,2,4,2,1,0,2,3,9
21062,SAS,1986,Mike Mitchell,30,82,82,2970,802,1697,.473,0,12,.000,802,1685,.476,.473,317,392,.809,134,275,409,188,56,25,184,175,1921
21063,SAS,1986,Alvin Robertson,23,82,82,2878,562,1093,.514,8,29,.276,554,1064,.521,.518,260,327,.795,184,332,516,448,301,40,256,296,1392
21064,SAS,1986,Artis Gilmore,36,71,71,2395,423,684,.618,0,1,.000,423,683,.619,.618,338,482,.701,166,434,600,102,39,108,186,239,1184
21065,SAS,1986,Dave Greenwood,28,68,24,1910,198,388,.510,0,1,.000,198,387,.512,.510,142,184,.772,151,380,531,90,37,52,113,207,538
21066,SAS,1986,Wes Matthews,26,75,46,1853,320,603,.531,4,25,.160,316,578,.547,.534,173,211,.820,30,101,131,476,87,32,232,168,817
21067,SAS,1986,Steve Johnson,28,71,55,1828,362,573,.632,0,0,,362,573,.632,.632,259,373,.694,143,319,462,95,44,66,191,291,983
21068,SAS,1986,Jon Sundvold,24,70,4,1150,220,476,.462,21,60,.350,199,416,.478,.484,39,48,.813,22,58,80,261,34,0,85,110,500
21069,SAS,1986,Alfredrick Hughes,23,68,0,866,152,372,.409,3,17,.176,149,355,.420,.413,49,84,.583,49,64,113,61,26,5,63,79,356
21070,SAS,1986,Johnny Moore,27,28,23,856,150,303,.495,4,22,.182,146,281,.520,.502,59,86,.686,25,61,86,252,70,6,81,78,363
21071,SAS,1986,Marc Iavaroni,29,42,7,669,74,163,.454,0,2,.000,74,161,.460,.454,43,67,.642,42,90,132,53,22,14,51,109,191
21072,SAS,1986,Jeff Lamp,26,30,1,620,136,271,.502,4,17,.235,132,254,.520,.509,56,69,.812,19,60,79,53,19,1,38,67,332
21073,SAS,1986,Jeff Wilkins,30,27,4,522,51,134,.381,0,0,,51,134,.381,.381,28,46,.609,34,93,127,18,8,10,20,71,130
21074,SAS,1986,Ray Williams,31,23,8,397,50,131,.382,2,6,.333,48,125,.384,.389,62,64,.969,13,24,37,111,28,3,51,64,164
21075,SAS,1986,Jeff Cook,29,34,0,356,28,67,.418,0,1,.000,28,66,.424,.418,26,41,.634,31,50,81,21,13,11,11,64,82
21076,SAS,1986,Mike Brittain,22,32,2,219,22,43,.512,0,0,,22,43,.512,.512,10,19,.526,10,39,49,5,3,12,20,54,54
21077,SAS,1986,Tyrone Corbin,23,16,0,174,27,64,.422,0,1,.000,27,63,.429,.422,10,14,.714,11,14,25,11,11,2,12,21,64
21078,SAS,1986,Rod Higgins,26,11,0,128,18,40,.450,0,2,.000,18,38,.474,.450,11,16,.688,5,19,24,12,2,3,5,21,47
21079,SAS,1986,Ennis Whatley,23,2,1,14,1,2,.500,0,0,,1,2,.500,.500,0,0,,0,0,0,3,0,0,4,1,2
21080,SAS,1985,Mike Mitchell,29,82,82,2853,775,1558,.497,5,23,.217,770,1535,.502,.499,269,346,.777,145,272,417,151,61,27,144,219,1824
21081,SAS,1985,Artis Gilmore,35,81,81,2756,532,854,.623,0,2,.000,532,852,.624,.623,484,646,.749,231,615,846,131,40,173,241,306,1548
21082,SAS,1985,Johnny Moore,26,82,82,2689,416,910,.457,25,89,.281,391,821,.476,.471,189,248,.762,94,284,378,816,229,18,236,247,1046
21083,SAS,1985,Gene Banks,25,82,41,2091,289,493,.586,1,3,.333,288,490,.588,.587,199,257,.774,133,312,445,234,65,13,140,220,778
21084,SAS,1985,George Gervin,32,72,69,2091,600,1182,.508,0,10,.000,600,1172,.512,.508,324,384,.844,79,155,234,178,66,48,198,208,1524
21085,SAS,1985,Alvin Robertson,22,79,9,1685,299,600,.498,4,11,.364,295,589,.501,.502,124,169,.734,116,149,265,275,127,24,167,217,726
21086,SAS,1985,John Paxson,24,78,1,1259,196,385,.509,10,34,.294,186,351,.530,.522,84,100,.840,19,49,68,215,45,3,81,117,486
21087,SAS,1985,Marc Iavaroni,28,57,33,1178,150,323,.464,0,4,.000,150,319,.470,.464,81,122,.664,84,191,275,113,31,32,103,193,381
21088,SAS,1985,Ozell Jones,24,67,6,888,106,180,.589,0,1,.000,106,179,.592,.589,33,83,.398,65,173,238,56,30,57,61,139,245
21089,SAS,1985,Jeff Cook,28,54,2,848,92,174,.529,0,0,,92,174,.529,.529,30,37,.811,81,129,210,39,25,14,32,150,214
21090,SAS,1985,Billy Knight,32,52,1,611,125,285,.439,10,24,.417,115,261,.441,.456,51,57,.895,40,56,96,59,14,1,57,48,311
21091,SAS,1985,Edgar Jones,28,18,1,322,44,91,.484,0,1,.000,44,90,.489,.484,41,51,.804,16,46,62,18,9,18,28,52,129
21092,SAS,1985,Fred Roberts,24,22,0,305,44,98,.449,0,0,,44,98,.449,.449,29,38,.763,10,25,35,22,10,12,21,45,117
21093,SAS,1985,Ron Brewer,29,9,0,81,13,34,.382,0,0,,13,34,.382,.382,7,7,1.000,1,2,3,6,1,1,4,8,33
21094,SAS,1985,Mark McNamara,25,12,0,63,12,18,.667,0,0,,12,18,.667,.667,9,18,.500,7,10,17,0,2,1,6,5,33
21095,SAS,1985,David Thirdkill,24,2,2,52,5,11,.455,0,0,,5,11,.455,.455,5,6,.833,5,2,7,3,2,1,2,5,15
21096,SAS,1985,Linton Townes,25,1,0,8,0,6,.000,0,0,,0,6,.000,.000,2,2,1.000,1,0,1,0,0,0,0,1,2
21097,SAS,1984,Mike Mitchell,28,79,79,2853,779,1597,.488,6,14,.429,773,1583,.488,.490,275,353,.779,188,382,570,93,62,73,141,251,1839
21098,SAS,1984,Gene Banks,24,80,66,2600,424,747,.568,1,6,.167,423,741,.571,.568,200,270,.741,204,378,582,254,105,23,166,256,1049
21099,SAS,1984,George Gervin,31,76,76,2584,765,1561,.490,10,24,.417,755,1537,.491,.493,427,507,.842,106,207,313,220,79,47,224,219,1967
21100,SAS,1984,Artis Gilmore,34,64,59,2034,351,556,.631,0,3,.000,351,553,.635,.631,280,390,.718,213,449,662,70,36,132,149,229,982
21101,SAS,1984,John Lucas,30,63,39,1807,275,595,.462,19,69,.275,256,526,.487,.478,120,157,.764,23,157,180,673,92,5,147,123,689
21102,SAS,1984,Edgar Jones,27,81,33,1770,322,644,.500,6,19,.316,316,625,.506,.505,176,242,.727,143,306,449,85,64,107,125,298,826
21103,SAS,1984,Johnny Moore,25,59,42,1650,231,518,.446,28,87,.322,203,431,.471,.473,105,139,.755,37,141,178,566,123,20,143,168,595
21104,SAS,1984,Fred Roberts,23,79,8,1531,214,399,.536,1,4,.250,213,395,.539,.538,144,172,.837,102,202,304,98,52,38,100,219,573
21105,SAS,1984,Mark McNamara,24,70,3,1037,157,253,.621,0,0,,157,253,.621,.621,74,157,.471,137,180,317,31,14,12,89,138,388
21106,SAS,1984,Ron Brewer,28,40,5,782,152,345,.441,3,13,.231,149,332,.449,.445,41,50,.820,17,33,50,44,18,16,33,54,348
21107,SAS,1984,Keith Edmonson,23,40,0,521,135,274,.493,0,0,,135,274,.493,.493,76,101,.752,40,30,70,27,22,6,45,67,346
21108,SAS,1984,John Paxson,23,49,0,458,61,137,.445,4,22,.182,57,115,.496,.460,16,26,.615,4,29,33,149,10,2,32,47,142
21109,SAS,1984,Kevin Williams,22,19,0,200,25,58,.431,0,1,.000,25,57,.439,.431,25,32,.781,4,9,13,43,8,4,22,42,75
21110,SAS,1984,Brant Weidner,23,8,0,38,2,9,.222,0,0,,2,9,.222,.222,4,4,1.000,4,7,11,0,0,2,2,5,8
21111,SAS,1984,Dave Robisch,34,4,0,37,4,8,.500,0,0,,4,8,.500,.500,0,0,,2,6,8,1,0,0,1,8,8
21112,SAS,1984,Dave Batton,27,4,0,31,5,10,.500,0,0,,5,10,.500,.500,0,0,,1,3,4,3,0,3,4,5,10
21113,SAS,1984,Darrell Lockhart,23,2,0,14,2,2,1.000,0,0,,2,2,1.000,1.000,0,0,,0,3,3,0,0,0,2,5,4
21114,SAS,1984,Steve Lingenfelter,25,3,0,14,1,1,1.000,0,0,,1,1,1.000,1.000,0,2,.000,3,1,4,1,0,0,1,6,2
21115,SAS,1984,Roger Phegley,27,3,0,11,2,4,.500,1,1,1.000,1,3,.333,.625,2,2,1.000,0,2,2,2,0,0,1,1,7
21116,SAS,1984,Bob Miller,27,2,0,8,2,3,.667,0,0,,2,3,.667,.667,0,0,,2,3,5,1,0,1,0,5,4
21117,SAS,1983,George Gervin,30,78,78,2830,757,1553,.487,12,33,.364,745,1520,.490,.491,517,606,.853,111,246,357,264,88,67,247,243,2043
21118,SAS,1983,Mike Mitchell,27,80,79,2803,686,1342,.511,0,3,.000,686,1339,.512,.511,219,289,.758,188,349,537,98,57,52,126,248,1591
21119,SAS,1983,Artis Gilmore,33,82,82,2797,556,888,.626,0,6,.000,556,882,.630,.626,367,496,.740,299,685,984,126,40,192,254,273,1479
21120,SAS,1983,Gene Banks,23,81,81,2722,505,919,.550,0,5,.000,505,914,.553,.550,196,278,.705,222,390,612,279,78,21,171,229,1206
21121,SAS,1983,Johnny Moore,24,77,73,2552,394,841,.468,5,22,.227,389,819,.475,.471,148,199,.744,65,212,277,753,194,32,226,247,941
21122,SAS,1983,Mike Dunleavy,28,79,9,1619,213,510,.418,67,194,.345,146,316,.462,.483,120,154,.779,18,116,134,437,74,4,160,210,613
21123,SAS,1983,Bill Willoughby,25,52,0,1062,136,295,.461,6,13,.462,130,282,.461,.471,41,53,.774,61,129,190,56,24,16,56,123,319
21124,SAS,1983,Paul Griffin,29,53,0,956,60,116,.517,0,0,,60,116,.517,.517,53,76,.697,77,139,216,86,33,25,68,153,173
21125,SAS,1983,Edgar Jones,26,28,3,622,92,185,.497,0,3,.000,92,182,.505,.497,84,114,.737,56,121,177,20,14,31,43,107,268
21126,SAS,1983,Roger Phegley,26,62,4,599,120,267,.449,3,14,.214,117,253,.462,.455,43,56,.768,39,45,84,60,30,8,49,92,286
21127,SAS,1983,Mike Sanders,22,26,0,393,76,157,.484,0,2,.000,76,155,.490,.484,31,43,.721,31,63,94,19,18,6,28,57,183
21128,SAS,1983,Ed Rains,26,34,1,292,33,83,.398,0,1,.000,33,82,.402,.398,29,43,.674,25,19,44,22,10,1,25,35,95
21129,SAS,1983,Geoff Crompton,27,14,0,148,14,34,.412,0,0,,14,34,.412,.412,3,5,.600,18,30,48,7,3,5,5,25,31
21130,SAS,1983,Oliver Robinson,22,35,0,147,35,97,.361,1,11,.091,34,86,.395,.366,30,45,.667,6,11,17,21,4,2,13,18,101
21131,SAS,1983,Billy Paultz,34,7,0,125,12,27,.444,0,0,,12,27,.444,.444,1,2,.500,10,23,33,4,5,6,6,14,25
21132,SAS,1983,Jim Johnstone,22,7,0,54,2,10,.200,0,0,,2,10,.200,.200,3,5,.600,4,12,16,1,1,1,4,9,7
21133,SAS,1983,Coby Dietrick,34,8,0,34,1,5,.200,0,0,,1,5,.200,.200,0,2,.000,2,6,8,6,1,0,1,6,2
21134,SAS,1983,Robert Smith,27,7,0,25,5,11,.455,0,1,.000,5,10,.500,.455,2,2,1.000,0,3,3,2,1,0,3,6,12
21135,SAS,1982,George Gervin,29,79,79,2817,993,1987,.500,10,36,.278,983,1951,.504,.502,555,642,.864,138,254,392,187,77,45,210,215,2551
21136,SAS,1982,Johnny Moore,23,79,78,2294,309,667,.463,1,21,.048,308,646,.477,.464,122,182,.670,62,213,275,762,163,12,175,254,741
21137,SAS,1982,Dave Corzine,25,82,21,2189,336,648,.519,1,4,.250,335,644,.520,.519,159,213,.746,211,418,629,130,33,126,139,235,832
21138,SAS,1982,Mark Olberding,25,68,63,2098,333,705,.472,2,12,.167,331,693,.478,.474,273,338,.808,118,321,439,202,57,29,139,253,941
21139,SAS,1982,Mike Mitchell,26,57,57,2090,524,973,.539,0,1,.000,524,972,.539,.539,148,202,.733,173,276,449,43,33,28,98,200,1196
21140,SAS,1982,Gene Banks,22,80,4,1700,311,652,.477,0,8,.000,311,644,.483,.477,145,212,.684,157,254,411,147,55,17,106,199,767
21141,SAS,1982,Mike Bratz,26,81,3,1616,230,565,.407,46,138,.333,184,427,.431,.448,119,152,.783,40,126,166,438,65,11,139,183,625
21142,SAS,1982,George Johnson,33,75,62,1578,91,195,.467,0,0,,91,195,.467,.467,43,64,.672,152,302,454,79,20,234,92,259,225
21143,SAS,1982,Ed Rains,25,49,15,637,77,177,.435,0,2,.000,77,175,.440,.435,38,64,.594,37,43,80,40,18,2,25,74,192
21144,SAS,1982,Roger Phegley,25,54,1,617,129,293,.440,1,18,.056,128,275,.465,.442,49,64,.766,33,50,83,61,20,6,33,91,308
21145,SAS,1982,Ron Brewer,26,25,4,595,182,361,.504,3,10,.300,179,351,.510,.508,77,88,.875,13,37,50,67,23,7,34,37,444
21146,SAS,1982,Reggie Johnson,24,21,17,504,94,194,.485,0,0,,94,194,.485,.485,32,40,.800,43,94,137,20,7,16,26,67,220
21147,SAS,1982,Paul Griffin,28,23,0,459,32,66,.485,0,0,,32,66,.485,.485,24,37,.649,29,66,95,54,20,8,40,67,88
21148,SAS,1982,John Lambert,29,21,6,271,26,58,.448,0,1,.000,26,57,.456,.448,13,14,.929,19,32,51,13,6,6,10,43,65
21149,SAS,1982,Kevin Restani,30,13,0,145,9,28,.321,0,1,.000,9,27,.333,.321,3,4,.750,8,27,35,7,1,4,6,16,21
21150,SAS,1982,Steve Hayes,26,9,0,75,8,18,.444,0,0,,8,18,.444,.444,7,12,.583,7,10,17,4,1,2,2,17,23
21151,SAS,1982,Rich Yonakor,23,10,0,70,14,26,.538,0,0,,14,26,.538,.538,5,7,.714,13,14,27,3,1,2,2,7,33
21152,SAS,1981,George Gervin,28,82,82,2765,850,1729,.492,9,35,.257,841,1694,.496,.494,512,620,.826,126,293,419,260,94,56,251,212,2221
21153,SAS,1981,Mark Olberding,24,82,82,2408,348,685,.508,1,7,.143,347,678,.512,.509,315,380,.829,146,325,471,277,75,31,202,307,1012
21154,SAS,1981,James Silas,31,75,,2055,476,997,.477,0,2,.000,476,995,.478,.477,374,440,.850,44,187,231,285,51,12,159,129,1326
21155,SAS,1981,Dave Corzine,24,82,,1960,366,747,.490,0,3,.000,366,744,.492,.490,125,175,.714,228,408,636,117,42,99,131,212,857
21156,SAS,1981,George Johnson,32,82,82,1935,164,347,.473,0,0,,164,347,.473,.473,80,109,.734,215,387,602,92,47,278,110,273,408
21157,SAS,1981,Paul Griffin,27,82,,1930,166,325,.511,0,0,,166,325,.511,.511,170,253,.672,184,321,505,249,77,38,132,207,502
21158,SAS,1981,Reggie Johnson,23,79,,1716,340,682,.499,0,1,.000,340,681,.499,.499,128,193,.663,132,226,358,78,45,48,130,283,808
21159,SAS,1981,Johnny Moore,22,82,,1578,249,520,.479,1,19,.053,248,501,.495,.480,105,172,.610,58,138,196,373,120,22,154,178,604
21160,SAS,1981,Kevin Restani,29,64,,999,192,369,.520,3,8,.375,189,361,.524,.524,62,88,.705,71,103,174,81,16,14,68,103,449
21161,SAS,1981,Ron Brewer,25,46,,904,180,385,.468,0,4,.000,180,381,.472,.468,65,80,.813,21,32,53,93,27,25,54,53,425
21162,SAS,1981,Mike Gale,30,35,,636,86,164,.524,1,3,.333,85,161,.528,.527,19,26,.731,7,45,52,99,55,2,39,56,192
21163,SAS,1981,John Shumate,28,22,,519,56,128,.438,0,0,,56,128,.438,.438,53,73,.726,33,54,87,24,21,9,41,46,165
21164,SAS,1981,Michael Wiley,23,33,,271,76,138,.551,0,2,.000,76,136,.559,.551,36,48,.750,22,42,64,11,8,6,28,38,188
21165,SAS,1981,Gus Gerard,27,11,,129,22,60,.367,0,1,.000,22,59,.373,.367,8,11,.727,17,21,38,9,7,3,8,17,52
21166,SAS,1980,George Gervin,27,78,,2934,1024,1940,.528,32,102,.314,992,1838,.540,.536,505,593,.852,154,249,403,202,110,79,254,208,2585
21167,SAS,1980,Larry Kenon,27,78,,2798,647,1333,.485,1,9,.111,646,1324,.488,.486,270,345,.783,258,517,775,231,111,18,232,192,1565
21168,SAS,1980,James Silas,30,77,,2293,513,999,.514,0,4,.000,513,995,.516,.514,339,382,.887,45,122,167,347,61,14,192,206,1365
21169,SAS,1980,Mark Olberding,23,75,,2111,291,609,.478,0,3,.000,291,606,.480,.478,210,264,.795,83,335,418,327,67,22,180,274,792
21170,SAS,1980,Kevin Restani,28,82,,1966,369,727,.508,5,29,.172,364,698,.521,.511,131,161,.814,142,244,386,189,54,12,129,186,874
21171,SAS,1980,Paul Griffin,26,82,,1812,173,313,.553,0,0,,173,313,.553,.553,174,240,.725,154,284,438,250,81,53,131,306,520
21172,SAS,1980,Mike Gale,29,67,,1474,171,377,.454,2,13,.154,169,364,.464,.456,97,120,.808,34,118,152,312,123,13,115,134,441
21173,SAS,1980,Mike Evans,24,79,,1246,208,464,.448,12,42,.286,196,422,.464,.461,58,85,.682,29,78,107,230,60,9,128,194,486
21174,SAS,1980,Billy Paultz,31,47,,1213,189,381,.496,0,1,.000,189,380,.497,.496,66,100,.660,95,226,321,118,47,45,58,127,444
21175,SAS,1980,John Shumate,27,27,,777,138,263,.525,0,1,.000,138,262,.527,.525,115,147,.782,65,149,214,52,23,31,50,71,391
21176,SAS,1980,Wiley Peck,22,52,,628,73,169,.432,0,2,.000,73,167,.437,.432,34,55,.618,66,117,183,33,17,23,48,100,180
21177,SAS,1980,Irv Kiffin,28,26,,212,32,96,.333,0,0,,32,96,.333,.333,18,25,.720,12,28,40,19,10,2,30,43,82
21178,SAS,1980,Sylvester Norris,22,17,,189,18,43,.419,0,0,,18,43,.419,.419,4,6,.667,10,33,43,6,3,12,19,41,40
21179,SAS,1980,Tim Bassett,28,5,,72,4,12,.333,0,0,,4,12,.333,.333,2,3,.667,4,11,15,10,3,0,5,13,10
21180,SAS,1980,Harry Davis,24,4,,30,6,12,.500,0,0,,6,12,.500,.500,1,2,.500,2,4,6,0,1,0,3,8,13
21181,UTA,2024,Collin Sexton,25,78,51,2075,506,1038,.487,128,325,.394,378,713,.530,.549,318,370,.859,71,134,205,383,62,18,165,154,1458
21182,UTA,2024,Keyonte George,20,75,44,2023,319,815,.391,147,440,.334,172,375,.459,.482,189,223,.848,15,196,211,332,36,7,188,91,974
21183,UTA,2024,John Collins,26,68,66,1901,397,746,.532,86,232,.371,311,514,.605,.590,147,185,.795,157,418,575,77,40,61,98,191,1027
21184,UTA,2024,Lauri Markkanen,26,55,55,1820,427,890,.480,175,439,.399,252,451,.559,.578,249,277,.899,122,327,449,110,50,26,77,100,1278
21185,UTA,2024,Jordan Clarkson,31,55,19,1682,337,816,.413,91,309,.294,246,507,.485,.469,177,201,.881,49,139,188,277,35,6,146,81,942
21186,UTA,2024,Walker Kessler,22,64,22,1493,229,350,.654,4,19,.211,225,331,.680,.660,56,93,.602,165,316,481,60,30,154,66,132,518
21187,UTA,2024,Kris Dunn,29,66,32,1249,147,313,.470,41,111,.369,106,202,.525,.535,22,32,.688,50,139,189,254,68,28,79,135,357
21188,UTA,2024,Simone Fontecchio,28,50,34,1160,161,358,.450,91,233,.391,70,125,.560,.577,32,40,.800,52,124,176,73,30,18,51,81,445
21189,UTA,2024,Kelly Olynyk,32,50,8,1019,145,258,.562,36,84,.429,109,174,.626,.632,80,95,.842,63,191,254,219,37,12,81,132,406
21190,UTA,2024,Talen Horton-Tucker,23,51,11,1009,184,465,.396,60,182,.330,124,283,.438,.460,88,109,.807,21,100,121,177,45,19,65,94,516
21191,UTA,2024,Ochai Agbaji,23,51,10,1003,106,249,.426,47,142,.331,59,107,.551,.520,15,20,.750,35,91,126,47,27,29,34,66,274
21192,UTA,2024,Taylor Hendricks,20,40,23,856,108,240,.450,53,140,.379,55,100,.550,.560,23,29,.793,46,139,185,32,28,30,27,77,292
21193,UTA,2024,Brice Sensabaugh,20,32,11,584,85,218,.390,34,115,.296,51,103,.495,.468,37,41,.902,16,86,102,55,13,6,47,43,241
21194,UTA,2024,Omer Yurtseven,25,48,12,545,99,184,.538,5,24,.208,94,160,.588,.552,19,28,.679,72,136,208,29,8,18,37,52,222
21195,UTA,2024,Luka Šamanić,24,43,7,404,60,158,.380,13,64,.203,47,94,.500,.421,44,56,.786,22,80,102,19,5,7,28,32,177
21196,UTA,2024,Johnny Juzang,22,20,5,372,51,110,.464,32,77,.416,19,33,.576,.609,10,14,.714,7,29,36,23,4,2,13,29,144
21197,UTA,2024,Micah Potter,25,16,0,186,19,40,.475,9,21,.429,10,19,.526,.588,6,8,.750,10,33,43,6,4,6,5,14,53
21198,UTA,2024,Darius Bazley,23,6,0,142,18,29,.621,2,8,.250,16,21,.762,.655,10,12,.833,8,19,27,5,6,7,7,3,48
21199,UTA,2024,Kira Lewis Jr.,22,12,0,119,18,40,.450,2,13,.154,16,27,.593,.475,7,9,.778,5,7,12,19,4,1,6,4,45
21200,UTA,2024,Kenneth Lofton Jr.,21,4,0,91,21,35,.600,4,12,.333,17,23,.739,.657,9,11,.818,10,10,20,19,3,2,6,9,55
21201,UTA,2024,Jason Preston,24,7,0,71,6,19,.316,0,3,.000,6,16,.375,.316,0,0,,6,11,17,16,2,1,2,3,12
21202,UTA,2023,Lauri Markkanen,25,66,66,2273,571,1145,.499,200,511,.391,371,634,.585,.586,349,399,.875,130,440,570,123,42,38,127,137,1691
21203,UTA,2023,Jordan Clarkson,30,61,61,1988,458,1031,.444,155,459,.338,303,572,.530,.519,200,245,.816,72,174,246,270,33,13,186,120,1271
21204,UTA,2023,Kelly Olynyk,31,68,68,1942,278,557,.499,93,236,.394,185,321,.576,.583,198,232,.853,82,338,420,252,60,37,168,232,847
21205,UTA,2023,Walker Kessler,21,74,40,1703,298,414,.720,1,3,.333,297,411,.723,.721,82,159,.516,231,389,620,69,26,173,58,169,679
21206,UTA,2023,Malik Beasley,26,55,13,1472,265,669,.396,169,471,.359,96,198,.485,.522,37,44,.841,27,170,197,93,44,8,60,75,736
21207,UTA,2023,Talen Horton-Tucker,22,65,20,1313,257,613,.419,58,203,.286,199,410,.485,.467,126,168,.750,41,169,210,246,41,29,126,108,698
21208,UTA,2023,Mike Conley,35,43,42,1276,153,375,.408,77,213,.362,76,162,.469,.511,78,96,.813,17,90,107,330,44,10,74,94,461
21209,UTA,2023,Jarred Vanderbilt,23,52,41,1254,173,311,.556,19,57,.333,154,254,.606,.587,67,102,.657,121,288,409,142,53,15,68,133,432
21210,UTA,2023,Ochai Agbaji,22,59,22,1209,165,386,.427,81,228,.355,84,158,.532,.532,56,69,.812,43,78,121,67,16,15,41,99,467
21211,UTA,2023,Collin Sexton,24,48,15,1145,237,468,.506,48,122,.393,189,346,.546,.558,163,199,.819,37,68,105,138,27,6,85,112,685
21212,UTA,2023,Rudy Gay,36,56,0,816,109,287,.380,33,130,.254,76,157,.484,.437,42,49,.857,33,130,163,57,19,18,37,68,293
21213,UTA,2023,Simone Fontecchio,27,52,6,766,115,312,.369,63,191,.330,52,121,.430,.470,35,44,.795,31,55,86,42,15,8,39,62,328
21214,UTA,2023,Kris Dunn,28,22,3,568,116,216,.537,17,36,.472,99,180,.550,.576,41,53,.774,9,91,100,124,25,10,35,58,290
21215,UTA,2023,Nickeil Alexander-Walker,24,36,3,528,83,170,.488,35,87,.402,48,83,.578,.591,27,39,.692,8,51,59,76,24,14,45,58,228
21216,UTA,2023,Udoka Azubuike,23,36,4,359,59,72,.819,0,0,,59,72,.819,.819,7,20,.350,31,88,119,11,6,15,18,34,125
21217,UTA,2023,Juan Toscano-Anderson,29,22,2,335,31,77,.403,4,23,.174,27,54,.500,.429,8,9,.889,14,49,63,40,6,3,17,34,74
21218,UTA,2023,Damian Jones,27,19,0,301,35,49,.714,10,14,.714,25,35,.714,.816,7,9,.778,24,43,67,11,5,9,14,38,87
21219,UTA,2023,Johnny Juzang,21,18,0,232,35,104,.337,15,63,.238,20,41,.488,.409,2,4,.500,8,31,39,8,4,3,3,13,87
21220,UTA,2023,Luka Šamanić,23,7,4,161,26,57,.456,8,31,.258,18,26,.692,.526,9,13,.692,0,30,30,15,6,2,10,17,69
21221,UTA,2023,Leandro Bolmaro,22,14,0,68,3,20,.150,0,4,.000,3,16,.188,.150,0,0,,4,3,7,7,3,1,7,10,6
21222,UTA,2023,Micah Potter,24,7,0,52,10,15,.667,4,7,.571,6,8,.750,.800,0,0,,3,13,16,4,1,0,2,5,24
21223,UTA,2023,Jarrell Brantley,26,4,0,39,8,14,.571,4,9,.444,4,5,.800,.714,2,2,1.000,1,5,6,3,0,2,2,3,22
21224,UTA,2023,Frank Jackson,24,1,0,5,0,3,.000,0,1,.000,0,2,.000,.000,0,0,,1,1,2,1,0,0,0,0,0
21225,UTA,2022,Royce O'Neale,28,77,77,2406,203,444,.457,119,306,.389,84,138,.609,.591,45,56,.804,64,304,368,191,86,32,79,183,570
21226,UTA,2022,Donovan Mitchell,25,67,67,2266,617,1376,.448,232,654,.355,385,722,.533,.533,267,313,.853,55,227,282,358,99,12,200,164,1733
21227,UTA,2022,Jordan Clarkson,29,79,1,2141,466,1113,.419,190,597,.318,276,516,.535,.504,144,174,.828,67,206,273,194,66,16,129,149,1266
21228,UTA,2022,Bojan Bogdanović,32,69,69,2131,422,928,.455,181,468,.387,241,460,.524,.552,223,260,.858,58,238,296,120,34,1,118,116,1248
21229,UTA,2022,Rudy Gobert,29,66,66,2120,362,508,.713,0,4,.000,362,504,.718,.713,303,439,.690,241,727,968,72,45,137,119,176,1027
21230,UTA,2022,Mike Conley,34,72,72,2058,344,791,.435,169,414,.408,175,377,.464,.542,129,162,.796,47,170,217,385,96,21,123,142,986
21231,UTA,2022,Hassan Whiteside,32,65,8,1162,215,330,.652,0,0,,215,330,.652,.652,104,167,.623,166,328,494,26,22,103,53,179,534
21232,UTA,2022,Joe Ingles,34,45,15,1122,115,285,.404,78,225,.347,37,60,.617,.540,17,22,.773,12,119,131,158,23,5,46,82,325
21233,UTA,2022,Rudy Gay,35,55,1,1038,157,379,.414,70,203,.345,87,176,.494,.507,62,79,.785,55,187,242,56,25,19,47,95,446
21234,UTA,2022,Trent Forrest,23,60,6,765,76,155,.490,5,27,.185,71,128,.555,.506,38,48,.792,23,76,99,106,30,6,48,43,195
21235,UTA,2022,Eric Paschall,25,58,3,737,114,235,.485,40,108,.370,74,127,.583,.570,66,86,.767,30,76,106,36,9,5,27,51,334
21236,UTA,2022,Danuel House Jr.,28,25,6,491,55,123,.447,34,82,.415,21,41,.512,.585,27,39,.692,14,54,68,25,16,12,15,35,171
21237,UTA,2022,Jared Butler,21,42,1,360,61,151,.404,28,88,.318,33,63,.524,.497,11,16,.688,5,40,45,63,17,8,33,47,161
21238,UTA,2022,Juancho Hernangómez,26,17,9,298,37,73,.507,21,48,.438,16,25,.640,.651,10,21,.476,15,45,60,14,9,7,8,18,105
21239,UTA,2022,Udoka Azubuike,22,17,6,195,37,49,.755,0,0,,37,49,.755,.755,6,11,.545,18,53,71,0,1,11,12,25,80
21240,UTA,2022,Nickeil Alexander-Walker,23,15,2,149,16,48,.333,10,33,.303,6,15,.400,.438,11,12,.917,1,22,23,17,5,4,8,15,53
21241,UTA,2022,Elijah Hughes,23,14,1,112,15,36,.417,10,28,.357,5,8,.625,.556,3,3,1.000,2,15,17,6,4,1,7,7,43
21242,UTA,2022,Miye Oni,24,16,0,44,2,9,.222,1,8,.125,1,1,1.000,.278,0,1,.000,1,6,7,5,0,0,1,7,5
21243,UTA,2022,Malik Fitts,24,7,0,35,2,9,.222,2,4,.500,0,5,.000,.333,0,0,,0,10,10,0,0,0,2,3,6
21244,UTA,2022,Xavier Sneed,24,7,0,31,2,8,.250,1,6,.167,1,2,.500,.313,0,0,,1,3,4,1,0,0,0,0,5
21245,UTA,2022,Greg Monroe,31,3,0,26,4,5,.800,0,0,,4,5,.800,.800,4,7,.571,6,3,9,3,0,1,0,6,12
21246,UTA,2022,Norvel Pelle,28,3,0,19,3,5,.600,0,0,,3,5,.600,.600,0,0,,3,3,6,0,0,1,2,1,6
21247,UTA,2022,Denzel Valentine,28,2,0,18,2,4,.500,1,3,.333,1,1,1.000,.625,0,0,,0,4,4,0,1,0,2,3,5
21248,UTA,2022,Zylan Cheatham,26,1,0,5,0,3,.000,0,2,.000,0,1,.000,.000,0,0,,0,0,0,0,0,0,0,0,0
21249,UTA,2021,Royce O'Neale,27,71,71,2241,175,394,.444,107,278,.385,68,116,.586,.580,39,46,.848,88,397,485,181,57,32,83,182,496
21250,UTA,2021,Bojan Bogdanović,31,72,72,2216,406,925,.439,180,461,.390,226,464,.487,.536,233,265,.879,40,241,281,136,45,4,128,115,1225
21251,UTA,2021,Rudy Gobert,28,71,71,2187,391,579,.675,0,4,.000,391,575,.680,.675,233,374,.623,240,720,960,89,40,190,118,163,1015
21252,UTA,2021,Joe Ingles,33,67,30,1867,275,562,.489,183,406,.451,92,156,.590,.652,76,90,.844,27,217,244,318,45,12,117,120,809
21253,UTA,2021,Jordan Clarkson,28,68,1,1818,457,1075,.425,208,599,.347,249,476,.523,.522,129,144,.896,47,227,274,168,61,10,115,110,1251
21254,UTA,2021,Donovan Mitchell,24,53,53,1771,478,1091,.438,178,461,.386,300,630,.476,.520,267,316,.845,50,185,235,277,52,15,147,117,1401
21255,UTA,2021,Mike Conley,33,51,51,1498,284,640,.444,138,335,.412,146,305,.479,.552,121,142,.852,36,141,177,305,70,9,99,98,827
21256,UTA,2021,Georges Niang,27,72,10,1154,177,405,.437,124,292,.425,53,113,.469,.590,22,23,.957,28,148,176,59,25,8,51,116,500
21257,UTA,2021,Derrick Favors,29,68,0,1039,155,243,.638,0,2,.000,155,241,.643,.638,59,80,.738,138,238,376,44,32,68,36,143,369
21258,UTA,2021,Miye Oni,23,54,0,519,35,99,.354,30,88,.341,5,11,.455,.505,5,6,.833,23,61,84,28,11,8,16,61,105
21259,UTA,2021,Trent Forrest,22,30,0,302,32,71,.451,5,26,.192,27,45,.600,.486,19,19,1.000,11,33,44,45,9,4,21,22,88
21260,UTA,2021,Ersan İlyasova,33,17,1,148,21,54,.389,18,41,.439,3,13,.231,.556,5,5,1.000,7,22,29,4,10,3,8,29,65
21261,UTA,2021,Juwan Morgan,23,29,0,147,14,30,.467,4,13,.308,10,17,.588,.533,3,7,.429,9,19,28,9,4,1,4,21,35
21262,UTA,2021,Jarrell Brantley,24,28,0,138,25,52,.481,12,28,.429,13,24,.542,.596,2,2,1.000,9,18,27,15,7,2,8,17,64
21263,UTA,2021,Matt Thomas,26,19,0,134,26,65,.400,10,39,.256,16,26,.615,.477,6,7,.857,4,19,23,10,2,0,8,8,68
21264,UTA,2021,Elijah Hughes,22,18,0,64,10,30,.333,8,23,.348,2,7,.286,.467,3,4,.750,1,8,9,6,1,1,6,1,31
21265,UTA,2021,Udoka Azubuike,21,15,0,57,4,9,.444,0,0,,4,9,.444,.444,8,10,.800,4,9,13,0,1,4,3,9,16
21266,UTA,2021,Shaquille Harrison,27,17,0,56,6,20,.300,0,2,.000,6,18,.333,.300,5,6,.833,3,6,9,9,2,0,5,3,17
21267,UTA,2020,Donovan Mitchell,23,69,69,2364,602,1342,.449,173,473,.366,429,869,.494,.513,278,322,.863,53,251,304,294,70,14,184,172,1655
21268,UTA,2020,Rudy Gobert,27,68,68,2333,386,557,.693,0,0,,386,557,.693,.693,254,403,.630,230,686,916,101,51,135,130,215,1026
21269,UTA,2020,Joe Ingles,32,72,45,2137,246,553,.445,141,353,.399,105,200,.525,.572,74,94,.787,27,251,278,373,65,11,142,154,707
21270,UTA,2020,Bojan Bogdanović,30,63,63,2083,418,935,.447,189,457,.414,229,478,.479,.548,250,277,.903,39,220,259,131,34,7,159,110,1275
21271,UTA,2020,Royce O'Neale,26,71,62,2049,158,365,.433,92,244,.377,66,121,.545,.559,42,55,.764,27,362,389,180,59,32,61,202,450
21272,UTA,2020,Mike Conley,32,47,41,1363,232,567,.409,96,256,.375,136,311,.437,.494,115,139,.827,33,118,151,208,36,5,92,104,675
21273,UTA,2020,Jordan Clarkson,27,42,2,1039,250,541,.462,93,254,.366,157,287,.547,.548,62,79,.785,29,89,118,66,29,8,58,75,655
21274,UTA,2020,Georges Niang,26,66,1,923,141,322,.438,90,225,.400,51,97,.526,.578,20,24,.833,15,112,127,44,18,5,30,75,392
21275,UTA,2020,Emmanuel Mudiay,23,54,2,850,151,327,.462,30,87,.345,121,240,.504,.508,63,83,.759,18,108,126,116,24,10,76,72,395
21276,UTA,2020,Tony Bradley,22,58,3,663,126,189,.667,3,3,1.000,123,186,.661,.675,30,46,.652,111,156,267,23,14,33,30,115,285
21277,UTA,2020,Jeff Green,33,30,2,553,75,195,.385,34,104,.327,41,91,.451,.472,49,63,.778,14,67,81,20,12,10,27,46,233
21278,UTA,2020,Ed Davis,30,28,1,303,22,46,.478,0,0,,22,46,.478,.478,7,14,.500,35,70,105,12,11,9,13,61,51
21279,UTA,2020,Rayjon Tucker,22,20,0,161,20,43,.465,3,17,.176,17,26,.654,.500,19,23,.826,3,17,20,5,1,1,8,10,62
21280,UTA,2020,Juwan Morgan,22,21,0,134,15,26,.577,3,8,.375,12,18,.667,.635,3,4,.750,10,19,29,6,1,2,6,19,36
21281,UTA,2020,Miye Oni,22,10,1,109,12,32,.375,7,19,.368,5,13,.385,.484,4,5,.800,5,12,17,4,4,2,4,9,35
21282,UTA,2020,Jarrell Brantley,23,9,0,96,10,28,.357,3,13,.231,7,15,.467,.411,1,2,.500,2,18,20,11,3,5,7,7,24
21283,UTA,2020,Dante Exum,24,11,0,83,10,23,.435,2,6,.333,8,17,.471,.478,2,2,1.000,3,9,12,7,1,2,10,8,24
21284,UTA,2020,Nigel Williams-Goss,25,10,0,50,5,16,.313,2,7,.286,3,9,.333,.375,2,2,1.000,2,4,6,6,3,1,3,6,14
21285,UTA,2020,Justin Wright-Foreman,22,4,0,45,7,20,.350,2,10,.200,5,10,.500,.400,3,4,.750,0,5,5,7,2,0,3,5,19
21286,UTA,2020,Stanton Kidd,27,4,0,15,0,3,.000,0,1,.000,0,2,.000,.000,0,0,,0,3,3,1,0,0,2,3,0
21287,UTA,2019,Donovan Mitchell,22,77,77,2598,661,1530,.432,188,519,.362,473,1011,.468,.493,319,396,.806,59,257,316,322,106,31,218,208,1829
21288,UTA,2019,Rudy Gobert,26,81,80,2577,476,712,.669,0,0,,476,712,.669,.669,332,522,.636,309,732,1041,161,66,187,130,231,1284
21289,UTA,2019,Joe Ingles,31,82,82,2568,359,802,.448,189,483,.391,170,319,.533,.565,87,123,.707,35,295,330,469,98,20,193,180,994
21290,UTA,2019,Jae Crowder,28,80,11,2166,318,797,.399,173,522,.331,145,275,.527,.508,142,197,.721,60,324,384,133,64,31,85,170,951
21291,UTA,2019,Ricky Rubio,28,68,67,1899,295,730,.404,79,254,.311,216,476,.454,.458,195,228,.855,33,210,243,416,91,10,180,180,864
21292,UTA,2019,Derrick Favors,27,76,70,1766,363,619,.586,17,78,.218,346,541,.640,.600,154,228,.675,207,353,560,89,56,106,84,163,897
21293,UTA,2019,Royce O'Neale,25,82,16,1671,163,343,.475,68,176,.386,95,167,.569,.574,32,42,.762,22,263,285,124,54,24,70,172,426
21294,UTA,2019,Kyle Korver,37,54,0,1083,166,407,.408,113,294,.384,53,113,.469,.547,47,57,.825,9,124,133,64,22,10,42,84,492
21295,UTA,2019,Dante Exum,23,42,1,664,101,241,.419,18,62,.290,83,179,.464,.456,68,86,.791,16,52,68,110,14,5,52,69,288
21296,UTA,2019,Thabo Sefolosha,34,50,2,609,71,149,.477,34,78,.436,37,71,.521,.591,14,22,.636,8,115,123,27,43,5,25,41,190
21297,UTA,2019,Georges Niang,25,59,0,516,86,181,.475,43,105,.410,43,76,.566,.594,20,24,.833,11,76,87,35,10,6,23,57,235
21298,UTA,2019,Raul Neto,26,37,1,474,74,161,.460,20,60,.333,54,101,.535,.522,28,33,.848,6,56,62,93,14,4,35,49,196
21299,UTA,2019,Grayson Allen,23,38,2,416,67,178,.376,32,99,.323,35,79,.443,.466,45,60,.750,3,20,23,25,6,6,33,47,211
21300,UTA,2019,Ekpe Udoh,31,51,1,320,50,72,.694,0,0,,50,72,.694,.694,19,30,.633,27,63,90,28,10,31,13,36,119
21301,UTA,2019,Alec Burks,27,17,0,269,47,114,.412,16,43,.372,31,71,.437,.482,33,38,.868,2,25,27,20,6,4,15,22,143
21302,UTA,2019,Naz Mitrou-Long,25,14,0,84,6,20,.300,2,11,.182,4,9,.444,.350,2,2,1.000,1,5,6,15,1,1,8,10,16
21303,UTA,2019,Tyler Cavanaugh,24,11,0,39,3,10,.300,1,5,.200,2,5,.400,.350,2,2,1.000,3,5,8,1,0,0,1,3,9
21304,UTA,2019,Tony Bradley,21,3,0,36,8,16,.500,0,0,,8,16,.500,.500,1,2,.500,9,6,15,1,2,2,3,6,17
21305,UTA,2018,Donovan Mitchell,21,79,71,2638,595,1362,.437,187,550,.340,408,812,.502,.506,239,297,.805,52,244,296,291,118,27,215,213,1616
21306,UTA,2018,Joe Ingles,30,82,81,2578,335,718,.467,204,464,.440,131,254,.516,.609,66,83,.795,24,320,344,392,90,20,159,178,940
21307,UTA,2018,Ricky Rubio,27,77,77,2254,346,827,.418,96,273,.352,250,554,.451,.476,220,254,.866,44,307,351,410,121,11,207,206,1008
21308,UTA,2018,Derrick Favors,26,77,77,2153,395,702,.563,14,63,.222,381,639,.596,.573,140,215,.651,198,354,552,102,54,82,88,164,944
21309,UTA,2018,Rudy Gobert,25,56,56,1816,276,444,.622,0,0,,276,444,.622,.622,204,299,.682,165,436,601,80,44,129,107,153,756
21310,UTA,2018,Royce O'Neale,24,69,4,1150,120,284,.423,42,118,.356,78,166,.470,.496,61,76,.803,25,211,236,95,36,16,55,105,343
21311,UTA,2018,Jonas Jerebko,30,74,19,1134,159,341,.466,65,157,.414,94,184,.511,.562,46,57,.807,53,193,246,42,24,12,27,127,429
21312,UTA,2018,Rodney Hood,25,39,12,1084,234,552,.424,102,262,.389,132,290,.455,.516,85,97,.876,14,97,111,65,30,7,63,64,655
21313,UTA,2018,Alec Burks,26,64,1,1059,170,414,.411,47,142,.331,123,272,.452,.467,107,124,.863,19,173,192,67,37,8,60,75,494
21314,UTA,2018,Ekpe Udoh,30,63,3,810,60,120,.500,0,1,.000,60,119,.504,.500,42,56,.750,68,82,150,53,43,74,20,105,162
21315,UTA,2018,Thabo Sefolosha,33,38,6,806,118,240,.492,32,84,.381,86,156,.551,.558,44,54,.815,29,132,161,33,52,12,30,59,312
21316,UTA,2018,Jae Crowder,27,27,0,744,114,295,.386,48,152,.316,66,143,.462,.468,43,56,.768,18,84,102,41,23,9,32,63,319
21317,UTA,2018,Joe Johnson,36,32,3,700,95,226,.420,23,84,.274,72,142,.507,.471,20,24,.833,12,95,107,45,12,6,31,32,233
21318,UTA,2018,Raul Neto,25,41,0,498,69,151,.457,19,47,.404,50,104,.481,.520,26,35,.743,7,42,49,75,13,4,36,38,183
21319,UTA,2018,Dante Exum,22,14,0,235,42,87,.483,5,18,.278,37,69,.536,.511,25,31,.806,4,22,26,43,8,3,20,20,114
21320,UTA,2018,Georges Niang,24,9,0,32,4,11,.364,0,4,.000,4,7,.571,.364,1,2,.500,3,6,9,3,2,0,3,1,9
21321,UTA,2018,Tony Bradley,20,9,0,29,3,11,.273,0,1,.000,3,10,.300,.273,2,2,1.000,4,7,11,1,0,0,0,1,8
21322,UTA,2018,Nate Wolters,26,5,0,19,1,6,.167,0,0,,1,6,.167,.167,0,0,,1,1,2,1,0,0,0,1,2
21323,UTA,2018,David Stockton,26,3,0,9,2,3,.667,2,3,.667,0,0,,1.000,4,4,1.000,0,0,0,0,0,0,1,3,10
21324,UTA,2018,Erik McCree,24,4,0,8,0,2,.000,0,1,.000,0,1,.000,.000,0,0,,0,1,1,0,1,0,1,0,0
21325,UTA,2018,Naz Mitrou-Long,24,1,0,1,1,1,1.000,1,1,1.000,0,0,,1.500,0,0,,0,0,0,0,0,0,0,0,3
21326,UTA,2017,Rudy Gobert,24,81,81,2744,413,625,.661,0,1,.000,413,624,.662,.661,311,476,.653,314,721,1035,97,49,214,147,246,1137
21327,UTA,2017,Gordon Hayward,26,73,73,2516,545,1156,.471,149,374,.398,396,782,.506,.536,362,429,.844,49,345,394,252,73,20,140,117,1601
21328,UTA,2017,Joe Ingles,29,82,26,1972,204,451,.452,123,279,.441,81,172,.471,.589,50,68,.735,23,238,261,225,96,8,107,163,581
21329,UTA,2017,Joe Johnson,35,78,14,1843,273,626,.436,106,258,.411,167,368,.454,.521,63,77,.818,33,210,243,144,36,18,69,93,715
21330,UTA,2017,Rodney Hood,24,59,55,1593,272,666,.408,114,307,.371,158,359,.440,.494,90,115,.783,16,186,202,96,38,11,65,132,748
21331,UTA,2017,George Hill,30,49,49,1544,289,606,.477,94,233,.403,195,373,.523,.554,157,196,.801,23,144,167,204,50,11,85,114,829
21332,UTA,2017,Boris Diaw,34,73,33,1283,146,327,.446,20,81,.247,126,246,.512,.477,26,35,.743,46,112,158,170,18,9,87,83,338
21333,UTA,2017,Dante Exum,21,66,26,1228,155,363,.427,44,149,.295,111,214,.519,.488,58,73,.795,30,102,132,111,21,12,80,146,412
21334,UTA,2017,Shelvin Mack,26,55,9,1205,170,381,.446,37,120,.308,133,261,.510,.495,53,77,.688,20,105,125,154,42,3,90,100,430
21335,UTA,2017,Derrick Favors,25,50,39,1186,203,417,.487,3,10,.300,200,407,.491,.490,67,109,.615,92,213,305,56,45,40,60,103,476
21336,UTA,2017,Trey Lyles,21,71,4,1158,159,439,.362,65,204,.319,94,235,.400,.436,57,79,.722,48,187,235,69,26,20,64,97,440
21337,UTA,2017,Alec Burks,25,42,0,653,99,248,.399,25,76,.329,74,172,.430,.450,60,78,.769,17,103,120,30,18,5,35,50,283
21338,UTA,2017,Jeff Withey,26,51,1,432,55,103,.534,0,1,.000,55,102,.539,.534,36,48,.750,52,69,121,7,16,32,14,52,146
21339,UTA,2017,Raul Neto,24,40,0,346,41,91,.451,10,31,.323,31,60,.517,.505,8,9,.889,4,26,30,34,21,5,15,48,100
21340,UTA,2017,Joel Bolomboy,23,12,0,53,9,16,.563,1,4,.250,8,12,.667,.594,3,6,.500,4,13,17,2,1,2,2,1,22
21341,UTA,2016,Gordon Hayward,25,80,80,2893,521,1202,.433,143,410,.349,378,792,.477,.493,393,477,.824,61,336,397,296,95,27,202,183,1578
21342,UTA,2016,Rodney Hood,23,79,79,2541,408,972,.420,161,449,.359,247,523,.472,.503,172,200,.860,38,229,267,213,73,16,125,202,1149
21343,UTA,2016,Derrick Favors,24,62,59,1983,418,811,.515,0,4,.000,418,807,.518,.515,180,254,.709,169,334,503,94,74,91,104,150,1016
21344,UTA,2016,Rudy Gobert,23,61,60,1932,198,354,.559,0,0,,198,354,.559,.559,161,283,.569,208,460,668,91,45,135,114,163,557
21345,UTA,2016,Trevor Booker,28,79,2,1632,190,388,.490,12,41,.293,178,347,.513,.505,71,106,.670,166,286,452,84,59,41,81,169,463
21346,UTA,2016,Raul Neto,23,81,53,1499,180,418,.431,64,162,.395,116,256,.453,.507,52,70,.743,17,103,120,174,62,2,109,122,476
21347,UTA,2016,Trey Lyles,20,80,33,1382,191,436,.438,49,128,.383,142,308,.461,.494,57,82,.695,59,240,299,59,26,18,65,114,488
21348,UTA,2016,Trey Burke,23,64,0,1366,262,634,.413,88,256,.344,174,378,.460,.483,67,82,.817,18,94,112,148,35,6,80,86,679
21349,UTA,2016,Joe Ingles,28,81,2,1241,124,291,.426,81,210,.386,43,81,.531,.565,13,18,.722,19,132,151,96,55,4,65,98,342
21350,UTA,2016,Shelvin Mack,25,28,27,879,142,320,.444,35,98,.357,107,222,.482,.498,36,49,.735,11,95,106,149,26,3,81,65,355
21351,UTA,2016,Chris Johnson,25,70,2,857,72,194,.371,27,99,.273,45,95,.474,.441,34,42,.810,27,105,132,45,32,20,40,100,205
21352,UTA,2016,Alec Burks,24,31,3,797,137,334,.410,32,79,.405,105,255,.412,.458,106,141,.752,16,93,109,63,18,4,51,71,412
21353,UTA,2016,Jeff Withey,25,51,10,658,87,162,.537,0,2,.000,87,160,.544,.537,43,59,.729,56,117,173,20,21,53,28,75,217
21354,UTA,2016,Elijah Millsap,28,20,0,173,11,39,.282,1,12,.083,10,27,.370,.295,13,18,.722,6,29,35,19,7,3,9,33,36
21355,UTA,2016,Tibor Pleiß,26,12,0,82,11,25,.440,0,2,.000,11,23,.478,.440,2,2,1.000,6,9,15,2,1,2,8,19,24
21356,UTA,2016,Erick Green,24,6,0,35,5,12,.417,1,4,.250,4,8,.500,.458,2,2,1.000,3,2,5,2,1,0,0,4,13
21357,UTA,2016,J.J. O'Brien,23,2,0,6,0,1,.000,0,0,,0,1,.000,.000,0,0,,0,1,1,0,1,0,0,1,0
21358,UTA,2015,Gordon Hayward,24,76,76,2618,484,1087,.445,120,330,.364,364,757,.481,.500,375,462,.812,54,319,373,313,108,30,206,131,1463
21359,UTA,2015,Trey Burke,22,76,43,2288,370,1005,.368,124,390,.318,246,615,.400,.430,109,145,.752,31,173,204,328,65,15,124,119,973
21360,UTA,2015,Derrick Favors,23,74,74,2280,482,918,.525,1,6,.167,481,912,.527,.526,222,332,.669,196,411,607,112,60,123,121,210,1187
21361,UTA,2015,Rudy Gobert,22,82,37,2158,258,427,.604,0,2,.000,258,425,.607,.604,170,273,.623,265,510,775,109,64,189,111,175,686
21362,UTA,2015,Dante Exum,19,82,41,1817,145,416,.349,83,264,.314,62,152,.408,.448,20,32,.625,27,104,131,198,41,14,118,147,393
21363,UTA,2015,Joe Ingles,27,79,32,1673,147,354,.415,72,202,.356,75,152,.493,.517,30,40,.750,22,153,175,182,72,10,98,124,396
21364,UTA,2015,Trevor Booker,27,79,5,1564,226,464,.487,29,84,.345,197,380,.518,.518,86,148,.581,139,258,397,83,43,41,88,144,567
21365,UTA,2015,Enes Freedom,22,49,48,1326,286,582,.491,13,41,.317,273,541,.505,.503,93,118,.788,147,237,384,26,23,16,93,114,678
21366,UTA,2015,Rodney Hood,22,50,21,1064,155,374,.414,62,170,.365,93,204,.456,.497,61,80,.763,9,108,117,83,30,12,45,119,433
21367,UTA,2015,Elijah Millsap,27,47,5,924,81,238,.340,28,90,.311,53,148,.358,.399,58,86,.674,28,122,150,58,56,16,67,124,248
21368,UTA,2015,Alec Burks,23,27,27,899,121,300,.403,26,68,.382,95,232,.409,.447,106,129,.822,19,95,114,82,17,5,52,64,374
21369,UTA,2015,Jeremy Evans,27,38,0,266,32,58,.552,2,5,.400,30,53,.566,.569,24,29,.828,26,45,71,13,11,12,5,29,90
21370,UTA,2015,Chris Johnson,24,12,0,211,31,64,.484,13,38,.342,18,26,.692,.586,6,6,1.000,3,15,18,7,12,0,6,18,81
21371,UTA,2015,Ian Clark,23,23,0,161,15,44,.341,9,25,.360,6,19,.316,.443,5,5,1.000,4,9,13,10,6,2,7,12,44
21372,UTA,2015,Bryce Cotton,22,15,0,159,29,69,.420,7,20,.350,22,49,.449,.471,15,18,.833,3,15,18,15,4,0,12,6,80
21373,UTA,2015,Steve Novak,31,22,0,109,16,35,.457,16,33,.485,0,2,.000,.686,0,2,.000,1,15,16,6,0,1,3,13,48
21374,UTA,2015,Jack Cooley,23,16,0,87,9,22,.409,0,0,,9,22,.409,.409,9,21,.429,10,15,25,1,6,3,3,23,27
21375,UTA,2015,Elliot Williams,25,5,0,42,6,13,.462,5,7,.714,1,6,.167,.654,1,2,.500,0,3,3,4,2,0,4,1,18
21376,UTA,2015,Patrick Christopher,26,4,1,29,3,12,.250,0,4,.000,3,8,.375,.250,0,0,,2,4,6,0,1,0,1,6,6
21377,UTA,2015,Grant Jerrett,21,3,0,26,4,9,.444,0,2,.000,4,7,.571,.444,1,1,1.000,1,4,5,2,2,0,1,4,9
21378,UTA,2015,Jerrelle Benimon,23,2,0,3,0,0,,0,0,,0,0,,,0,0,,1,2,3,0,0,0,1,0,0
21379,UTA,2015,Toure' Murry,25,1,0,1,0,1,.000,0,0,,0,1,.000,.000,0,0,,0,0,0,0,0,0,0,0,0
21380,UTA,2014,Gordon Hayward,23,77,77,2800,426,1032,.413,85,280,.304,341,752,.453,.454,311,381,.816,62,329,391,400,110,40,212,155,1248
21381,UTA,2014,Trey Burke,21,70,68,2262,341,897,.380,111,336,.330,230,561,.410,.442,102,113,.903,37,171,208,396,42,6,131,145,895
21382,UTA,2014,Richard Jefferson,33,82,78,2213,294,654,.450,123,301,.409,171,353,.484,.544,120,162,.741,18,201,219,130,56,14,94,168,831
21383,UTA,2014,Derrick Favors,22,73,73,2201,390,747,.522,0,1,.000,390,746,.523,.522,190,284,.669,199,438,637,91,75,108,129,236,970
21384,UTA,2014,Alec Burks,22,78,12,2193,380,831,.457,50,143,.350,330,688,.480,.487,279,373,.748,59,198,257,212,69,14,149,190,1089
21385,UTA,2014,Enes Freedom,21,80,37,2138,419,853,.491,0,1,.000,419,852,.492,.491,149,204,.730,222,376,598,75,28,42,144,230,987
21386,UTA,2014,Marvin Williams,27,66,50,1674,231,526,.439,84,234,.359,147,292,.503,.519,57,73,.781,82,252,334,78,54,31,53,151,603
21387,UTA,2014,Jeremy Evans,26,66,4,1209,175,332,.527,0,2,.000,175,330,.530,.527,51,75,.680,120,190,310,44,42,46,40,139,401
21388,UTA,2014,Diante Garrett,25,71,0,1048,101,265,.381,36,96,.375,65,169,.385,.449,10,12,.833,11,86,97,120,41,5,75,75,248
21389,UTA,2014,John Lucas III,31,42,6,591,62,190,.326,25,84,.298,37,106,.349,.392,10,16,.625,12,27,39,42,14,0,22,41,159
21390,UTA,2014,Rudy Gobert,21,45,0,434,36,74,.486,0,0,,36,74,.486,.486,32,65,.492,51,104,155,7,8,41,32,57,104
21391,UTA,2014,Brandon Rush,28,38,0,418,30,90,.333,16,47,.340,14,43,.326,.422,3,5,.600,5,39,44,24,5,9,20,31,79
21392,UTA,2014,Mike Harris,30,20,0,225,29,61,.475,0,2,.000,29,59,.492,.475,26,27,.963,15,18,33,5,16,7,11,36,84
21393,UTA,2014,Ian Clark,22,23,0,172,26,67,.388,11,31,.355,15,36,.417,.470,5,7,.714,3,16,19,15,8,2,14,24,68
21394,UTA,2014,Jamaal Tinsley,35,8,5,110,4,20,.200,1,15,.067,3,5,.600,.225,0,0,,2,9,11,23,2,0,9,10,9
21395,UTA,2014,Malcolm Thomas,25,7,0,48,6,12,.500,1,4,.250,5,8,.625,.542,0,0,,4,8,12,2,0,1,8,5,13
21396,UTA,2014,Andris Biedriņš,27,6,0,45,1,1,1.000,0,0,,1,1,1.000,1.000,1,6,.167,2,15,17,0,0,0,2,6,3
21397,UTA,2013,Al Jefferson,28,78,78,2578,611,1236,.494,2,17,.118,609,1219,.500,.495,167,217,.770,156,564,720,164,80,89,105,170,1391
21398,UTA,2013,Paul Millsap,27,78,78,2375,429,875,.490,13,39,.333,416,836,.498,.498,264,356,.742,177,377,554,201,102,80,138,232,1135
21399,UTA,2013,Randy Foye,29,82,72,2249,293,738,.397,178,434,.410,115,304,.378,.518,118,144,.819,17,110,127,167,66,27,92,190,882
21400,UTA,2013,Gordon Hayward,22,72,27,2104,336,773,.435,102,246,.415,234,527,.444,.501,243,294,.827,51,174,225,213,58,38,120,125,1017
21401,UTA,2013,Derrick Favors,21,77,8,1787,274,568,.482,0,5,.000,274,563,.487,.482,179,260,.688,184,362,546,75,67,130,129,247,727
21402,UTA,2013,Marvin Williams,26,73,51,1727,199,470,.423,54,166,.325,145,304,.477,.481,77,99,.778,55,208,263,77,37,38,60,98,529
21403,UTA,2013,Mo Williams,30,46,46,1418,229,533,.430,59,154,.383,170,379,.449,.485,75,85,.882,24,86,110,285,46,9,125,105,592
21404,UTA,2013,Jamaal Tinsley,34,66,32,1221,86,234,.368,39,127,.307,47,107,.439,.451,18,26,.692,17,98,115,290,64,14,106,106,229
21405,UTA,2013,Alec Burks,21,64,0,1137,163,388,.420,33,92,.359,130,296,.439,.463,92,129,.713,37,108,145,92,35,13,74,114,451
21406,UTA,2013,DeMarre Carroll,26,66,12,1111,149,324,.460,20,70,.286,129,254,.508,.491,75,98,.765,87,101,188,61,58,24,34,119,393
21407,UTA,2013,Enes Freedom,20,70,2,1078,206,379,.544,1,1,1.000,205,378,.542,.545,93,117,.795,135,169,304,31,28,32,101,116,506
21408,UTA,2013,Earl Watson,33,48,4,829,37,120,.308,5,28,.179,32,92,.348,.329,17,25,.680,23,64,87,190,40,8,69,94,96
21409,UTA,2013,Jeremy Evans,25,37,0,215,27,44,.614,0,1,.000,27,43,.628,.614,21,33,.636,26,32,58,11,8,13,8,30,75
21410,UTA,2013,Kevin Murphy,22,17,0,52,7,28,.250,1,5,.200,6,23,.261,.268,0,0,,0,4,4,2,1,0,3,4,15
21411,UTA,2012,Paul Millsap,26,64,62,2100,426,861,.495,7,31,.226,419,830,.505,.499,202,255,.792,180,383,563,150,118,52,112,222,1061
21412,UTA,2012,Al Jefferson,27,61,61,2075,516,1048,.492,1,4,.250,515,1044,.493,.493,137,177,.774,133,452,585,134,47,101,62,155,1170
21413,UTA,2012,Gordon Hayward,21,66,58,2015,267,586,.456,55,159,.346,212,427,.496,.503,193,232,.832,59,171,230,207,53,41,109,106,782
21414,UTA,2012,Devin Harris,28,63,63,1741,241,542,.445,77,213,.362,164,329,.498,.516,156,209,.746,12,100,112,316,64,13,122,136,715
21415,UTA,2012,Derrick Favors,20,65,9,1376,222,445,.499,0,0,,222,445,.499,.499,126,194,.649,158,267,425,43,38,65,103,145,570
21416,UTA,2012,C.J. Miles,24,56,14,1145,177,465,.381,46,150,.307,131,315,.416,.430,108,136,.794,27,89,116,69,46,18,53,122,508
21417,UTA,2012,Earl Watson,32,50,2,1033,54,160,.338,10,52,.192,44,108,.407,.369,31,46,.674,30,91,121,217,54,22,85,105,149
21418,UTA,2012,Josh Howard,31,43,18,991,144,361,.399,9,37,.243,135,324,.417,.411,75,97,.773,39,119,158,50,32,10,53,91,372
21419,UTA,2012,Alec Burks,20,59,0,939,153,357,.429,15,45,.333,138,312,.442,.450,104,143,.727,57,75,132,55,27,5,51,84,425
21420,UTA,2012,Enes Freedom,19,66,0,874,117,236,.496,0,1,.000,117,235,.498,.496,70,105,.667,107,171,278,8,18,23,54,87,304
21421,UTA,2012,Raja Bell,35,34,33,796,81,174,.466,34,87,.391,47,87,.540,.563,21,25,.840,6,43,49,38,13,2,21,78,217
21422,UTA,2012,Jamaal Tinsley,33,37,1,507,57,141,.404,10,37,.270,47,104,.452,.440,13,17,.765,6,39,45,123,17,8,52,47,137
21423,UTA,2012,DeMarre Carroll,25,20,9,327,37,99,.374,7,19,.368,30,80,.375,.409,14,16,.875,28,22,50,15,12,1,9,36,95
21424,UTA,2012,Jeremy Evans,24,29,0,217,27,42,.643,0,1,.000,27,41,.659,.643,8,16,.500,19,31,50,13,6,24,5,23,62
21425,UTA,2012,Blake Ahearn,27,4,0,30,4,14,.286,2,9,.222,2,5,.400,.357,0,0,,0,2,2,1,0,0,5,4,10
21426,UTA,2011,Al Jefferson,26,82,82,2940,654,1319,.496,0,0,,654,1319,.496,.496,220,289,.761,235,559,794,149,46,153,105,238,1528
21427,UTA,2011,Paul Millsap,25,76,76,2605,525,988,.531,9,23,.391,516,965,.535,.536,256,338,.757,164,415,579,187,103,69,145,272,1315
21428,UTA,2011,Raja Bell,34,68,63,2097,191,467,.409,68,193,.352,123,274,.449,.482,91,102,.892,31,145,176,118,56,14,63,169,541
21429,UTA,2011,Deron Williams,26,53,53,2009,369,806,.458,89,258,.345,280,548,.511,.513,302,354,.853,32,173,205,514,64,12,187,152,1129
21430,UTA,2011,Andrei Kirilenko,29,64,62,1999,253,542,.467,36,98,.367,217,444,.489,.500,208,270,.770,100,227,327,192,81,74,117,113,750
21431,UTA,2011,C.J. Miles,23,78,19,1969,366,899,.407,109,339,.322,257,560,.459,.468,159,196,.811,54,201,255,135,74,38,93,221,1000
21432,UTA,2011,Earl Watson,31,80,13,1567,126,307,.410,36,107,.336,90,200,.450,.469,55,82,.671,52,130,182,278,61,17,116,146,343
21433,UTA,2011,Gordon Hayward,20,72,17,1218,142,293,.485,35,74,.473,107,219,.489,.544,69,97,.711,41,98,139,81,30,19,70,106,388
21434,UTA,2011,Ronnie Price,27,59,0,717,74,210,.352,20,69,.290,54,141,.383,.400,29,39,.744,22,39,61,56,42,5,55,106,197
21435,UTA,2011,Francisco Elson,34,62,1,610,54,113,.478,0,0,,54,113,.478,.478,26,31,.839,35,80,115,33,21,14,32,84,134
21436,UTA,2011,Devin Harris,27,17,16,530,83,201,.413,25,70,.357,58,131,.443,.475,77,95,.811,6,34,40,92,13,2,49,33,268
21437,UTA,2011,Jeremy Evans,23,49,3,463,76,115,.661,0,1,.000,76,114,.667,.661,26,37,.703,36,61,97,24,17,17,19,50,178
21438,UTA,2011,Kyrylo Fesenko,24,53,1,456,44,100,.440,0,1,.000,44,99,.444,.440,18,46,.391,34,74,108,18,4,16,25,90,106
21439,UTA,2011,Derrick Favors,19,22,4,444,74,140,.529,0,0,,74,140,.529,.529,32,57,.561,45,70,115,18,11,27,21,63,180
21440,UTA,2011,Mehmet Okur,31,13,0,168,22,62,.355,5,16,.313,17,46,.370,.395,15,20,.750,9,21,30,19,4,4,7,18,64
21441,UTA,2011,Kyle Weaver,24,5,0,69,9,25,.360,3,7,.429,6,18,.333,.420,7,8,.875,2,8,10,7,2,2,7,3,28
21442,UTA,2011,Marcus Cousin,24,4,0,18,2,3,.667,0,0,,2,3,.667,.667,0,0,,0,3,3,0,0,1,1,1,4
21443,UTA,2010,Deron Williams,25,76,76,2802,494,1053,.469,96,259,.371,398,794,.501,.515,335,418,.801,50,253,303,798,96,16,252,208,1419
21444,UTA,2010,Carlos Boozer,28,78,78,2673,617,1098,.562,0,0,,617,1098,.562,.562,285,384,.742,181,693,874,247,84,36,212,270,1519
21445,UTA,2010,Paul Millsap,24,82,8,2277,385,716,.538,1,9,.111,384,707,.543,.538,183,264,.693,186,373,559,131,64,99,116,285,954
21446,UTA,2010,Mehmet Okur,30,73,73,2149,355,775,.458,82,213,.385,273,562,.486,.511,196,239,.820,132,383,515,119,38,81,127,223,988
21447,UTA,2010,Wesley Matthews,23,82,48,2025,273,565,.483,63,165,.382,210,400,.525,.539,160,193,.829,50,141,191,124,64,15,93,152,769
21448,UTA,2010,Andrei Kirilenko,28,58,35,1681,244,482,.506,26,89,.292,218,393,.555,.533,174,234,.744,76,188,264,158,83,71,79,102,688
21449,UTA,2010,Ronnie Brewer,24,53,53,1662,206,416,.495,8,31,.258,198,385,.514,.505,81,128,.633,44,136,180,151,85,15,51,80,501
21450,UTA,2010,C.J. Miles,22,63,28,1497,241,562,.429,74,217,.341,167,345,.484,.495,66,95,.695,42,126,168,105,58,17,81,190,622
21451,UTA,2010,Kyle Korver,28,52,0,952,138,280,.493,59,110,.536,79,170,.465,.598,39,49,.796,10,101,111,89,26,12,42,76,374
21452,UTA,2010,Ronnie Price,26,60,4,806,98,242,.405,18,63,.286,80,179,.447,.442,41,59,.695,28,46,74,123,40,13,56,109,255
21453,UTA,2010,Kyrylo Fesenko,23,49,5,408,52,95,.547,0,1,.000,52,94,.553,.547,24,57,.421,33,57,90,15,6,19,24,78,128
21454,UTA,2010,Eric Maynor,22,26,2,363,52,133,.391,5,24,.208,47,109,.431,.410,25,33,.758,10,28,38,81,13,2,28,33,134
21455,UTA,2010,Sundiata Gaines,23,32,0,217,38,82,.463,7,26,.269,31,56,.554,.506,23,46,.500,6,23,29,39,12,0,14,17,106
21456,UTA,2010,Kosta Koufos,20,36,0,172,22,47,.468,0,0,,22,47,.468,.468,9,15,.600,16,29,45,6,2,4,15,26,53
21457,UTA,2010,Othyus Jeffers,24,14,0,73,12,29,.414,0,0,,12,29,.414,.414,13,19,.684,8,11,19,1,4,0,6,10,37
21458,UTA,2009,Ronnie Brewer,23,81,80,2605,421,828,.508,22,85,.259,399,743,.537,.522,247,352,.702,101,199,300,179,138,30,110,128,1111
21459,UTA,2009,Deron Williams,24,68,68,2505,463,984,.471,70,226,.310,393,758,.518,.506,326,384,.849,24,171,195,725,73,20,228,134,1322
21460,UTA,2009,Mehmet Okur,29,72,72,2409,431,888,.485,90,202,.446,341,686,.497,.536,273,334,.817,124,433,557,120,54,53,132,219,1225
21461,UTA,2009,Paul Millsap,23,76,38,2290,400,749,.534,0,4,.000,400,745,.537,.534,228,326,.699,251,403,654,138,78,73,129,288,1028
21462,UTA,2009,Kyle Korver,27,78,2,1874,245,560,.438,103,267,.386,142,293,.485,.529,112,127,.882,35,223,258,137,47,30,90,170,705
21463,UTA,2009,Andrei Kirilenko,27,67,10,1831,256,570,.449,20,73,.274,236,497,.475,.467,244,311,.785,84,235,319,175,83,77,121,127,776
21464,UTA,2009,C.J. Miles,21,72,72,1623,258,562,.459,63,179,.352,195,383,.509,.515,78,89,.876,45,122,167,107,46,15,64,187,657
21465,UTA,2009,Carlos Boozer,27,37,37,1197,251,512,.490,0,0,,251,512,.490,.490,97,139,.698,111,274,385,79,39,7,79,132,599
21466,UTA,2009,Brevin Knight,33,74,0,938,66,189,.349,0,6,.000,66,183,.361,.349,48,64,.750,13,75,88,190,68,4,66,98,180
21467,UTA,2009,Ronnie Price,25,52,17,738,77,203,.379,19,61,.311,58,142,.408,.426,34,45,.756,12,57,69,108,39,5,61,74,207
21468,UTA,2009,Matt Harpring,32,63,2,693,111,241,.461,0,2,.000,111,239,.464,.461,55,72,.764,47,76,123,28,29,9,29,102,277
21469,UTA,2009,Kosta Koufos,19,48,7,565,94,185,.508,0,0,,94,185,.508,.508,36,51,.706,50,88,138,20,12,31,26,70,224
21470,UTA,2009,Morris Almond,23,25,1,255,33,81,.407,5,17,.294,28,64,.438,.438,21,26,.808,9,27,36,7,4,4,16,31,92
21471,UTA,2009,Jarron Collins,30,26,3,201,16,35,.457,0,0,,16,35,.457,.457,8,11,.727,20,17,37,7,2,1,9,35,40
21472,UTA,2009,Kyrylo Fesenko,22,21,1,156,21,36,.583,0,0,,21,36,.583,.583,7,21,.333,14,23,37,4,7,15,9,35,49
21473,UTA,2008,Deron Williams,23,82,82,3059,566,1117,.507,83,210,.395,483,907,.533,.544,330,411,.803,34,209,243,862,90,23,279,200,1545
21474,UTA,2008,Carlos Boozer,26,81,81,2827,709,1297,.547,0,1,.000,709,1296,.547,.547,290,393,.738,197,647,844,233,100,41,210,293,1708
21475,UTA,2008,Mehmet Okur,28,72,72,2390,374,841,.445,114,294,.388,260,547,.475,.512,185,230,.804,132,424,556,145,55,29,104,236,1047
21476,UTA,2008,Andrei Kirilenko,26,72,72,2217,275,544,.506,44,116,.379,231,428,.540,.546,198,257,.770,121,218,339,285,86,109,140,165,792
21477,UTA,2008,Ronnie Brewer,22,76,76,2088,354,634,.558,11,50,.220,343,584,.587,.567,195,257,.759,97,121,218,134,129,19,69,110,914
21478,UTA,2008,Paul Millsap,22,82,2,1702,253,502,.504,0,4,.000,253,498,.508,.504,155,229,.677,167,293,460,81,72,73,87,269,661
21479,UTA,2008,Matt Harpring,31,76,0,1374,237,474,.500,2,10,.200,235,464,.506,.502,146,205,.712,96,144,240,82,45,14,95,162,622
21480,UTA,2008,Kyle Korver,26,50,0,1075,165,348,.474,73,188,.388,92,160,.575,.579,88,96,.917,9,90,99,68,22,23,47,125,491
21481,UTA,2008,Jarron Collins,29,70,9,702,36,82,.439,0,1,.000,36,81,.444,.439,46,74,.622,40,76,116,37,10,6,22,106,118
21482,UTA,2008,C.J. Miles,20,60,13,689,113,236,.479,30,77,.390,83,159,.522,.542,41,52,.788,16,62,78,53,32,8,27,98,297
21483,UTA,2008,Jason Hart,29,57,0,606,58,180,.322,11,31,.355,47,149,.315,.353,38,45,.844,5,50,55,86,30,3,28,75,165
21484,UTA,2008,Ronnie Price,24,61,3,588,88,204,.431,26,75,.347,62,129,.481,.495,26,38,.684,8,38,46,78,32,3,30,83,228
21485,UTA,2008,Gordan Giriček,30,22,0,279,41,102,.402,12,34,.353,29,68,.426,.461,1,1,1.000,6,25,31,16,13,1,21,24,95
21486,UTA,2008,Kyrylo Fesenko,21,9,0,70,6,16,.375,0,0,,6,16,.375,.375,2,4,.500,14,11,25,2,0,3,8,19,14
21487,UTA,2008,Morris Almond,22,9,0,39,4,15,.267,1,4,.250,3,11,.273,.300,4,6,.667,0,2,2,3,1,0,2,5,13
21488,UTA,2007,Deron Williams,22,80,80,2950,494,1083,.456,82,255,.322,412,828,.498,.494,227,296,.767,41,226,267,745,78,13,246,254,1297
21489,UTA,2007,Mehmet Okur,27,80,80,2664,490,1061,.462,129,336,.384,361,725,.498,.523,296,387,.765,160,419,579,156,36,38,125,257,1405
21490,UTA,2007,Carlos Boozer,25,74,74,2557,647,1154,.561,0,0,,647,1154,.561,.561,255,372,.685,235,632,867,221,70,21,194,217,1549
21491,UTA,2007,Derek Fisher,32,82,61,2287,258,675,.382,48,156,.308,210,519,.405,.418,262,307,.853,30,119,149,274,83,6,120,234,826
21492,UTA,2007,Andrei Kirilenko,25,70,70,2049,197,418,.471,16,75,.213,181,343,.528,.490,174,239,.728,88,241,329,202,74,144,135,172,584
21493,UTA,2007,Matt Harpring,30,77,2,1965,322,656,.491,13,39,.333,309,617,.501,.501,237,309,.767,117,236,353,99,52,11,118,232,894
21494,UTA,2007,Paul Millsap,21,82,1,1472,209,398,.525,1,3,.333,208,395,.527,.526,140,208,.673,183,240,423,62,67,74,94,236,559
21495,UTA,2007,Gordan Giriček,29,61,6,1188,176,381,.462,52,122,.426,124,259,.479,.530,71,87,.816,24,105,129,63,28,5,64,122,475
21496,UTA,2007,Jarron Collins,28,82,9,913,75,170,.441,0,0,,75,170,.441,.441,54,83,.651,71,100,171,60,13,8,37,147,204
21497,UTA,2007,Ronnie Brewer,21,56,14,675,102,193,.528,0,9,.000,102,184,.554,.528,56,83,.675,37,38,75,24,37,6,24,44,260
21498,UTA,2007,Dee Brown,22,49,0,450,32,98,.327,6,28,.214,26,70,.371,.357,24,37,.649,8,32,40,83,22,7,31,51,94
21499,UTA,2007,C.J. Miles,19,37,13,373,40,116,.345,7,32,.219,33,84,.393,.375,14,23,.609,11,24,35,25,11,4,28,60,101
21500,UTA,2007,Rafael Araújo,26,28,0,248,27,65,.415,0,0,,27,65,.415,.415,18,29,.621,22,44,66,10,6,2,17,39,72
21501,UTA,2007,Roger Powell,24,3,0,13,0,3,.000,0,1,.000,0,2,.000,.000,2,2,1.000,3,0,3,0,0,0,3,2,2
21502,UTA,2007,Lou Amundson,24,1,0,2,0,0,,0,0,,0,0,,,0,0,,0,0,0,0,0,0,0,0,0
21503,UTA,2006,Mehmet Okur,26,82,82,2945,519,1128,.460,80,234,.342,439,894,.491,.496,354,454,.780,211,535,746,194,40,73,163,285,1472
21504,UTA,2006,Andrei Kirilenko,24,69,63,2604,336,730,.460,36,117,.308,300,613,.489,.485,346,495,.699,161,391,552,299,102,220,203,162,1054
21505,UTA,2006,Deron Williams,21,80,47,2307,339,805,.421,91,219,.416,248,586,.423,.478,95,135,.704,35,159,194,359,60,17,145,233,864
21506,UTA,2006,Matt Harpring,29,71,32,1944,322,678,.475,14,39,.359,308,639,.482,.485,227,313,.725,158,210,368,98,59,14,109,202,885
21507,UTA,2006,Jarron Collins,27,79,41,1730,129,280,.461,0,0,,129,280,.461,.461,157,219,.717,134,199,333,97,36,27,61,252,415
21508,UTA,2006,Devin Brown,27,81,14,1711,207,527,.393,39,118,.331,168,409,.411,.430,158,212,.745,73,134,207,104,44,14,99,153,611
21509,UTA,2006,Milt Palacio,27,71,18,1376,171,403,.424,1,16,.063,170,387,.439,.426,98,150,.653,17,117,134,190,47,14,110,125,441
21510,UTA,2006,Keith McLeod,26,66,32,1232,120,340,.353,24,82,.293,96,258,.372,.388,106,133,.797,11,67,78,151,42,9,76,131,370
21511,UTA,2006,Carlos Boozer,24,33,19,1025,219,399,.549,0,0,,219,399,.549,.549,99,137,.723,73,212,285,88,30,8,69,105,537
21512,UTA,2006,Gordan Giriček,28,37,36,956,166,383,.433,18,59,.305,148,324,.457,.457,43,57,.754,15,55,70,63,16,4,63,87,393
21513,UTA,2006,Greg Ostertag,32,60,22,807,61,124,.492,0,0,,61,124,.492,.492,24,48,.500,82,143,225,58,6,66,46,129,146
21514,UTA,2006,Kris Humphries,20,62,2,619,77,203,.379,0,5,.000,77,198,.389,.379,34,65,.523,56,101,157,30,23,16,31,82,188
21515,UTA,2006,Robert Whaley,23,23,0,212,23,57,.404,0,0,,23,57,.404,.404,3,6,.500,16,27,43,17,7,8,14,41,49
21516,UTA,2006,Andre Owens,25,23,2,210,27,74,.365,3,16,.188,24,58,.414,.385,12,18,.667,11,10,21,8,5,0,13,25,69
21517,UTA,2006,C.J. Miles,18,23,0,203,28,76,.368,5,20,.250,23,56,.411,.401,18,24,.750,18,20,38,16,7,2,9,20,79
21518,UTA,2005,Matt Harpring,28,78,55,2584,418,855,.489,9,43,.209,409,812,.504,.494,245,315,.778,196,284,480,142,70,16,133,250,1090
21519,UTA,2005,Mehmet Okur,25,82,25,2304,354,756,.468,17,63,.270,337,693,.486,.479,329,387,.850,194,422,616,166,32,68,141,227,1054
21520,UTA,2005,Raja Bell,28,63,32,1790,303,667,.454,54,134,.403,249,533,.467,.495,112,150,.747,48,153,201,91,44,8,79,205,772
21521,UTA,2005,Carlos Boozer,23,51,51,1772,361,693,.521,0,1,.000,361,692,.522,.521,187,268,.698,141,316,457,144,41,24,137,179,909
21522,UTA,2005,Gordan Giriček,27,81,44,1660,283,632,.448,38,105,.362,245,527,.465,.478,111,137,.810,25,157,182,137,46,11,90,155,715
21523,UTA,2005,Howard Eisley,32,74,1,1428,161,405,.398,27,103,.262,134,302,.444,.431,66,83,.795,15,75,90,250,45,9,111,156,415
21524,UTA,2005,Keith McLeod,25,53,47,1382,143,408,.350,18,72,.250,125,336,.372,.373,112,146,.767,20,93,113,236,63,12,99,138,416
21525,UTA,2005,Andrei Kirilenko,23,41,37,1349,207,420,.493,23,77,.299,184,343,.536,.520,203,259,.784,89,166,255,132,67,136,90,101,640
21526,UTA,2005,Jarron Collins,26,50,38,961,65,157,.414,0,1,.000,65,156,.417,.414,83,119,.697,57,107,164,61,11,6,34,146,213
21527,UTA,2005,Kirk Snyder,21,68,7,906,122,328,.372,30,85,.353,92,243,.379,.418,64,96,.667,50,71,121,36,26,19,58,116,338
21528,UTA,2005,Kris Humphries,19,67,4,873,116,287,.404,2,6,.333,114,281,.406,.408,44,101,.436,73,124,197,43,25,18,52,96,278
21529,UTA,2005,Curtis Borchardt,24,67,23,859,74,172,.430,0,0,,74,172,.430,.430,52,71,.732,86,138,224,49,10,32,52,160,200
21530,UTA,2005,Carlos Arroyo,25,30,16,742,93,232,.401,7,18,.389,86,214,.402,.416,53,63,.841,11,35,46,152,20,3,55,67,246
21531,UTA,2005,Raül López,24,31,15,518,57,135,.422,20,45,.444,37,90,.411,.496,27,33,.818,7,32,39,123,22,3,47,78,161
21532,UTA,2005,Ben Handlogten,31,21,5,297,43,83,.518,0,1,.000,43,82,.524,.518,9,17,.529,23,42,65,13,7,5,18,55,95
21533,UTA,2005,Randy Livingston,29,17,4,227,22,52,.423,5,8,.625,17,44,.386,.471,15,17,.882,3,9,12,45,12,2,14,28,64
21534,UTA,2005,Aleksandar Radojević,28,12,6,128,6,19,.316,0,0,,6,19,.316,.316,7,10,.700,9,19,28,6,0,2,15,32,19
21535,UTA,2004,Andrei Kirilenko,22,78,78,2895,412,931,.443,68,201,.338,344,730,.471,.479,392,496,.790,226,403,629,244,150,215,215,174,1284
21536,UTA,2004,Greg Ostertag,30,78,51,2153,208,437,.476,0,1,.000,208,436,.477,.476,113,195,.579,221,357,578,123,30,139,99,228,529
21537,UTA,2004,Raja Bell,27,82,4,2020,329,805,.409,62,166,.373,267,639,.418,.447,195,248,.786,60,181,241,107,63,13,111,262,915
21538,UTA,2004,Carlos Arroyo,24,71,71,2008,339,768,.441,38,117,.325,301,651,.462,.466,181,225,.804,41,144,185,355,63,5,156,165,897
21539,UTA,2004,Jarron Collins,25,81,31,1732,147,295,.498,0,1,.000,147,294,.500,.498,188,262,.718,117,199,316,77,26,18,79,255,482
21540,UTA,2004,Raül López,23,82,11,1617,223,517,.431,25,85,.294,198,432,.458,.456,101,117,.863,24,131,155,305,62,2,174,200,572
21541,UTA,2004,DeShawn Stevenson,22,54,54,1511,261,586,.445,7,30,.233,254,556,.457,.451,89,133,.669,43,135,178,92,28,16,80,86,618
21542,UTA,2004,Sasha Pavlović,20,79,14,1144,149,376,.396,19,70,.271,130,306,.425,.422,65,84,.774,44,115,159,60,41,16,67,187,382
21543,UTA,2004,Matt Harpring,27,31,31,1134,193,410,.471,8,33,.242,185,377,.491,.480,108,157,.688,91,156,247,63,22,2,65,102,502
21544,UTA,2004,Mo Williams,21,57,0,772,115,303,.380,10,39,.256,105,264,.398,.396,44,56,.786,23,49,72,76,28,2,51,87,284
21545,UTA,2004,Michael Ruffin,27,41,23,733,38,117,.325,0,0,,38,117,.325,.325,16,38,.421,78,129,207,41,22,21,42,103,92
21546,UTA,2004,Gordan Giriček,26,25,18,606,128,297,.431,14,39,.359,114,258,.442,.455,68,77,.883,14,48,62,42,15,5,40,46,338
21547,UTA,2004,Tom Gugliotta,34,25,24,515,39,104,.375,1,3,.333,38,101,.376,.380,14,20,.700,50,81,131,42,17,8,19,47,93
21548,UTA,2004,Mikki Moore,28,28,0,385,49,94,.521,0,0,,49,94,.521,.521,30,35,.857,28,54,82,19,7,13,22,64,128
21549,UTA,2004,Curtis Borchardt,23,16,0,258,22,56,.393,0,1,.000,22,55,.400,.393,14,18,.778,13,41,54,15,4,14,18,40,58
21550,UTA,2004,Ben Handlogten,30,17,0,172,25,47,.532,0,0,,25,47,.532,.532,18,27,.667,22,33,55,6,3,4,10,32,68
21551,UTA,2004,Paul Grant,30,10,0,98,11,23,.478,0,0,,11,23,.478,.478,3,8,.375,7,10,17,3,1,1,7,17,25
21552,UTA,2004,Keon Clark,28,2,0,27,2,6,.333,0,0,,2,6,.333,.333,0,0,,1,6,7,1,1,0,0,1,4
21553,UTA,2003,Karl Malone,39,81,81,2936,595,1289,.462,3,14,.214,592,1275,.464,.463,474,621,.763,113,515,628,379,136,31,210,204,1667
21554,UTA,2003,Matt Harpring,26,78,69,2557,521,1020,.511,66,160,.413,455,860,.529,.543,262,331,.792,190,324,514,133,73,17,160,217,1370
21555,UTA,2003,Calbert Cheaney,31,81,74,2351,325,651,.499,10,25,.400,315,626,.503,.507,40,69,.580,73,211,284,163,65,13,108,225,700
21556,UTA,2003,John Stockton,40,82,82,2275,309,640,.483,29,80,.363,280,560,.500,.505,237,287,.826,51,150,201,629,137,16,182,184,884
21557,UTA,2003,Andrei Kirilenko,21,80,11,2213,315,642,.491,37,114,.325,278,528,.527,.519,296,370,.800,147,273,420,138,118,175,136,185,963
21558,UTA,2003,Greg Ostertag,29,81,74,1926,169,326,.518,0,0,,169,326,.518,.518,100,196,.510,180,323,503,55,20,147,104,235,438
21559,UTA,2003,Mark Jackson,37,82,0,1467,147,369,.398,27,95,.284,120,274,.438,.435,61,80,.763,34,142,176,375,48,3,152,90,382
21560,UTA,2003,Scott Padgett,26,82,2,1321,170,423,.402,45,133,.338,125,290,.431,.455,81,107,.757,83,189,272,86,41,24,70,148,466
21561,UTA,2003,Tony Massenburg,35,58,1,792,104,232,.448,0,0,,104,232,.448,.448,65,84,.774,59,97,156,17,17,19,50,144,273
21562,UTA,2003,DeShawn Stevenson,21,61,8,760,114,284,.401,4,12,.333,110,272,.404,.408,47,68,.691,22,63,85,40,22,8,49,57,279
21563,UTA,2003,John Amaechi,32,50,1,474,37,118,.314,0,0,,37,118,.314,.314,25,52,.481,26,51,77,21,14,7,34,50,99
21564,UTA,2003,Jarron Collins,24,22,7,421,38,86,.442,0,1,.000,38,85,.447,.442,44,62,.710,32,28,60,14,5,6,19,70,120
21565,UTA,2003,Carlos Arroyo,23,44,0,287,50,109,.459,3,7,.429,47,102,.461,.472,18,22,.818,11,15,26,53,12,1,30,28,121
21566,UTA,2002,Karl Malone,38,80,80,3040,635,1399,.454,9,25,.360,626,1374,.456,.457,509,639,.797,142,544,686,341,152,59,263,229,1788
21567,UTA,2002,John Stockton,39,82,82,2566,401,775,.517,25,78,.321,376,697,.539,.534,275,321,.857,59,204,263,674,152,24,208,209,1102
21568,UTA,2002,Andrei Kirilenko,20,82,40,2151,285,633,.450,25,100,.250,260,533,.488,.470,285,371,.768,149,253,402,94,116,159,108,156,880
21569,UTA,2002,Bryon Russell,31,66,40,1998,222,584,.380,77,226,.341,145,358,.405,.446,115,140,.821,79,216,295,136,64,19,110,205,636
21570,UTA,2002,Donyell Marshall,28,58,42,1750,343,661,.519,13,42,.310,330,619,.533,.529,160,226,.708,158,285,443,101,50,67,124,150,859
21571,UTA,2002,Jarron Collins,23,70,68,1440,158,343,.461,0,1,.000,158,342,.462,.461,134,181,.740,138,158,296,58,29,22,56,234,450
21572,UTA,2002,Scott Padgett,25,75,1,1295,188,395,.476,49,113,.434,139,282,.493,.538,75,102,.735,111,174,285,82,43,13,69,140,500
21573,UTA,2002,DeShawn Stevenson,20,67,23,1134,143,371,.385,2,25,.080,141,346,.408,.388,37,53,.698,44,87,131,116,29,24,68,82,325
21574,UTA,2002,Greg Ostertag,28,74,14,1107,91,201,.453,0,0,,91,201,.453,.453,63,130,.485,125,188,313,50,15,109,51,152,245
21575,UTA,2002,John Starks,36,66,1,929,114,310,.368,29,95,.305,85,215,.395,.415,33,41,.805,15,53,68,70,33,0,52,126,290
21576,UTA,2002,John Crotty,32,41,0,802,98,208,.471,31,69,.449,67,139,.482,.546,57,66,.864,16,59,75,141,19,1,51,77,284
21577,UTA,2002,John Amaechi,31,54,0,586,54,166,.325,0,0,,54,166,.325,.325,67,105,.638,52,57,109,29,7,10,55,64,175
21578,UTA,2002,Rusty LaRue,28,33,0,542,73,185,.395,17,50,.340,56,135,.415,.441,30,35,.857,11,38,49,71,17,7,43,58,193
21579,UTA,2002,Quincy Lewis,24,36,19,490,64,143,.448,3,18,.167,61,125,.488,.458,13,20,.650,10,33,43,36,23,9,32,89,144
21580,UTA,2001,Karl Malone,37,81,81,2895,670,1345,.498,2,5,.400,668,1340,.499,.499,536,676,.793,114,555,669,361,93,62,244,216,1878
21581,UTA,2001,Bryon Russell,30,78,46,2473,308,700,.440,95,230,.413,213,470,.453,.508,222,285,.779,94,236,330,160,96,20,113,229,933
21582,UTA,2001,John Stockton,38,82,82,2397,328,651,.504,61,132,.462,267,519,.514,.551,227,278,.817,54,173,227,713,132,21,203,194,944
21583,UTA,2001,Donyell Marshall,27,81,49,2326,427,849,.503,41,128,.320,386,721,.535,.527,205,273,.751,172,394,566,133,85,78,128,196,1100
21584,UTA,2001,John Starks,35,75,64,2122,273,686,.398,64,182,.352,209,504,.415,.445,89,111,.802,29,125,154,178,73,10,94,217,699
21585,UTA,2001,Jacque Vaughn,25,82,0,1620,170,393,.433,30,78,.385,140,315,.444,.471,128,164,.780,18,132,150,323,48,3,129,145,498
21586,UTA,2001,Olden Polynice,36,81,79,1619,206,415,.496,0,1,.000,206,414,.498,.496,17,65,.262,157,221,378,31,27,77,78,241,429
21587,UTA,2001,Greg Ostertag,27,81,3,1491,139,281,.495,1,2,.500,138,279,.495,.496,84,151,.556,164,251,415,22,22,142,63,215,363
21588,UTA,2001,Danny Manning,34,82,0,1305,247,500,.494,7,28,.250,240,472,.508,.501,102,140,.729,66,148,214,92,47,29,96,219,603
21589,UTA,2001,David Benoit,32,49,2,446,71,147,.483,5,13,.385,66,134,.493,.500,31,39,.795,20,61,81,22,6,6,28,75,178
21590,UTA,2001,Quincy Lewis,23,35,2,402,50,123,.407,9,25,.360,41,98,.418,.443,15,21,.714,14,33,47,18,10,10,17,78,124
21591,UTA,2001,DeShawn Stevenson,19,40,2,293,31,91,.341,1,12,.083,30,79,.380,.346,26,38,.684,9,19,28,18,10,2,28,29,89
21592,UTA,2001,John Crotty,31,31,0,264,22,65,.338,4,7,.571,18,58,.310,.369,17,19,.895,13,15,28,34,6,0,19,32,65
21593,UTA,2001,Scott Padgett,24,27,0,127,18,43,.419,5,9,.556,13,34,.382,.477,15,20,.750,19,20,39,5,6,3,10,21,56
21594,UTA,2000,Karl Malone,36,82,82,2947,752,1476,.509,2,8,.250,750,1468,.511,.510,589,739,.797,169,610,779,304,79,71,231,229,2095
21595,UTA,2000,Bryon Russell,29,82,70,2900,408,914,.446,106,268,.396,302,646,.467,.504,237,316,.750,99,328,427,158,128,23,101,255,1159
21596,UTA,2000,John Stockton,37,82,82,2432,363,725,.501,43,121,.355,320,604,.530,.530,221,257,.860,45,170,215,703,143,15,179,192,990
21597,UTA,2000,Jeff Hornacek,36,77,77,2133,358,728,.492,66,138,.478,292,590,.495,.537,171,180,.950,49,133,182,202,66,16,113,149,953
21598,UTA,2000,Howard Eisley,27,82,5,2096,282,675,.418,60,163,.368,222,512,.434,.462,84,102,.824,23,147,170,347,59,9,132,223,708
21599,UTA,2000,Olden Polynice,35,82,79,1819,203,398,.510,1,2,.500,202,396,.510,.511,28,90,.311,166,287,453,37,30,84,70,260,435
21600,UTA,2000,Greg Ostertag,26,81,3,1606,124,267,.464,0,1,.000,124,266,.466,.464,119,187,.636,172,310,482,18,20,172,79,196,367
21601,UTA,2000,Quincy Lewis,22,74,0,896,111,298,.372,23,63,.365,88,235,.374,.411,38,52,.731,46,67,113,40,24,15,46,158,283
21602,UTA,2000,Jacque Vaughn,24,78,0,884,109,262,.416,14,34,.412,95,228,.417,.443,57,76,.750,11,54,65,121,32,0,77,92,289
21603,UTA,2000,Armen Gilliam,35,50,0,782,133,305,.436,0,1,.000,133,304,.438,.436,67,86,.779,72,137,209,42,12,16,55,83,333
21604,UTA,2000,Adam Keefe,29,62,3,604,53,130,.408,0,1,.000,53,129,.411,.408,29,36,.806,45,91,136,34,17,13,46,90,135
21605,UTA,2000,Scott Padgett,23,47,9,432,44,140,.314,13,44,.295,31,96,.323,.361,19,27,.704,24,64,88,25,14,8,22,55,120
21606,UTA,2000,Pete Chilcutt,31,26,0,224,22,62,.355,1,10,.100,21,52,.404,.363,2,2,1.000,15,28,43,10,5,4,9,31,47
21607,UTA,1999,Karl Malone,35,49,49,1832,393,797,.493,0,1,.000,393,796,.494,.493,378,480,.788,107,356,463,201,62,28,162,134,1164
21608,UTA,1999,Bryon Russell,28,50,50,1770,217,468,.464,52,147,.354,165,321,.514,.519,136,171,.795,65,201,266,74,76,15,76,154,622
21609,UTA,1999,Jeff Hornacek,35,48,48,1435,214,449,.477,34,81,.420,180,368,.489,.514,125,140,.893,33,127,160,192,52,14,82,95,587
21610,UTA,1999,John Stockton,36,50,50,1410,200,410,.488,16,50,.320,184,360,.511,.507,137,169,.811,31,115,146,374,81,13,110,107,553
21611,UTA,1999,Greg Ostertag,25,48,48,1340,99,208,.476,0,0,,99,208,.476,.476,75,121,.620,105,243,348,23,12,131,45,140,273
21612,UTA,1999,Shandon Anderson,25,50,2,1072,162,363,.446,14,41,.341,148,322,.460,.466,89,125,.712,49,83,132,56,39,10,66,89,427
21613,UTA,1999,Howard Eisley,26,50,0,1038,140,314,.446,21,50,.420,119,264,.451,.479,67,80,.838,12,82,94,185,30,2,109,122,368
21614,UTA,1999,Adam Keefe,28,44,0,642,56,124,.452,0,4,.000,56,120,.467,.452,62,89,.697,51,91,142,28,16,12,33,63,174
21615,UTA,1999,Thurl Bailey,37,43,0,543,78,175,.446,0,2,.000,78,173,.451,.446,25,34,.735,36,58,94,26,9,28,27,78,181
21616,UTA,1999,Todd Fuller,24,42,2,462,56,124,.452,0,0,,56,124,.452,.452,30,50,.600,28,73,101,6,6,14,27,60,142
21617,UTA,1999,Greg Foster,30,42,1,458,52,138,.377,1,4,.250,51,134,.381,.380,13,21,.619,28,55,83,25,6,8,24,63,118
21618,UTA,1999,Jacque Vaughn,23,19,0,87,11,30,.367,2,8,.250,9,22,.409,.400,20,24,.833,1,10,11,12,5,0,14,14,44
21619,UTA,1999,Anthony Avent,29,5,0,44,4,13,.308,0,0,,4,13,.308,.308,1,2,.500,8,4,12,1,2,0,7,6,9
21620,UTA,1999,Chris King,29,8,0,42,2,7,.286,0,0,,2,7,.286,.286,0,4,.000,1,10,11,1,2,1,4,8,4
21621,UTA,1998,Karl Malone,34,81,81,3030,780,1472,.530,2,6,.333,778,1466,.531,.531,628,825,.761,189,645,834,316,96,70,247,237,2190
21622,UTA,1998,Jeff Hornacek,34,80,80,2460,399,828,.482,56,127,.441,343,701,.489,.516,285,322,.885,65,205,270,349,109,15,132,175,1139
21623,UTA,1998,Bryon Russell,27,82,7,2219,226,525,.430,73,214,.341,153,311,.492,.500,213,278,.766,78,248,326,101,90,31,81,229,738
21624,UTA,1998,Adam Keefe,27,80,75,2047,229,424,.540,0,0,,229,424,.540,.540,162,200,.810,179,259,438,89,52,24,71,172,620
21625,UTA,1998,John Stockton,35,64,64,1858,270,511,.528,39,91,.429,231,420,.550,.567,191,231,.827,35,131,166,543,89,10,161,138,770
21626,UTA,1998,Howard Eisley,25,82,18,1726,229,519,.441,48,118,.407,181,401,.451,.487,127,149,.852,25,141,166,346,54,13,160,182,633
21627,UTA,1998,Shandon Anderson,24,82,2,1602,269,500,.538,7,32,.219,262,468,.560,.545,136,185,.735,86,141,227,89,66,18,91,145,681
21628,UTA,1998,Greg Foster,29,78,49,1446,186,418,.445,2,9,.222,184,409,.450,.447,67,87,.770,85,188,273,51,15,28,68,187,441
21629,UTA,1998,Greg Ostertag,24,63,23,1288,115,239,.481,0,0,,115,239,.481,.481,67,140,.479,134,240,374,25,28,132,74,166,297
21630,UTA,1998,Antoine Carr,36,66,8,1086,151,325,.465,0,0,,151,325,.465,.465,76,98,.776,42,89,131,48,11,53,48,195,378
21631,UTA,1998,Chris Morris,32,54,1,538,85,207,.411,19,62,.306,66,145,.455,.457,44,61,.721,35,79,114,24,25,17,33,61,233
21632,UTA,1998,Jacque Vaughn,22,45,0,419,44,122,.361,3,8,.375,41,114,.360,.373,48,68,.706,4,34,38,84,9,1,56,63,139
21633,UTA,1998,William Cunningham,23,6,2,38,4,9,.444,0,0,,4,9,.444,.444,0,0,,4,4,8,1,2,0,0,10,8
21634,UTA,1998,Troy Hudson,21,8,0,23,6,14,.429,0,3,.000,6,11,.545,.429,0,0,,1,1,2,4,2,0,1,1,12
21635,UTA,1997,Karl Malone,33,82,82,2998,864,1571,.550,0,13,.000,864,1558,.555,.550,521,690,.755,193,616,809,368,113,48,233,217,2249
21636,UTA,1997,John Stockton,34,82,82,2896,416,759,.548,76,180,.422,340,579,.587,.598,275,325,.846,45,183,228,860,166,15,248,194,1183
21637,UTA,1997,Jeff Hornacek,33,82,82,2592,413,856,.482,72,195,.369,341,661,.516,.525,293,326,.899,60,181,241,361,124,26,134,188,1191
21638,UTA,1997,Bryon Russell,26,81,81,2525,297,620,.479,108,264,.409,189,356,.531,.566,171,244,.701,79,252,331,123,129,27,94,237,873
21639,UTA,1997,Greg Ostertag,23,77,70,1818,210,408,.515,0,4,.000,210,404,.520,.515,139,205,.678,180,385,565,27,24,152,74,233,559
21640,UTA,1997,Antoine Carr,35,82,0,1460,252,522,.483,0,3,.000,252,519,.486,.483,99,127,.780,60,135,195,74,24,63,75,214,603
21641,UTA,1997,Howard Eisley,24,82,0,1083,139,308,.451,20,72,.278,119,236,.504,.484,70,89,.787,20,64,84,198,44,10,110,141,368
21642,UTA,1997,Shandon Anderson,23,65,0,1066,147,318,.462,24,47,.511,123,271,.454,.500,68,99,.687,52,127,179,49,27,8,73,113,386
21643,UTA,1997,Chris Morris,31,73,1,977,122,299,.408,31,113,.274,91,186,.489,.460,39,54,.722,37,125,162,43,29,24,45,121,314
21644,UTA,1997,Greg Foster,28,79,12,920,111,245,.453,2,3,.667,109,242,.450,.457,54,65,.831,56,131,187,31,10,20,54,145,278
21645,UTA,1997,Adam Keefe,26,62,0,915,82,160,.513,0,1,.000,82,159,.516,.513,71,103,.689,75,141,216,32,30,13,45,97,235
21646,UTA,1997,Stephen Howard,26,42,0,349,55,96,.573,0,0,,55,96,.573,.573,40,67,.597,25,51,76,10,11,10,20,55,150
21647,UTA,1997,Jamie Watson,24,13,0,129,11,25,.440,1,3,.333,10,22,.455,.460,10,12,.833,4,14,18,10,11,2,9,16,33
21648,UTA,1997,Ruben Nembhard,24,8,0,94,12,29,.414,0,4,.000,12,25,.480,.414,8,10,.800,3,5,8,12,6,0,3,9,32
21649,UTA,1997,Brooks Thompson,26,2,0,8,0,1,.000,0,0,,0,1,.000,.000,0,0,,0,0,0,1,0,0,1,1,0
21650,UTA,1996,Karl Malone,32,82,82,3113,789,1520,.519,16,40,.400,773,1480,.522,.524,512,708,.723,175,629,804,345,138,56,199,245,2106
21651,UTA,1996,John Stockton,33,82,82,2915,440,818,.538,95,225,.422,345,593,.582,.596,234,282,.830,54,172,226,916,140,15,246,207,1209
21652,UTA,1996,Jeff Hornacek,32,82,59,2588,442,880,.502,104,223,.466,338,657,.514,.561,259,290,.893,62,147,209,340,106,20,127,171,1247
21653,UTA,1996,David Benoit,27,81,63,1961,255,581,.439,64,192,.333,191,389,.491,.494,87,112,.777,90,293,383,82,43,49,71,166,661
21654,UTA,1996,Adam Keefe,25,82,0,1708,180,346,.520,0,4,.000,180,342,.526,.520,139,201,.692,176,279,455,64,51,41,88,174,499
21655,UTA,1996,Antoine Carr,34,80,0,1532,233,510,.457,0,3,.000,233,507,.460,.457,114,144,.792,71,129,200,74,28,65,78,254,580
21656,UTA,1996,Chris Morris,30,66,33,1424,265,606,.437,63,197,.320,202,409,.494,.489,98,127,.772,100,129,229,77,63,20,71,140,691
21657,UTA,1996,Felton Spencer,28,71,70,1267,146,281,.520,0,0,,146,281,.520,.520,104,151,.689,100,206,306,11,20,54,77,240,396
21658,UTA,1996,Howard Eisley,23,65,0,961,104,242,.430,14,62,.226,90,180,.500,.459,65,77,.844,22,56,78,146,29,3,77,130,287
21659,UTA,1996,Greg Foster,27,73,2,803,107,244,.439,1,8,.125,106,236,.449,.441,61,72,.847,53,125,178,25,7,22,58,120,276
21660,UTA,1996,Greg Ostertag,22,57,10,661,86,182,.473,0,0,,86,182,.473,.473,36,54,.667,57,118,175,5,5,63,25,91,208
21661,UTA,1996,Bryon Russell,25,59,9,577,56,142,.394,14,40,.350,42,102,.412,.444,48,67,.716,28,62,90,29,29,8,36,66,174
21662,UTA,1996,Jamie Watson,23,16,0,217,18,43,.419,3,7,.429,15,36,.417,.453,9,13,.692,5,22,27,24,8,2,17,30,48
21663,UTA,1996,Andy Toolson,30,13,0,53,8,22,.364,3,12,.250,5,10,.500,.432,3,4,.750,0,6,6,1,0,0,2,12,22
21664,UTA,1995,Karl Malone,31,82,82,3126,830,1548,.536,11,41,.268,819,1507,.543,.540,516,695,.742,156,715,871,285,129,85,236,269,2187
21665,UTA,1995,John Stockton,32,82,82,2867,429,791,.542,102,227,.449,327,564,.580,.607,246,306,.804,57,194,251,1011,194,22,267,215,1206
21666,UTA,1995,Jeff Hornacek,31,81,81,2696,482,937,.514,89,219,.406,393,718,.547,.562,284,322,.882,53,157,210,347,129,17,145,181,1337
21667,UTA,1995,David Benoit,26,71,67,1841,285,587,.486,38,115,.330,247,472,.523,.518,132,157,.841,96,272,368,58,45,47,75,183,740
21668,UTA,1995,Antoine Carr,33,78,4,1677,290,546,.531,1,4,.250,289,542,.533,.532,165,201,.821,81,184,265,67,24,68,87,253,746
21669,UTA,1995,Adam Keefe,24,75,0,1270,172,298,.577,0,0,,172,298,.577,.577,117,173,.676,135,192,327,30,36,25,62,141,461
21670,UTA,1995,Tom Chambers,35,81,4,1240,195,427,.457,4,24,.167,191,403,.474,.461,109,135,.807,66,147,213,73,25,30,52,173,503
21671,UTA,1995,John Crotty,25,80,0,1019,93,231,.403,11,36,.306,82,195,.421,.426,98,121,.810,27,70,97,205,39,6,70,105,295
21672,UTA,1995,Felton Spencer,27,34,34,905,105,215,.488,0,0,,105,215,.488,.488,107,135,.793,90,170,260,17,12,32,68,131,317
21673,UTA,1995,Bryon Russell,24,63,15,860,104,238,.437,13,44,.295,91,194,.469,.464,62,93,.667,44,97,141,34,48,11,42,101,283
21674,UTA,1995,Jamie Watson,22,60,1,673,76,152,.500,5,19,.263,71,133,.534,.516,38,56,.679,16,58,74,59,35,11,51,86,195
21675,UTA,1995,James Donaldson,37,43,40,613,44,74,.595,0,0,,44,74,.595,.595,22,31,.710,19,88,107,14,6,28,22,66,110
21676,UTA,1995,Blue Edwards,29,36,0,605,98,198,.495,11,32,.344,87,166,.524,.523,32,42,.762,25,40,65,30,24,6,42,79,239
21677,UTA,1995,Walter Bond,25,18,0,239,36,72,.500,14,37,.378,22,35,.629,.597,11,16,.688,7,20,27,17,5,4,14,37,97
21678,UTA,1995,Jay Humphries,32,12,0,149,4,25,.160,2,3,.667,2,22,.091,.200,0,0,,2,8,10,9,7,0,12,25,10
21679,UTA,1994,Karl Malone,30,82,82,3329,772,1552,.497,8,32,.250,764,1520,.503,.500,511,736,.694,235,705,940,328,125,126,234,268,2063
21680,UTA,1994,John Stockton,31,82,82,2969,458,868,.528,48,149,.322,410,719,.570,.555,272,338,.805,72,186,258,1031,199,22,266,236,1236
21681,UTA,1994,Felton Spencer,26,79,79,2210,256,507,.505,0,0,,256,507,.505,.505,165,272,.607,235,423,658,43,41,67,127,304,677
21682,UTA,1994,Tyrone Corbin,31,82,17,2149,268,588,.456,6,29,.207,262,559,.469,.461,117,144,.813,150,239,389,122,99,24,92,212,659
21683,UTA,1994,Tom Chambers,34,80,0,1838,329,748,.440,14,45,.311,315,703,.448,.449,221,281,.786,87,239,326,79,40,32,89,232,893
21684,UTA,1994,Jeff Malone,32,50,50,1657,338,692,.488,3,6,.500,335,686,.488,.491,129,153,.843,28,87,115,66,26,5,57,77,808
21685,UTA,1994,Jay Humphries,31,75,19,1619,233,535,.436,38,96,.396,195,439,.444,.471,57,76,.750,35,92,127,219,65,11,95,168,561
21686,UTA,1994,Bryon Russell,23,67,48,1121,135,279,.484,2,22,.091,133,257,.518,.487,62,101,.614,61,120,181,54,68,19,55,138,334
21687,UTA,1994,David Benoit,25,55,18,1070,139,361,.385,12,59,.203,127,302,.421,.402,68,88,.773,89,171,260,23,23,37,37,115,358
21688,UTA,1994,Jeff Hornacek,30,27,9,826,147,289,.509,18,42,.429,129,247,.522,.540,82,92,.891,19,48,67,104,32,3,33,71,394
21689,UTA,1994,Walter Bond,24,56,4,559,63,156,.404,19,54,.352,44,102,.431,.465,31,40,.775,20,41,61,31,16,12,17,90,176
21690,UTA,1994,John Crotty,24,45,0,313,45,99,.455,11,24,.458,34,75,.453,.510,31,36,.861,11,20,31,77,15,1,27,36,132
21691,UTA,1994,Luther Wright,22,15,2,92,8,23,.348,0,1,.000,8,22,.364,.348,3,4,.750,6,4,10,0,1,2,6,21,19
21692,UTA,1994,Stephen Howard,23,9,0,53,10,17,.588,0,0,,10,17,.588,.588,11,16,.688,10,6,16,1,1,3,6,13,31
21693,UTA,1994,Aaron Williams,22,6,0,12,2,8,.250,0,0,,2,8,.250,.250,0,1,.000,1,2,3,1,0,0,1,4,4
21694,UTA,1994,Dave Jamerson,26,1,0,4,0,2,.000,0,0,,0,2,.000,.000,1,1,1.000,0,1,1,0,0,0,0,0,1
21695,UTA,1994,Darren Morningstar,24,1,0,4,1,1,1.000,0,0,,1,1,1.000,1.000,0,0,,0,1,1,0,0,0,0,1,2
21696,UTA,1994,Chad Gallagher,24,2,0,3,3,3,1.000,0,0,,3,3,1.000,1.000,0,0,,0,0,0,0,0,0,0,2,6
21697,UTA,1994,Sean Green,23,1,0,2,0,1,.000,0,0,,0,1,.000,.000,0,0,,0,0,0,0,0,0,0,0,0
21698,UTA,1993,Karl Malone,29,82,82,3099,797,1443,.552,4,20,.200,793,1423,.557,.554,619,836,.740,227,692,919,308,124,85,240,261,2217
21699,UTA,1993,John Stockton,30,82,82,2863,437,899,.486,72,187,.385,365,712,.513,.526,293,367,.798,64,173,237,987,199,21,266,224,1239
21700,UTA,1993,Jeff Malone,31,79,59,2558,595,1205,.494,3,9,.333,592,1196,.495,.495,236,277,.852,31,142,173,128,42,4,125,117,1429
21701,UTA,1993,Tyrone Corbin,30,82,58,2555,385,766,.503,0,5,.000,385,761,.506,.503,180,218,.826,194,325,519,173,108,32,108,252,950
21702,UTA,1993,Jay Humphries,30,78,20,2034,287,659,.436,15,75,.200,272,584,.466,.447,101,130,.777,40,103,143,317,101,11,132,236,690
21703,UTA,1993,David Benoit,24,82,27,1712,258,592,.436,34,98,.347,224,494,.453,.465,114,152,.750,116,276,392,43,45,43,90,201,664
21704,UTA,1993,Mike Brown,29,82,21,1551,176,409,.430,0,1,.000,176,408,.431,.430,113,164,.689,147,244,391,64,32,23,95,190,465
21705,UTA,1993,Larry Krystkowiak,28,71,0,1362,198,425,.466,0,1,.000,198,424,.467,.466,117,147,.796,74,205,279,68,42,13,62,181,513
21706,UTA,1993,Mark Eaton,36,64,57,1104,71,130,.546,0,0,,71,130,.546,.546,35,50,.700,73,191,264,17,18,79,43,143,177
21707,UTA,1993,Isaac Austin,23,46,3,306,50,112,.446,0,1,.000,50,111,.450,.446,29,44,.659,38,41,79,6,8,14,23,60,129
21708,UTA,1993,Stephen Howard,22,49,0,260,35,93,.376,0,0,,35,93,.376,.376,34,53,.642,26,34,60,10,15,12,23,58,104
21709,UTA,1993,John Crotty,23,40,0,243,37,72,.514,2,14,.143,35,58,.603,.528,26,38,.684,4,13,17,55,11,0,30,29,102
21710,UTA,1993,James Donaldson,35,6,1,94,8,14,.571,0,0,,8,14,.571,.571,5,9,.556,6,23,29,1,1,7,4,13,21
21711,UTA,1993,Henry James,27,2,0,9,1,6,.167,0,3,.000,1,3,.333,.167,5,6,.833,1,0,1,0,0,0,0,0,7
21712,UTA,1993,Tim Legler,26,3,0,5,1,3,.333,0,0,,1,3,.333,.333,0,0,,0,1,1,0,0,0,0,0,2
21713,UTA,1992,Karl Malone,28,81,81,3054,798,1516,.526,3,17,.176,795,1499,.530,.527,673,865,.778,225,684,909,241,108,51,248,226,2272
21714,UTA,1992,John Stockton,29,82,82,3002,453,939,.482,83,204,.407,370,735,.503,.527,308,366,.842,68,202,270,1126,244,22,286,234,1297
21715,UTA,1992,Jeff Malone,30,81,81,2922,691,1353,.511,1,12,.083,690,1341,.515,.511,256,285,.898,49,184,233,180,56,5,140,126,1639
21716,UTA,1992,Blue Edwards,26,81,81,2283,433,830,.522,39,103,.379,394,727,.542,.545,113,146,.774,86,212,298,137,81,46,122,236,1018
21717,UTA,1992,Mark Eaton,35,81,81,2023,107,240,.446,0,0,,107,240,.446,.446,52,87,.598,150,341,491,40,36,205,60,239,266
21718,UTA,1992,Tyrone Corbin,29,69,1,1863,246,488,.504,0,3,.000,246,485,.507,.504,130,148,.878,139,264,403,107,70,14,71,162,622
21719,UTA,1992,Mike Brown,28,82,1,1783,221,488,.453,0,1,.000,221,487,.454,.453,190,285,.667,187,289,476,81,42,34,105,196,632
21720,UTA,1992,David Benoit,23,77,2,1161,175,375,.467,3,14,.214,172,361,.476,.471,81,100,.810,105,191,296,34,19,44,71,124,434
21721,UTA,1992,Delaney Rudd,29,65,0,538,75,188,.399,11,47,.234,64,141,.454,.428,32,42,.762,15,39,54,109,15,1,49,64,193
21722,UTA,1992,Eric Murdock,23,50,0,478,76,183,.415,5,26,.192,71,157,.452,.429,46,61,.754,21,33,54,92,30,7,50,52,203
21723,UTA,1992,Corey Crowder,22,51,0,328,43,112,.384,13,30,.433,30,82,.366,.442,15,18,.833,16,25,41,17,7,2,13,35,114
21724,UTA,1992,Thurl Bailey,30,13,0,327,39,101,.386,0,1,.000,39,100,.390,.386,44,55,.800,23,55,78,19,5,15,21,31,122
21725,UTA,1992,Isaac Austin,22,31,0,112,21,46,.457,0,0,,21,46,.457,.457,19,30,.633,11,24,35,5,2,2,8,20,61
21726,UTA,1992,Bob Thornton,29,2,0,6,1,7,.143,0,0,,1,7,.143,.143,2,2,1.000,2,0,2,0,0,0,0,1,4
21727,UTA,1991,Karl Malone,27,82,82,3302,847,1608,.527,4,14,.286,843,1594,.529,.528,684,888,.770,236,731,967,270,89,79,244,268,2382
21728,UTA,1991,John Stockton,28,82,82,3103,496,978,.507,58,168,.345,438,810,.541,.537,363,434,.836,46,191,237,1164,234,16,298,233,1413
21729,UTA,1991,Mark Eaton,34,80,80,2580,169,292,.579,0,0,,169,292,.579,.579,71,112,.634,182,485,667,51,39,188,99,298,409
21730,UTA,1991,Thurl Bailey,29,82,22,2486,399,872,.458,0,3,.000,399,869,.459,.458,219,271,.808,101,306,407,124,53,91,130,160,1017
21731,UTA,1991,Jeff Malone,29,69,69,2466,525,1034,.508,1,6,.167,524,1028,.510,.508,231,252,.917,36,170,206,143,50,6,108,128,1282
21732,UTA,1991,Blue Edwards,25,62,56,1611,244,464,.526,6,24,.250,238,440,.541,.532,82,117,.701,51,150,201,108,57,29,105,203,576
21733,UTA,1991,Mike Brown,27,82,2,1391,129,284,.454,0,0,,129,284,.454,.454,132,178,.742,109,228,337,49,29,24,82,166,390
21734,UTA,1991,Darrell Griffith,32,75,2,1005,174,445,.391,48,138,.348,126,307,.410,.445,34,45,.756,17,73,90,37,42,7,48,100,430
21735,UTA,1991,Delaney Rudd,28,82,0,874,124,285,.435,17,61,.279,107,224,.478,.465,59,71,.831,14,52,66,216,36,2,102,92,324
21736,UTA,1991,Andy Toolson,25,47,15,470,50,124,.403,12,32,.375,38,92,.413,.452,25,33,.758,32,35,67,31,14,2,24,58,137
21737,UTA,1991,Tony Brown,30,23,0,267,28,77,.364,2,11,.182,26,66,.394,.377,20,23,.870,24,15,39,13,4,0,12,39,78
21738,UTA,1991,Dan O'Sullivan,22,21,0,85,7,16,.438,0,0,,7,16,.438,.438,7,11,.636,5,12,17,4,1,1,4,18,21
21739,UTA,1991,Walter Palmer,22,28,0,85,15,45,.333,0,1,.000,15,44,.341,.333,10,15,.667,6,15,21,6,3,4,6,20,40
21740,UTA,1991,Chris Munk,23,11,0,29,3,7,.429,0,0,,3,7,.429,.429,7,12,.583,5,9,14,1,1,2,5,5,13
21741,UTA,1991,Pat Cummings,34,4,0,26,4,6,.667,0,0,,4,6,.667,.667,7,10,.700,3,2,5,0,0,0,2,8,15
21742,UTA,1990,Karl Malone,26,82,82,3122,914,1627,.562,16,43,.372,898,1584,.567,.567,696,913,.762,232,679,911,226,121,50,304,259,2540
21743,UTA,1990,John Stockton,27,78,78,2915,472,918,.514,47,113,.416,425,805,.528,.540,354,432,.819,57,149,206,1134,207,18,272,233,1345
21744,UTA,1990,Thurl Bailey,28,82,33,2583,470,977,.481,0,8,.000,470,969,.485,.481,222,285,.779,116,294,410,137,32,100,139,175,1162
21745,UTA,1990,Mark Eaton,33,82,82,2281,158,300,.527,0,0,,158,300,.527,.527,79,118,.669,171,430,601,39,33,201,75,238,395
21746,UTA,1990,Bob Hansen,29,81,81,2174,265,568,.467,54,154,.351,211,414,.510,.514,33,64,.516,66,163,229,149,52,11,79,194,617
21747,UTA,1990,Blue Edwards,24,82,49,1889,286,564,.507,9,30,.300,277,534,.519,.515,146,203,.719,69,182,251,145,76,36,152,280,727
21748,UTA,1990,Darrell Griffith,31,82,1,1444,301,649,.464,80,215,.372,221,434,.509,.525,51,78,.654,43,123,166,63,68,19,75,149,733
21749,UTA,1990,Mike Brown,26,82,0,1397,177,344,.515,1,2,.500,176,342,.515,.516,157,199,.789,111,262,373,47,32,28,88,187,512
21750,UTA,1990,Delaney Rudd,27,77,2,850,111,259,.429,16,56,.286,95,203,.468,.459,35,53,.660,12,43,55,177,22,1,88,81,273
21751,UTA,1990,Eric Leckner,23,77,0,764,125,222,.563,0,0,,125,222,.563,.563,81,109,.743,48,144,192,19,15,23,63,157,331
21752,UTA,1990,Eric Johnson,23,48,2,272,20,84,.238,1,6,.167,19,78,.244,.244,13,17,.765,8,20,28,64,17,2,26,49,54
21753,UTA,1990,José Ortiz,26,13,0,64,19,42,.452,1,2,.500,18,40,.450,.464,3,5,.600,8,7,15,7,2,1,5,15,42
21754,UTA,1990,Raymond Brown,24,16,0,56,8,28,.286,0,0,,8,28,.286,.286,0,2,.000,10,5,15,4,0,0,6,11,16
21755,UTA,1990,Nate Johnston,23,6,0,13,4,11,.364,1,1,1.000,3,10,.300,.409,2,2,1.000,2,0,2,0,0,1,1,0,11
21756,UTA,1990,Jim Les,26,1,0,6,0,0,,0,0,,0,0,,,2,4,.500,0,0,0,1,0,0,3,3,2
21757,UTA,1989,John Stockton,26,82,82,3171,497,923,.538,16,66,.242,481,857,.561,.547,390,452,.863,83,165,248,1118,263,14,308,241,1400
21758,UTA,1989,Karl Malone,25,80,80,3126,809,1559,.519,5,16,.313,804,1543,.521,.521,703,918,.766,259,594,853,219,144,70,285,286,2326
21759,UTA,1989,Mark Eaton,32,82,82,2914,188,407,.462,0,0,,188,407,.462,.462,132,200,.660,227,616,843,83,40,315,142,290,508
21760,UTA,1989,Thurl Bailey,27,82,3,2777,615,1272,.483,2,5,.400,613,1267,.484,.484,363,440,.825,115,332,447,138,48,91,208,185,1595
21761,UTA,1989,Darrell Griffith,30,82,73,2382,466,1045,.446,61,196,.311,405,849,.477,.475,142,182,.780,77,253,330,130,86,22,141,175,1135
21762,UTA,1989,Mike Brown,25,66,16,1051,104,248,.419,0,0,,104,248,.419,.419,92,130,.708,92,166,258,41,25,17,77,133,300
21763,UTA,1989,Bob Hansen,28,46,9,964,140,300,.467,19,54,.352,121,246,.492,.498,42,75,.560,29,99,128,50,37,6,43,105,341
21764,UTA,1989,Marc Iavaroni,32,77,50,796,72,163,.442,0,1,.000,72,162,.444,.442,36,44,.818,41,91,132,32,11,13,52,99,180
21765,UTA,1989,Jim Les,25,82,0,781,40,133,.301,1,14,.071,39,119,.328,.305,57,73,.781,23,64,87,215,27,5,88,88,138
21766,UTA,1989,Eric Leckner,22,75,0,779,120,220,.545,0,0,,120,220,.545,.545,79,113,.699,48,151,199,16,8,22,69,174,319
21767,UTA,1989,Jim Farmer,24,37,0,412,57,142,.401,9,20,.450,48,122,.393,.433,29,41,.707,22,33,55,28,9,0,26,41,152
21768,UTA,1989,José Ortiz,25,51,15,327,55,125,.440,0,1,.000,55,124,.444,.440,31,52,.596,30,28,58,11,8,7,36,40,141
21769,UTA,1989,Bart Kofoed,24,19,0,176,12,33,.364,0,1,.000,12,32,.375,.364,6,11,.545,4,7,11,20,9,0,13,22,30
21770,UTA,1989,Scott Roth,25,16,0,72,7,24,.292,1,6,.167,6,18,.333,.313,8,11,.727,0,8,8,7,5,1,7,14,23
21771,UTA,1989,Eric White,23,1,0,2,0,1,.000,0,0,,0,1,.000,.000,0,0,,0,0,0,0,0,0,0,1,0
21772,UTA,1988,Karl Malone,24,82,82,3198,858,1650,.520,0,5,.000,858,1645,.522,.520,552,789,.700,277,709,986,199,117,50,325,296,2268
21773,UTA,1988,John Stockton,25,82,79,2842,454,791,.574,24,67,.358,430,724,.594,.589,272,324,.840,54,183,237,1128,242,16,262,247,1204
21774,UTA,1988,Thurl Bailey,26,82,10,2804,633,1286,.492,1,3,.333,632,1283,.493,.493,337,408,.826,134,397,531,158,49,125,190,186,1604
21775,UTA,1988,Mark Eaton,31,82,82,2731,226,541,.418,0,0,,226,541,.418,.418,119,191,.623,230,487,717,55,41,304,131,320,571
21776,UTA,1988,Bob Hansen,27,81,51,1796,316,611,.517,32,97,.330,284,514,.553,.543,113,152,.743,64,123,187,175,65,5,91,193,777
21777,UTA,1988,Marc Iavaroni,31,81,71,1238,143,308,.464,0,2,.000,143,306,.467,.464,78,99,.788,94,174,268,67,23,25,83,162,364
21778,UTA,1988,Rickey Green,33,81,3,1116,157,370,.424,4,19,.211,153,351,.436,.430,75,83,.904,14,66,80,300,57,1,94,83,393
21779,UTA,1988,Darrell Griffith,29,52,11,1052,251,585,.429,28,102,.275,223,483,.462,.453,59,92,.641,36,91,127,91,52,5,67,102,589
21780,UTA,1988,Melvin Turpin,27,79,0,1011,199,389,.512,1,3,.333,198,386,.513,.513,71,98,.724,88,148,236,32,26,68,71,157,470
21781,UTA,1988,Kelly Tripucka,28,49,21,976,139,303,.459,31,74,.419,108,229,.472,.510,59,68,.868,30,87,117,105,34,4,68,68,368
21782,UTA,1988,Carey Scurry,25,29,0,447,54,116,.466,3,8,.375,51,108,.472,.478,27,39,.692,29,52,81,49,47,22,41,78,138
21783,UTA,1988,Bart Kofoed,23,36,0,225,18,48,.375,2,7,.286,16,41,.390,.396,8,13,.615,4,11,15,23,6,1,18,42,46
21784,UTA,1988,Scott Roth,24,26,0,201,30,74,.405,2,11,.182,28,63,.444,.419,22,30,.733,7,21,28,16,12,0,11,37,84
21785,UTA,1988,Eddie Hughes,27,11,0,42,5,13,.385,1,6,.167,4,7,.571,.423,6,6,1.000,3,1,4,8,0,0,6,5,17
21786,UTA,1988,Darryl Dawkins,31,4,0,26,1,7,.143,0,0,,1,7,.143,.143,4,12,.333,2,3,5,1,0,1,4,10,6
21787,UTA,1987,Karl Malone,23,82,82,2857,728,1422,.512,0,7,.000,728,1415,.514,.512,323,540,.598,278,577,855,158,104,60,237,323,1779
21788,UTA,1987,Mark Eaton,30,79,79,2505,234,585,.400,0,0,,234,585,.400,.400,140,213,.657,211,486,697,105,43,321,142,273,608
21789,UTA,1987,Thurl Bailey,25,81,2,2155,463,1036,.447,0,2,.000,463,1034,.448,.447,190,236,.805,145,287,432,102,38,88,123,150,1116
21790,UTA,1987,Rickey Green,32,81,80,2090,301,644,.467,7,19,.368,294,625,.470,.473,172,208,.827,38,125,163,541,110,2,133,108,781
21791,UTA,1987,Kelly Tripucka,27,79,76,1865,291,621,.469,19,52,.365,272,569,.478,.484,197,226,.872,54,188,242,243,85,11,167,147,798
21792,UTA,1987,John Stockton,24,82,2,1858,231,463,.499,7,39,.179,224,424,.528,.506,179,229,.782,32,119,151,670,177,14,164,224,648
21793,UTA,1987,Darrell Griffith,28,76,10,1843,463,1038,.446,67,200,.335,396,838,.473,.478,149,212,.703,81,146,227,129,97,29,135,167,1142
21794,UTA,1987,Bob Hansen,26,72,72,1453,272,601,.453,16,45,.356,256,556,.460,.466,136,179,.760,84,119,203,102,44,6,77,146,696
21795,UTA,1987,Kent Benson,32,73,2,895,140,316,.443,2,7,.286,138,309,.447,.446,47,58,.810,80,151,231,39,39,28,45,138,329
21796,UTA,1987,Marc Iavaroni,30,78,0,845,100,215,.465,0,4,.000,100,211,.474,.465,78,116,.672,64,109,173,36,16,11,56,154,278
21797,UTA,1987,Carey Scurry,24,69,5,753,123,247,.498,4,13,.308,119,234,.509,.506,94,134,.701,97,101,198,57,55,54,56,124,344
21798,UTA,1987,Dell Curry,22,67,0,636,139,326,.426,17,60,.283,122,266,.459,.452,30,38,.789,30,48,78,58,27,4,44,86,325
21799,UTA,1986,Adrian Dantley,30,76,75,2744,818,1453,.563,1,11,.091,817,1442,.567,.563,630,796,.791,178,217,395,264,64,4,231,206,2267
21800,UTA,1986,Mark Eaton,29,80,80,2551,277,589,.470,0,0,,277,589,.470,.470,122,202,.604,172,503,675,101,33,369,157,282,676
21801,UTA,1986,Karl Malone,22,81,76,2475,504,1016,.496,0,2,.000,504,1014,.497,.496,195,405,.481,174,544,718,236,105,44,279,295,1203
21802,UTA,1986,Thurl Bailey,24,82,13,2358,483,1077,.448,0,7,.000,483,1070,.451,.448,230,277,.830,148,345,493,153,42,114,144,160,1196
21803,UTA,1986,Bob Hansen,25,82,82,2032,299,628,.476,17,50,.340,282,578,.488,.490,95,132,.720,82,162,244,193,74,9,126,205,710
21804,UTA,1986,Rickey Green,31,80,44,2012,357,758,.471,5,29,.172,352,729,.483,.474,213,250,.852,32,103,135,411,106,6,132,130,932
21805,UTA,1986,John Stockton,23,82,38,1935,228,466,.489,2,15,.133,226,451,.501,.491,172,205,.839,33,146,179,610,157,10,168,227,630
21806,UTA,1986,Carey Scurry,23,78,0,1168,142,301,.472,1,11,.091,141,290,.486,.473,78,126,.619,97,145,242,85,78,66,96,171,363
21807,UTA,1986,Pace Mannion,25,57,0,673,97,214,.453,8,42,.190,89,172,.517,.472,53,82,.646,26,56,82,55,32,5,41,68,255
21808,UTA,1986,Jeff Wilkins,30,48,0,604,96,240,.400,0,0,,96,240,.400,.400,30,47,.638,40,105,145,28,3,11,32,86,222
21809,UTA,1986,Fred Roberts,25,58,0,469,74,167,.443,1,2,.500,73,165,.442,.446,67,87,.770,31,49,80,27,8,6,53,72,216
21810,UTA,1986,Steve Hayes,30,58,0,397,39,87,.448,0,0,,39,87,.448,.448,11,36,.306,32,45,77,7,5,19,16,81,89
21811,UTA,1986,Marc Iavaroni,29,26,2,345,36,81,.444,0,0,,36,81,.444,.444,33,48,.688,21,56,77,29,10,3,21,54,105
21812,UTA,1986,Jeff Cook,29,2,0,17,3,6,.500,0,0,,3,6,.500,.500,1,1,1.000,2,3,5,0,0,0,3,1,7
21813,UTA,1985,Mark Eaton,28,82,82,2813,302,673,.449,0,0,,302,673,.449,.449,190,267,.712,207,720,927,124,36,456,206,312,794
21814,UTA,1985,Darrell Griffith,26,78,78,2776,728,1593,.457,92,257,.358,636,1336,.476,.486,216,298,.725,124,220,344,243,133,30,247,178,1764
21815,UTA,1985,Thurl Bailey,23,80,68,2481,507,1034,.490,1,1,1.000,506,1033,.490,.491,197,234,.842,153,372,525,138,51,105,152,215,1212
21816,UTA,1985,Rickey Green,30,77,77,2431,381,798,.477,6,20,.300,375,778,.482,.481,232,267,.869,37,152,189,597,132,3,177,131,1000
21817,UTA,1985,Adrian Dantley,29,55,46,1971,512,964,.531,0,0,,512,964,.531,.531,438,545,.804,148,175,323,186,57,8,171,133,1462
21818,UTA,1985,Jeff Wilkins,29,79,0,1505,285,582,.490,0,1,.000,285,581,.491,.490,61,80,.763,78,288,366,81,35,18,91,173,631
21819,UTA,1985,John Stockton,22,82,5,1490,157,333,.471,2,11,.182,155,322,.481,.474,142,193,.736,26,79,105,415,109,11,150,203,458
21820,UTA,1985,Rich Kelley,31,77,34,1276,103,216,.477,0,2,.000,103,214,.481,.477,84,112,.750,118,232,350,120,42,30,124,227,290
21821,UTA,1985,Fred Roberts,24,52,0,873,164,320,.513,1,1,1.000,163,319,.511,.514,121,144,.840,68,83,151,65,18,10,68,96,450
21822,UTA,1985,Bob Hansen,24,54,4,646,110,225,.489,1,7,.143,109,218,.500,.491,40,72,.556,20,50,70,75,25,1,49,88,261
21823,UTA,1985,John Drew,30,19,16,463,107,260,.412,0,4,.000,107,256,.418,.412,94,122,.770,36,46,82,35,22,2,42,65,308
21824,UTA,1985,J.J. Anderson,24,44,0,457,61,149,.409,0,2,.000,61,147,.415,.409,27,45,.600,29,53,82,21,29,9,32,70,149
21825,UTA,1985,Billy Paultz,36,62,0,370,32,87,.368,0,0,,32,87,.368,.368,18,28,.643,24,72,96,16,6,11,30,51,82
21826,UTA,1985,Pace Mannion,24,34,0,190,27,63,.429,0,1,.000,27,62,.435,.429,16,23,.696,12,11,23,27,16,3,18,17,70
21827,UTA,1985,Kenny Natt,26,4,0,13,2,5,.400,0,0,,2,5,.400,.400,2,4,.500,1,1,2,0,1,0,3,2,6
21828,UTA,1984,Adrian Dantley,28,79,79,2984,802,1438,.558,1,4,.250,801,1434,.559,.558,813,946,.859,179,269,448,310,61,4,263,201,2418
21829,UTA,1984,Rickey Green,29,81,81,2768,439,904,.486,2,17,.118,437,887,.493,.487,192,234,.821,56,174,230,748,215,13,172,155,1072
21830,UTA,1984,Darrell Griffith,25,82,82,2650,697,1423,.490,91,252,.361,606,1171,.518,.522,151,217,.696,95,243,338,283,114,23,243,202,1636
21831,UTA,1984,Mark Eaton,27,82,78,2139,194,416,.466,0,1,.000,194,415,.467,.466,73,123,.593,148,447,595,113,25,351,98,303,461
21832,UTA,1984,Thurl Bailey,22,81,54,2009,302,590,.512,0,0,,302,590,.512,.512,88,117,.752,115,349,464,129,38,122,105,193,692
21833,UTA,1984,John Drew,29,81,4,1797,511,1067,.479,6,22,.273,505,1045,.483,.482,402,517,.778,146,192,338,135,88,2,192,208,1430
21834,UTA,1984,Jeff Wilkins,28,81,1,1734,249,520,.479,0,3,.000,249,517,.482,.479,134,182,.736,109,346,455,73,27,42,109,205,632
21835,UTA,1984,Rich Kelley,30,75,30,1674,132,264,.500,0,0,,132,264,.500,.500,124,162,.765,140,350,490,157,55,29,148,273,388
21836,UTA,1984,Jerry Eaves,24,80,1,1034,132,293,.451,0,6,.000,132,287,.460,.451,92,132,.697,29,56,85,200,33,5,93,90,356
21837,UTA,1984,Bob Hansen,23,55,0,419,65,145,.448,0,8,.000,65,137,.474,.448,18,28,.643,13,35,48,44,15,4,35,62,148
21838,UTA,1984,J.J. Anderson,23,48,0,311,55,130,.423,0,3,.000,55,127,.433,.423,12,29,.414,38,25,63,22,15,9,20,28,122
21839,UTA,1984,Tom Boswell,30,38,0,261,28,52,.538,1,1,1.000,27,51,.529,.548,16,21,.762,28,36,64,16,9,0,13,58,73
21840,UTA,1983,Darrell Griffith,24,77,76,2787,752,1554,.484,38,132,.288,714,1422,.502,.496,167,246,.679,100,204,304,270,138,33,252,184,1709
21841,UTA,1983,Rickey Green,28,78,78,2783,464,942,.493,2,13,.154,462,929,.497,.494,185,232,.797,62,161,223,697,220,4,222,154,1115
21842,UTA,1983,Ben Poquette,27,75,50,2331,329,697,.472,1,5,.200,328,692,.474,.473,166,221,.751,155,366,521,168,64,116,100,264,825
21843,UTA,1983,Jeff Wilkins,27,81,34,2307,389,816,.477,0,3,.000,389,813,.478,.477,156,200,.780,154,442,596,132,41,42,186,251,934
21844,UTA,1983,Danny Schayes,23,50,50,1638,231,514,.449,0,1,.000,231,513,.450,.449,157,195,.805,137,312,449,165,39,68,195,216,619
21845,UTA,1983,Jerry Eaves,23,82,7,1588,280,575,.487,1,8,.125,279,567,.492,.488,200,247,.810,34,88,122,210,51,3,152,116,761
21846,UTA,1983,Mark Eaton,26,81,32,1528,146,353,.414,0,1,.000,146,352,.415,.414,59,90,.656,86,376,462,112,24,275,140,257,351
21847,UTA,1983,John Drew,28,44,33,1206,318,671,.474,0,5,.000,318,666,.477,.474,296,392,.755,98,137,235,97,35,7,135,152,932
21848,UTA,1983,J.J. Anderson,22,52,2,1154,182,357,.510,0,3,.000,182,354,.514,.510,99,172,.576,115,167,282,66,62,21,74,147,463
21849,UTA,1983,Adrian Dantley,27,22,22,887,233,402,.580,0,0,,233,402,.580,.580,210,248,.847,58,82,140,105,20,0,81,62,676
21850,UTA,1983,Rich Kelley,29,32,23,780,71,152,.467,0,0,,71,152,.467,.467,87,105,.829,70,162,232,79,33,21,65,106,229
21851,UTA,1983,Rickey Williams,25,44,0,346,56,135,.415,0,3,.000,56,132,.424,.415,35,53,.660,15,23,38,37,20,4,38,42,147
21852,UTA,1983,Kenny Natt,24,22,0,210,38,73,.521,0,2,.000,38,71,.535,.521,9,14,.643,6,16,22,28,5,0,22,36,85
21853,UTA,1983,Freeman Williams,26,18,3,210,36,101,.356,2,7,.286,34,94,.362,.366,18,25,.720,3,14,17,10,6,1,12,30,92
21854,UTA,1982,Adrian Dantley,26,81,81,3222,904,1586,.570,1,3,.333,903,1583,.570,.570,648,818,.792,231,283,514,324,95,14,299,252,2457
21855,UTA,1982,Rickey Green,27,81,73,2822,500,1015,.493,0,8,.000,500,1007,.497,.493,202,264,.765,85,158,243,630,185,9,198,183,1202
21856,UTA,1982,Darrell Griffith,23,80,79,2597,689,1429,.482,15,52,.288,674,1377,.489,.487,189,271,.697,128,177,305,187,95,34,193,213,1582
21857,UTA,1982,Jeff Wilkins,26,82,62,2274,314,718,.437,0,3,.000,314,715,.439,.437,137,176,.778,120,491,611,90,32,77,134,248,765
21858,UTA,1982,James Hardy,25,82,17,1814,179,369,.485,0,1,.000,179,368,.486,.485,64,93,.688,153,317,470,110,58,67,78,192,422
21859,UTA,1982,Ben Poquette,26,82,56,1698,220,428,.514,3,10,.300,217,418,.519,.518,97,120,.808,117,294,411,94,51,65,69,235,540
21860,UTA,1982,Danny Schayes,22,82,20,1623,252,524,.481,0,1,.000,252,523,.482,.481,140,185,.757,131,296,427,146,46,72,151,292,644
21861,UTA,1982,Carl Nicks,23,80,1,1322,252,555,.454,0,5,.000,252,550,.458,.454,85,150,.567,67,94,161,89,66,4,101,184,589
21862,UTA,1982,John Duren,23,79,9,1056,121,268,.451,3,11,.273,118,257,.459,.457,27,37,.730,14,70,84,157,20,4,72,143,272
21863,UTA,1982,Bill Robinzine,29,56,9,651,131,294,.446,0,0,,131,294,.446,.446,61,75,.813,56,88,144,49,37,5,83,156,323
21864,UTA,1982,Howard Wood,22,42,3,342,55,120,.458,0,1,.000,55,119,.462,.458,34,52,.654,22,43,65,9,8,6,15,37,144
21865,UTA,1982,Bobby Cattage,23,49,0,337,60,135,.444,0,2,.000,60,133,.451,.444,30,41,.732,22,51,73,7,7,0,18,58,150
21866,UTA,1982,Sam Worthen,24,5,0,22,2,5,.400,0,0,,2,5,.400,.400,0,0,,1,0,1,3,0,0,2,3,4
21867,UTA,1981,Adrian Dantley,25,80,,3417,909,1627,.559,2,7,.286,907,1620,.560,.559,632,784,.806,192,317,509,322,109,18,282,245,2452
21868,UTA,1981,Darrell Griffith,22,81,,2867,716,1544,.464,10,52,.192,706,1492,.473,.467,229,320,.716,79,209,288,194,106,40,231,219,1671
21869,UTA,1981,Ben Poquette,25,82,82,2808,324,614,.528,3,6,.500,321,608,.528,.530,126,162,.778,160,469,629,161,67,174,122,342,777
21870,UTA,1981,Allan Bristow,29,82,,2001,271,611,.444,5,18,.278,266,593,.449,.448,166,198,.838,103,327,430,383,63,3,171,190,713
21871,UTA,1981,Wayne Cooper,24,71,,1420,213,471,.452,1,3,.333,212,468,.453,.453,62,90,.689,166,274,440,52,18,51,77,219,489
21872,UTA,1981,Rickey Green,26,47,,1307,176,366,.481,0,1,.000,176,365,.482,.481,70,97,.722,30,86,116,235,75,1,83,123,422
21873,UTA,1981,Ron Boone,34,52,,1146,160,371,.431,11,39,.282,149,332,.449,.446,75,94,.798,17,67,84,161,33,8,111,126,406
21874,UTA,1981,Jeff Wilkins,25,56,,1058,117,260,.450,0,0,,117,260,.450,.450,27,40,.675,62,212,274,40,32,46,59,169,261
21875,UTA,1981,Billy McKinney,25,35,,1032,124,233,.532,1,2,.500,123,231,.532,.534,44,48,.917,12,62,74,157,38,4,70,107,293
21876,UTA,1981,Jeff Judkins,24,62,,666,92,216,.426,9,28,.321,83,188,.441,.447,45,51,.882,29,64,93,59,16,2,30,84,238
21877,UTA,1981,Carl Nicks,22,40,,616,107,210,.510,0,3,.000,107,207,.517,.510,36,67,.537,24,37,61,69,32,1,53,89,250
21878,UTA,1981,James Hardy,24,23,,509,52,111,.468,0,0,,52,111,.468,.468,11,20,.550,39,94,133,36,21,20,23,58,115
21879,UTA,1981,John Duren,22,40,,458,33,101,.327,0,1,.000,33,100,.330,.327,5,9,.556,8,27,35,54,18,2,37,54,71
21880,UTA,1981,Mel Bennett,26,28,,313,26,60,.433,0,2,.000,26,58,.448,.433,53,81,.654,33,60,93,15,3,11,31,56,105
21881,UTA,1981,Brett Vroman,25,11,,93,10,27,.370,0,1,.000,10,26,.385,.370,14,19,.737,7,18,25,9,5,5,9,26,34
21882,UTA,1981,Dick Miller,22,3,,19,2,3,.667,0,0,,2,3,.667,.667,0,0,,1,2,3,1,1,0,4,3,4
21883,UTA,1980,Adrian Dantley,24,68,,2674,730,1267,.576,0,2,.000,730,1265,.577,.576,443,526,.842,183,333,516,191,96,14,233,211,1903
21884,UTA,1980,Ben Poquette,24,82,,2349,296,566,.523,0,2,.000,296,564,.525,.523,139,167,.832,124,436,560,131,45,162,103,283,731
21885,UTA,1980,Allan Bristow,28,82,,2304,377,785,.480,2,7,.286,375,778,.482,.482,197,243,.811,170,342,512,341,88,6,179,211,953
21886,UTA,1980,Ron Boone,33,75,,2286,391,875,.447,19,50,.380,372,825,.451,.458,169,189,.894,50,166,216,302,92,3,184,219,970
21887,UTA,1980,Duck Williams,23,77,,1794,232,519,.447,0,12,.000,232,507,.458,.447,42,60,.700,21,85,106,183,100,11,107,166,506
21888,UTA,1980,Terry Furlow,25,55,,1718,364,765,.476,23,73,.315,341,692,.493,.491,127,145,.876,47,105,152,221,54,14,129,79,878
21889,UTA,1980,James Hardy,23,76,,1600,184,363,.507,1,2,.500,183,361,.507,.508,51,66,.773,124,275,399,104,47,87,105,207,420
21890,UTA,1980,Tom Boswell,26,61,,1555,274,478,.573,4,8,.500,270,470,.574,.577,148,203,.729,106,222,328,115,24,29,142,214,700
21891,UTA,1980,Paul Dawkins,22,57,,776,141,300,.470,1,5,.200,140,295,.475,.472,33,48,.688,42,83,125,77,33,9,76,112,316
21892,UTA,1980,Mack Calvin,32,48,,772,100,227,.441,1,11,.091,99,216,.458,.443,105,117,.897,13,71,84,134,27,0,57,72,306
21893,UTA,1980,Pete Maravich,32,17,,522,121,294,.412,7,11,.636,114,283,.403,.423,41,50,.820,7,33,40,54,15,4,45,30,290
21894,UTA,1980,Bernard King,23,19,,419,71,137,.518,0,0,,71,137,.518,.518,34,63,.540,24,64,88,52,7,4,50,66,176
21895,UTA,1980,Jerome Whitehead,23,32,,328,31,69,.449,0,0,,31,69,.449,.449,5,17,.294,27,70,97,18,7,11,28,65,67
21896,UTA,1980,John Gianelli,29,17,,285,23,66,.348,0,0,,23,66,.348,.348,9,16,.563,14,48,62,17,6,7,22,26,55
21897,UTA,1980,Brad Davis,24,13,,225,33,56,.589,0,1,.000,33,55,.600,.589,10,12,.833,4,11,15,45,10,1,11,21,76
21898,UTA,1980,Robert Smith,24,6,,73,5,15,.333,0,0,,5,15,.333,.333,5,5,1.000,3,0,3,7,4,0,1,3,15
21899,UTA,1980,Greg Deane,22,7,,48,2,11,.182,1,1,1.000,1,10,.100,.227,5,7,.714,2,4,6,6,0,0,3,3,10
21900,UTA,1980,Andre Wakefield,25,8,,47,6,15,.400,0,0,,6,15,.400,.400,3,3,1.000,0,4,4,3,1,0,8,13,15
21901,UTA,1980,John Brown,28,4,,24,0,7,.000,0,0,,0,7,.000,.000,4,4,1.000,5,4,9,4,0,0,5,4,4
21902,UTA,1980,Carl Kilpatrick,23,2,,6,1,2,.500,0,0,,1,2,.500,.500,1,2,.500,1,3,4,0,0,0,0,1,3
21903,HOU,2024,Fred VanVleet,29,73,73,2684,423,1018,.416,227,586,.387,196,432,.454,.527,197,229,.860,33,245,278,589,101,59,126,183,1270
21904,HOU,2024,Jalen Green,21,82,82,2601,563,1332,.423,201,605,.332,362,727,.498,.498,283,352,.804,41,382,423,291,66,28,191,115,1610
21905,HOU,2024,Jabari Smith Jr.,20,76,76,2424,378,833,.454,138,380,.363,240,453,.530,.537,150,185,.811,139,477,616,121,52,61,89,200,1044
21906,HOU,2024,Dillon Brooks,28,72,72,2227,329,768,.428,133,370,.359,196,398,.492,.515,124,147,.844,53,193,246,119,64,10,88,241,915
21907,HOU,2024,Alperen Sengun,21,63,63,2046,527,982,.537,33,111,.297,494,871,.567,.553,244,352,.693,183,406,589,312,76,46,162,211,1331
21908,HOU,2024,Amen Thompson,21,62,23,1388,239,446,.536,8,58,.138,231,388,.595,.545,106,155,.684,148,261,409,163,78,38,90,141,592
21909,HOU,2024,Jeff Green,37,78,6,1307,167,366,.456,53,160,.331,114,206,.553,.529,122,149,.819,46,132,178,70,16,31,46,100,509
21910,HOU,2024,Aaron Holiday,27,78,1,1269,186,417,.446,84,217,.387,102,200,.510,.547,58,63,.921,23,100,123,140,42,6,53,125,514
21911,HOU,2024,Jae'Sean Tate,28,65,9,1031,108,229,.472,23,77,.299,85,152,.559,.522,26,39,.667,61,136,197,64,42,15,37,137,265
21912,HOU,2024,Cam Whitmore,19,47,2,880,212,467,.454,79,220,.359,133,247,.538,.539,76,112,.679,44,136,180,33,30,17,46,64,579
21913,HOU,2024,Jock Landale,28,56,3,763,106,206,.515,10,40,.250,96,166,.578,.539,52,65,.800,88,84,172,65,20,33,31,74,274
21914,HOU,2024,Tari Eason,22,22,0,480,88,189,.466,18,50,.360,70,139,.504,.513,21,33,.636,46,107,153,27,31,19,20,51,215
21915,HOU,2024,Reggie Bullock,32,44,0,417,34,82,.415,27,67,.403,7,15,.467,.579,1,1,1.000,6,67,73,15,12,5,10,29,96
21916,HOU,2024,Jeenathan Williams,24,22,0,129,27,50,.540,2,5,.400,25,45,.556,.560,7,13,.538,12,11,23,7,4,1,4,10,63
21917,HOU,2024,Nate Hinton,24,15,0,75,11,26,.423,7,14,.500,4,12,.333,.558,4,5,.800,7,15,22,10,3,2,3,11,33
21918,HOU,2024,Boban Marjanović,35,14,0,71,18,34,.529,0,2,.000,18,32,.563,.529,9,14,.643,7,25,32,6,1,2,5,5,45
21919,HOU,2024,Jermaine Samuels,25,14,0,60,9,14,.643,0,2,.000,9,12,.750,.643,2,2,1.000,3,10,13,3,1,2,0,5,20
21920,HOU,2023,Jalen Green,20,76,76,2602,566,1359,.416,187,554,.338,379,805,.471,.485,364,463,.786,43,241,284,281,59,18,200,131,1683
21921,HOU,2023,Jabari Smith Jr.,19,79,79,2451,364,892,.408,120,391,.307,244,501,.487,.475,162,206,.786,122,447,569,101,43,74,104,227,1010
21922,HOU,2023,KJ Martin,22,82,49,2292,410,720,.569,68,216,.315,342,504,.679,.617,151,222,.680,126,326,452,123,41,30,91,147,1039
21923,HOU,2023,Alperen Sengun,20,75,72,2171,442,799,.553,19,57,.333,423,742,.570,.565,206,288,.715,242,436,678,291,70,70,193,258,1109
21924,HOU,2023,Kevin Porter Jr.,22,59,59,2024,391,884,.442,141,385,.366,250,499,.501,.522,207,264,.784,76,238,314,338,82,17,188,156,1130
21925,HOU,2023,Tari Eason,21,82,5,1767,296,660,.448,59,172,.343,237,488,.486,.493,109,145,.752,195,301,496,88,96,47,101,189,760
21926,HOU,2023,Eric Gordon,34,47,47,1418,210,478,.439,85,245,.347,125,233,.536,.528,110,135,.815,12,85,97,136,30,17,83,45,615
21927,HOU,2023,Usman Garuba,20,75,1,970,86,177,.486,24,59,.407,62,118,.525,.554,29,47,.617,120,187,307,64,44,29,47,135,225
21928,HOU,2023,Daishen Nix,20,57,7,914,81,237,.342,40,140,.286,41,97,.423,.426,24,36,.667,18,80,98,132,31,7,86,59,226
21929,HOU,2023,Josh Christopher,21,64,2,786,153,329,.465,21,89,.236,132,240,.550,.497,45,60,.750,20,51,71,73,33,15,60,59,372
21930,HOU,2023,Jae'Sean Tate,27,31,7,677,110,229,.480,13,46,.283,97,183,.530,.509,50,69,.725,41,77,118,84,21,7,47,106,283
21931,HOU,2023,Garrison Mathews,26,45,0,602,60,170,.353,53,155,.342,7,15,.467,.509,41,45,.911,10,52,62,23,23,4,18,56,214
21932,HOU,2023,TyTy Washington Jr.,21,31,2,433,58,160,.363,19,80,.238,39,80,.488,.422,10,18,.556,2,43,45,47,15,2,14,29,145
21933,HOU,2023,Bruno Fernando,24,31,4,364,48,93,.516,0,1,.000,48,92,.522,.516,30,44,.682,48,74,122,30,6,31,20,68,126
21934,HOU,2023,Boban Marjanović,34,31,0,171,41,60,.683,0,1,.000,41,59,.695,.683,20,27,.741,20,40,60,9,5,2,14,10,102
21935,HOU,2023,Frank Kaminsky,29,10,0,59,6,19,.316,2,10,.200,4,9,.444,.368,4,4,1.000,4,12,16,11,1,3,0,1,18
21936,HOU,2023,Trevor Hudgins,23,5,0,28,2,9,.222,2,8,.250,0,1,.000,.333,3,3,1.000,0,0,0,3,0,0,1,1,9
21937,HOU,2023,Darius Days,23,4,0,25,5,12,.417,3,10,.300,2,2,1.000,.542,2,2,1.000,1,5,6,1,0,1,0,2,15
21938,HOU,2022,Jalen Green,19,67,67,2138,406,954,.426,157,458,.343,249,496,.502,.508,188,236,.797,33,193,226,176,44,18,135,103,1157
21939,HOU,2022,Christian Wood,26,68,67,2094,440,878,.501,131,336,.390,309,542,.570,.576,207,332,.623,110,576,686,155,54,65,126,171,1218
21940,HOU,2022,Jae'Sean Tate,26,78,77,2056,363,729,.498,63,202,.312,300,527,.569,.541,130,184,.707,135,285,420,222,72,41,139,286,919
21941,HOU,2022,Kevin Porter Jr.,21,61,61,1907,335,808,.415,155,413,.375,180,395,.456,.511,124,193,.642,43,224,267,376,69,22,192,156,949
21942,HOU,2022,Garrison Mathews,25,65,33,1712,184,461,.399,139,386,.360,45,75,.600,.550,143,180,.794,32,158,190,64,57,24,41,168,650
21943,HOU,2022,Eric Gordon,33,57,46,1670,268,564,.475,124,301,.412,144,263,.548,.585,105,135,.778,15,98,113,154,28,18,107,63,765
21944,HOU,2022,KJ Martin,21,79,2,1656,279,523,.533,60,168,.357,219,355,.617,.591,78,123,.634,80,217,297,101,34,40,60,113,696
21945,HOU,2022,Alperen Sengun,19,72,13,1489,249,525,.474,29,117,.248,220,408,.539,.502,165,232,.711,138,255,393,185,59,68,145,214,692
21946,HOU,2022,Josh Christopher,20,74,2,1334,224,500,.448,56,189,.296,168,311,.540,.504,83,113,.735,52,134,186,150,65,13,114,97,587
21947,HOU,2022,Armoni Brooks,23,41,8,690,87,251,.347,64,213,.300,23,38,.605,.474,16,19,.842,12,69,81,49,21,8,23,60,254
21948,HOU,2022,David Nwaba,29,46,4,609,85,176,.483,15,49,.306,70,127,.551,.526,48,67,.716,41,110,151,35,28,20,21,55,233
21949,HOU,2022,Daniel Theis,29,26,21,584,84,179,.469,23,79,.291,61,100,.610,.534,27,40,.675,32,98,130,20,11,17,31,62,218
21950,HOU,2022,D.J. Augustin,34,34,2,510,55,136,.404,39,96,.406,16,40,.400,.548,33,38,.868,7,34,41,74,10,0,45,17,182
21951,HOU,2022,Dennis Schröder,28,15,4,404,55,140,.393,19,58,.328,36,82,.439,.461,34,39,.872,6,44,50,88,12,3,39,38,163
21952,HOU,2022,Daishen Nix,19,24,0,261,27,67,.403,7,26,.269,20,41,.488,.455,16,30,.533,7,26,33,40,15,0,26,21,77
21953,HOU,2022,Usman Garuba,19,24,2,240,19,44,.432,5,20,.250,14,24,.583,.489,5,7,.714,21,62,83,17,10,11,6,28,48
21954,HOU,2022,Danuel House Jr.,28,16,1,233,25,74,.338,10,34,.294,15,40,.375,.405,17,19,.895,4,39,43,19,5,5,18,16,77
21955,HOU,2022,Bruno Fernando,23,10,0,94,29,41,.707,0,1,.000,29,40,.725,.707,11,19,.579,11,29,40,3,1,8,9,18,69
21956,HOU,2022,Trevelin Queen,24,10,0,74,15,33,.455,9,24,.375,6,9,.667,.591,4,4,1.000,7,9,16,4,5,1,7,6,43
21957,HOU,2021,Jae'Sean Tate,25,70,58,2043,316,625,.506,60,195,.308,256,430,.595,.554,102,147,.694,132,242,374,178,85,36,98,222,794
21958,HOU,2021,Christian Wood,25,41,41,1326,329,640,.514,77,206,.374,252,434,.581,.574,125,198,.631,76,319,395,71,34,48,80,88,860
21959,HOU,2021,John Wall,30,40,40,1288,293,726,.404,79,249,.317,214,477,.449,.458,158,211,.749,17,112,129,275,42,31,141,46,823
21960,HOU,2021,Sterling Brown,25,51,14,1229,150,335,.448,91,215,.423,59,120,.492,.584,25,31,.806,38,186,224,72,38,12,41,97,416
21961,HOU,2021,KJ Martin,20,45,8,1068,162,318,.509,35,96,.365,127,222,.572,.564,60,84,.714,73,169,242,48,30,41,38,89,419
21962,HOU,2021,P.J. Tucker,35,32,32,959,48,131,.366,27,86,.314,21,45,.467,.469,18,23,.783,33,115,148,45,29,18,33,91,141
21963,HOU,2021,Danuel House Jr.,27,36,23,932,110,272,.404,54,156,.346,56,116,.483,.504,41,63,.651,18,114,132,69,20,16,36,67,315
21964,HOU,2021,Kelly Olynyk,29,27,24,840,175,321,.545,49,125,.392,126,196,.643,.621,114,135,.844,43,185,228,112,39,16,71,84,513
21965,HOU,2021,Kevin Porter Jr.,20,26,23,835,156,367,.425,50,161,.311,106,206,.515,.493,69,94,.734,20,79,99,164,19,8,91,61,431
21966,HOU,2021,Eric Gordon,32,27,13,789,159,367,.433,69,210,.329,90,157,.573,.527,94,114,.825,8,50,58,71,14,13,51,44,481
21967,HOU,2021,David Nwaba,28,30,9,679,106,218,.486,17,63,.270,89,155,.574,.525,47,68,.691,40,78,118,31,30,21,17,60,276
21968,HOU,2021,Victor Oladipo,28,20,20,669,155,381,.407,49,153,.320,106,228,.465,.471,65,83,.783,8,87,95,99,24,10,51,45,424
21969,HOU,2021,Ben McLemore,27,32,4,537,80,224,.357,55,166,.331,25,58,.431,.480,23,32,.719,11,55,66,28,20,3,28,51,238
21970,HOU,2021,Armoni Brooks,22,20,5,520,78,192,.406,60,157,.382,18,35,.514,.563,7,12,.583,10,58,68,30,12,5,22,34,223
21971,HOU,2021,DeMarcus Cousins,30,25,11,506,79,210,.376,39,116,.336,40,94,.426,.469,44,59,.746,30,161,191,60,21,18,39,74,241
21972,HOU,2021,D.J. Augustin,33,20,6,416,64,151,.424,34,88,.386,30,63,.476,.536,49,54,.907,9,35,44,78,8,0,31,23,211
21973,HOU,2021,Anthony Lamb,23,24,3,415,46,118,.390,23,71,.324,23,47,.489,.487,18,21,.857,27,43,70,23,6,5,19,34,133
21974,HOU,2021,Avery Bradley,30,17,5,391,33,105,.314,17,63,.270,16,42,.381,.395,5,6,.833,6,33,39,32,14,2,19,29,88
21975,HOU,2021,D.J. Wilson,24,23,1,328,52,125,.416,20,59,.339,32,66,.485,.496,16,23,.696,17,70,87,20,10,12,18,31,140
21976,HOU,2021,Mason Jones,22,26,1,307,47,114,.412,23,64,.359,24,50,.480,.513,35,57,.614,4,47,51,39,6,1,28,22,152
21977,HOU,2021,James Harden,31,8,8,290,60,135,.444,25,72,.347,35,63,.556,.537,53,60,.883,5,36,41,83,7,6,34,14,198
21978,HOU,2021,DaQuan Jeffries,23,13,3,261,26,63,.413,11,39,.282,15,24,.625,.500,1,1,1.000,10,32,42,16,8,6,6,25,64
21979,HOU,2021,Justin Patton,23,13,6,247,29,70,.414,9,34,.265,20,36,.556,.479,3,4,.750,14,35,49,14,12,14,4,34,70
21980,HOU,2021,Khyri Thomas,24,5,2,153,32,66,.485,9,27,.333,23,39,.590,.553,9,9,1.000,7,11,18,25,9,6,6,8,82
21981,HOU,2021,Cameron Oliver,24,4,0,87,19,33,.576,4,13,.308,15,20,.750,.636,1,4,.250,5,16,21,5,2,4,3,11,43
21982,HOU,2021,Rodions Kurucs,22,11,0,75,5,21,.238,2,15,.133,3,6,.500,.286,1,2,.500,2,9,11,4,6,4,9,7,13
21983,HOU,2021,Bruno Caboclo,25,6,0,36,8,17,.471,0,5,.000,8,12,.667,.471,1,2,.500,3,11,14,1,0,2,4,6,17
21984,HOU,2021,Cameron Reynolds,25,2,0,34,5,16,.313,3,12,.250,2,4,.500,.406,0,0,,2,3,5,2,0,0,0,2,13
21985,HOU,2021,Brodric Thomas,24,4,0,24,2,7,.286,1,6,.167,1,1,1.000,.357,5,7,.714,1,3,4,4,1,1,4,5,10
21986,HOU,2021,Ray Spalding,23,2,0,19,2,4,.500,0,1,.000,2,3,.667,.500,0,2,.000,2,2,4,0,0,2,3,3,4
21987,HOU,2020,James Harden,30,68,68,2483,672,1514,.444,299,843,.355,373,671,.556,.543,692,800,.865,70,376,446,512,125,60,308,227,2335
21988,HOU,2020,P.J. Tucker,34,72,72,2467,177,426,.415,107,299,.358,70,127,.551,.541,39,48,.813,112,364,476,115,77,36,72,229,500
21989,HOU,2020,Russell Westbrook,31,57,57,2049,604,1281,.472,55,213,.258,549,1068,.514,.493,290,380,.763,100,351,451,401,93,20,255,200,1553
21990,HOU,2020,Danuel House Jr.,26,63,52,1913,230,539,.427,129,355,.363,101,184,.549,.546,73,90,.811,57,210,267,85,67,34,54,132,662
21991,HOU,2020,Ben McLemore,26,71,23,1619,242,545,.444,181,452,.400,61,93,.656,.610,50,67,.746,21,136,157,58,45,16,50,155,715
21992,HOU,2020,Austin Rivers,27,68,4,1594,211,501,.421,96,270,.356,115,231,.498,.517,78,111,.703,27,148,175,113,49,10,50,129,596
21993,HOU,2020,Clint Capela,25,39,39,1279,244,388,.629,0,0,,244,388,.629,.629,55,104,.529,168,369,537,48,33,72,63,102,543
21994,HOU,2020,Eric Gordon,31,36,15,1016,171,463,.369,96,303,.317,75,160,.469,.473,82,107,.766,9,62,71,54,23,13,43,70,520
21995,HOU,2020,Robert Covington,29,22,21,726,89,227,.392,53,168,.315,36,59,.610,.509,24,30,.800,27,149,176,32,35,48,30,72,255
21996,HOU,2020,Thabo Sefolosha,35,41,0,436,37,91,.407,15,54,.278,22,37,.595,.489,3,8,.375,21,72,93,25,24,12,15,43,92
21997,HOU,2020,Jeff Green,33,18,2,407,84,149,.564,28,79,.354,56,70,.800,.658,24,28,.857,10,42,52,30,14,9,15,43,220
21998,HOU,2020,Chris Clemons,22,33,0,291,57,142,.401,37,107,.346,20,35,.571,.532,10,11,.909,4,26,30,27,9,6,19,26,161
21999,HOU,2020,Isaiah Hartenstein,21,23,2,266,44,67,.657,0,5,.000,44,62,.710,.657,19,28,.679,29,61,90,18,9,12,16,41,107
22000,HOU,2020,Tyson Chandler,37,26,5,219,14,18,.778,0,0,,14,18,.778,.778,6,13,.462,25,41,66,6,6,8,8,32,34
22001,HOU,2020,Gary Clark,25,18,0,212,23,59,.390,18,51,.353,5,8,.625,.542,6,7,.857,11,29,40,12,2,7,2,21,70
22002,HOU,2020,DeMarre Carroll,33,9,0,155,16,37,.432,5,20,.250,11,17,.647,.500,17,22,.773,5,19,24,14,6,3,7,12,54
22003,HOU,2020,Michael Frazier,25,13,0,145,7,29,.241,4,23,.174,3,6,.500,.310,9,14,.643,1,9,10,2,2,0,5,22,27
22004,HOU,2020,Bruno Caboclo,24,8,0,52,10,20,.500,2,8,.250,8,12,.667,.550,6,6,1.000,6,10,16,2,5,5,6,8,28
22005,HOU,2020,Luc Mbah a Moute,33,3,0,25,2,5,.400,0,2,.000,2,3,.667,.400,1,2,.500,1,1,2,0,2,0,1,0,5
22006,HOU,2020,Ryan Anderson,31,2,0,14,2,7,.286,1,5,.200,1,2,.500,.357,0,0,,0,7,7,2,1,0,1,1,5
22007,HOU,2020,William Howard,26,2,0,13,0,4,.000,0,4,.000,0,0,,.000,0,0,,0,2,2,1,0,0,1,1,0
22008,HOU,2019,James Harden,29,78,78,2867,843,1909,.442,378,1028,.368,465,881,.528,.541,754,858,.879,66,452,518,586,158,58,387,244,2818
22009,HOU,2019,P.J. Tucker,33,82,82,2802,207,523,.396,146,387,.377,61,136,.449,.535,41,59,.695,121,358,479,96,132,39,63,252,601
22010,HOU,2019,Clint Capela,24,67,67,2249,474,732,.648,0,0,,474,732,.648,.648,166,261,.636,298,550,848,96,44,102,94,168,1114
22011,HOU,2019,Eric Gordon,30,68,53,2158,384,938,.409,216,600,.360,168,338,.497,.525,119,152,.783,17,131,148,129,41,27,90,143,1103
22012,HOU,2019,Chris Paul,33,58,58,1857,302,720,.419,127,355,.358,175,365,.479,.508,175,203,.862,36,229,265,473,114,18,152,146,906
22013,HOU,2019,Gerald Green,33,73,0,1473,231,578,.400,156,441,.354,75,137,.547,.535,57,68,.838,30,152,182,40,33,27,55,126,675
22014,HOU,2019,Austin Rivers,26,47,13,1345,156,378,.413,71,221,.321,85,157,.541,.507,25,49,.510,15,76,91,109,29,13,32,135,408
22015,HOU,2019,Danuel House Jr.,25,39,13,979,118,252,.468,74,178,.416,44,74,.595,.615,56,71,.789,25,115,140,40,21,11,35,80,366
22016,HOU,2019,James Ennis III,28,40,25,949,104,211,.493,44,120,.367,60,91,.659,.597,42,58,.724,37,80,117,27,38,16,23,111,294
22017,HOU,2019,Gary Clark,24,51,2,641,50,151,.331,41,138,.297,9,13,.692,.467,7,7,1.000,24,92,116,18,20,26,7,47,148
22018,HOU,2019,Kenneth Faried,29,25,13,610,131,223,.587,7,20,.350,124,203,.611,.603,54,83,.651,82,124,206,18,15,19,27,74,323
22019,HOU,2019,Nenê,36,42,2,546,60,116,.517,0,3,.000,60,113,.531,.517,31,47,.660,34,89,123,26,18,15,11,87,151
22020,HOU,2019,Iman Shumpert,28,20,1,382,34,98,.347,21,71,.296,13,27,.481,.454,2,4,.500,8,46,54,21,12,4,12,35,91
22021,HOU,2019,Carmelo Anthony,34,10,2,294,49,121,.405,21,64,.328,28,57,.491,.492,15,22,.682,9,45,54,5,4,7,8,32,134
22022,HOU,2019,Isaiah Hartenstein,20,28,0,221,20,41,.488,2,6,.333,18,35,.514,.512,11,14,.786,21,26,47,15,7,12,13,56,53
22023,HOU,2019,Michael Carter-Williams,27,16,1,145,25,61,.410,7,19,.368,18,42,.429,.467,12,26,.462,3,10,13,21,9,6,10,27,69
22024,HOU,2019,Brandon Knight,27,12,0,118,11,47,.234,5,32,.156,6,15,.400,.287,9,11,.818,1,8,9,9,2,0,5,14,36
22025,HOU,2019,Marquese Chriss,21,16,0,104,11,34,.324,1,15,.067,10,19,.526,.338,6,7,.857,7,21,28,6,2,4,12,17,29
22026,HOU,2019,James Nunnally,28,2,0,38,3,13,.231,3,12,.250,0,1,.000,.346,0,0,,0,1,1,2,0,0,0,6,9
22027,HOU,2019,Chris Chiozza,23,7,0,33,2,8,.250,2,5,.400,0,3,.000,.375,0,0,,1,3,4,4,1,1,1,2,6
22028,HOU,2019,Vince Edwards,22,2,0,16,1,4,.250,1,4,.250,0,0,,.375,0,0,,1,1,2,0,0,0,0,0,3
22029,HOU,2019,Terrence Jones,27,2,0,5,1,4,.250,0,2,.000,1,2,.500,.250,0,1,.000,0,4,4,0,0,0,1,1,2
22030,HOU,2019,Zhou Qi,23,1,0,1,1,1,1.000,0,0,,1,1,1.000,1.000,0,0,,0,0,0,0,0,0,0,0,2
22031,HOU,2018,James Harden,28,72,72,2551,651,1449,.449,265,722,.367,386,727,.531,.541,624,727,.858,41,348,389,630,126,50,315,169,2191
22032,HOU,2018,P.J. Tucker,32,82,34,2281,172,441,.390,115,310,.371,57,131,.435,.520,43,60,.717,93,364,457,77,78,26,74,205,502
22033,HOU,2018,Trevor Ariza,32,67,67,2269,268,651,.412,170,462,.368,98,189,.519,.542,76,89,.854,33,261,294,105,98,13,52,132,782
22034,HOU,2018,Eric Gordon,29,69,30,2154,415,970,.428,218,608,.359,197,362,.544,.540,195,241,.809,25,145,170,154,44,27,130,116,1243
22035,HOU,2018,Clint Capela,23,74,74,2034,441,676,.652,0,1,.000,441,675,.653,.652,144,257,.560,241,561,802,68,58,137,103,185,1026
22036,HOU,2018,Chris Paul,32,58,58,1847,367,798,.460,144,379,.380,223,419,.532,.550,203,221,.919,37,276,313,457,96,14,128,141,1081
22037,HOU,2018,Ryan Anderson,29,66,50,1725,207,480,.431,131,339,.386,76,141,.539,.568,72,93,.774,94,237,331,60,24,21,42,126,617
22038,HOU,2018,Luc Mbah a Moute,31,61,15,1564,166,345,.481,63,173,.364,103,172,.599,.572,65,95,.684,22,164,186,55,72,25,68,100,460
22039,HOU,2018,Gerald Green,32,41,2,929,168,413,.407,110,298,.369,58,115,.504,.540,51,60,.850,15,118,133,25,24,15,31,87,497
22040,HOU,2018,Nenê,35,52,4,758,136,239,.569,0,2,.000,136,237,.574,.569,68,107,.636,54,122,176,45,28,14,38,123,340
22041,HOU,2018,Tarik Black,26,51,2,536,75,127,.591,1,11,.091,74,116,.638,.594,29,63,.460,63,100,163,13,21,30,35,107,180
22042,HOU,2018,Joe Johnson,36,23,1,505,51,134,.381,17,61,.279,34,73,.466,.444,20,21,.952,2,63,65,38,6,1,18,35,139
22043,HOU,2018,Zhou Qi,22,18,0,124,6,32,.188,2,19,.105,4,13,.308,.219,8,12,.667,6,16,22,2,2,14,10,14,22
22044,HOU,2018,Briante Weber,25,13,0,118,9,22,.409,4,9,.444,5,13,.385,.500,4,4,1.000,3,15,18,13,10,3,7,18,26
22045,HOU,2018,Bobby Brown,33,20,0,115,19,58,.328,11,40,.275,8,18,.444,.422,1,2,.500,0,7,7,11,4,0,9,6,50
22046,HOU,2018,Demetrius Jackson,23,12,0,63,4,14,.286,0,6,.000,4,8,.500,.286,0,0,,4,7,11,5,4,1,9,6,8
22047,HOU,2018,R.J. Hunter,24,5,1,45,7,20,.350,3,14,.214,4,6,.667,.425,2,2,1.000,0,5,5,3,3,0,2,7,19
22048,HOU,2018,Aaron Jackson,31,1,0,35,3,9,.333,1,4,.250,2,5,.400,.389,1,2,.500,2,1,3,1,0,0,1,4,8
22049,HOU,2018,Markel Brown,26,4,0,31,2,7,.286,1,5,.200,1,2,.500,.357,0,0,,1,4,5,2,0,0,2,6,5
22050,HOU,2018,Chinanu Onuaku,21,1,0,22,2,5,.400,0,0,,2,5,.400,.400,0,0,,1,3,4,1,0,0,3,4,4
22051,HOU,2018,Troy Williams,23,4,0,17,2,9,.222,0,5,.000,2,4,.500,.222,1,3,.333,1,3,4,1,1,0,1,2,5
22052,HOU,2018,Brandan Wright,30,1,0,15,2,3,.667,0,0,,2,3,.667,.667,0,0,,1,1,2,0,0,1,0,3,4
22053,HOU,2018,Tim Quarterman,23,3,0,13,1,3,.333,0,2,.000,1,1,1.000,.333,2,2,1.000,0,3,3,1,0,0,2,1,4
22054,HOU,2018,Isaiah Canaan,26,1,0,4,0,1,.000,0,0,,0,1,.000,.000,0,0,,0,1,1,0,0,0,0,0,0
22055,HOU,2017,James Harden,27,81,81,2947,674,1533,.440,262,756,.347,412,777,.530,.525,746,881,.847,95,564,659,907,121,38,464,215,2356
22056,HOU,2017,Trevor Ariza,31,80,80,2773,326,798,.409,191,555,.344,135,243,.556,.528,93,126,.738,54,404,458,175,147,20,73,133,936
22057,HOU,2017,Eric Gordon,28,75,15,2323,412,1016,.406,246,661,.372,166,355,.468,.527,147,175,.840,29,172,201,188,48,41,121,150,1217
22058,HOU,2017,Ryan Anderson,28,72,72,2116,323,773,.418,204,506,.403,119,267,.446,.550,129,150,.860,112,218,330,68,31,14,55,142,979
22059,HOU,2017,Patrick Beverley,28,67,67,2058,228,543,.420,110,288,.382,118,255,.463,.521,73,95,.768,95,298,393,281,99,25,100,222,639
22060,HOU,2017,Clint Capela,22,65,59,1551,362,563,.643,0,0,,362,563,.643,.643,94,177,.531,178,348,526,63,34,79,87,179,818
22061,HOU,2017,Sam Dekker,22,77,2,1419,203,429,.473,60,187,.321,143,242,.591,.543,38,68,.559,94,190,284,76,38,21,41,83,504
22062,HOU,2017,Nenê,34,67,8,1198,245,397,.617,3,9,.333,242,388,.624,.621,116,197,.589,95,187,282,65,56,39,73,163,609
22063,HOU,2017,Montrezl Harrell,23,58,14,1064,225,345,.652,1,7,.143,224,338,.663,.654,76,121,.628,81,138,219,64,20,42,44,126,527
22064,HOU,2017,Corey Brewer,30,58,8,923,94,227,.414,22,94,.234,72,133,.541,.463,32,44,.727,21,93,114,61,37,12,36,104,242
22065,HOU,2017,Lou Williams,30,23,0,591,102,264,.386,41,129,.318,61,135,.452,.464,98,113,.867,12,58,70,56,15,9,40,25,343
22066,HOU,2017,K.J. McDaniels,23,29,0,212,31,68,.456,9,27,.333,22,41,.537,.522,9,10,.900,6,24,30,4,7,8,10,24,80
22067,HOU,2017,Tyler Ennis,22,31,0,196,25,64,.391,6,16,.375,19,48,.396,.438,2,3,.667,4,15,19,34,6,0,24,29,58
22068,HOU,2017,Troy Williams,22,6,3,139,22,44,.500,8,21,.381,14,23,.609,.591,6,7,.857,9,15,24,6,3,1,6,18,58
22069,HOU,2017,Bobby Brown,32,25,0,123,23,60,.383,14,35,.400,9,25,.360,.500,2,2,1.000,0,6,6,14,1,0,5,5,62
22070,HOU,2017,Chinanu Onuaku,20,5,1,52,5,7,.714,0,0,,5,7,.714,.714,4,4,1.000,2,8,10,3,3,1,4,6,14
22071,HOU,2017,Isaiah Taylor,22,4,0,52,1,7,.143,0,2,.000,1,5,.200,.143,1,2,.500,1,2,3,3,1,1,0,6,3
22072,HOU,2017,Kyle Wiltjer,24,14,0,44,4,14,.286,4,13,.308,0,1,.000,.429,1,2,.500,4,6,10,2,3,1,5,4,13
22073,HOU,2016,James Harden,26,82,82,3125,710,1617,.439,236,657,.359,474,960,.494,.512,720,837,.860,63,438,501,612,139,51,374,229,2376
22074,HOU,2016,Trevor Ariza,30,81,81,2859,357,859,.416,185,499,.371,172,360,.478,.523,126,161,.783,67,299,366,188,160,26,113,177,1025
22075,HOU,2016,Dwight Howard,30,71,71,2280,372,600,.620,0,6,.000,372,594,.626,.620,232,474,.489,238,597,835,98,69,113,166,219,976
22076,HOU,2016,Patrick Beverley,27,71,63,2041,258,594,.434,124,310,.400,134,284,.472,.539,60,88,.682,73,177,250,239,94,26,91,234,700
22077,HOU,2016,Corey Brewer,29,82,12,1669,212,552,.384,61,224,.272,151,328,.460,.439,105,140,.750,42,157,199,109,84,19,78,168,590
22078,HOU,2016,Clint Capela,21,77,35,1471,231,397,.582,0,1,.000,231,396,.583,.582,80,211,.379,194,300,494,47,59,92,60,190,542
22079,HOU,2016,Jason Terry,38,72,7,1258,151,376,.402,93,261,.356,58,115,.504,.525,27,33,.818,14,65,79,103,47,9,49,91,422
22080,HOU,2016,Ty Lawson,28,53,12,1176,111,287,.387,31,94,.330,80,193,.415,.441,56,80,.700,20,69,89,180,43,6,82,71,309
22081,HOU,2016,Terrence Jones,24,50,11,1044,166,367,.452,25,79,.316,141,288,.490,.486,77,116,.664,62,149,211,41,23,39,49,86,434
22082,HOU,2016,Marcus Thornton,28,47,6,885,174,435,.400,73,216,.338,101,219,.461,.484,51,58,.879,31,84,115,66,34,3,40,73,472
22083,HOU,2016,Donatas Motiejūnas,25,37,22,547,90,205,.439,16,57,.281,74,148,.500,.478,34,53,.642,37,72,109,41,17,5,44,69,230
22084,HOU,2016,Josh Smith,30,23,6,421,58,169,.343,23,85,.271,35,84,.417,.411,12,25,.480,18,49,67,48,16,13,36,56,151
22085,HOU,2016,Montrezl Harrell,22,39,1,379,58,90,.644,0,1,.000,58,89,.652,.644,24,46,.522,25,40,65,17,11,11,17,48,140
22086,HOU,2016,Michael Beasley,27,20,0,363,107,205,.522,3,9,.333,104,196,.531,.529,38,49,.776,29,69,98,16,11,9,24,39,255
22087,HOU,2016,K.J. McDaniels,22,37,1,235,29,72,.403,7,25,.280,22,47,.468,.451,24,30,.800,16,26,42,10,7,6,17,30,89
22088,HOU,2016,Andrew Goudelock,27,8,0,50,9,20,.450,1,9,.111,8,11,.727,.475,3,4,.750,1,1,2,4,6,2,7,4,22
22089,HOU,2016,Chuck Hayes,32,2,0,24,1,2,.500,0,0,,1,2,.500,.500,2,2,1.000,0,8,8,2,0,0,3,6,4
22090,HOU,2016,Sam Dekker,21,3,0,6,0,0,,0,0,,0,0,,,0,0,,0,1,1,0,1,0,0,0,0
22091,HOU,2015,James Harden,25,81,81,2981,647,1470,.440,208,555,.375,439,915,.480,.511,715,824,.868,75,384,459,565,154,60,321,208,2217
22092,HOU,2015,Trevor Ariza,29,82,82,2930,366,910,.402,194,555,.350,172,355,.485,.509,122,143,.853,77,382,459,209,152,17,141,186,1048
22093,HOU,2015,Donatas Motiejūnas,24,71,62,2037,353,700,.504,49,133,.368,304,567,.536,.539,100,166,.602,137,284,421,130,56,34,123,203,855
22094,HOU,2015,Patrick Beverley,26,56,55,1727,204,532,.383,115,323,.356,89,209,.426,.492,45,60,.750,67,170,237,192,59,23,83,182,568
22095,HOU,2015,Jason Terry,37,77,18,1641,188,446,.422,126,323,.390,62,123,.504,.563,39,48,.813,15,106,121,147,66,19,74,116,541
22096,HOU,2015,Corey Brewer,28,56,1,1407,249,580,.429,55,194,.284,194,386,.503,.477,113,148,.764,48,155,203,95,60,15,81,111,666
22097,HOU,2015,Josh Smith,29,55,7,1404,261,596,.438,63,191,.330,198,405,.489,.491,75,144,.521,100,228,328,145,50,68,134,146,660
22098,HOU,2015,Dwight Howard,29,41,41,1223,251,423,.593,1,2,.500,250,421,.594,.595,143,271,.528,110,321,431,50,28,53,115,137,646
22099,HOU,2015,Terrence Jones,23,33,24,889,158,299,.528,13,37,.351,145,262,.553,.550,57,94,.606,78,142,220,36,18,59,37,78,386
22100,HOU,2015,Joey Dorsey,31,69,17,854,80,145,.552,0,1,.000,80,144,.556,.552,24,83,.289,103,176,279,25,40,25,41,157,184
22101,HOU,2015,Kostas Papanikolaou,24,43,1,795,69,197,.350,31,106,.292,38,91,.418,.429,13,18,.722,39,79,118,85,29,13,55,71,182
22102,HOU,2015,Pablo Prigioni,37,24,0,402,23,67,.343,14,51,.275,9,16,.563,.448,13,15,.867,12,27,39,67,27,0,15,35,73
22103,HOU,2015,Tarik Black,23,25,12,393,45,83,.542,0,1,.000,45,82,.549,.542,15,29,.517,58,69,127,8,6,2,19,56,105
22104,HOU,2015,Isaiah Canaan,23,25,9,369,53,131,.405,32,84,.381,21,47,.447,.527,16,21,.762,11,22,33,29,14,0,23,28,154
22105,HOU,2015,Nick Johnson,22,28,0,262,26,75,.347,5,21,.238,21,54,.389,.380,17,25,.680,13,26,39,11,7,3,19,34,74
22106,HOU,2015,Francisco García,33,14,0,200,17,63,.270,10,45,.222,7,18,.389,.349,1,4,.250,3,14,17,15,9,5,10,20,45
22107,HOU,2015,Troy Daniels,23,17,0,108,15,47,.319,13,43,.302,2,4,.500,.457,3,4,.750,0,6,6,4,0,0,5,14,46
22108,HOU,2015,Clint Capela,20,12,0,90,14,29,.483,0,0,,14,29,.483,.483,4,23,.174,10,26,36,2,1,9,5,14,32
22109,HOU,2015,Alexey Shved,26,9,0,59,8,24,.333,4,12,.333,4,12,.333,.417,9,11,.818,1,3,4,3,1,0,5,2,29
22110,HOU,2015,K.J. McDaniels,21,10,0,33,5,15,.333,0,3,.000,5,12,.417,.333,1,2,.500,1,4,5,2,0,2,1,5,11
22111,HOU,2014,Chandler Parsons,25,74,74,2783,466,987,.472,130,351,.370,336,636,.528,.538,164,221,.742,69,340,409,298,88,29,144,168,1226
22112,HOU,2014,James Harden,24,73,73,2777,549,1205,.456,177,483,.366,372,722,.515,.529,576,665,.866,61,283,344,446,115,29,265,177,1851
22113,HOU,2014,Dwight Howard,28,71,71,2396,473,800,.591,2,7,.286,471,793,.594,.593,349,638,.547,231,635,866,131,60,128,229,240,1297
22114,HOU,2014,Terrence Jones,22,76,71,2078,386,712,.542,31,101,.307,355,611,.581,.564,118,195,.605,162,366,528,87,53,99,71,139,921
22115,HOU,2014,Jeremy Lin,25,71,33,2054,295,662,.446,82,229,.358,213,433,.492,.508,218,265,.823,34,153,187,294,68,27,176,166,890
22116,HOU,2014,Patrick Beverley,25,56,55,1751,199,481,.414,92,255,.361,107,226,.473,.509,83,102,.814,72,124,196,151,77,23,66,174,573
22117,HOU,2014,Omri Casspi,25,71,2,1283,173,410,.422,61,176,.347,112,234,.479,.496,83,122,.680,55,205,260,88,44,14,72,100,490
22118,HOU,2014,Francisco García,32,55,4,1083,118,294,.401,69,193,.358,49,101,.485,.519,10,19,.526,21,101,122,63,27,33,30,120,315
22119,HOU,2014,Ömer Aşık,27,48,19,968,101,190,.532,0,0,,101,190,.532,.532,78,126,.619,101,277,378,25,14,37,59,92,280
22120,HOU,2014,Donatas Motiejūnas,23,62,3,952,131,296,.443,21,84,.250,110,212,.519,.478,58,96,.604,60,165,225,34,20,21,49,132,341
22121,HOU,2014,Aaron Brooks,29,43,0,716,104,263,.395,54,132,.409,50,131,.382,.498,37,44,.841,23,39,62,83,25,6,51,76,299
22122,HOU,2014,Jordan Hamilton,23,21,1,349,48,122,.393,25,69,.362,23,53,.434,.496,17,20,.850,9,52,61,18,13,7,19,36,138
22123,HOU,2014,Isaiah Canaan,22,22,0,252,31,87,.356,18,55,.327,13,32,.406,.460,21,29,.724,7,17,24,22,8,4,21,25,101
22124,HOU,2014,Ronnie Brewer,28,23,3,158,3,15,.200,1,8,.125,2,7,.286,.233,0,2,.000,2,12,14,10,6,1,2,4,7
22125,HOU,2014,Greg Smith,23,11,0,100,18,28,.643,0,0,,18,28,.643,.643,2,5,.400,11,16,27,0,1,2,5,17,38
22126,HOU,2014,Troy Daniels,22,5,1,75,15,31,.484,12,25,.480,3,6,.500,.677,0,0,,0,4,4,5,0,0,3,6,42
22127,HOU,2014,Robert Covington,23,7,0,34,6,14,.429,4,11,.364,2,3,.667,.571,0,0,,2,3,5,0,2,0,1,3,16
22128,HOU,2014,Josh Powell,31,1,0,19,2,6,.333,0,0,,2,6,.333,.333,0,0,,0,5,5,0,0,1,1,1,4
22129,HOU,2013,James Harden,23,78,78,2985,585,1337,.438,179,486,.368,406,851,.477,.504,674,792,.851,62,317,379,455,142,38,295,178,2023
22130,HOU,2013,Chandler Parsons,24,76,76,2758,456,939,.486,152,395,.385,304,544,.559,.567,113,155,.729,79,325,404,269,75,32,147,148,1177
22131,HOU,2013,Jeremy Lin,24,82,82,2640,396,897,.441,87,257,.339,309,640,.483,.490,216,275,.785,32,215,247,497,134,29,236,205,1095
22132,HOU,2013,Ömer Aşık,26,82,82,2464,332,614,.541,0,1,.000,332,613,.542,.541,168,299,.562,275,681,956,75,46,87,173,223,832
22133,HOU,2013,Carlos Delfino,30,67,5,1689,251,620,.405,158,421,.375,93,199,.467,.532,48,56,.857,18,202,220,135,68,9,72,114,708
22134,HOU,2013,Patrick Patterson,23,47,38,1219,236,455,.519,35,96,.365,201,359,.560,.557,37,49,.755,73,148,221,51,18,27,42,90,544
22135,HOU,2013,Marcus Morris,23,54,17,1154,171,400,.428,74,194,.381,97,206,.471,.520,49,75,.653,63,156,219,47,27,16,53,120,465
22136,HOU,2013,Greg Smith,22,70,10,1110,170,274,.620,0,1,.000,170,273,.623,.620,81,130,.623,111,210,321,25,18,40,41,175,421
22137,HOU,2013,Toney Douglas,26,49,0,913,139,352,.395,61,162,.377,78,190,.411,.482,60,68,.882,23,67,90,93,40,2,56,103,399
22138,HOU,2013,Patrick Beverley,24,41,0,713,79,189,.418,36,96,.375,43,93,.462,.513,34,41,.829,45,64,109,117,37,21,44,83,228
22139,HOU,2013,Donatas Motiejūnas,22,44,14,538,97,213,.455,24,83,.289,73,130,.562,.512,32,51,.627,36,57,93,31,7,10,37,73,250
22140,HOU,2013,Francisco García,31,18,5,319,41,95,.432,27,70,.386,14,25,.560,.574,6,7,.857,1,22,23,20,14,7,12,22,115
22141,HOU,2013,James Anderson,23,29,2,307,41,101,.406,16,49,.327,25,52,.481,.485,17,19,.895,15,43,58,33,12,3,18,18,115
22142,HOU,2013,Terrence Jones,21,19,0,276,43,94,.457,5,19,.263,38,75,.507,.484,13,17,.765,28,37,65,15,12,19,13,21,104
22143,HOU,2013,Thomas Robinson,21,19,0,247,35,78,.449,0,1,.000,35,77,.455,.449,16,38,.421,30,47,77,10,16,5,23,29,86
22144,HOU,2013,Cole Aldrich,24,30,0,213,23,43,.535,0,0,,23,43,.535,.535,4,9,.444,12,45,57,6,3,9,14,41,50
22145,HOU,2013,Daequan Cook,25,16,1,165,21,59,.356,11,30,.367,10,29,.345,.449,2,3,.667,5,13,18,10,6,2,6,13,55
22146,HOU,2013,Aaron Brooks,28,7,0,38,4,13,.308,2,7,.286,2,6,.333,.385,0,0,,1,1,2,6,1,3,4,5,10
22147,HOU,2013,Scott Machado,22,6,0,21,3,6,.500,0,1,.000,3,5,.600,.500,2,2,1.000,0,1,1,6,2,0,8,0,8
22148,HOU,2013,Tim Ohlbrecht,24,3,0,12,1,3,.333,0,0,,1,3,.333,.333,1,1,1.000,0,1,1,1,1,0,4,1,3
22149,HOU,2012,Luis Scola,31,66,66,2067,436,888,.491,0,3,.000,436,885,.493,.491,153,198,.773,122,306,428,140,35,24,153,214,1025
22150,HOU,2012,Chandler Parsons,23,63,57,1804,248,549,.452,60,178,.337,188,371,.507,.506,43,78,.551,90,210,300,134,73,29,81,142,599
22151,HOU,2012,Courtney Lee,26,58,26,1757,251,580,.433,87,217,.401,164,363,.452,.508,71,86,.826,26,133,159,88,68,22,64,106,660
22152,HOU,2012,Goran Dragić,25,66,28,1752,277,600,.462,68,202,.337,209,398,.525,.518,153,190,.805,53,115,168,351,85,10,157,166,775
22153,HOU,2012,Kyle Lowry,25,47,38,1510,210,513,.409,79,211,.374,131,302,.434,.486,171,198,.864,37,176,213,310,73,14,130,133,670
22154,HOU,2012,Patrick Patterson,22,64,1,1483,225,511,.440,0,3,.000,225,508,.443,.440,40,57,.702,112,174,286,53,27,36,49,113,490
22155,HOU,2012,Samuel Dalembert,30,65,45,1446,200,395,.506,0,1,.000,200,394,.508,.506,90,113,.796,158,298,456,33,37,111,82,162,490
22156,HOU,2012,Chase Budinger,23,58,9,1298,208,471,.442,88,219,.402,120,252,.476,.535,54,70,.771,38,179,217,74,29,7,55,65,558
22157,HOU,2012,Kevin Martin,28,40,40,1264,222,537,.413,78,225,.347,144,312,.462,.486,160,179,.894,13,93,106,110,28,3,70,70,682
22158,HOU,2012,Jordan Hill,24,32,7,469,68,135,.504,0,3,.000,68,132,.515,.504,25,39,.641,47,108,155,14,9,21,24,60,161
22159,HOU,2012,Marcus Camby,37,19,13,458,61,126,.484,2,5,.400,59,121,.488,.492,11,26,.423,52,124,176,32,17,29,10,38,135
22160,HOU,2012,Terrence Williams,24,12,0,181,20,57,.351,8,19,.421,12,38,.316,.421,6,12,.500,2,26,28,10,4,1,10,16,54
22161,HOU,2012,Jonny Flynn,22,11,0,135,12,41,.293,2,9,.222,10,32,.313,.317,11,14,.786,1,7,8,28,3,1,9,8,37
22162,HOU,2012,Marcus Morris,22,17,0,126,16,54,.296,2,17,.118,14,37,.378,.315,6,8,.750,5,11,16,3,2,2,4,12,40
22163,HOU,2012,Earl Boykins,35,8,0,111,12,36,.333,2,9,.222,10,27,.370,.361,13,15,.867,0,11,11,17,1,0,7,5,39
22164,HOU,2012,Greg Smith,21,8,0,69,7,11,.636,0,0,,7,11,.636,.636,0,0,,5,15,20,1,2,5,1,17,14
22165,HOU,2012,Jeff Adrien,25,8,0,63,7,16,.438,0,0,,7,16,.438,.438,7,12,.583,5,17,22,1,0,2,2,13,21
22166,HOU,2012,Courtney Fortson,23,6,0,49,6,20,.300,2,9,.222,4,11,.364,.350,4,6,.667,2,5,7,5,3,0,5,2,18
22167,HOU,2012,Hasheem Thabeet,24,5,0,23,3,3,1.000,0,0,,3,3,1.000,1.000,0,0,,1,6,7,0,0,2,0,5,6
22168,HOU,2011,Kevin Martin,27,80,80,2603,553,1267,.436,176,459,.383,377,808,.467,.506,594,669,.888,28,230,258,198,80,15,184,155,1876
22169,HOU,2011,Kyle Lowry,24,75,71,2563,345,809,.426,129,343,.376,216,466,.464,.506,192,251,.765,89,220,309,500,102,23,158,207,1011
22170,HOU,2011,Luis Scola,30,74,74,2412,569,1129,.504,0,3,.000,569,1126,.505,.504,214,290,.738,147,459,606,185,48,44,147,227,1352
22171,HOU,2011,Chuck Hayes,27,74,63,2079,244,463,.527,0,2,.000,244,461,.529,.527,94,142,.662,219,380,599,202,79,49,86,200,582
22172,HOU,2011,Shane Battier,32,59,59,1818,186,408,.456,88,225,.391,98,183,.536,.564,49,76,.645,58,223,281,153,53,71,63,127,509
22173,HOU,2011,Chase Budinger,22,78,22,1738,279,656,.425,89,274,.325,190,382,.497,.493,118,138,.855,52,229,281,127,41,18,67,114,765
22174,HOU,2011,Courtney Lee,25,81,1,1723,253,576,.439,71,174,.408,182,402,.453,.501,95,120,.792,51,158,209,100,58,18,68,102,672
22175,HOU,2011,Jordan Hill,23,72,11,1125,173,352,.491,0,2,.000,173,350,.494,.491,60,85,.706,128,178,306,29,14,52,62,157,406
22176,HOU,2011,Brad Miller,34,60,5,1015,132,296,.446,40,107,.374,92,189,.487,.514,78,94,.830,44,178,222,145,28,21,54,98,382
22177,HOU,2011,Patrick Patterson,21,52,6,868,149,267,.558,0,2,.000,149,265,.562,.558,30,42,.714,86,114,200,41,17,37,31,77,328
22178,HOU,2011,Aaron Brooks,26,34,7,811,134,387,.346,48,169,.284,86,218,.394,.408,78,83,.940,11,40,51,129,21,2,55,69,394
22179,HOU,2011,Goran Dragić,24,22,3,378,59,125,.472,28,54,.519,31,71,.437,.584,24,36,.667,12,44,56,55,14,4,21,35,170
22180,HOU,2011,Ish Smith,22,28,3,329,32,83,.386,3,8,.375,29,75,.387,.404,7,10,.700,6,36,42,64,13,2,26,26,74
22181,HOU,2011,Jared Jeffries,29,18,0,138,11,36,.306,1,6,.167,10,30,.333,.319,4,10,.400,20,15,35,11,7,3,4,21,27
22182,HOU,2011,Yao Ming,30,5,5,91,18,37,.486,0,0,,18,37,.486,.486,15,16,.938,7,20,27,4,0,8,7,13,51
22183,HOU,2011,Terrence Williams,23,11,0,84,14,42,.333,2,10,.200,12,32,.375,.357,9,11,.818,1,14,15,7,4,0,8,4,39
22184,HOU,2011,Jermaine Taylor,24,8,0,77,16,32,.500,2,5,.400,14,27,.519,.531,5,6,.833,1,8,9,2,2,2,6,4,39
22185,HOU,2011,Mike Harris,27,4,0,16,3,6,.500,0,0,,3,6,.500,.500,2,4,.500,2,3,5,1,0,1,1,2,8
22186,HOU,2011,DeMarre Carroll,24,5,0,11,0,3,.000,0,0,,0,3,.000,.000,0,0,,0,0,0,2,0,0,0,0,0
22187,HOU,2011,Hasheem Thabeet,23,2,0,4,0,1,.000,0,0,,0,1,.000,.000,0,0,,0,0,0,0,0,1,0,3,0
22188,HOU,2010,Aaron Brooks,25,82,82,2919,575,1331,.432,209,525,.398,366,806,.454,.511,245,298,.822,54,161,215,434,69,14,232,199,1604
22189,HOU,2010,Luis Scola,29,82,82,2671,560,1090,.514,1,5,.200,559,1085,.515,.514,208,267,.779,175,530,705,169,63,26,163,246,1329
22190,HOU,2010,Trevor Ariza,24,72,71,2629,394,999,.394,136,407,.334,258,592,.436,.462,148,228,.649,78,325,403,276,126,40,161,162,1072
22191,HOU,2010,Shane Battier,31,67,62,2168,178,447,.398,101,279,.362,77,168,.458,.511,77,106,.726,74,238,312,164,53,76,64,139,534
22192,HOU,2010,Chuck Hayes,26,82,82,1773,161,329,.489,0,0,,161,329,.489,.489,36,66,.545,151,314,465,139,73,43,74,219,358
22193,HOU,2010,Kyle Lowry,23,68,0,1651,184,464,.397,37,136,.272,147,328,.448,.436,215,260,.827,91,156,247,305,60,9,116,173,620
22194,HOU,2010,Chase Budinger,21,74,4,1488,249,565,.441,92,249,.369,157,316,.497,.522,67,87,.770,38,182,220,88,34,11,48,85,657
22195,HOU,2010,Carl Landry,26,52,1,1415,302,552,.547,0,0,,302,552,.547,.547,235,280,.839,122,164,286,40,28,46,86,146,839
22196,HOU,2010,David Andersen,29,63,0,891,147,340,.432,27,78,.346,120,262,.458,.472,46,67,.687,54,154,208,44,15,12,37,119,367
22197,HOU,2010,Kevin Martin,26,24,22,859,154,354,.435,31,100,.310,123,254,.484,.479,171,185,.924,9,61,70,54,23,2,57,45,510
22198,HOU,2010,Jordan Hill,22,23,0,372,58,109,.532,0,0,,58,109,.532,.532,31,47,.660,44,70,114,13,4,12,18,55,147
22199,HOU,2010,Jared Jeffries,28,18,0,332,36,84,.429,1,9,.111,35,75,.467,.435,15,27,.556,31,34,65,18,9,13,14,46,88
22200,HOU,2010,Jermaine Taylor,23,31,4,303,45,119,.378,5,22,.227,40,97,.412,.399,33,46,.717,21,25,46,16,10,3,19,15,128
22201,HOU,2010,Garrett Temple,23,9,0,118,13,29,.448,3,12,.250,10,17,.588,.500,16,24,.667,2,12,14,7,4,4,14,16,45
22202,HOU,2010,Mike Harris,26,8,0,82,10,27,.370,0,1,.000,10,26,.385,.370,5,9,.556,9,11,20,3,4,1,9,10,25
22203,HOU,2010,Joey Dorsey,26,7,0,54,5,11,.455,0,0,,5,11,.455,.455,1,2,.500,11,14,25,2,2,1,4,12,11
22204,HOU,2010,Tracy McGrady,30,6,0,46,7,19,.368,1,2,.500,6,17,.353,.395,4,6,.667,0,5,5,6,0,2,1,2,19
22205,HOU,2010,Brian Cook,29,15,0,44,7,23,.304,2,9,.222,5,14,.357,.348,5,7,.714,1,8,9,1,0,2,6,5,21
22206,HOU,2010,Hilton Armstrong,25,9,0,40,5,17,.294,0,1,.000,5,16,.313,.294,0,2,.000,5,1,6,3,5,0,5,10,10
22207,HOU,2010,Will Conroy,27,5,0,36,3,10,.300,0,3,.000,3,7,.429,.300,0,2,.000,0,3,3,7,0,0,4,5,6
22208,HOU,2010,Pops Mensah-Bonsu,26,4,0,13,1,4,.250,0,0,,1,4,.250,.250,3,6,.500,1,3,4,1,1,1,0,3,5
22209,HOU,2009,Yao Ming,28,77,77,2589,566,1032,.548,1,1,1.000,565,1031,.548,.549,381,440,.866,204,557,761,137,30,150,234,257,1514
22210,HOU,2009,Luis Scola,28,82,82,2488,424,799,.531,0,3,.000,424,796,.533,.531,196,258,.760,200,520,720,123,68,11,123,261,1044
22211,HOU,2009,Metta World Peace,29,69,55,2452,416,1037,.401,153,383,.399,263,654,.402,.475,196,262,.748,65,294,359,229,105,24,140,155,1181
22212,HOU,2009,Shane Battier,30,60,59,2031,145,354,.410,91,237,.384,54,117,.462,.538,55,67,.821,52,233,285,137,48,54,49,114,436
22213,HOU,2009,Aaron Brooks,24,80,35,1998,316,783,.404,113,309,.366,203,474,.428,.476,149,172,.866,33,124,157,238,46,8,125,152,894
22214,HOU,2009,Rafer Alston,32,48,48,1591,193,522,.370,80,230,.348,113,292,.387,.446,86,109,.789,25,119,144,258,57,7,88,72,552
22215,HOU,2009,Carl Landry,25,69,0,1467,240,418,.574,1,3,.333,239,415,.576,.575,157,193,.813,124,219,343,39,26,31,68,166,638
22216,HOU,2009,Von Wafer,23,63,11,1225,229,512,.447,64,164,.390,165,348,.474,.510,88,117,.752,19,94,113,71,40,8,59,71,610
22217,HOU,2009,Tracy McGrady,29,35,35,1181,188,485,.388,44,117,.376,144,368,.391,.433,125,156,.801,20,134,154,175,42,15,69,38,545
22218,HOU,2009,Chuck Hayes,25,71,1,858,42,113,.372,0,4,.000,42,109,.385,.372,7,19,.368,74,176,250,42,34,19,25,134,91
22219,HOU,2009,Brent Barry,37,56,1,857,70,172,.407,49,131,.374,21,41,.512,.549,19,20,.950,17,77,94,78,24,3,48,45,208
22220,HOU,2009,Kyle Lowry,22,28,0,608,77,162,.475,8,29,.276,69,133,.519,.500,52,65,.800,13,65,78,97,21,9,38,57,214
22221,HOU,2009,Luther Head,26,22,4,322,39,101,.386,14,38,.368,25,63,.397,.455,14,16,.875,3,24,27,35,6,1,16,15,106
22222,HOU,2009,Dikembe Mutombo,42,9,2,96,5,13,.385,0,0,,5,13,.385,.385,6,9,.667,12,21,33,0,0,11,6,11,16
22223,HOU,2009,Brian Cook,28,9,0,25,5,16,.313,2,5,.400,3,11,.273,.375,0,0,,1,4,5,1,0,3,2,3,12
22224,HOU,2009,James White,26,4,0,11,3,5,.600,1,2,.500,2,3,.667,.700,0,0,,0,0,0,1,1,1,3,2,7
22225,HOU,2009,Joey Dorsey,25,3,0,6,1,2,.500,0,0,,1,2,.500,.500,0,0,,0,1,1,1,0,0,0,0,2
22226,HOU,2008,Shane Battier,29,80,78,2907,265,619,.428,139,369,.377,126,250,.504,.540,75,101,.743,131,276,407,155,77,90,78,196,744
22227,HOU,2008,Rafer Alston,31,74,74,2526,364,924,.394,143,407,.351,221,517,.427,.471,98,137,.715,28,232,260,392,98,18,160,139,969
22228,HOU,2008,Tracy McGrady,28,66,62,2440,548,1307,.419,86,295,.292,462,1012,.457,.452,245,358,.684,42,297,339,387,68,30,160,91,1427
22229,HOU,2008,Yao Ming,27,55,55,2044,432,852,.507,0,2,.000,432,850,.508,.507,345,406,.850,172,422,594,129,25,111,183,171,1209
22230,HOU,2008,Luis Scola,27,82,39,2024,345,670,.515,0,3,.000,345,667,.517,.515,157,235,.668,174,351,525,106,60,19,105,235,847
22231,HOU,2008,Chuck Hayes,24,79,44,1575,113,221,.511,0,3,.000,113,218,.518,.511,11,24,.458,132,295,427,91,85,43,62,212,237
22232,HOU,2008,Luther Head,25,73,17,1379,206,477,.432,79,225,.351,127,252,.504,.515,66,81,.815,18,117,135,138,44,9,70,75,557
22233,HOU,2008,Bonzi Wells,31,51,7,1124,175,412,.425,8,38,.211,167,374,.447,.434,111,174,.638,63,197,260,80,51,24,76,113,469
22234,HOU,2008,Carl Landry,24,42,0,711,135,219,.616,0,1,.000,135,218,.619,.616,72,109,.661,96,111,207,21,17,7,26,98,342
22235,HOU,2008,Dikembe Mutombo,41,39,25,619,43,80,.538,0,0,,43,80,.538,.538,32,45,.711,68,131,199,5,11,48,17,55,118
22236,HOU,2008,Aaron Brooks,23,51,0,608,93,225,.413,36,109,.330,57,116,.491,.493,42,49,.857,13,43,56,87,13,5,44,69,264
22237,HOU,2008,Mike James,32,33,1,537,79,226,.350,24,74,.324,55,152,.362,.403,33,42,.786,11,41,52,54,17,2,29,44,215
22238,HOU,2008,Bobby Jackson,34,26,5,498,88,210,.419,28,82,.341,60,128,.469,.486,24,32,.750,10,61,71,63,13,2,28,37,228
22239,HOU,2008,Steve Novak,24,35,0,264,49,102,.480,34,71,.479,15,31,.484,.647,3,4,.750,4,31,35,6,2,3,4,17,135
22240,HOU,2008,Steve Francis,30,10,3,199,19,57,.333,4,17,.235,15,40,.375,.368,13,23,.565,8,15,23,30,9,5,14,25,55
22241,HOU,2008,Mike Harris,24,17,0,159,27,54,.500,0,2,.000,27,52,.519,.500,8,13,.615,24,30,54,3,6,3,9,16,62
22242,HOU,2008,Kirk Snyder,24,9,0,81,13,28,.464,2,9,.222,11,19,.579,.500,6,11,.545,5,7,12,8,1,1,4,6,34
22243,HOU,2008,Loren Woods,29,7,0,17,3,5,.600,0,0,,3,5,.600,.600,0,0,,0,1,1,2,0,0,0,2,6
22244,HOU,2008,Bobby Jones,24,4,0,9,2,4,.500,0,0,,2,4,.500,.500,0,0,,0,1,1,0,1,0,1,3,4
22245,HOU,2008,Justin Williams,23,1,0,6,1,3,.333,0,0,,1,3,.333,.333,1,4,.250,1,0,1,0,0,0,1,3,3
22246,HOU,2008,Gerald Green,22,1,0,4,3,3,1.000,0,0,,3,3,1.000,1.000,0,0,,2,0,2,0,0,0,0,2,6
22247,HOU,2007,Rafer Alston,30,82,82,3040,383,1020,.375,192,529,.363,191,491,.389,.470,130,177,.734,29,253,282,444,129,10,170,195,1088
22248,HOU,2007,Shane Battier,28,82,82,2988,292,654,.446,157,373,.421,135,281,.480,.567,88,113,.779,67,271,338,175,79,60,72,190,829
22249,HOU,2007,Tracy McGrady,27,71,71,2539,638,1480,.431,126,381,.331,512,1099,.466,.474,345,488,.707,56,322,378,458,92,36,213,136,1747
22250,HOU,2007,Luther Head,24,80,10,2211,306,700,.437,177,401,.441,129,299,.431,.564,83,105,.790,31,221,252,194,76,5,137,133,872
22251,HOU,2007,Juwan Howard,33,80,38,2123,309,665,.465,0,0,,309,665,.465,.465,155,188,.824,138,332,470,131,29,8,112,205,773
22252,HOU,2007,Chuck Hayes,23,78,43,1714,192,335,.573,0,0,,192,335,.573,.573,55,89,.618,204,317,521,47,70,18,64,281,439
22253,HOU,2007,Yao Ming,26,48,48,1624,423,819,.516,0,2,.000,423,817,.518,.516,356,413,.862,101,351,452,94,17,94,167,159,1202
22254,HOU,2007,Dikembe Mutombo,40,75,33,1289,85,153,.556,0,0,,85,153,.556,.556,60,87,.690,164,324,488,13,22,76,38,156,230
22255,HOU,2007,Bonzi Wells,30,28,1,590,85,207,.411,1,7,.143,84,200,.420,.413,46,82,.561,26,94,120,31,24,13,57,62,217
22256,HOU,2007,Kirk Snyder,23,39,1,563,66,146,.452,11,44,.250,55,102,.539,.490,49,75,.653,17,66,83,39,11,12,26,51,192
22257,HOU,2007,John Lucas III,24,47,0,383,62,156,.397,15,59,.254,47,97,.485,.446,15,19,.789,9,27,36,33,17,0,15,38,154
22258,HOU,2007,Vassilis Spanoulis,24,31,0,272,23,72,.319,5,29,.172,18,43,.419,.354,34,42,.810,5,17,22,28,7,1,29,33,85
22259,HOU,2007,Scott Padgett,30,24,0,198,15,49,.306,8,29,.276,7,20,.350,.388,6,11,.545,11,34,45,8,4,3,8,33,44
22260,HOU,2007,Steve Novak,23,35,1,191,18,50,.360,13,39,.333,5,11,.455,.490,2,2,1.000,4,22,26,6,5,0,4,21,51
22261,HOU,2007,Jake Tsakalidis,27,13,0,132,9,22,.409,0,0,,9,22,.409,.409,12,15,.800,18,22,40,3,1,1,3,17,30
22262,HOU,2006,Juwan Howard,32,80,80,2537,394,859,.459,0,4,.000,394,855,.461,.459,154,191,.806,168,367,535,112,49,8,133,235,942
22263,HOU,2006,Rafer Alston,29,63,63,2431,280,738,.379,102,312,.327,178,426,.418,.449,99,143,.692,36,219,255,425,101,15,157,194,761
22264,HOU,2006,David Wesley,35,71,59,2372,226,561,.403,99,271,.365,127,290,.438,.491,151,187,.807,24,154,178,204,59,6,120,212,702
22265,HOU,2006,Luther Head,23,80,27,2310,254,630,.403,113,313,.361,141,317,.445,.493,86,123,.699,33,233,266,215,89,9,119,169,707
22266,HOU,2006,Yao Ming,25,57,57,1949,467,900,.519,0,1,.000,467,899,.519,.519,337,395,.853,148,433,581,85,30,94,147,195,1271
22267,HOU,2006,Tracy McGrady,26,47,47,1745,410,1011,.406,73,234,.312,337,777,.434,.442,254,340,.747,46,261,307,225,59,41,120,88,1147
22268,HOU,2006,Stromile Swift,26,66,5,1344,225,458,.491,0,2,.000,225,456,.493,.491,136,209,.651,103,188,291,25,38,50,91,198,586
22269,HOU,2006,Keith Bogans,25,33,22,1064,101,256,.395,32,102,.314,69,154,.448,.457,47,81,.580,26,123,149,83,32,6,49,89,281
22270,HOU,2006,Dikembe Mutombo,39,64,23,955,50,95,.526,0,0,,50,95,.526,.526,69,91,.758,100,206,306,4,17,57,35,128,169
22271,HOU,2006,Ryan Bowen,30,68,19,652,37,124,.298,3,22,.136,34,102,.333,.310,11,14,.786,31,57,88,24,21,6,13,85,88
22272,HOU,2006,Derek Anderson,31,20,8,582,68,173,.393,19,67,.284,49,106,.462,.448,61,73,.836,12,71,83,53,15,4,37,49,216
22273,HOU,2006,Chuck Hayes,22,40,0,535,59,105,.562,0,1,.000,59,104,.567,.562,29,45,.644,67,112,179,14,26,14,12,76,147
22274,HOU,2006,Jon Barry,36,20,0,342,25,65,.385,12,32,.375,13,33,.394,.477,24,29,.828,1,30,31,26,13,1,22,25,86
22275,HOU,2006,Lonny Baxter,27,23,0,281,33,72,.458,0,0,,33,72,.458,.458,16,19,.842,38,46,84,2,9,7,13,48,82
22276,HOU,2006,Moochie Norris,32,29,0,241,26,65,.400,0,5,.000,26,60,.433,.400,13,17,.765,9,25,34,29,14,1,16,31,65
22277,HOU,2006,Rick Brunson,33,23,0,215,16,46,.348,5,12,.417,11,34,.324,.402,7,12,.583,1,19,20,33,8,1,19,21,44
22278,HOU,2006,Richie Frahm,28,8,0,117,15,35,.429,8,22,.364,7,13,.538,.543,4,5,.800,0,10,10,6,1,0,4,8,42
22279,HOU,2006,John Lucas III,23,13,0,107,14,36,.389,2,9,.222,12,27,.444,.417,0,0,,2,3,5,12,5,0,7,6,30
22280,HOU,2006,Stephen Graham,23,6,0,38,6,16,.375,1,5,.200,5,11,.455,.406,4,4,1.000,1,6,7,3,2,0,5,5,17
22281,HOU,2006,Maciej Lampe,20,4,0,12,2,7,.286,0,0,,2,7,.286,.286,0,2,.000,3,2,5,0,0,0,2,0,4
22282,HOU,2006,Josh Davis,25,1,0,0,0,0,,0,0,,0,0,,,0,0,,0,0,0,0,0,0,0,1,0
22283,HOU,2005,Tracy McGrady,25,78,78,3182,715,1660,.431,142,435,.326,573,1225,.468,.473,431,557,.774,71,413,484,448,135,52,201,167,2003
22284,HOU,2005,Yao Ming,24,80,80,2447,538,975,.552,0,0,,538,975,.552,.552,389,497,.783,208,461,669,61,34,160,196,298,1465
22285,HOU,2005,Bob Sura,31,61,59,1922,215,504,.427,55,155,.355,160,349,.458,.481,141,188,.750,79,258,337,317,65,7,147,168,626
22286,HOU,2005,David Wesley,34,54,53,1840,201,498,.404,90,235,.383,111,263,.422,.494,95,113,.841,26,117,143,156,61,8,59,150,587
22287,HOU,2005,Juwan Howard,31,61,47,1624,244,541,.451,0,1,.000,244,540,.452,.451,97,115,.843,126,220,346,94,32,5,79,143,585
22288,HOU,2005,Jon Barry,35,53,2,1230,130,291,.447,60,133,.451,70,158,.443,.550,52,58,.897,22,116,138,139,46,7,53,67,372
22289,HOU,2005,Dikembe Mutombo,38,80,2,1212,108,217,.498,0,0,,108,217,.498,.498,106,143,.741,150,276,426,10,16,101,51,135,322
22290,HOU,2005,Jim Jackson,34,24,24,990,118,283,.417,54,147,.367,64,136,.471,.512,30,33,.909,10,105,115,86,23,1,56,67,320
22291,HOU,2005,Scott Padgett,28,66,0,942,98,233,.421,50,126,.397,48,107,.449,.528,29,40,.725,47,138,185,55,33,10,30,119,275
22292,HOU,2005,Maurice Taylor,28,38,16,905,127,292,.435,3,8,.375,124,284,.437,.440,39,60,.650,41,123,164,53,16,12,63,123,296
22293,HOU,2005,Mike James,29,27,5,692,126,291,.433,42,107,.393,84,184,.457,.505,42,55,.764,12,74,86,78,25,2,26,60,336
22294,HOU,2005,Ryan Bowen,29,66,6,604,47,111,.423,3,6,.500,44,105,.419,.437,14,21,.667,21,55,76,18,23,5,7,61,111
22295,HOU,2005,Clarence Weatherspoon,34,40,18,525,47,114,.412,0,0,,47,114,.412,.412,29,35,.829,35,87,122,17,9,6,15,74,123
22296,HOU,2005,Tyronn Lue,27,21,3,479,48,122,.393,15,45,.333,33,77,.429,.455,14,18,.778,0,40,40,58,8,0,24,48,125
22297,HOU,2005,Charlie Ward,34,14,13,360,24,77,.312,16,51,.314,8,26,.308,.416,11,13,.846,6,33,39,43,15,0,18,22,75
22298,HOU,2005,Andre Barrett,22,27,0,314,20,69,.290,9,37,.243,11,32,.344,.355,7,10,.700,5,14,19,42,14,0,16,35,56
22299,HOU,2005,Boštjan Nachbar,24,16,2,204,15,43,.349,10,21,.476,5,22,.227,.465,9,12,.750,4,26,30,9,1,0,5,30,49
22300,HOU,2005,Rod Strickland,38,16,2,196,9,43,.209,1,2,.500,8,41,.195,.221,9,10,.900,3,24,27,39,3,2,16,15,28
22301,HOU,2005,Reece Gaines,24,10,0,108,10,27,.370,3,12,.250,7,15,.467,.426,3,4,.750,0,11,11,3,3,0,4,12,26
22302,HOU,2005,Moochie Norris,31,6,0,39,3,16,.188,0,0,,3,16,.188,.188,2,2,1.000,1,3,4,5,1,0,2,2,8
22303,HOU,2005,Torraye Braggs,28,7,0,24,3,7,.429,0,0,,3,7,.429,.429,0,0,,7,5,12,0,0,0,2,4,6
22304,HOU,2005,Vin Baker,33,3,0,13,0,4,.000,0,0,,0,4,.000,.000,2,2,1.000,0,2,2,1,0,0,2,7,2
22305,HOU,2005,Brandin Knight,23,1,0,3,0,1,.000,0,0,,0,1,.000,.000,0,0,,0,0,0,1,0,0,0,0,0
22306,HOU,2004,Cuttino Mobley,28,80,80,3229,460,1081,.426,164,420,.390,296,661,.448,.501,176,217,.811,40,322,362,258,107,33,180,179,1260
22307,HOU,2004,Steve Francis,26,79,79,3194,450,1117,.403,73,250,.292,377,867,.435,.436,337,435,.775,116,317,433,493,139,35,294,257,1310
22308,HOU,2004,Jim Jackson,33,80,80,3119,382,900,.424,162,405,.400,220,495,.444,.514,107,127,.843,52,435,487,226,86,23,175,227,1033
22309,HOU,2004,Yao Ming,23,82,82,2692,535,1025,.522,0,2,.000,535,1023,.523,.522,361,446,.809,197,538,735,122,22,156,204,273,1431
22310,HOU,2004,Maurice Taylor,27,75,10,2081,367,765,.480,0,2,.000,367,763,.481,.480,128,174,.736,131,253,384,107,43,47,149,253,862
22311,HOU,2004,Kelvin Cato,29,69,67,1743,161,360,.447,0,0,,161,360,.447,.447,96,142,.676,153,319,472,72,52,96,84,203,418
22312,HOU,2004,Eric Piatkowski,33,49,0,703,72,191,.377,43,122,.352,29,69,.420,.490,14,16,.875,10,63,73,26,16,5,29,42,201
22313,HOU,2004,Clarence Weatherspoon,33,37,0,652,86,171,.503,0,1,.000,86,170,.506,.503,35,53,.660,60,94,154,17,22,13,26,56,207
22314,HOU,2004,Mark Jackson,38,42,3,577,34,100,.340,7,41,.171,27,59,.458,.375,28,39,.718,10,60,70,119,17,1,53,41,103
22315,HOU,2004,Scott Padgett,27,58,5,547,74,167,.443,28,65,.431,46,102,.451,.527,24,32,.750,46,93,139,23,12,13,22,73,200
22316,HOU,2004,Boštjan Nachbar,23,45,3,516,47,132,.356,23,63,.365,24,69,.348,.443,21,29,.724,8,62,70,30,14,14,23,72,138
22317,HOU,2004,Moochie Norris,30,30,0,401,27,87,.310,8,23,.348,19,64,.297,.356,18,24,.750,2,28,30,48,16,2,30,16,80
22318,HOU,2004,Mike Wilks,24,26,0,145,17,36,.472,6,10,.600,11,26,.423,.556,10,12,.833,3,13,16,17,3,0,7,15,50
22319,HOU,2004,Adrian Griffin,29,19,1,133,5,18,.278,1,2,.500,4,16,.250,.306,0,4,.000,1,18,19,10,7,2,3,17,11
22320,HOU,2004,Torraye Braggs,27,11,0,132,13,28,.464,0,0,,13,28,.464,.464,8,12,.667,15,19,34,6,4,2,12,21,34
22321,HOU,2004,Alton Ford,22,9,0,41,6,11,.545,0,0,,6,11,.545,.545,3,6,.500,3,8,11,3,0,1,3,9,15
22322,HOU,2004,Charles Oakley,40,7,0,25,2,6,.333,0,0,,2,6,.333,.333,5,6,.833,0,5,5,2,0,0,1,8,9
22323,HOU,2003,Steve Francis,25,81,81,3318,571,1312,.435,85,240,.354,486,1072,.453,.468,476,595,.800,159,340,499,502,141,41,299,251,1703
22324,HOU,2003,Cuttino Mobley,27,73,73,3044,463,1067,.434,112,318,.352,351,749,.469,.486,242,282,.858,70,233,303,208,95,36,166,185,1280
22325,HOU,2003,Yao Ming,22,82,72,2382,401,805,.498,1,2,.500,400,803,.498,.499,301,371,.811,196,479,675,137,31,147,173,230,1104
22326,HOU,2003,Eddie Griffin,20,77,66,1890,271,678,.400,64,192,.333,207,486,.426,.447,58,94,.617,138,323,461,86,52,111,76,136,664
22327,HOU,2003,James Posey,26,58,47,1646,188,428,.439,46,141,.326,142,287,.495,.493,119,144,.826,52,229,281,106,77,9,78,134,541
22328,HOU,2003,Glen Rice,35,62,26,1532,196,457,.429,101,254,.398,95,203,.468,.539,63,83,.759,28,126,154,65,23,5,55,99,556
22329,HOU,2003,Maurice Taylor,26,67,9,1377,231,535,.432,0,2,.000,231,533,.433,.432,100,138,.725,95,143,238,66,22,22,100,151,562
22330,HOU,2003,Moochie Norris,29,82,3,1375,134,330,.406,11,45,.244,123,285,.432,.423,78,114,.684,37,122,159,196,55,4,86,72,357
22331,HOU,2003,Kelvin Cato,28,73,5,1247,133,256,.520,0,4,.000,133,252,.528,.520,66,124,.532,132,296,428,20,38,85,56,176,332
22332,HOU,2003,Juaquin Hawkins,29,58,10,685,57,148,.385,10,24,.417,47,124,.379,.419,10,20,.500,16,62,78,47,29,6,29,57,134
22333,HOU,2003,Terence Morris,24,49,0,632,82,176,.466,7,32,.219,75,144,.521,.486,11,14,.786,40,88,128,25,8,17,29,35,182
22334,HOU,2003,Kenny Thomas,25,20,14,586,82,190,.432,0,0,,82,190,.432,.432,33,45,.733,45,92,137,39,16,6,40,49,197
22335,HOU,2003,Jason Collier,25,13,3,104,17,36,.472,0,0,,17,36,.472,.472,2,2,1.000,12,17,29,1,2,1,2,10,36
22336,HOU,2003,Boštjan Nachbar,22,14,1,77,11,31,.355,2,10,.200,9,21,.429,.387,5,10,.500,3,8,11,3,2,2,6,13,29
22337,HOU,2003,Tito Maddox,21,9,0,35,3,12,.250,0,3,.000,3,9,.333,.250,5,8,.625,1,6,7,5,3,1,3,4,11
22338,HOU,2002,Cuttino Mobley,26,74,74,3116,595,1358,.438,149,377,.395,446,981,.455,.493,267,314,.850,63,237,300,187,109,37,180,189,1606
22339,HOU,2002,Kenny Thomas,24,72,71,2484,396,829,.478,0,16,.000,396,813,.487,.478,223,336,.664,158,358,516,137,85,66,143,195,1015
22340,HOU,2002,Steve Francis,24,57,56,2343,420,1007,.417,68,210,.324,352,797,.442,.451,326,422,.773,102,299,401,362,71,25,221,172,1234
22341,HOU,2002,Moochie Norris,28,82,26,2249,251,631,.398,36,134,.269,215,497,.433,.426,127,169,.751,73,173,246,403,81,4,156,130,665
22342,HOU,2002,Kelvin Cato,27,75,73,1917,190,326,.583,0,1,.000,190,325,.585,.583,113,194,.582,176,349,525,29,40,95,53,208,493
22343,HOU,2002,Eddie Griffin,19,73,24,1896,244,666,.366,90,273,.330,154,393,.392,.434,64,86,.744,117,299,416,53,17,134,47,117,642
22344,HOU,2002,Walt Williams,31,48,25,1117,166,396,.419,78,183,.426,88,213,.413,.518,40,51,.784,37,125,162,69,18,10,53,106,450
22345,HOU,2002,Terence Morris,23,68,12,1110,111,289,.384,15,78,.192,96,211,.455,.410,18,28,.643,77,134,211,64,21,27,45,72,255
22346,HOU,2002,Óscar Torres,25,65,13,1075,135,341,.396,37,126,.294,98,215,.456,.450,82,105,.781,47,75,122,40,25,9,49,64,389
22347,HOU,2002,Kevin Willis,39,52,5,865,125,284,.440,0,1,.000,125,283,.442,.440,65,87,.747,105,194,299,14,25,23,41,98,315
22348,HOU,2002,Glen Rice,34,20,20,606,65,167,.389,18,64,.281,47,103,.456,.443,24,30,.800,5,42,47,31,12,3,24,34,172
22349,HOU,2002,Dan Langhi,24,34,8,434,49,125,.392,1,4,.250,48,121,.397,.396,8,11,.727,22,45,67,14,8,5,9,25,107
22350,HOU,2002,Tierre Brown,22,40,1,403,49,115,.426,4,12,.333,45,103,.437,.443,21,28,.750,12,30,42,70,19,3,40,26,123
22351,HOU,2002,Jason Collier,24,25,2,365,41,95,.432,0,1,.000,41,94,.436,.432,24,32,.750,31,51,82,9,6,4,13,40,106
22352,HOU,2001,Steve Francis,23,80,79,3194,550,1219,.451,133,336,.396,417,883,.472,.506,358,438,.817,190,363,553,517,141,31,265,274,1591
22353,HOU,2001,Cuttino Mobley,25,79,49,3002,527,1214,.434,90,252,.357,437,962,.454,.471,394,474,.831,83,314,397,195,84,26,165,169,1538
22354,HOU,2001,Shandon Anderson,27,82,82,2396,263,590,.446,46,170,.271,217,420,.517,.485,138,188,.734,72,261,333,189,82,40,131,202,710
22355,HOU,2001,Maurice Taylor,24,69,69,1972,390,797,.489,0,4,.000,390,793,.492,.489,119,162,.735,109,269,378,104,28,38,125,208,899
22356,HOU,2001,Kenny Thomas,23,74,21,1820,206,465,.443,25,92,.272,181,373,.485,.470,91,126,.722,122,295,417,77,40,43,116,178,528
22357,HOU,2001,Moochie Norris,27,82,6,1654,184,413,.446,25,89,.281,159,324,.491,.476,151,194,.778,44,154,198,283,69,2,107,84,544
22358,HOU,2001,Walt Williams,30,72,31,1583,202,513,.394,98,248,.395,104,265,.392,.489,97,126,.770,31,214,245,97,30,28,73,153,599
22359,HOU,2001,Hakeem Olajuwon,38,58,55,1545,283,568,.498,0,1,.000,283,567,.499,.498,123,198,.621,124,307,431,72,70,88,81,141,689
22360,HOU,2001,Matt Bullard,33,61,5,1000,129,305,.423,86,213,.404,43,92,.467,.564,10,14,.714,22,108,130,42,10,9,12,76,354
22361,HOU,2001,Kelvin Cato,26,35,13,624,64,111,.577,0,0,,64,111,.577,.577,37,57,.649,47,94,141,11,13,31,25,89,165
22362,HOU,2001,Carlos Rogers,29,39,0,544,75,110,.682,0,1,.000,75,109,.688,.682,29,52,.558,48,91,139,9,10,18,17,33,179
22363,HOU,2001,Dan Langhi,23,33,0,241,37,99,.374,0,1,.000,37,98,.378,.374,16,29,.552,13,28,41,4,7,1,8,16,90
22364,HOU,2001,Jason Collier,23,23,0,222,27,71,.380,0,1,.000,27,70,.386,.380,17,24,.708,12,25,37,6,2,3,11,27,71
22365,HOU,2001,Sean Colson,25,10,0,30,6,19,.316,1,4,.250,5,15,.333,.342,2,4,.500,2,1,3,7,1,0,0,6,15
22366,HOU,2001,Anthony Miller,29,1,0,3,0,0,,0,0,,0,0,,,0,0,,0,0,0,0,0,0,0,1,0
22367,HOU,2000,Steve Francis,22,77,77,2776,497,1117,.445,107,310,.345,390,807,.483,.493,287,365,.786,152,257,409,507,118,29,306,231,1388
22368,HOU,2000,Shandon Anderson,26,82,82,2700,368,778,.473,79,225,.351,289,553,.523,.524,194,253,.767,91,293,384,239,96,32,194,182,1009
22369,HOU,2000,Cuttino Mobley,24,81,8,2496,437,1016,.430,104,292,.356,333,724,.460,.481,299,353,.847,59,229,288,208,87,32,186,171,1277
22370,HOU,2000,Walt Williams,29,76,66,1859,312,681,.458,102,261,.391,210,420,.500,.533,101,123,.821,69,237,306,157,49,44,113,190,827
22371,HOU,2000,Kenny Thomas,22,72,29,1797,212,531,.399,32,122,.262,180,409,.440,.429,138,209,.660,147,290,437,113,54,22,112,167,594
22372,HOU,2000,Kelvin Cato,25,65,32,1581,216,402,.537,0,4,.000,216,398,.543,.537,135,208,.649,102,287,389,26,33,124,71,175,567
22373,HOU,2000,Bryce Drew,25,72,5,1293,158,413,.383,59,163,.362,99,250,.396,.454,45,53,.849,23,80,103,162,41,1,66,79,420
22374,HOU,2000,Carlos Rogers,28,53,15,1101,170,324,.525,1,14,.071,169,310,.545,.526,81,137,.591,98,177,275,42,14,34,63,77,422
22375,HOU,2000,Hakeem Olajuwon,37,44,28,1049,193,421,.458,0,2,.000,193,419,.461,.458,69,112,.616,65,209,274,61,41,70,73,88,455
22376,HOU,2000,Matt Bullard,32,56,27,1024,139,340,.409,79,177,.446,60,163,.368,.525,25,30,.833,13,125,138,63,19,13,36,85,382
22377,HOU,2000,Charles Barkley,36,20,18,620,106,222,.477,6,26,.231,100,196,.510,.491,71,110,.645,71,138,209,63,14,4,44,48,289
22378,HOU,2000,Moochie Norris,26,30,0,502,69,159,.434,12,29,.414,57,130,.438,.472,57,73,.781,16,52,68,94,23,1,30,32,207
22379,HOU,2000,Anthony Miller,28,35,14,476,52,97,.536,0,0,,52,97,.536,.536,26,51,.510,49,115,164,16,11,10,19,68,130
22380,HOU,2000,Thomas Hamilton,24,22,7,273,35,79,.443,0,0,,35,79,.443,.443,12,23,.522,31,59,90,15,4,14,28,25,82
22381,HOU,2000,Devin Gray,27,21,2,124,15,37,.405,0,0,,15,37,.405,.405,19,29,.655,11,14,25,5,5,3,4,22,49
22382,HOU,2000,Tony Massenburg,32,10,0,109,16,36,.444,0,0,,16,36,.444,.444,14,16,.875,7,20,27,3,2,5,9,13,46
22383,HOU,2000,Bill Curley,27,4,0,50,6,11,.545,0,0,,6,11,.545,.545,0,0,,4,4,8,0,2,0,4,10,12
22384,HOU,1999,Scottie Pippen,33,50,50,2011,261,604,.432,72,212,.340,189,392,.482,.492,132,183,.721,63,260,323,293,98,37,159,118,726
22385,HOU,1999,Hakeem Olajuwon,36,50,50,1784,373,725,.514,4,13,.308,369,712,.518,.517,195,272,.717,106,372,478,88,82,123,139,160,945
22386,HOU,1999,Michael Dickerson,23,50,50,1558,215,462,.465,71,164,.433,144,298,.483,.542,46,72,.639,26,57,83,95,27,11,66,90,547
22387,HOU,1999,Charles Barkley,35,42,40,1526,240,502,.478,4,25,.160,236,477,.495,.482,192,267,.719,167,349,516,192,43,13,100,89,676
22388,HOU,1999,Cuttino Mobley,23,49,37,1456,172,405,.425,53,148,.358,119,257,.463,.490,90,110,.818,22,89,111,121,44,23,79,98,487
22389,HOU,1999,Othella Harrington,25,41,10,903,156,304,.513,0,0,,156,304,.513,.513,88,122,.721,72,174,246,15,6,25,61,103,400
22390,HOU,1999,Brent Price,30,40,6,806,100,207,.483,46,112,.411,54,95,.568,.594,46,61,.754,18,60,78,113,33,1,65,90,292
22391,HOU,1999,Sam Mack,28,25,0,506,81,172,.471,45,111,.405,36,61,.590,.602,23,28,.821,7,35,42,32,15,3,13,41,230
22392,HOU,1999,Bryce Drew,24,34,0,441,47,129,.364,16,49,.327,31,80,.388,.426,8,8,1.000,3,29,32,52,12,4,31,61,118
22393,HOU,1999,Matt Bullard,31,41,0,413,43,114,.377,24,62,.387,19,52,.365,.482,7,10,.700,9,33,42,18,13,4,14,28,117
22394,HOU,1999,Anthony Miller,27,29,0,249,28,60,.467,0,1,.000,28,59,.475,.467,14,22,.636,26,41,67,7,7,5,9,34,70
22395,HOU,1999,Matt Maloney,27,15,7,186,5,28,.179,1,15,.067,4,13,.308,.196,10,11,.909,2,8,10,21,4,0,14,7,21
22396,HOU,1999,Antoine Carr,37,18,0,152,21,52,.404,0,1,.000,21,51,.412,.404,5,7,.714,9,22,31,9,1,10,9,31,47
22397,HOU,1999,Rodrick Rhodes,25,3,0,33,2,8,.250,0,0,,2,8,.250,.250,5,6,.833,2,2,4,1,1,0,5,5,9
22398,HOU,1999,Stanley Roberts,28,6,0,33,5,13,.385,0,0,,5,13,.385,.385,4,8,.500,4,7,11,0,0,1,4,2,14
22399,HOU,1999,Eddie Johnson,39,3,0,18,6,13,.462,0,1,.000,6,12,.500,.462,0,0,,0,2,2,1,0,0,2,3,12
22400,HOU,1998,Kevin Willis,35,81,74,2528,531,1041,.510,1,7,.143,530,1034,.513,.511,242,305,.793,232,447,679,78,55,38,170,235,1305
22401,HOU,1998,Clyde Drexler,35,70,70,2473,452,1059,.427,106,334,.317,346,725,.477,.477,277,346,.801,105,241,346,382,126,42,189,193,1287
22402,HOU,1998,Charles Barkley,34,68,41,2243,361,744,.485,18,84,.214,343,660,.520,.497,296,397,.746,241,553,794,217,71,28,147,187,1036
22403,HOU,1998,Matt Maloney,26,78,78,2217,239,586,.408,126,346,.364,113,240,.471,.515,65,78,.833,16,126,142,219,62,5,107,99,669
22404,HOU,1998,Mario Elie,34,73,59,1988,206,456,.452,55,189,.291,151,267,.566,.512,145,174,.833,39,117,156,221,81,8,100,115,612
22405,HOU,1998,Hakeem Olajuwon,35,47,45,1633,306,633,.483,0,3,.000,306,630,.486,.483,160,212,.755,116,344,460,143,84,96,126,152,772
22406,HOU,1998,Eddie Johnson,38,75,1,1490,227,544,.417,66,198,.333,161,346,.465,.478,113,136,.831,50,103,153,88,32,3,62,89,633
22407,HOU,1998,Brent Price,29,72,2,1332,128,310,.413,73,187,.390,55,123,.447,.531,77,98,.786,37,70,107,192,52,4,111,163,406
22408,HOU,1998,Matt Bullard,30,67,24,1190,175,389,.450,96,231,.416,79,158,.500,.573,20,27,.741,25,121,146,60,31,24,39,104,466
22409,HOU,1998,Rodrick Rhodes,24,58,13,1070,112,305,.367,2,8,.250,110,297,.370,.370,111,180,.617,28,42,70,110,62,10,97,125,337
22410,HOU,1998,Othella Harrington,24,58,3,903,129,266,.485,0,1,.000,129,265,.487,.485,92,122,.754,73,134,207,24,10,27,47,112,350
22411,HOU,1998,Emanual Davis,29,45,0,599,63,142,.444,27,72,.375,36,70,.514,.539,31,37,.838,10,37,47,59,17,3,52,55,184
22412,HOU,1998,Charles Jones,40,24,0,127,7,10,.700,0,0,,7,10,.700,.700,1,2,.500,12,12,24,5,1,6,4,22,15
22413,HOU,1998,Joe Stephens,25,7,0,37,10,28,.357,3,10,.300,7,18,.389,.411,4,6,.667,3,3,6,1,2,0,2,2,27
22414,HOU,1997,Hakeem Olajuwon,34,78,78,2852,727,1426,.510,5,16,.313,722,1410,.512,.512,351,446,.787,173,543,716,236,117,173,281,249,1810
22415,HOU,1997,Mario Elie,33,78,77,2687,291,585,.497,120,286,.420,171,299,.572,.600,207,231,.896,60,175,235,310,92,12,135,200,909
22416,HOU,1997,Matt Maloney,25,82,82,2386,271,615,.441,154,381,.404,117,234,.500,.566,71,93,.763,19,141,160,303,82,1,122,125,767
22417,HOU,1997,Clyde Drexler,34,62,62,2271,397,899,.442,119,335,.355,278,564,.493,.508,201,268,.750,118,255,373,354,119,36,156,151,1114
22418,HOU,1997,Charles Barkley,33,53,53,2009,335,692,.484,58,205,.283,277,487,.569,.526,288,415,.694,212,504,716,248,69,25,151,153,1016
22419,HOU,1997,Kevin Willis,34,75,32,1964,350,728,.481,2,14,.143,348,714,.487,.482,140,202,.693,146,415,561,71,42,32,119,216,842
22420,HOU,1997,Matt Bullard,29,71,12,1025,114,284,.401,67,183,.366,47,101,.465,.519,25,34,.735,13,104,117,67,21,18,38,68,320
22421,HOU,1997,Randy Livingston,21,64,0,981,100,229,.437,9,22,.409,91,207,.440,.456,42,65,.646,32,62,94,155,39,12,102,107,251
22422,HOU,1997,Sam Mack,26,52,10,904,105,262,.401,47,142,.331,58,120,.483,.490,35,42,.833,20,86,106,58,29,6,42,67,292
22423,HOU,1997,Othella Harrington,23,57,1,860,112,204,.549,0,3,.000,112,201,.557,.549,49,81,.605,75,123,198,18,12,22,57,112,273
22424,HOU,1997,Eddie Johnson,37,24,2,607,101,226,.447,40,103,.388,61,123,.496,.535,35,41,.854,24,74,98,35,10,1,30,48,277
22425,HOU,1997,Brent Price,28,25,0,390,44,105,.419,17,53,.321,27,52,.519,.500,21,21,1.000,10,19,29,65,17,0,32,34,126
22426,HOU,1997,Sedale Threatt,35,21,0,334,28,74,.378,8,20,.400,20,54,.370,.432,6,8,.750,5,19,24,40,15,3,13,29,70
22427,HOU,1997,Tracy Moore,31,27,1,237,33,85,.388,11,43,.256,22,42,.524,.453,22,31,.710,11,15,26,20,5,0,14,19,99
22428,HOU,1997,Emanual Davis,28,13,0,230,24,54,.444,12,27,.444,12,27,.444,.556,5,8,.625,2,20,22,26,9,2,17,20,65
22429,HOU,1997,Charles Jones,39,12,0,93,2,5,.400,0,0,,2,5,.400,.400,0,0,,5,8,13,3,2,4,0,8,4
22430,HOU,1997,Elmer Bennett,26,4,0,16,2,6,.333,1,3,.333,1,3,.333,.417,5,6,.833,0,1,1,4,2,0,0,1,10
22431,HOU,1997,Joe Stephens,24,2,0,9,1,5,.200,1,3,.333,0,2,.000,.300,0,0,,2,1,3,0,3,0,3,3,3
22432,HOU,1996,Hakeem Olajuwon,33,72,72,2797,768,1494,.514,3,14,.214,765,1480,.517,.515,397,548,.724,176,608,784,257,113,207,247,242,1936
22433,HOU,1996,Robert Horry,25,71,71,2634,300,732,.410,142,388,.366,158,344,.459,.507,111,143,.776,97,315,412,281,116,109,160,197,853
22434,HOU,1996,Chucky Brown,27,82,82,2019,300,555,.541,1,8,.125,299,547,.547,.541,104,150,.693,134,307,441,89,47,38,94,163,705
22435,HOU,1996,Clyde Drexler,33,52,51,1997,331,764,.433,78,235,.332,253,529,.478,.484,265,338,.784,97,276,373,302,105,24,134,153,1005
22436,HOU,1996,Sam Cassell,26,61,0,1682,289,658,.439,73,210,.348,216,448,.482,.495,235,285,.825,51,137,188,278,53,4,157,166,886
22437,HOU,1996,Kenny Smith,30,68,56,1617,201,464,.433,91,238,.382,110,226,.487,.531,87,106,.821,21,75,96,245,47,3,100,116,580
22438,HOU,1996,Mark Bryant,30,71,9,1587,242,446,.543,0,2,.000,242,444,.545,.543,127,177,.718,131,220,351,52,31,19,85,234,611
22439,HOU,1996,Mario Elie,32,45,16,1385,180,357,.504,41,127,.323,139,230,.604,.562,98,115,.852,47,108,155,138,45,11,59,93,499
22440,HOU,1996,Eldridge Recasner,28,63,27,1275,149,359,.415,81,191,.424,68,168,.405,.528,57,66,.864,31,113,144,170,23,5,61,111,436
22441,HOU,1996,Sam Mack,25,31,20,868,121,287,.422,54,135,.400,67,152,.441,.516,39,46,.848,18,80,98,79,22,9,28,75,335
22442,HOU,1996,Pete Chilcutt,27,74,0,651,73,179,.408,37,98,.378,36,81,.444,.511,17,26,.654,51,105,156,26,19,14,22,65,200
22443,HOU,1996,Tim Breaux,25,54,4,570,59,161,.366,15,46,.326,44,115,.383,.413,28,45,.622,22,38,60,24,11,8,30,42,161
22444,HOU,1996,Charles Jones,38,46,0,297,6,19,.316,0,0,,6,19,.316,.316,4,13,.308,28,46,74,12,5,24,3,44,16
22445,HOU,1996,Tracy Moore,30,8,2,190,30,76,.395,13,30,.433,17,46,.370,.480,18,19,.947,10,12,22,6,2,0,8,16,91
22446,HOU,1996,Melvin Booker,23,11,0,131,16,50,.320,3,19,.158,13,31,.419,.350,9,11,.818,1,8,9,21,5,1,12,18,44
22447,HOU,1996,Henry James,30,7,0,58,10,24,.417,5,15,.333,5,9,.556,.521,5,5,1.000,3,3,6,2,0,0,4,13,30
22448,HOU,1996,Jaren Jackson,28,4,0,33,0,8,.000,0,5,.000,0,3,.000,.000,8,10,.800,0,3,3,0,1,0,0,5,8
22449,HOU,1996,Alvin Heggs,28,4,0,14,3,5,.600,0,0,,3,5,.600,.600,2,3,.667,1,1,2,0,0,0,0,0,8
22450,HOU,1995,Hakeem Olajuwon,32,72,72,2853,798,1545,.517,3,16,.188,795,1529,.520,.517,406,537,.756,172,603,775,255,133,242,237,250,2005
22451,HOU,1995,Robert Horry,24,64,61,2074,240,537,.447,86,227,.379,154,310,.497,.527,86,113,.761,81,243,324,216,94,76,122,161,652
22452,HOU,1995,Vernon Maxwell,29,64,54,2038,306,777,.394,143,441,.324,163,336,.485,.486,99,144,.688,18,146,164,274,75,13,137,157,854
22453,HOU,1995,Kenny Smith,29,81,81,2030,287,593,.484,142,331,.429,145,262,.553,.604,126,148,.851,27,128,155,323,71,10,123,109,842
22454,HOU,1995,Mario Elie,31,81,13,1896,243,487,.499,80,201,.398,163,286,.570,.581,144,171,.842,50,146,196,189,65,12,104,158,710
22455,HOU,1995,Sam Cassell,25,82,1,1882,253,593,.427,63,191,.330,190,402,.473,.480,214,254,.843,38,173,211,405,94,14,167,209,783
22456,HOU,1995,Pete Chilcutt,26,68,17,1347,146,328,.445,35,86,.407,111,242,.459,.498,31,42,.738,106,211,317,66,25,43,61,117,358
22457,HOU,1995,Carl Herrera,28,61,26,1331,171,327,.523,0,2,.000,171,325,.526,.523,73,117,.624,98,180,278,44,40,38,71,136,415
22458,HOU,1995,Clyde Drexler,32,35,34,1300,266,526,.506,60,168,.357,206,358,.575,.563,157,194,.809,68,178,246,154,62,23,89,89,749
22459,HOU,1995,Otis Thorpe,32,36,35,1188,206,366,.563,0,3,.000,206,363,.567,.563,67,127,.528,113,209,322,58,22,13,76,102,479
22460,HOU,1995,Chucky Brown,26,41,14,814,105,174,.603,1,3,.333,104,171,.608,.606,38,62,.613,64,125,189,30,11,14,29,105,249
22461,HOU,1995,Tim Breaux,24,42,2,340,45,121,.372,6,25,.240,39,96,.406,.397,32,49,.653,16,18,34,15,11,4,16,25,128
22462,HOU,1995,Tracy Murray,23,25,0,203,32,80,.400,19,45,.422,13,35,.371,.519,5,8,.625,2,20,22,5,7,3,15,31,88
22463,HOU,1995,Scott Brooks,29,28,0,186,35,65,.538,8,17,.471,27,48,.563,.600,18,21,.857,1,12,13,22,8,1,14,14,96
22464,HOU,1995,Žan Tabak,24,37,0,182,24,53,.453,0,1,.000,24,52,.462,.453,27,44,.614,23,34,57,4,2,7,18,37,75
22465,HOU,1995,Charles Jones,37,3,0,36,1,3,.333,0,0,,1,3,.333,.333,1,2,.500,2,5,7,0,0,1,0,8,3
22466,HOU,1995,Adrian Caldwell,28,7,0,30,1,4,.250,0,0,,1,4,.250,.250,3,6,.500,1,9,10,0,1,0,1,6,5
22467,HOU,1994,Hakeem Olajuwon,31,80,80,3277,894,1694,.528,8,19,.421,886,1675,.529,.530,388,542,.716,229,726,955,287,128,297,271,289,2184
22468,HOU,1994,Otis Thorpe,31,82,82,2909,449,801,.561,0,2,.000,449,799,.562,.561,251,382,.657,271,599,870,189,66,28,185,253,1149
22469,HOU,1994,Vernon Maxwell,28,75,73,2571,380,976,.389,120,403,.298,260,573,.454,.451,143,191,.749,42,187,229,380,125,20,185,143,1023
22470,HOU,1994,Robert Horry,23,81,81,2370,322,702,.459,44,136,.324,278,566,.491,.490,115,157,.732,128,312,440,231,119,75,137,186,803
22471,HOU,1994,Kenny Smith,28,78,78,2209,341,711,.480,89,220,.405,252,491,.513,.542,135,155,.871,24,114,138,327,59,4,126,121,906
22472,HOU,1994,Mario Elie,30,67,8,1606,208,466,.446,56,167,.335,152,299,.508,.506,154,179,.860,28,153,181,208,50,8,109,124,626
22473,HOU,1994,Carl Herrera,27,75,0,1292,142,310,.458,0,0,,142,310,.458,.458,69,97,.711,101,184,285,37,32,26,69,159,353
22474,HOU,1994,Scott Brooks,28,73,0,1225,142,289,.491,23,61,.377,119,228,.522,.531,74,85,.871,10,92,102,149,51,2,55,98,381
22475,HOU,1994,Sam Cassell,24,66,6,1122,162,388,.418,26,88,.295,136,300,.453,.451,90,107,.841,25,109,134,192,59,7,94,136,440
22476,HOU,1994,Matt Bullard,26,65,0,725,78,226,.345,50,154,.325,28,72,.389,.456,20,26,.769,23,61,84,64,14,6,28,67,226
22477,HOU,1994,Eric Riley,23,47,2,219,34,70,.486,0,1,.000,34,69,.493,.486,20,37,.541,24,35,59,9,5,9,15,30,88
22478,HOU,1994,Richard Petruška,25,22,0,92,20,46,.435,7,15,.467,13,31,.419,.511,6,8,.750,9,22,31,1,2,3,15,15,53
22479,HOU,1994,Chris Jent,24,3,0,78,13,26,.500,4,11,.364,9,15,.600,.577,1,2,.500,4,11,15,7,0,0,5,13,31
22480,HOU,1994,Larry Robinson,26,6,0,55,10,20,.500,2,8,.250,8,12,.667,.550,3,8,.375,4,6,10,6,7,0,10,8,25
22481,HOU,1994,Earl Cureton,36,2,0,30,2,8,.250,0,0,,2,8,.250,.250,0,2,.000,4,8,12,0,0,0,1,4,4
22482,HOU,1993,Hakeem Olajuwon,30,82,82,3242,848,1603,.529,0,8,.000,848,1595,.532,.529,444,570,.779,283,785,1068,291,150,342,262,305,2140
22483,HOU,1993,Kenny Smith,27,82,82,2422,387,744,.520,96,219,.438,291,525,.554,.585,195,222,.878,28,132,160,446,80,7,163,110,1065
22484,HOU,1993,Otis Thorpe,30,72,69,2357,385,690,.558,0,2,.000,385,688,.560,.558,153,256,.598,219,370,589,181,43,19,151,234,923
22485,HOU,1993,Robert Horry,22,79,79,2330,323,682,.474,12,47,.255,311,635,.490,.482,143,200,.715,113,279,392,191,80,83,156,210,801
22486,HOU,1993,Vernon Maxwell,27,71,68,2251,349,858,.407,120,361,.332,229,497,.461,.477,164,228,.719,29,192,221,297,86,8,140,124,982
22487,HOU,1993,Carl Herrera,26,81,12,1800,240,444,.541,0,2,.000,240,442,.543,.541,125,176,.710,148,306,454,61,47,35,92,190,605
22488,HOU,1993,Scott Brooks,27,82,0,1516,183,385,.475,41,99,.414,142,286,.497,.529,112,135,.830,22,77,99,243,79,3,72,136,519
22489,HOU,1993,Matt Bullard,25,79,4,1356,213,494,.431,91,243,.374,122,251,.486,.523,58,74,.784,66,156,222,110,30,11,57,129,575
22490,HOU,1993,Winston Garland,28,66,4,1004,152,343,.443,6,13,.462,146,330,.442,.452,81,89,.910,32,76,108,138,39,4,67,116,391
22491,HOU,1993,Sleepy Floyd,32,52,10,867,124,305,.407,16,56,.286,108,249,.434,.433,81,102,.794,14,72,86,132,32,6,68,59,345
22492,HOU,1993,Kennard Winchester,26,39,0,340,61,139,.439,4,19,.211,57,120,.475,.453,17,22,.773,17,32,49,13,10,10,15,40,143
22493,HOU,1993,Tree Rollins,37,42,0,247,11,41,.268,0,2,.000,11,39,.282,.268,9,12,.750,12,48,60,10,6,15,9,43,31
22494,HOU,1993,Terry Teagle,32,2,0,25,2,7,.286,0,0,,2,7,.286,.286,1,2,.500,0,3,3,2,0,0,1,1,5
22495,HOU,1993,Mark Acres,30,6,0,23,2,9,.222,1,2,.500,1,7,.143,.278,1,2,.500,2,4,6,0,0,0,2,2,6
22496,HOU,1992,Otis Thorpe,29,82,82,3056,558,943,.592,0,7,.000,558,936,.596,.592,304,463,.657,285,577,862,250,52,37,237,307,1420
22497,HOU,1992,Kenny Smith,26,81,80,2735,432,910,.475,54,137,.394,378,773,.489,.504,219,253,.866,34,143,177,562,104,7,227,112,1137
22498,HOU,1992,Vernon Maxwell,26,80,80,2700,502,1216,.413,162,473,.342,340,743,.458,.479,206,267,.772,37,206,243,326,104,28,178,200,1372
22499,HOU,1992,Hakeem Olajuwon,29,70,69,2636,591,1177,.502,0,1,.000,591,1176,.503,.502,328,428,.766,246,599,845,157,127,304,187,263,1510
22500,HOU,1992,Buck Johnson,28,80,69,2202,290,633,.458,1,9,.111,289,624,.463,.459,104,143,.727,95,217,312,158,72,49,104,234,685
22501,HOU,1992,Sleepy Floyd,31,82,3,1662,286,704,.406,37,123,.301,249,581,.429,.433,135,170,.794,34,116,150,239,57,21,128,128,744
22502,HOU,1992,Matt Bullard,24,80,7,1278,205,447,.459,64,166,.386,141,281,.502,.530,38,50,.760,73,150,223,75,26,21,56,129,512
22503,HOU,1992,Larry Smith,34,45,7,800,50,92,.543,0,1,.000,50,91,.549,.543,4,11,.364,107,149,256,33,21,7,44,121,104
22504,HOU,1992,Avery Johnson,26,49,1,772,103,222,.464,3,10,.300,100,212,.472,.471,42,69,.609,8,37,45,166,40,6,65,46,251
22505,HOU,1992,Tree Rollins,36,59,5,697,46,86,.535,0,0,,46,86,.535,.535,26,30,.867,61,110,171,15,14,62,18,85,118
22506,HOU,1992,Carl Herrera,25,43,7,566,83,161,.516,0,1,.000,83,160,.519,.516,25,44,.568,33,66,99,27,16,25,37,60,191
22507,HOU,1992,Dave Jamerson,24,48,0,378,79,191,.414,8,28,.286,71,163,.436,.435,25,27,.926,22,21,43,33,17,0,24,39,191
22508,HOU,1992,John Turner,24,42,0,345,43,98,.439,0,0,,43,98,.439,.439,31,59,.525,38,40,78,12,6,4,32,40,117
22509,HOU,1992,Gerald Henderson,36,8,0,34,4,11,.364,0,3,.000,4,8,.500,.364,4,6,.667,1,1,2,5,0,0,4,4,12
22510,HOU,1992,Kennard Winchester,25,4,0,17,1,3,.333,0,0,,1,3,.333,.333,0,0,,0,0,0,0,0,0,0,1,2
22511,HOU,1992,Dan Godfread,24,1,0,2,0,0,,0,0,,0,0,,,0,0,,0,0,0,0,0,0,0,0,0
22512,HOU,1991,Otis Thorpe,28,82,82,3039,549,988,.556,3,7,.429,546,981,.557,.557,334,480,.696,287,559,846,197,73,20,217,278,1435
22513,HOU,1991,Vernon Maxwell,25,82,79,2870,504,1247,.404,172,510,.337,332,737,.450,.473,217,296,.733,41,197,238,303,127,15,171,179,1397
22514,HOU,1991,Kenny Smith,25,78,78,2699,522,1003,.520,49,135,.363,473,868,.545,.545,287,340,.844,36,127,163,554,106,11,237,131,1380
22515,HOU,1991,Buck Johnson,27,73,70,2279,416,873,.477,2,15,.133,414,858,.483,.478,157,216,.727,108,222,330,142,81,47,122,240,991
22516,HOU,1991,Hakeem Olajuwon,28,56,50,2062,487,959,.508,0,4,.000,487,955,.510,.508,213,277,.769,219,551,770,131,121,221,174,221,1187
22517,HOU,1991,Larry Smith,33,81,28,1923,128,263,.487,0,0,,128,263,.487,.487,12,50,.240,302,407,709,88,83,22,93,265,268
22518,HOU,1991,Sleepy Floyd,30,82,4,1850,386,939,.411,48,176,.273,338,763,.443,.437,185,246,.752,52,107,159,317,95,17,140,122,1005
22519,HOU,1991,David Wood,26,82,13,1421,148,349,.424,28,90,.311,120,259,.463,.464,108,133,.812,107,139,246,94,58,16,89,236,432
22520,HOU,1991,Kennard Winchester,24,64,1,607,98,245,.400,8,20,.400,90,225,.400,.416,35,45,.778,34,33,67,25,16,13,30,70,239
22521,HOU,1991,Dave Feitl,28,52,2,372,52,140,.371,0,3,.000,52,137,.380,.371,33,44,.750,29,71,100,8,3,12,25,52,137
22522,HOU,1991,Adrian Caldwell,24,42,0,343,35,83,.422,0,1,.000,35,82,.427,.422,7,17,.412,43,57,100,8,19,10,30,35,77
22523,HOU,1991,Dave Jamerson,23,37,0,202,43,113,.381,5,19,.263,38,94,.404,.403,22,27,.815,9,21,30,27,6,1,20,24,113
22524,HOU,1991,Mike Woodson,32,11,3,125,21,54,.389,1,6,.167,20,48,.417,.398,10,12,.833,2,9,11,10,5,4,7,11,53
22525,HOU,1991,Matt Bullard,23,18,0,63,14,31,.452,0,3,.000,14,28,.500,.452,11,17,.647,6,8,14,2,3,0,3,10,39
22526,HOU,1990,Hakeem Olajuwon,27,82,82,3124,806,1609,.501,1,6,.167,805,1603,.502,.501,382,536,.713,299,850,1149,234,174,376,316,314,1995
22527,HOU,1990,Otis Thorpe,27,82,82,2947,547,998,.548,0,10,.000,547,988,.554,.548,307,446,.688,258,476,734,261,66,24,229,270,1401
22528,HOU,1990,Buck Johnson,26,82,82,2832,504,1019,.495,2,17,.118,502,1002,.501,.496,205,270,.759,113,268,381,252,104,62,167,321,1215
22529,HOU,1990,Sleepy Floyd,29,82,73,2630,362,803,.451,89,234,.380,273,569,.480,.506,187,232,.806,46,152,198,600,94,11,204,159,1000
22530,HOU,1990,Mitchell Wiggins,30,66,52,1852,416,853,.488,0,3,.000,416,850,.489,.488,192,237,.810,133,153,286,104,85,1,87,165,1024
22531,HOU,1990,Larry Smith,32,74,0,1300,101,213,.474,0,2,.000,101,211,.479,.474,20,55,.364,180,272,452,69,56,28,70,203,222
22532,HOU,1990,Mike Woodson,31,61,11,972,160,405,.395,12,41,.293,148,364,.407,.410,62,86,.721,25,63,88,66,42,11,49,100,394
22533,HOU,1990,John Lucas,36,49,18,938,109,291,.375,26,87,.299,83,204,.407,.419,42,55,.764,19,71,90,238,45,2,85,59,286
22534,HOU,1990,Anthony Bowie,26,66,0,918,119,293,.406,6,21,.286,113,272,.415,.416,40,54,.741,36,82,118,96,42,5,59,80,284
22535,HOU,1990,Vernon Maxwell,24,30,10,869,142,321,.442,13,53,.245,129,268,.481,.463,77,116,.664,15,72,87,150,42,5,72,69,374
22536,HOU,1990,Derrick Chievous,22,41,0,492,90,178,.506,3,8,.375,87,170,.512,.514,61,87,.701,28,47,75,27,23,4,40,59,244
22537,HOU,1990,Byron Dinkins,22,33,0,362,44,109,.404,1,9,.111,43,100,.430,.408,26,30,.867,13,27,40,75,19,2,37,30,115
22538,HOU,1990,Adrian Caldwell,23,51,0,331,42,76,.553,0,0,,42,76,.553,.553,13,28,.464,36,73,109,7,11,18,32,69,97
22539,HOU,1990,Tim McCormick,27,18,0,116,10,29,.345,0,0,,10,29,.345,.345,10,19,.526,8,19,27,3,3,1,10,24,30
22540,HOU,1990,Lewis Lloyd,30,19,0,113,29,51,.569,0,0,,29,51,.569,.569,9,16,.563,8,10,18,11,3,0,16,9,67
22541,HOU,1990,Chuck Nevitt,30,3,0,9,2,2,1.000,0,0,,2,2,1.000,1.000,0,0,,0,3,3,1,0,1,2,3,4
22542,HOU,1989,Otis Thorpe,26,82,82,3135,521,961,.542,0,2,.000,521,959,.543,.542,328,450,.729,272,515,787,202,82,37,225,259,1370
22543,HOU,1989,Hakeem Olajuwon,26,82,82,3024,790,1556,.508,0,10,.000,790,1546,.511,.508,454,652,.696,338,767,1105,149,213,282,275,329,2034
22544,HOU,1989,Sleepy Floyd,28,82,82,2788,396,893,.443,109,292,.373,287,601,.478,.504,261,309,.845,48,258,306,709,124,11,253,196,1162
22545,HOU,1989,Mike Woodson,30,81,79,2259,410,936,.438,31,89,.348,379,847,.447,.455,195,237,.823,51,143,194,206,89,18,136,195,1046
22546,HOU,1989,Buck Johnson,25,67,51,1850,270,515,.524,1,9,.111,269,506,.532,.525,101,134,.754,114,172,286,126,64,35,110,213,642
22547,HOU,1989,Derrick Chievous,21,81,1,1539,277,634,.437,5,24,.208,272,610,.446,.441,191,244,.783,114,142,256,77,48,11,136,161,750
22548,HOU,1989,Tim McCormick,26,81,0,1257,169,351,.481,0,4,.000,169,347,.487,.481,87,129,.674,87,174,261,54,18,24,68,193,425
22549,HOU,1989,Purvis Short,31,65,16,1157,198,480,.413,9,33,.273,189,447,.423,.422,77,89,.865,65,114,179,107,44,13,70,116,482
22550,HOU,1989,Frank Johnson,30,67,0,879,109,246,.443,1,6,.167,108,240,.450,.445,75,93,.806,22,57,79,181,42,0,102,91,294
22551,HOU,1989,Walter Berry,24,40,14,799,146,270,.541,1,2,.500,145,268,.541,.543,57,80,.713,54,98,152,57,19,35,49,114,350
22552,HOU,1989,Allen Leavell,31,55,3,627,65,188,.346,5,41,.122,60,147,.408,.359,44,60,.733,13,40,53,127,25,5,62,61,179
22553,HOU,1989,Chuck Nevitt,29,43,0,228,27,62,.435,0,0,,27,62,.435,.435,11,16,.688,17,47,64,3,5,29,22,51,65
22554,HOU,1989,Bernard Thompson,26,23,0,222,20,59,.339,0,2,.000,20,57,.351,.339,22,26,.846,9,19,28,13,13,1,19,33,62
22555,HOU,1989,Tony Brown,28,14,0,91,14,45,.311,2,9,.222,12,36,.333,.333,6,8,.750,7,8,15,5,3,0,7,14,36
22556,HOU,1988,Hakeem Olajuwon,25,79,79,2825,712,1385,.514,0,4,.000,712,1381,.516,.514,381,548,.695,302,657,959,163,162,214,243,324,1805
22557,HOU,1988,Rodney McCray,26,81,80,2689,359,746,.481,0,4,.000,359,742,.484,.481,288,367,.785,232,399,631,264,57,51,144,166,1006
22558,HOU,1988,Allen Leavell,30,80,54,2150,291,666,.437,19,88,.216,272,578,.471,.451,218,251,.869,22,126,148,405,124,9,130,162,819
22559,HOU,1988,Purvis Short,30,81,11,1949,474,986,.481,5,21,.238,469,965,.486,.483,206,240,.858,71,151,222,162,58,14,118,197,1159
22560,HOU,1988,Sleepy Floyd,27,59,55,1834,288,668,.431,13,52,.250,275,616,.446,.441,185,215,.860,51,154,205,366,68,10,156,144,774
22561,HOU,1988,Jim Petersen,25,69,50,1793,249,488,.510,1,6,.167,248,482,.515,.511,114,153,.745,145,291,436,106,36,40,119,203,613
22562,HOU,1988,Joe Barry Carroll,29,63,16,1596,323,715,.452,0,1,.000,323,714,.452,.452,113,151,.748,110,286,396,94,37,81,121,149,759
22563,HOU,1988,Robert Reid,32,62,31,980,165,356,.463,13,34,.382,152,322,.472,.482,50,63,.794,38,87,125,67,27,5,41,118,393
22564,HOU,1988,Buck Johnson,24,70,2,879,155,298,.520,1,8,.125,154,290,.531,.522,67,91,.736,77,91,168,49,30,26,54,127,378
22565,HOU,1988,Cedric Maxwell,32,71,0,848,80,171,.468,0,2,.000,80,169,.473,.468,110,143,.769,74,105,179,60,22,12,54,75,270
22566,HOU,1988,Ralph Sampson,27,19,19,705,119,271,.439,2,6,.333,117,265,.442,.443,63,85,.741,58,114,172,37,17,33,62,63,303
22567,HOU,1988,World B. Free,34,58,0,682,143,350,.409,8,35,.229,135,315,.429,.420,80,100,.800,14,30,44,60,20,3,49,74,374
22568,HOU,1988,Lester Conner,28,52,3,399,50,108,.463,0,7,.000,50,101,.495,.463,32,41,.780,20,18,38,59,38,1,33,31,132
22569,HOU,1988,Steve Harris,24,14,10,199,34,86,.395,0,1,.000,34,85,.400,.395,15,16,.938,12,9,21,17,8,2,6,15,83
22570,HOU,1988,Andre Turner,23,12,0,99,12,34,.353,1,7,.143,11,27,.407,.368,10,14,.714,4,4,8,23,7,1,12,13,35
22571,HOU,1988,Richard Anderson,27,12,0,53,11,26,.423,6,15,.400,5,11,.455,.538,4,5,.800,9,8,17,4,1,0,1,4,32
22572,HOU,1987,Rodney McCray,25,81,81,3136,432,783,.552,0,9,.000,432,774,.558,.552,306,393,.779,190,388,578,434,88,53,208,172,1170
22573,HOU,1987,Hakeem Olajuwon,24,75,75,2760,677,1332,.508,1,5,.200,676,1327,.509,.509,400,570,.702,315,543,858,220,140,254,228,294,1755
22574,HOU,1987,Robert Reid,31,75,63,2594,420,1006,.417,53,162,.327,367,844,.435,.444,136,177,.768,47,242,289,323,75,21,104,232,1029
22575,HOU,1987,Jim Petersen,24,82,56,2403,386,755,.511,0,4,.000,386,751,.514,.511,152,209,.727,177,380,557,127,43,102,152,268,924
22576,HOU,1987,Dirk Minniefield,26,63,52,1478,205,440,.466,11,34,.324,194,406,.478,.478,61,86,.709,28,102,130,335,66,6,145,166,482
22577,HOU,1987,Ralph Sampson,26,43,32,1326,277,566,.489,0,3,.000,277,563,.492,.489,118,189,.624,88,284,372,120,40,58,126,169,672
22578,HOU,1987,Allen Leavell,29,53,11,1175,147,358,.411,18,57,.316,129,301,.429,.436,100,119,.840,14,47,61,224,53,10,64,126,412
22579,HOU,1987,Steve Harris,23,74,3,1174,251,599,.419,0,8,.000,251,591,.425,.419,111,130,.854,71,99,170,100,37,16,74,111,613
22580,HOU,1987,Cedric Maxwell,31,46,0,836,103,188,.548,0,1,.000,103,187,.551,.548,126,163,.773,72,112,184,75,13,5,48,76,332
22581,HOU,1987,Mitchell Wiggins,27,32,19,788,153,350,.437,0,5,.000,153,345,.443,.437,49,65,.754,74,59,133,76,44,3,50,82,355
22582,HOU,1987,Lewis Lloyd,27,32,14,688,165,310,.532,1,7,.143,164,303,.541,.534,65,86,.756,13,35,48,90,19,5,52,69,396
22583,HOU,1987,Buck Johnson,23,60,3,520,94,201,.468,0,1,.000,94,200,.470,.468,40,58,.690,38,50,88,40,17,15,37,81,228
22584,HOU,1987,Dave Feitl,24,62,1,498,88,202,.436,0,1,.000,88,201,.438,.436,53,71,.746,39,78,117,22,9,4,38,83,229
22585,HOU,1987,Richard Anderson,26,51,0,312,59,139,.424,4,16,.250,55,123,.447,.439,22,29,.759,24,55,79,33,7,3,19,37,144
22586,HOU,1987,Conner Henry,23,18,0,92,8,33,.242,1,11,.091,7,22,.318,.258,7,10,.700,0,7,7,8,3,0,9,7,24
22587,HOU,1986,Ralph Sampson,25,79,76,2864,624,1280,.488,2,15,.133,622,1265,.492,.488,241,376,.641,258,621,879,283,99,129,285,308,1491
22588,HOU,1986,Rodney McCray,24,82,82,2610,338,629,.537,0,3,.000,338,626,.540,.537,171,222,.770,159,361,520,292,50,58,130,197,847
22589,HOU,1986,Hakeem Olajuwon,23,68,68,2467,625,1188,.526,0,0,,625,1188,.526,.526,347,538,.645,333,448,781,137,134,231,195,271,1597
22590,HOU,1986,Lewis Lloyd,26,82,82,2444,592,1119,.529,3,15,.200,589,1104,.534,.530,199,236,.843,155,169,324,300,102,24,194,216,1386
22591,HOU,1986,Robert Reid,30,82,5,2157,409,881,.464,6,33,.182,403,848,.475,.468,162,214,.757,67,234,301,222,91,16,96,231,986
22592,HOU,1986,John Lucas,32,65,65,2120,365,818,.446,45,146,.308,320,672,.476,.474,231,298,.775,33,110,143,571,77,5,149,124,1006
22593,HOU,1986,Jim Petersen,23,82,20,1664,196,411,.477,0,3,.000,196,408,.480,.477,113,160,.706,149,247,396,85,38,54,84,231,505
22594,HOU,1986,Mitchell Wiggins,26,78,0,1198,222,489,.454,1,12,.083,221,477,.463,.455,86,118,.729,87,72,159,101,59,5,62,155,531
22595,HOU,1986,Allen Leavell,28,74,12,1190,212,458,.463,24,67,.358,188,391,.481,.489,135,158,.854,6,61,67,234,58,8,88,126,583
22596,HOU,1986,Steve Harris,22,57,0,482,103,233,.442,1,5,.200,102,228,.447,.444,50,54,.926,25,32,57,50,21,4,34,55,257
22597,HOU,1986,Hank McDowell,26,22,0,204,24,42,.571,0,1,.000,24,41,.585,.571,17,25,.680,12,37,49,6,1,3,10,25,65
22598,HOU,1986,Craig Ehlo,24,36,0,199,36,84,.429,3,9,.333,33,75,.440,.446,23,29,.793,17,29,46,29,11,4,15,22,98
22599,HOU,1986,Granville Waiters,25,43,0,156,13,39,.333,0,1,.000,13,38,.342,.333,1,6,.167,15,13,28,8,4,10,11,30,27
22600,HOU,1985,Ralph Sampson,24,82,82,3086,753,1499,.502,0,6,.000,753,1493,.504,.502,303,448,.676,227,626,853,224,81,168,326,306,1809
22601,HOU,1985,Rodney McCray,23,82,82,3001,476,890,.535,0,6,.000,476,884,.538,.535,231,313,.738,201,338,539,355,90,75,178,215,1183
22602,HOU,1985,Hakeem Olajuwon,22,82,82,2914,677,1258,.538,0,0,,677,1258,.538,.538,338,551,.613,440,534,974,111,99,220,234,344,1692
22603,HOU,1985,Lewis Lloyd,25,82,58,2128,457,869,.526,2,8,.250,455,861,.528,.527,161,220,.732,98,133,231,280,73,28,177,196,1077
22604,HOU,1985,Lionel Hollins,31,80,60,1950,249,540,.461,3,13,.231,246,527,.467,.464,108,136,.794,33,140,173,417,78,10,170,187,609
22605,HOU,1985,Robert Reid,29,82,0,1763,312,648,.481,1,16,.063,311,632,.492,.482,88,126,.698,81,192,273,171,48,22,101,196,713
22606,HOU,1985,Mitchell Wiggins,25,82,24,1575,318,657,.484,6,23,.261,312,634,.492,.489,96,131,.733,110,125,235,119,83,13,90,195,738
22607,HOU,1985,John Lucas,31,47,21,1158,206,446,.462,21,66,.318,185,380,.487,.485,103,129,.798,21,64,85,318,62,2,102,78,536
22608,HOU,1985,Jim Petersen,22,60,0,714,70,144,.486,0,0,,70,144,.486,.486,50,66,.758,44,103,147,29,14,32,71,125,190
22609,HOU,1985,Allen Leavell,27,42,0,536,88,209,.421,8,37,.216,80,172,.465,.440,44,57,.772,8,29,37,102,23,4,51,61,228
22610,HOU,1985,Larry Micheaux,24,39,0,394,74,122,.607,0,3,.000,74,119,.622,.607,17,26,.654,44,55,99,17,12,14,28,49,165
22611,HOU,1985,Phil Ford,28,25,1,290,14,47,.298,0,4,.000,14,43,.326,.298,16,18,.889,3,24,27,61,6,1,17,33,44
22612,HOU,1985,Craig Ehlo,23,45,0,189,34,69,.493,0,3,.000,34,66,.515,.493,19,30,.633,8,17,25,26,11,3,22,26,87
22613,HOU,1985,Hank McDowell,25,34,0,132,20,42,.476,0,1,.000,20,41,.488,.476,7,10,.700,7,15,22,9,3,5,8,22,47
22614,HOU,1984,Ralph Sampson,23,82,82,2693,716,1369,.523,1,4,.250,715,1365,.524,.523,287,434,.661,293,620,913,163,70,197,294,339,1720
22615,HOU,1984,Lewis Lloyd,24,82,82,2578,610,1182,.516,3,13,.231,607,1169,.519,.517,235,298,.789,128,167,295,321,102,44,245,211,1458
22616,HOU,1984,Caldwell Jones,33,81,73,2506,318,633,.502,1,3,.333,317,630,.503,.503,164,196,.837,168,414,582,156,46,80,158,335,801
22617,HOU,1984,Rodney McCray,22,79,36,2081,335,672,.499,1,4,.250,334,668,.500,.499,182,249,.731,173,277,450,176,53,54,120,205,853
22618,HOU,1984,Phil Ford,27,81,55,2020,236,470,.502,2,15,.133,234,455,.514,.504,98,117,.838,28,109,137,410,59,8,135,243,572
22619,HOU,1984,Allen Leavell,26,82,27,2009,349,731,.477,11,71,.155,338,660,.512,.485,238,286,.832,31,86,117,459,107,12,184,199,947
22620,HOU,1984,Robert Reid,28,64,28,1936,406,857,.474,2,8,.250,404,849,.476,.475,81,123,.659,97,244,341,217,88,30,92,243,895
22621,HOU,1984,James Bailey,26,73,0,1174,254,517,.491,0,1,.000,254,516,.492,.491,138,192,.719,104,190,294,79,33,40,101,197,646
22622,HOU,1984,Elvin Hayes,38,81,4,994,158,389,.406,0,2,.000,158,387,.408,.406,86,132,.652,87,173,260,71,16,28,82,123,402
22623,HOU,1984,Terry Teagle,23,68,0,616,148,315,.470,7,27,.259,141,288,.490,.481,37,44,.841,28,50,78,63,13,4,62,81,340
22624,HOU,1984,Wally Walker,29,58,18,612,118,241,.490,2,6,.333,116,235,.494,.494,6,18,.333,26,66,92,55,17,4,33,65,244
22625,HOU,1984,Major Jones,30,57,5,473,70,130,.538,0,0,,70,130,.538,.538,30,49,.612,33,82,115,28,14,14,30,63,170
22626,HOU,1984,Craig Ehlo,22,7,0,63,11,27,.407,0,0,,11,27,.407,.407,1,1,1.000,4,5,9,6,3,0,3,13,23
22627,HOU,1983,Allen Leavell,25,79,76,2602,439,1059,.415,42,175,.240,397,884,.449,.434,247,297,.832,64,131,195,530,165,14,198,215,1167
22628,HOU,1983,Caldwell Jones,32,82,82,2440,307,677,.453,0,2,.000,307,675,.455,.453,162,206,.786,222,446,668,138,46,131,171,278,776
22629,HOU,1983,Elvin Hayes,37,81,43,2302,424,890,.476,2,4,.500,422,886,.476,.478,196,287,.683,199,417,616,158,50,81,200,232,1046
22630,HOU,1983,Wally Walker,28,82,59,2251,362,806,.449,1,4,.250,361,802,.450,.450,72,116,.621,137,236,373,199,37,22,144,202,797
22631,HOU,1983,Joe Bryant,28,81,56,2055,344,768,.448,8,36,.222,336,732,.459,.453,116,165,.703,88,189,277,186,82,30,177,258,812
22632,HOU,1983,James Bailey,25,69,39,1715,376,756,.497,0,1,.000,376,755,.498,.497,224,320,.700,168,300,468,65,42,59,190,256,976
22633,HOU,1983,Terry Teagle,22,73,44,1708,332,776,.428,10,29,.345,322,747,.431,.434,87,125,.696,74,120,194,150,53,18,137,171,761
22634,HOU,1983,Calvin Murphy,34,64,0,1423,337,754,.447,4,14,.286,333,740,.450,.450,138,150,.920,34,40,74,158,59,4,89,163,816
22635,HOU,1983,Major Jones,29,60,4,878,142,311,.457,0,2,.000,142,309,.460,.457,56,102,.549,114,149,263,39,22,22,83,104,340
22636,HOU,1983,Tom Henderson,31,51,2,789,107,263,.407,0,2,.000,107,261,.410,.407,45,57,.789,18,51,69,138,37,2,50,57,259
22637,HOU,1983,Jeff Taylor,23,44,5,774,64,160,.400,0,1,.000,64,159,.403,.400,30,46,.652,25,53,78,110,40,15,60,82,158
22638,HOU,1983,Billy Paultz,34,57,0,695,89,200,.445,0,0,,89,200,.445,.445,26,57,.456,54,113,167,57,12,12,41,95,204
22639,HOU,1983,Chuck Nevitt,23,6,0,64,11,15,.733,0,0,,11,15,.733,.733,1,4,.250,6,11,17,0,1,12,7,14,23
22640,HOU,1983,Calvin Garrett,26,4,0,34,4,11,.364,0,1,.000,4,10,.400,.364,2,2,1.000,3,4,7,3,0,0,3,4,10
22641,HOU,1982,Moses Malone,26,81,81,3398,945,1822,.519,0,6,.000,945,1816,.520,.519,630,827,.762,558,630,1188,142,76,125,294,208,2520
22642,HOU,1982,Elvin Hayes,36,82,82,3032,519,1100,.472,0,5,.000,519,1095,.474,.472,280,422,.664,267,480,747,144,62,104,208,287,1318
22643,HOU,1982,Robert Reid,26,77,75,2913,437,958,.456,1,10,.100,436,948,.460,.457,160,214,.748,175,336,511,314,115,48,157,297,1035
22644,HOU,1982,Allen Leavell,24,79,61,2150,370,793,.467,9,31,.290,361,762,.474,.472,115,135,.852,49,119,168,457,150,15,153,182,864
22645,HOU,1982,Tom Henderson,30,75,23,1721,183,403,.454,0,2,.000,183,401,.456,.454,105,150,.700,33,105,138,306,55,7,105,120,471
22646,HOU,1982,Bill Willoughby,24,69,42,1475,240,464,.517,3,7,.429,237,457,.519,.520,56,77,.727,107,157,264,75,31,59,78,146,539
22647,HOU,1982,Mike Dunleavy,27,70,15,1315,206,450,.458,33,86,.384,173,364,.475,.494,75,106,.708,24,80,104,227,45,3,80,161,520
22648,HOU,1982,Calvin Murphy,33,64,0,1204,277,648,.427,1,16,.063,276,632,.437,.428,100,110,.909,20,41,61,163,43,1,82,142,655
22649,HOU,1982,Calvin Garrett,25,51,22,858,105,242,.434,3,10,.300,102,232,.440,.440,17,26,.654,27,67,94,76,32,6,38,94,230
22650,HOU,1982,Billy Paultz,33,65,3,807,89,226,.394,0,0,,89,226,.394,.394,34,65,.523,54,126,180,41,15,22,45,99,212
22651,HOU,1982,Major Jones,28,60,6,746,113,213,.531,0,3,.000,113,210,.538,.531,42,77,.545,80,122,202,25,20,29,50,100,268
22652,HOU,1982,Jawann Oldham,24,22,0,124,13,36,.361,0,0,,13,36,.361,.361,8,14,.571,7,17,24,3,2,10,6,28,34
22653,HOU,1982,Larry Spriggs,22,4,0,37,7,11,.636,0,0,,7,11,.636,.636,0,2,.000,2,4,6,4,2,0,4,7,14
22654,HOU,1981,Moses Malone,25,80,,3245,806,1545,.522,1,3,.333,805,1542,.522,.522,609,804,.757,474,706,1180,141,83,150,308,223,2222
22655,HOU,1981,Robert Reid,25,82,82,2963,536,1113,.482,0,4,.000,536,1109,.483,.482,229,303,.756,164,419,583,344,163,66,198,325,1301
22656,HOU,1981,Calvin Murphy,32,76,,2014,528,1074,.492,4,17,.235,524,1057,.496,.493,206,215,.958,33,54,87,222,111,6,129,209,1266
22657,HOU,1981,Allen Leavell,23,79,,1686,258,548,.471,2,17,.118,256,531,.482,.473,124,149,.832,30,104,134,384,97,15,189,160,642
22658,HOU,1981,Billy Paultz,32,81,,1659,262,517,.507,0,3,.000,262,514,.510,.507,75,153,.490,111,280,391,105,28,72,89,182,599
22659,HOU,1981,Calvin Garrett,24,70,,1638,188,415,.453,1,3,.333,187,412,.454,.454,50,62,.806,85,179,264,132,50,10,90,167,427
22660,HOU,1981,Mike Dunleavy,26,74,,1609,310,632,.491,1,16,.063,309,616,.502,.491,156,186,.839,28,90,118,268,64,2,137,165,777
22661,HOU,1981,Tom Henderson,29,66,,1411,137,332,.413,0,3,.000,137,329,.416,.413,78,95,.821,30,74,104,307,53,4,93,111,352
22662,HOU,1981,Rudy Tomjanovich,32,52,,1264,263,563,.467,12,51,.235,251,512,.490,.478,65,82,.793,78,130,208,81,19,6,58,121,603
22663,HOU,1981,Bill Willoughby,23,55,,1145,150,287,.523,0,0,,150,287,.523,.523,49,64,.766,74,153,227,64,18,31,74,102,349
22664,HOU,1981,Major Jones,27,68,,1003,117,252,.464,0,1,.000,117,251,.466,.464,64,101,.634,96,138,234,41,18,23,57,112,298
22665,HOU,1981,John Stroud,23,9,,88,11,34,.324,0,0,,11,34,.324,.324,3,4,.750,7,6,13,9,1,0,4,7,25
22666,HOU,1981,Lee Johnson,23,10,,80,7,23,.304,0,0,,7,23,.304,.304,3,5,.600,6,14,20,1,0,5,7,17,17
22667,HOU,1980,Moses Malone,24,82,82,3140,778,1549,.502,0,6,.000,778,1543,.504,.502,563,783,.719,573,617,1190,147,80,107,300,210,2119
22668,HOU,1980,Calvin Murphy,31,76,,2676,624,1267,.493,1,25,.040,623,1242,.502,.493,271,302,.897,68,82,150,299,143,9,162,269,1520
22669,HOU,1980,Robert Reid,24,76,,2304,419,861,.487,0,3,.000,419,858,.488,.487,153,208,.736,140,301,441,244,132,57,164,281,991
22670,HOU,1980,Allen Leavell,22,77,,2123,330,656,.503,3,19,.158,327,637,.513,.505,180,221,.814,57,127,184,417,127,28,205,197,843
22671,HOU,1980,Rudy Tomjanovich,31,62,,1834,370,778,.476,22,79,.278,348,699,.498,.490,118,147,.803,132,226,358,109,32,10,98,161,880
22672,HOU,1980,Rick Barry,35,72,,1816,325,771,.422,73,221,.330,252,550,.458,.469,143,153,.935,53,183,236,268,80,28,152,182,866
22673,HOU,1980,Tom Henderson,28,66,,1551,154,323,.477,0,2,.000,154,321,.480,.477,56,77,.727,34,77,111,274,55,4,102,107,364
22674,HOU,1980,Major Jones,26,82,,1545,188,392,.480,1,3,.333,187,389,.481,.481,61,108,.565,147,234,381,67,50,67,112,186,438
22675,HOU,1980,Mike Dunleavy,25,51,,1036,148,319,.464,3,20,.150,145,299,.485,.469,111,134,.828,26,74,100,210,40,4,110,120,410
22676,HOU,1980,Billy Paultz,31,37,,980,138,292,.473,0,0,,138,292,.473,.473,43,82,.524,92,173,265,70,22,39,57,86,319
22677,HOU,1980,John Shumate,27,29,,332,34,64,.531,0,0,,34,64,.531,.531,33,44,.750,25,54,79,23,8,9,27,39,101
22678,HOU,1980,Dwight Jones,27,21,,278,50,119,.420,0,0,,50,119,.420,.420,27,36,.750,31,41,72,11,4,5,20,48,127
22679,HOU,1980,Paul Mokeski,23,12,,113,11,33,.333,0,0,,11,33,.333,.333,7,9,.778,14,15,29,2,1,6,10,24,29
22680,HOU,1980,Rudy White,26,9,,106,13,24,.542,0,0,,13,24,.542,.542,10,13,.769,0,9,9,5,5,0,8,8,36
22681,HOU,1980,Alonzo Bradley,26,22,,96,17,48,.354,1,1,1.000,16,47,.340,.365,6,9,.667,2,4,6,3,3,0,8,9,41
